NODE_1_length_25698_cov_36.651041	315	395	0	80	80	1.0000000
NODE_1_length_25698_cov_36.651041	368	403	0	29	35	0.8285714
NODE_1_length_25698_cov_36.651041	368	403	2	3	35	0.0857143
NODE_1_length_25698_cov_36.651041	368	403	6	1	35	0.0285714
NODE_1_length_25698_cov_36.651041	368	403	8	1	35	0.0285714
NODE_1_length_25698_cov_36.651041	368	403	31	1	35	0.0285714
NODE_1_length_25698_cov_36.651041	24448	24494	0	46	46	1.0000000
NODE_2_length_24307_cov_15.119712	2613	2689	0	2	76	0.0263158
NODE_2_length_24307_cov_15.119712	2613	2689	2	17	76	0.2236842
NODE_2_length_24307_cov_15.119712	2613	2689	4	30	76	0.3947369
NODE_2_length_24307_cov_15.119712	2613	2689	7	1	76	0.0131579
NODE_2_length_24307_cov_15.119712	2613	2689	8	26	76	0.3421053
NODE_2_length_24307_cov_15.119712	2662	2716	0	29	54	0.5370370
NODE_2_length_24307_cov_15.119712	2662	2716	2	17	54	0.3148148
NODE_2_length_24307_cov_15.119712	2662	2716	4	8	54	0.1481481
NODE_2_length_24307_cov_15.119712	11257	11320	0	63	63	1.0000000
NODE_2_length_24307_cov_15.119712	20621	20701	2	69	80	0.8625000
NODE_2_length_24307_cov_15.119712	20621	20701	4	11	80	0.1375000
NODE_2_length_24307_cov_15.119712	20674	20754	0	16	80	0.2000000
NODE_2_length_24307_cov_15.119712	20674	20754	2	64	80	0.8000000
NODE_7_length_12349_cov_28.144571	12251	12310	2	4	59	0.0677966
NODE_7_length_12349_cov_28.144571	12251	12310	4	8	59	0.1355932
NODE_7_length_12349_cov_28.144571	12251	12310	5	9	59	0.1525424
NODE_7_length_12349_cov_28.144571	12251	12310	7	2	59	0.0338983
NODE_7_length_12349_cov_28.144571	12251	12310	9	1	59	0.0169492
NODE_7_length_12349_cov_28.144571	12251	12310	11	2	59	0.0338983
NODE_7_length_12349_cov_28.144571	12251	12310	13	11	59	0.1864407
NODE_7_length_12349_cov_28.144571	12251	12310	15	22	59	0.3728814
NODE_7_length_12349_cov_28.144571	12284	12310	2	4	26	0.1538462
NODE_7_length_12349_cov_28.144571	12284	12310	4	8	26	0.3076923
NODE_7_length_12349_cov_28.144571	12284	12310	5	9	26	0.3461539
NODE_7_length_12349_cov_28.144571	12284	12310	7	2	26	0.0769231
NODE_7_length_12349_cov_28.144571	12284	12310	9	1	26	0.0384615
NODE_7_length_12349_cov_28.144571	12284	12310	11	2	26	0.0769231
NODE_10_length_11096_cov_14.154679	6455	6535	0	80	80	1.0000000
NODE_10_length_11096_cov_14.154679	6508	6588	0	80	80	1.0000000
NODE_10_length_11096_cov_14.154679	6584	6664	0	80	80	1.0000000
NODE_10_length_11096_cov_14.154679	6637	6717	0	38	80	0.4750000
NODE_10_length_11096_cov_14.154679	6637	6717	1	42	80	0.5250000
NODE_10_length_11096_cov_14.154679	7182	7229	227	3	47	0.0638298
NODE_10_length_11096_cov_14.154679	7182	7229	230	1	47	0.0212766
NODE_10_length_11096_cov_14.154679	7182	7229	233	1	47	0.0212766
NODE_10_length_11096_cov_14.154679	7182	7229	235	1	47	0.0212766
NODE_10_length_11096_cov_14.154679	7182	7229	236	1	47	0.0212766
NODE_10_length_11096_cov_14.154679	7182	7229	237	4	47	0.0851064
NODE_10_length_11096_cov_14.154679	7182	7229	238	1	47	0.0212766
NODE_10_length_11096_cov_14.154679	7182	7229	245	1	47	0.0212766
NODE_10_length_11096_cov_14.154679	7182	7229	261	1	47	0.0212766
NODE_10_length_11096_cov_14.154679	7182	7229	264	1	47	0.0212766
NODE_10_length_11096_cov_14.154679	7182	7229	268	1	47	0.0212766
NODE_10_length_11096_cov_14.154679	7182	7229	269	1	47	0.0212766
NODE_10_length_11096_cov_14.154679	7182	7229	272	1	47	0.0212766
NODE_10_length_11096_cov_14.154679	7182	7229	280	1	47	0.0212766
NODE_10_length_11096_cov_14.154679	7182	7229	286	1	47	0.0212766
NODE_10_length_11096_cov_14.154679	7182	7229	290	1	47	0.0212766
NODE_10_length_11096_cov_14.154679	7182	7229	294	1	47	0.0212766
NODE_10_length_11096_cov_14.154679	7182	7229	296	1	47	0.0212766
NODE_10_length_11096_cov_14.154679	7182	7229	299	1	47	0.0212766
NODE_10_length_11096_cov_14.154679	7182	7229	300	1	47	0.0212766
NODE_10_length_11096_cov_14.154679	7182	7229	301	1	47	0.0212766
NODE_10_length_11096_cov_14.154679	7182	7229	303	1	47	0.0212766
NODE_10_length_11096_cov_14.154679	7182	7229	306	1	47	0.0212766
NODE_10_length_11096_cov_14.154679	7182	7229	307	1	47	0.0212766
NODE_10_length_11096_cov_14.154679	7182	7229	310	1	47	0.0212766
NODE_10_length_11096_cov_14.154679	7182	7229	312	1	47	0.0212766
NODE_10_length_11096_cov_14.154679	7182	7229	314	2	47	0.0425532
NODE_10_length_11096_cov_14.154679	7182	7229	316	1	47	0.0212766
NODE_10_length_11096_cov_14.154679	7182	7229	317	1	47	0.0212766
NODE_10_length_11096_cov_14.154679	7182	7229	322	2	47	0.0425532
NODE_10_length_11096_cov_14.154679	7182	7229	325	2	47	0.0425532
NODE_10_length_11096_cov_14.154679	7182	7229	331	2	47	0.0425532
NODE_10_length_11096_cov_14.154679	7182	7229	339	1	47	0.0212766
NODE_10_length_11096_cov_14.154679	7182	7229	343	3	47	0.0638298
NODE_10_length_11096_cov_14.154679	7182	7229	348	1	47	0.0212766
NODE_10_length_11096_cov_14.154679	7182	7229	353	1	47	0.0212766
NODE_10_length_11096_cov_14.154679	7218	7282	144	3	64	0.0468750
NODE_10_length_11096_cov_14.154679	7218	7282	147	1	64	0.0156250
NODE_10_length_11096_cov_14.154679	7218	7282	148	2	64	0.0312500
NODE_10_length_11096_cov_14.154679	7218	7282	149	2	64	0.0312500
NODE_10_length_11096_cov_14.154679	7218	7282	150	4	64	0.0625000
NODE_10_length_11096_cov_14.154679	7218	7282	151	2	64	0.0312500
NODE_10_length_11096_cov_14.154679	7218	7282	152	4	64	0.0625000
NODE_10_length_11096_cov_14.154679	7218	7282	154	1	64	0.0156250
NODE_10_length_11096_cov_14.154679	7218	7282	155	1	64	0.0156250
NODE_10_length_11096_cov_14.154679	7218	7282	156	3	64	0.0468750
NODE_10_length_11096_cov_14.154679	7218	7282	158	1	64	0.0156250
NODE_10_length_11096_cov_14.154679	7218	7282	162	1	64	0.0156250
NODE_10_length_11096_cov_14.154679	7218	7282	164	2	64	0.0312500
NODE_10_length_11096_cov_14.154679	7218	7282	165	3	64	0.0468750
NODE_10_length_11096_cov_14.154679	7218	7282	167	1	64	0.0156250
NODE_10_length_11096_cov_14.154679	7218	7282	180	1	64	0.0156250
NODE_10_length_11096_cov_14.154679	7218	7282	181	1	64	0.0156250
NODE_10_length_11096_cov_14.154679	7218	7282	187	2	64	0.0312500
NODE_10_length_11096_cov_14.154679	7218	7282	189	1	64	0.0156250
NODE_10_length_11096_cov_14.154679	7218	7282	197	1	64	0.0156250
NODE_10_length_11096_cov_14.154679	7218	7282	199	2	64	0.0312500
NODE_10_length_11096_cov_14.154679	7218	7282	200	1	64	0.0156250
NODE_10_length_11096_cov_14.154679	7218	7282	201	1	64	0.0156250
NODE_10_length_11096_cov_14.154679	7218	7282	203	2	64	0.0312500
NODE_10_length_11096_cov_14.154679	7218	7282	204	1	64	0.0156250
NODE_10_length_11096_cov_14.154679	7218	7282	205	2	64	0.0312500
NODE_10_length_11096_cov_14.154679	7218	7282	207	2	64	0.0312500
NODE_10_length_11096_cov_14.154679	7218	7282	208	2	64	0.0312500
NODE_10_length_11096_cov_14.154679	7218	7282	210	1	64	0.0156250
NODE_10_length_11096_cov_14.154679	7218	7282	213	1	64	0.0156250
NODE_10_length_11096_cov_14.154679	7218	7282	217	1	64	0.0156250
NODE_10_length_11096_cov_14.154679	7218	7282	227	3	64	0.0468750
NODE_10_length_11096_cov_14.154679	7218	7282	230	1	64	0.0156250
NODE_10_length_11096_cov_14.154679	7218	7282	233	1	64	0.0156250
NODE_10_length_11096_cov_14.154679	7218	7282	235	1	64	0.0156250
NODE_10_length_11096_cov_14.154679	7218	7282	236	1	64	0.0156250
NODE_10_length_11096_cov_14.154679	7218	7282	237	3	64	0.0468750
NODE_10_length_11096_cov_14.154679	7218	7282	238	1	64	0.0156250
NODE_13_length_10749_cov_34.330235	3589	3669	0	80	80	1.0000000
NODE_13_length_10749_cov_34.330235	3642	3722	0	80	80	1.0000000
NODE_13_length_10749_cov_34.330235	3718	3798	0	80	80	1.0000000
NODE_13_length_10749_cov_34.330235	3771	3851	0	73	80	0.9125000
NODE_13_length_10749_cov_34.330235	3771	3851	2	2	80	0.0250000
NODE_13_length_10749_cov_34.330235	3771	3851	4	5	80	0.0625000
NODE_14_length_10557_cov_50.055938	423	503	0	80	80	1.0000000
NODE_14_length_10557_cov_50.055938	476	556	0	80	80	1.0000000
NODE_14_length_10557_cov_50.055938	1625	1696	0	5	71	0.0704225
NODE_14_length_10557_cov_50.055938	1625	1696	2	1	71	0.0140845
NODE_14_length_10557_cov_50.055938	1625	1696	6	65	71	0.9154930
NODE_14_length_10557_cov_50.055938	1678	1733	5	12	55	0.2181818
NODE_14_length_10557_cov_50.055938	1678	1733	6	41	55	0.7454545
NODE_14_length_10557_cov_50.055938	1678	1733	7	2	55	0.0363636
NODE_14_length_10557_cov_50.055938	2428	2488	5	31	60	0.5166667
NODE_14_length_10557_cov_50.055938	2428	2488	7	25	60	0.4166667
NODE_14_length_10557_cov_50.055938	2428	2488	9	4	60	0.0666667
NODE_17_length_10101_cov_12.236253	923	966	0	43	43	1.0000000
NODE_17_length_10101_cov_12.236253	943	1007	0	64	64	1.0000000
NODE_17_length_10101_cov_12.236253	1715	1795	0	80	80	1.0000000
NODE_17_length_10101_cov_12.236253	1768	1820	0	51	52	0.9807692
NODE_17_length_10101_cov_12.236253	1768	1820	6	1	52	0.0192308
NODE_20_length_9442_cov_109.961147	2108	2188	0	26	80	0.3250000
NODE_20_length_9442_cov_109.961147	2108	2188	2	27	80	0.3375000
NODE_20_length_9442_cov_109.961147	2108	2188	4	27	80	0.3375000
NODE_20_length_9442_cov_109.961147	2161	2241	0	11	80	0.1375000
NODE_20_length_9442_cov_109.961147	2161	2241	2	27	80	0.3375000
NODE_20_length_9442_cov_109.961147	2161	2241	4	42	80	0.5250000
NODE_21_length_9414_cov_34.165217	2363	2443	26	1	80	0.0125000
NODE_21_length_9414_cov_34.165217	2363	2443	28	14	80	0.1750000
NODE_21_length_9414_cov_34.165217	2363	2443	29	1	80	0.0125000
NODE_21_length_9414_cov_34.165217	2363	2443	31	2	80	0.0250000
NODE_21_length_9414_cov_34.165217	2363	2443	32	1	80	0.0125000
NODE_21_length_9414_cov_34.165217	2363	2443	37	34	80	0.4250000
NODE_21_length_9414_cov_34.165217	2363	2443	38	27	80	0.3375000
NODE_21_length_9414_cov_34.165217	2416	2484	10	13	68	0.1911765
NODE_21_length_9414_cov_34.165217	2416	2484	12	4	68	0.0588235
NODE_21_length_9414_cov_34.165217	2416	2484	14	1	68	0.0147059
NODE_21_length_9414_cov_34.165217	2416	2484	18	8	68	0.1176471
NODE_21_length_9414_cov_34.165217	2416	2484	20	5	68	0.0735294
NODE_21_length_9414_cov_34.165217	2416	2484	22	3	68	0.0441176
NODE_21_length_9414_cov_34.165217	2416	2484	24	4	68	0.0588235
NODE_21_length_9414_cov_34.165217	2416	2484	27	3	68	0.0441176
NODE_21_length_9414_cov_34.165217	2416	2484	29	1	68	0.0147059
NODE_21_length_9414_cov_34.165217	2416	2484	31	2	68	0.0294118
NODE_21_length_9414_cov_34.165217	2416	2484	37	24	68	0.3529412
NODE_21_length_9414_cov_34.165217	5899	5975	59	2	76	0.0263158
NODE_21_length_9414_cov_34.165217	5899	5975	60	3	76	0.0394737
NODE_21_length_9414_cov_34.165217	5899	5975	61	2	76	0.0263158
NODE_21_length_9414_cov_34.165217	5899	5975	62	7	76	0.0921053
NODE_21_length_9414_cov_34.165217	5899	5975	63	2	76	0.0263158
NODE_21_length_9414_cov_34.165217	5899	5975	64	1	76	0.0131579
NODE_21_length_9414_cov_34.165217	5899	5975	65	3	76	0.0394737
NODE_21_length_9414_cov_34.165217	5899	5975	67	8	76	0.1052632
NODE_21_length_9414_cov_34.165217	5899	5975	68	2	76	0.0263158
NODE_21_length_9414_cov_34.165217	5899	5975	69	9	76	0.1184211
NODE_21_length_9414_cov_34.165217	5899	5975	70	4	76	0.0526316
NODE_21_length_9414_cov_34.165217	5899	5975	71	9	76	0.1184211
NODE_21_length_9414_cov_34.165217	5899	5975	73	1	76	0.0131579
NODE_21_length_9414_cov_34.165217	5899	5975	74	1	76	0.0131579
NODE_21_length_9414_cov_34.165217	5899	5975	75	5	76	0.0657895
NODE_21_length_9414_cov_34.165217	5899	5975	77	6	76	0.0789474
NODE_21_length_9414_cov_34.165217	5899	5975	78	4	76	0.0526316
NODE_21_length_9414_cov_34.165217	5899	5975	79	7	76	0.0921053
NODE_24_length_9168_cov_47.407542	470	550	25	3	80	0.0375000
NODE_24_length_9168_cov_47.407542	470	550	26	1	80	0.0125000
NODE_24_length_9168_cov_47.407542	470	550	27	10	80	0.1250000
NODE_24_length_9168_cov_47.407542	470	550	29	2	80	0.0250000
NODE_24_length_9168_cov_47.407542	470	550	30	1	80	0.0125000
NODE_24_length_9168_cov_47.407542	470	550	31	7	80	0.0875000
NODE_24_length_9168_cov_47.407542	470	550	32	1	80	0.0125000
NODE_24_length_9168_cov_47.407542	470	550	33	2	80	0.0250000
NODE_24_length_9168_cov_47.407542	470	550	35	8	80	0.1000000
NODE_24_length_9168_cov_47.407542	470	550	37	5	80	0.0625000
NODE_24_length_9168_cov_47.407542	470	550	41	7	80	0.0875000
NODE_24_length_9168_cov_47.407542	470	550	43	1	80	0.0125000
NODE_24_length_9168_cov_47.407542	470	550	45	10	80	0.1250000
NODE_24_length_9168_cov_47.407542	470	550	47	13	80	0.1625000
NODE_24_length_9168_cov_47.407542	470	550	48	1	80	0.0125000
NODE_24_length_9168_cov_47.407542	470	550	49	8	80	0.1000000
NODE_24_length_9168_cov_47.407542	523	603	8	29	80	0.3625000
NODE_24_length_9168_cov_47.407542	523	603	11	6	80	0.0750000
NODE_24_length_9168_cov_47.407542	523	603	13	16	80	0.2000000
NODE_24_length_9168_cov_47.407542	523	603	15	2	80	0.0250000
NODE_24_length_9168_cov_47.407542	523	603	25	3	80	0.0375000
NODE_24_length_9168_cov_47.407542	523	603	26	1	80	0.0125000
NODE_24_length_9168_cov_47.407542	523	603	27	10	80	0.1250000
NODE_24_length_9168_cov_47.407542	523	603	29	2	80	0.0250000
NODE_24_length_9168_cov_47.407542	523	603	30	1	80	0.0125000
NODE_24_length_9168_cov_47.407542	523	603	31	7	80	0.0875000
NODE_24_length_9168_cov_47.407542	523	603	32	1	80	0.0125000
NODE_24_length_9168_cov_47.407542	523	603	33	2	80	0.0250000
NODE_27_length_9108_cov_47.430347	4786	4866	220	2	80	0.0250000
NODE_27_length_9108_cov_47.430347	4786	4866	222	2	80	0.0250000
NODE_27_length_9108_cov_47.430347	4786	4866	224	1	80	0.0125000
NODE_27_length_9108_cov_47.430347	4786	4866	226	2	80	0.0250000
NODE_27_length_9108_cov_47.430347	4786	4866	227	4	80	0.0500000
NODE_27_length_9108_cov_47.430347	4786	4866	230	1	80	0.0125000
NODE_27_length_9108_cov_47.430347	4786	4866	232	2	80	0.0250000
NODE_27_length_9108_cov_47.430347	4786	4866	233	6	80	0.0750000
NODE_27_length_9108_cov_47.430347	4786	4866	234	3	80	0.0375000
NODE_27_length_9108_cov_47.430347	4786	4866	235	1	80	0.0125000
NODE_27_length_9108_cov_47.430347	4786	4866	236	2	80	0.0250000
NODE_27_length_9108_cov_47.430347	4786	4866	239	2	80	0.0250000
NODE_27_length_9108_cov_47.430347	4786	4866	241	3	80	0.0375000
NODE_27_length_9108_cov_47.430347	4786	4866	242	1	80	0.0125000
NODE_27_length_9108_cov_47.430347	4786	4866	243	2	80	0.0250000
NODE_27_length_9108_cov_47.430347	4786	4866	244	1	80	0.0125000
NODE_27_length_9108_cov_47.430347	4786	4866	246	3	80	0.0375000
NODE_27_length_9108_cov_47.430347	4786	4866	247	3	80	0.0375000
NODE_27_length_9108_cov_47.430347	4786	4866	248	2	80	0.0250000
NODE_27_length_9108_cov_47.430347	4786	4866	249	1	80	0.0125000
NODE_27_length_9108_cov_47.430347	4786	4866	250	1	80	0.0125000
NODE_27_length_9108_cov_47.430347	4786	4866	251	4	80	0.0500000
NODE_27_length_9108_cov_47.430347	4786	4866	252	8	80	0.1000000
NODE_27_length_9108_cov_47.430347	4786	4866	253	1	80	0.0125000
NODE_27_length_9108_cov_47.430347	4786	4866	254	5	80	0.0625000
NODE_27_length_9108_cov_47.430347	4786	4866	255	2	80	0.0250000
NODE_27_length_9108_cov_47.430347	4786	4866	256	3	80	0.0375000
NODE_27_length_9108_cov_47.430347	4786	4866	258	2	80	0.0250000
NODE_27_length_9108_cov_47.430347	4786	4866	259	1	80	0.0125000
NODE_27_length_9108_cov_47.430347	4786	4866	260	2	80	0.0250000
NODE_27_length_9108_cov_47.430347	4786	4866	261	3	80	0.0375000
NODE_27_length_9108_cov_47.430347	4786	4866	262	3	80	0.0375000
NODE_27_length_9108_cov_47.430347	4786	4866	264	1	80	0.0125000
NODE_27_length_9108_cov_47.430347	4839	4902	235	1	63	0.0158730
NODE_27_length_9108_cov_47.430347	4839	4902	236	1	63	0.0158730
NODE_27_length_9108_cov_47.430347	4839	4902	237	2	63	0.0317460
NODE_27_length_9108_cov_47.430347	4839	4902	239	2	63	0.0317460
NODE_27_length_9108_cov_47.430347	4839	4902	241	2	63	0.0317460
NODE_27_length_9108_cov_47.430347	4839	4902	242	1	63	0.0158730
NODE_27_length_9108_cov_47.430347	4839	4902	244	1	63	0.0158730
NODE_27_length_9108_cov_47.430347	4839	4902	246	3	63	0.0476190
NODE_27_length_9108_cov_47.430347	4839	4902	247	3	63	0.0476190
NODE_27_length_9108_cov_47.430347	4839	4902	248	7	63	0.1111111
NODE_27_length_9108_cov_47.430347	4839	4902	249	1	63	0.0158730
NODE_27_length_9108_cov_47.430347	4839	4902	250	4	63	0.0634921
NODE_27_length_9108_cov_47.430347	4839	4902	251	5	63	0.0793651
NODE_27_length_9108_cov_47.430347	4839	4902	252	10	63	0.1587302
NODE_27_length_9108_cov_47.430347	4839	4902	253	1	63	0.0158730
NODE_27_length_9108_cov_47.430347	4839	4902	254	8	63	0.1269841
NODE_27_length_9108_cov_47.430347	4839	4902	255	3	63	0.0476190
NODE_27_length_9108_cov_47.430347	4839	4902	256	3	63	0.0476190
NODE_27_length_9108_cov_47.430347	4839	4902	257	3	63	0.0476190
NODE_27_length_9108_cov_47.430347	4839	4902	258	1	63	0.0158730
NODE_27_length_9108_cov_47.430347	4839	4902	259	1	63	0.0158730
NODE_27_length_9108_cov_47.430347	4895	4963	162	1	68	0.0147059
NODE_27_length_9108_cov_47.430347	4895	4963	168	1	68	0.0147059
NODE_27_length_9108_cov_47.430347	4895	4963	172	1	68	0.0147059
NODE_27_length_9108_cov_47.430347	4895	4963	174	2	68	0.0294118
NODE_27_length_9108_cov_47.430347	4895	4963	176	1	68	0.0147059
NODE_27_length_9108_cov_47.430347	4895	4963	178	1	68	0.0147059
NODE_27_length_9108_cov_47.430347	4895	4963	182	1	68	0.0147059
NODE_27_length_9108_cov_47.430347	4895	4963	186	1	68	0.0147059
NODE_27_length_9108_cov_47.430347	4895	4963	188	3	68	0.0441176
NODE_27_length_9108_cov_47.430347	4895	4963	192	5	68	0.0735294
NODE_27_length_9108_cov_47.430347	4895	4963	197	1	68	0.0147059
NODE_27_length_9108_cov_47.430347	4895	4963	199	1	68	0.0147059
NODE_27_length_9108_cov_47.430347	4895	4963	201	1	68	0.0147059
NODE_27_length_9108_cov_47.430347	4895	4963	203	4	68	0.0588235
NODE_27_length_9108_cov_47.430347	4895	4963	208	3	68	0.0441176
NODE_27_length_9108_cov_47.430347	4895	4963	214	1	68	0.0147059
NODE_27_length_9108_cov_47.430347	4895	4963	218	3	68	0.0441176
NODE_27_length_9108_cov_47.430347	4895	4963	223	3	68	0.0441176
NODE_27_length_9108_cov_47.430347	4895	4963	228	1	68	0.0147059
NODE_27_length_9108_cov_47.430347	4895	4963	230	1	68	0.0147059
NODE_27_length_9108_cov_47.430347	4895	4963	233	4	68	0.0588235
NODE_27_length_9108_cov_47.430347	4895	4963	239	1	68	0.0147059
NODE_27_length_9108_cov_47.430347	4895	4963	244	1	68	0.0147059
NODE_27_length_9108_cov_47.430347	4895	4963	245	1	68	0.0147059
NODE_27_length_9108_cov_47.430347	4895	4963	250	1	68	0.0147059
NODE_27_length_9108_cov_47.430347	4895	4963	253	1	68	0.0147059
NODE_27_length_9108_cov_47.430347	4895	4963	254	6	68	0.0882353
NODE_27_length_9108_cov_47.430347	4895	4963	255	1	68	0.0147059
NODE_27_length_9108_cov_47.430347	4895	4963	256	6	68	0.0882353
NODE_27_length_9108_cov_47.430347	4895	4963	257	4	68	0.0588235
NODE_27_length_9108_cov_47.430347	4895	4963	258	4	68	0.0588235
NODE_27_length_9108_cov_47.430347	4895	4963	259	1	68	0.0147059
NODE_27_length_9108_cov_47.430347	4895	4963	262	1	68	0.0147059
NODE_27_length_9108_cov_47.430347	4936	5016	37	3	80	0.0375000
NODE_27_length_9108_cov_47.430347	4936	5016	39	2	80	0.0250000
NODE_27_length_9108_cov_47.430347	4936	5016	48	1	80	0.0125000
NODE_27_length_9108_cov_47.430347	4936	5016	50	1	80	0.0125000
NODE_27_length_9108_cov_47.430347	4936	5016	57	2	80	0.0250000
NODE_27_length_9108_cov_47.430347	4936	5016	61	1	80	0.0125000
NODE_27_length_9108_cov_47.430347	4936	5016	71	1	80	0.0125000
NODE_27_length_9108_cov_47.430347	4936	5016	76	1	80	0.0125000
NODE_27_length_9108_cov_47.430347	4936	5016	88	2	80	0.0250000
NODE_27_length_9108_cov_47.430347	4936	5016	89	2	80	0.0250000
NODE_27_length_9108_cov_47.430347	4936	5016	94	1	80	0.0125000
NODE_27_length_9108_cov_47.430347	4936	5016	98	1	80	0.0125000
NODE_27_length_9108_cov_47.430347	4936	5016	103	5	80	0.0625000
NODE_27_length_9108_cov_47.430347	4936	5016	108	1	80	0.0125000
NODE_27_length_9108_cov_47.430347	4936	5016	113	1	80	0.0125000
NODE_27_length_9108_cov_47.430347	4936	5016	114	2	80	0.0250000
NODE_27_length_9108_cov_47.430347	4936	5016	118	1	80	0.0125000
NODE_27_length_9108_cov_47.430347	4936	5016	122	5	80	0.0625000
NODE_27_length_9108_cov_47.430347	4936	5016	124	1	80	0.0125000
NODE_27_length_9108_cov_47.430347	4936	5016	126	1	80	0.0125000
NODE_27_length_9108_cov_47.430347	4936	5016	128	2	80	0.0250000
NODE_27_length_9108_cov_47.430347	4936	5016	136	3	80	0.0375000
NODE_27_length_9108_cov_47.430347	4936	5016	142	1	80	0.0125000
NODE_27_length_9108_cov_47.430347	4936	5016	144	3	80	0.0375000
NODE_27_length_9108_cov_47.430347	4936	5016	147	1	80	0.0125000
NODE_27_length_9108_cov_47.430347	4936	5016	151	1	80	0.0125000
NODE_27_length_9108_cov_47.430347	4936	5016	155	1	80	0.0125000
NODE_27_length_9108_cov_47.430347	4936	5016	157	2	80	0.0250000
NODE_27_length_9108_cov_47.430347	4936	5016	161	3	80	0.0375000
NODE_27_length_9108_cov_47.430347	4936	5016	162	2	80	0.0250000
NODE_27_length_9108_cov_47.430347	4936	5016	168	1	80	0.0125000
NODE_27_length_9108_cov_47.430347	4936	5016	172	1	80	0.0125000
NODE_27_length_9108_cov_47.430347	4936	5016	174	2	80	0.0250000
NODE_27_length_9108_cov_47.430347	4936	5016	176	1	80	0.0125000
NODE_27_length_9108_cov_47.430347	4936	5016	178	1	80	0.0125000
NODE_27_length_9108_cov_47.430347	4936	5016	182	1	80	0.0125000
NODE_27_length_9108_cov_47.430347	4936	5016	186	1	80	0.0125000
NODE_27_length_9108_cov_47.430347	4936	5016	188	3	80	0.0375000
NODE_27_length_9108_cov_47.430347	4936	5016	192	5	80	0.0625000
NODE_27_length_9108_cov_47.430347	4936	5016	197	1	80	0.0125000
NODE_27_length_9108_cov_47.430347	4936	5016	199	1	80	0.0125000
NODE_27_length_9108_cov_47.430347	4936	5016	201	1	80	0.0125000
NODE_27_length_9108_cov_47.430347	4936	5016	203	4	80	0.0500000
NODE_27_length_9108_cov_47.430347	4936	5016	208	3	80	0.0375000
NODE_28_length_9108_cov_26.469974	44	120	0	76	76	1.0000000
NODE_28_length_9108_cov_26.469974	7711	7791	0	1	80	0.0125000
NODE_28_length_9108_cov_26.469974	7711	7791	11	2	80	0.0250000
NODE_28_length_9108_cov_26.469974	7711	7791	13	2	80	0.0250000
NODE_28_length_9108_cov_26.469974	7711	7791	14	6	80	0.0750000
NODE_28_length_9108_cov_26.469974	7711	7791	16	8	80	0.1000000
NODE_28_length_9108_cov_26.469974	7711	7791	17	3	80	0.0375000
NODE_28_length_9108_cov_26.469974	7711	7791	25	1	80	0.0125000
NODE_28_length_9108_cov_26.469974	7711	7791	31	2	80	0.0250000
NODE_28_length_9108_cov_26.469974	7711	7791	33	1	80	0.0125000
NODE_28_length_9108_cov_26.469974	7711	7791	35	1	80	0.0125000
NODE_28_length_9108_cov_26.469974	7711	7791	41	1	80	0.0125000
NODE_28_length_9108_cov_26.469974	7711	7791	42	3	80	0.0375000
NODE_28_length_9108_cov_26.469974	7711	7791	47	8	80	0.1000000
NODE_28_length_9108_cov_26.469974	7711	7791	49	3	80	0.0375000
NODE_28_length_9108_cov_26.469974	7711	7791	50	1	80	0.0125000
NODE_28_length_9108_cov_26.469974	7711	7791	54	2	80	0.0250000
NODE_28_length_9108_cov_26.469974	7711	7791	57	2	80	0.0250000
NODE_28_length_9108_cov_26.469974	7711	7791	59	1	80	0.0125000
NODE_28_length_9108_cov_26.469974	7711	7791	61	5	80	0.0625000
NODE_28_length_9108_cov_26.469974	7711	7791	63	1	80	0.0125000
NODE_28_length_9108_cov_26.469974	7711	7791	65	3	80	0.0375000
NODE_28_length_9108_cov_26.469974	7711	7791	68	2	80	0.0250000
NODE_28_length_9108_cov_26.469974	7711	7791	70	1	80	0.0125000
NODE_28_length_9108_cov_26.469974	7711	7791	73	3	80	0.0375000
NODE_28_length_9108_cov_26.469974	7711	7791	74	1	80	0.0125000
NODE_28_length_9108_cov_26.469974	7711	7791	78	1	80	0.0125000
NODE_28_length_9108_cov_26.469974	7711	7791	80	1	80	0.0125000
NODE_28_length_9108_cov_26.469974	7711	7791	84	3	80	0.0375000
NODE_28_length_9108_cov_26.469974	7711	7791	85	1	80	0.0125000
NODE_28_length_9108_cov_26.469974	7711	7791	89	1	80	0.0125000
NODE_28_length_9108_cov_26.469974	7711	7791	92	2	80	0.0250000
NODE_28_length_9108_cov_26.469974	7711	7791	97	2	80	0.0250000
NODE_28_length_9108_cov_26.469974	7711	7791	105	1	80	0.0125000
NODE_28_length_9108_cov_26.469974	7711	7791	106	1	80	0.0125000
NODE_28_length_9108_cov_26.469974	7711	7791	108	1	80	0.0125000
NODE_28_length_9108_cov_26.469974	7711	7791	111	2	80	0.0250000
NODE_28_length_9108_cov_26.469974	8144	8224	13	1	80	0.0125000
NODE_28_length_9108_cov_26.469974	8144	8224	24	1	80	0.0125000
NODE_28_length_9108_cov_26.469974	8144	8224	25	1	80	0.0125000
NODE_28_length_9108_cov_26.469974	8144	8224	27	1	80	0.0125000
NODE_28_length_9108_cov_26.469974	8144	8224	29	2	80	0.0250000
NODE_28_length_9108_cov_26.469974	8144	8224	30	2	80	0.0250000
NODE_28_length_9108_cov_26.469974	8144	8224	32	2	80	0.0250000
NODE_28_length_9108_cov_26.469974	8144	8224	34	6	80	0.0750000
NODE_28_length_9108_cov_26.469974	8144	8224	36	1	80	0.0125000
NODE_28_length_9108_cov_26.469974	8144	8224	38	1	80	0.0125000
NODE_28_length_9108_cov_26.469974	8144	8224	40	2	80	0.0250000
NODE_28_length_9108_cov_26.469974	8144	8224	52	3	80	0.0375000
NODE_28_length_9108_cov_26.469974	8144	8224	59	3	80	0.0375000
NODE_28_length_9108_cov_26.469974	8144	8224	63	1	80	0.0125000
NODE_28_length_9108_cov_26.469974	8144	8224	64	1	80	0.0125000
NODE_28_length_9108_cov_26.469974	8144	8224	66	2	80	0.0250000
NODE_28_length_9108_cov_26.469974	8144	8224	69	1	80	0.0125000
NODE_28_length_9108_cov_26.469974	8144	8224	72	4	80	0.0500000
NODE_28_length_9108_cov_26.469974	8144	8224	76	10	80	0.1250000
NODE_28_length_9108_cov_26.469974	8144	8224	78	1	80	0.0125000
NODE_28_length_9108_cov_26.469974	8144	8224	82	1	80	0.0125000
NODE_28_length_9108_cov_26.469974	8144	8224	83	9	80	0.1125000
NODE_28_length_9108_cov_26.469974	8144	8224	85	7	80	0.0875000
NODE_28_length_9108_cov_26.469974	8144	8224	86	1	80	0.0125000
NODE_28_length_9108_cov_26.469974	8144	8224	92	2	80	0.0250000
NODE_28_length_9108_cov_26.469974	8144	8224	94	3	80	0.0375000
NODE_28_length_9108_cov_26.469974	8144	8224	98	1	80	0.0125000
NODE_28_length_9108_cov_26.469974	8144	8224	105	3	80	0.0375000
NODE_28_length_9108_cov_26.469974	8144	8224	107	2	80	0.0250000
NODE_28_length_9108_cov_26.469974	8144	8224	109	3	80	0.0375000
NODE_28_length_9108_cov_26.469974	8144	8224	111	1	80	0.0125000
NODE_28_length_9108_cov_26.469974	8144	8224	115	1	80	0.0125000
NODE_28_length_9108_cov_26.469974	8568	8648	0	38	80	0.4750000
NODE_28_length_9108_cov_26.469974	8568	8648	2	42	80	0.5250000
NODE_28_length_9108_cov_26.469974	8621	8701	2	80	80	1.0000000
NODE_30_length_8743_cov_14.172721	7849	7929	78	1	80	0.0125000
NODE_30_length_8743_cov_14.172721	7849	7929	81	1	80	0.0125000
NODE_30_length_8743_cov_14.172721	7849	7929	83	1	80	0.0125000
NODE_30_length_8743_cov_14.172721	7849	7929	91	1	80	0.0125000
NODE_30_length_8743_cov_14.172721	7849	7929	97	1	80	0.0125000
NODE_30_length_8743_cov_14.172721	7849	7929	99	1	80	0.0125000
NODE_30_length_8743_cov_14.172721	7849	7929	106	1	80	0.0125000
NODE_30_length_8743_cov_14.172721	7849	7929	110	1	80	0.0125000
NODE_30_length_8743_cov_14.172721	7849	7929	112	1	80	0.0125000
NODE_30_length_8743_cov_14.172721	7849	7929	115	2	80	0.0250000
NODE_30_length_8743_cov_14.172721	7849	7929	117	3	80	0.0375000
NODE_30_length_8743_cov_14.172721	7849	7929	118	4	80	0.0500000
NODE_30_length_8743_cov_14.172721	7849	7929	126	1	80	0.0125000
NODE_30_length_8743_cov_14.172721	7849	7929	130	1	80	0.0125000
NODE_30_length_8743_cov_14.172721	7849	7929	131	1	80	0.0125000
NODE_30_length_8743_cov_14.172721	7849	7929	134	7	80	0.0875000
NODE_30_length_8743_cov_14.172721	7849	7929	136	2	80	0.0250000
NODE_30_length_8743_cov_14.172721	7849	7929	138	1	80	0.0125000
NODE_30_length_8743_cov_14.172721	7849	7929	139	3	80	0.0375000
NODE_30_length_8743_cov_14.172721	7849	7929	140	1	80	0.0125000
NODE_30_length_8743_cov_14.172721	7849	7929	142	1	80	0.0125000
NODE_30_length_8743_cov_14.172721	7849	7929	148	1	80	0.0125000
NODE_30_length_8743_cov_14.172721	7849	7929	150	3	80	0.0375000
NODE_30_length_8743_cov_14.172721	7849	7929	152	1	80	0.0125000
NODE_30_length_8743_cov_14.172721	7849	7929	154	3	80	0.0375000
NODE_30_length_8743_cov_14.172721	7849	7929	156	2	80	0.0250000
NODE_30_length_8743_cov_14.172721	7849	7929	159	1	80	0.0125000
NODE_30_length_8743_cov_14.172721	7849	7929	160	5	80	0.0625000
NODE_30_length_8743_cov_14.172721	7849	7929	162	2	80	0.0250000
NODE_30_length_8743_cov_14.172721	7849	7929	164	4	80	0.0500000
NODE_30_length_8743_cov_14.172721	7849	7929	168	5	80	0.0625000
NODE_30_length_8743_cov_14.172721	7849	7929	169	1	80	0.0125000
NODE_30_length_8743_cov_14.172721	7849	7929	171	2	80	0.0250000
NODE_30_length_8743_cov_14.172721	7849	7929	174	1	80	0.0125000
NODE_30_length_8743_cov_14.172721	7849	7929	178	2	80	0.0250000
NODE_30_length_8743_cov_14.172721	7849	7929	179	1	80	0.0125000
NODE_30_length_8743_cov_14.172721	7849	7929	180	1	80	0.0125000
NODE_30_length_8743_cov_14.172721	7849	7929	181	1	80	0.0125000
NODE_30_length_8743_cov_14.172721	7849	7929	183	2	80	0.0250000
NODE_30_length_8743_cov_14.172721	7849	7929	185	6	80	0.0750000
NODE_30_length_8743_cov_14.172721	7902	7964	23	2	62	0.0322581
NODE_30_length_8743_cov_14.172721	7902	7964	25	3	62	0.0483871
NODE_30_length_8743_cov_14.172721	7902	7964	27	3	62	0.0483871
NODE_30_length_8743_cov_14.172721	7902	7964	31	1	62	0.0161290
NODE_30_length_8743_cov_14.172721	7902	7964	35	2	62	0.0322581
NODE_30_length_8743_cov_14.172721	7902	7964	43	1	62	0.0161290
NODE_30_length_8743_cov_14.172721	7902	7964	47	3	62	0.0483871
NODE_30_length_8743_cov_14.172721	7902	7964	51	1	62	0.0161290
NODE_30_length_8743_cov_14.172721	7902	7964	53	1	62	0.0161290
NODE_30_length_8743_cov_14.172721	7902	7964	55	3	62	0.0483871
NODE_30_length_8743_cov_14.172721	7902	7964	57	1	62	0.0161290
NODE_30_length_8743_cov_14.172721	7902	7964	59	1	62	0.0161290
NODE_30_length_8743_cov_14.172721	7902	7964	63	5	62	0.0806452
NODE_30_length_8743_cov_14.172721	7902	7964	64	3	62	0.0483871
NODE_30_length_8743_cov_14.172721	7902	7964	66	2	62	0.0322581
NODE_30_length_8743_cov_14.172721	7902	7964	68	2	62	0.0322581
NODE_30_length_8743_cov_14.172721	7902	7964	76	1	62	0.0161290
NODE_30_length_8743_cov_14.172721	7902	7964	78	1	62	0.0161290
NODE_30_length_8743_cov_14.172721	7902	7964	81	1	62	0.0161290
NODE_30_length_8743_cov_14.172721	7902	7964	83	1	62	0.0161290
NODE_30_length_8743_cov_14.172721	7902	7964	91	1	62	0.0161290
NODE_30_length_8743_cov_14.172721	7902	7964	97	1	62	0.0161290
NODE_30_length_8743_cov_14.172721	7902	7964	99	1	62	0.0161290
NODE_30_length_8743_cov_14.172721	7902	7964	106	1	62	0.0161290
NODE_30_length_8743_cov_14.172721	7902	7964	110	1	62	0.0161290
NODE_30_length_8743_cov_14.172721	7902	7964	112	1	62	0.0161290
NODE_30_length_8743_cov_14.172721	7902	7964	115	2	62	0.0322581
NODE_30_length_8743_cov_14.172721	7902	7964	117	3	62	0.0483871
NODE_30_length_8743_cov_14.172721	7902	7964	118	4	62	0.0645161
NODE_30_length_8743_cov_14.172721	7902	7964	126	1	62	0.0161290
NODE_30_length_8743_cov_14.172721	7902	7964	130	1	62	0.0161290
NODE_30_length_8743_cov_14.172721	7902	7964	131	1	62	0.0161290
NODE_30_length_8743_cov_14.172721	7902	7964	134	6	62	0.0967742
NODE_32_length_8707_cov_6.353044	8541	8621	0	9	80	0.1125000
NODE_32_length_8707_cov_6.353044	8541	8621	4	4	80	0.0500000
NODE_32_length_8707_cov_6.353044	8541	8621	10	3	80	0.0375000
NODE_32_length_8707_cov_6.353044	8541	8621	15	1	80	0.0125000
NODE_32_length_8707_cov_6.353044	8541	8621	17	2	80	0.0250000
NODE_32_length_8707_cov_6.353044	8541	8621	23	9	80	0.1125000
NODE_32_length_8707_cov_6.353044	8541	8621	25	3	80	0.0375000
NODE_32_length_8707_cov_6.353044	8541	8621	27	7	80	0.0875000
NODE_32_length_8707_cov_6.353044	8541	8621	29	2	80	0.0250000
NODE_32_length_8707_cov_6.353044	8541	8621	33	1	80	0.0125000
NODE_32_length_8707_cov_6.353044	8541	8621	36	4	80	0.0500000
NODE_32_length_8707_cov_6.353044	8541	8621	37	14	80	0.1750000
NODE_32_length_8707_cov_6.353044	8541	8621	39	21	80	0.2625000
NODE_32_length_8707_cov_6.353044	8541	8621	0	9	80	0.1125000
NODE_32_length_8707_cov_6.353044	8541	8621	4	4	80	0.0500000
NODE_32_length_8707_cov_6.353044	8541	8621	10	3	80	0.0375000
NODE_32_length_8707_cov_6.353044	8541	8621	15	1	80	0.0125000
NODE_32_length_8707_cov_6.353044	8541	8621	17	2	80	0.0250000
NODE_32_length_8707_cov_6.353044	8541	8621	23	9	80	0.1125000
NODE_32_length_8707_cov_6.353044	8541	8621	25	3	80	0.0375000
NODE_32_length_8707_cov_6.353044	8541	8621	27	7	80	0.0875000
NODE_32_length_8707_cov_6.353044	8541	8621	29	2	80	0.0250000
NODE_32_length_8707_cov_6.353044	8541	8621	33	1	80	0.0125000
NODE_32_length_8707_cov_6.353044	8541	8621	36	4	80	0.0500000
NODE_32_length_8707_cov_6.353044	8541	8621	37	14	80	0.1750000
NODE_32_length_8707_cov_6.353044	8541	8621	39	21	80	0.2625000
NODE_32_length_8707_cov_6.353044	8541	8621	0	9	80	0.1125000
NODE_32_length_8707_cov_6.353044	8541	8621	4	4	80	0.0500000
NODE_32_length_8707_cov_6.353044	8541	8621	10	3	80	0.0375000
NODE_32_length_8707_cov_6.353044	8541	8621	15	1	80	0.0125000
NODE_32_length_8707_cov_6.353044	8541	8621	17	2	80	0.0250000
NODE_32_length_8707_cov_6.353044	8541	8621	23	9	80	0.1125000
NODE_32_length_8707_cov_6.353044	8541	8621	25	3	80	0.0375000
NODE_32_length_8707_cov_6.353044	8541	8621	27	7	80	0.0875000
NODE_32_length_8707_cov_6.353044	8541	8621	29	2	80	0.0250000
NODE_32_length_8707_cov_6.353044	8541	8621	33	1	80	0.0125000
NODE_32_length_8707_cov_6.353044	8541	8621	36	4	80	0.0500000
NODE_32_length_8707_cov_6.353044	8541	8621	37	14	80	0.1750000
NODE_32_length_8707_cov_6.353044	8541	8621	39	21	80	0.2625000
NODE_32_length_8707_cov_6.353044	8594	8674	29	1	80	0.0125000
NODE_32_length_8707_cov_6.353044	8594	8674	31	3	80	0.0375000
NODE_32_length_8707_cov_6.353044	8594	8674	33	4	80	0.0500000
NODE_32_length_8707_cov_6.353044	8594	8674	35	20	80	0.2500000
NODE_32_length_8707_cov_6.353044	8594	8674	37	6	80	0.0750000
NODE_32_length_8707_cov_6.353044	8594	8674	39	46	80	0.5750000
NODE_32_length_8707_cov_6.353044	8594	8674	29	1	80	0.0125000
NODE_32_length_8707_cov_6.353044	8594	8674	31	3	80	0.0375000
NODE_32_length_8707_cov_6.353044	8594	8674	33	4	80	0.0500000
NODE_32_length_8707_cov_6.353044	8594	8674	35	20	80	0.2500000
NODE_32_length_8707_cov_6.353044	8594	8674	37	6	80	0.0750000
NODE_32_length_8707_cov_6.353044	8594	8674	39	46	80	0.5750000
NODE_32_length_8707_cov_6.353044	8594	8673	31	3	79	0.0379747
NODE_32_length_8707_cov_6.353044	8594	8673	33	4	79	0.0506329
NODE_32_length_8707_cov_6.353044	8594	8673	35	20	79	0.2531646
NODE_32_length_8707_cov_6.353044	8594	8673	37	6	79	0.0759494
NODE_32_length_8707_cov_6.353044	8594	8673	39	46	79	0.5822785
NODE_32_length_8707_cov_6.353044	8599	8674	29	1	75	0.0133333
NODE_32_length_8707_cov_6.353044	8599	8674	31	3	75	0.0400000
NODE_32_length_8707_cov_6.353044	8599	8674	33	4	75	0.0533333
NODE_32_length_8707_cov_6.353044	8599	8674	35	20	75	0.2666667
NODE_32_length_8707_cov_6.353044	8599	8674	37	1	75	0.0133333
NODE_32_length_8707_cov_6.353044	8599	8674	39	46	75	0.6133333
NODE_38_length_8281_cov_13.025177	7108	7188	0	13	80	0.1625000
NODE_38_length_8281_cov_13.025177	7108	7188	1	1	80	0.0125000
NODE_38_length_8281_cov_13.025177	7108	7188	2	27	80	0.3375000
NODE_38_length_8281_cov_13.025177	7108	7188	4	36	80	0.4500000
NODE_38_length_8281_cov_13.025177	7108	7188	6	3	80	0.0375000
NODE_38_length_8281_cov_13.025177	7161	7199	4	24	38	0.6315789
NODE_38_length_8281_cov_13.025177	7161	7199	6	14	38	0.3684210
NODE_38_length_8281_cov_13.025177	7175	7255	2	32	80	0.4000000
NODE_38_length_8281_cov_13.025177	7175	7255	4	16	80	0.2000000
NODE_38_length_8281_cov_13.025177	7175	7255	6	32	80	0.4000000
NODE_38_length_8281_cov_13.025177	7228	7308	2	80	80	1.0000000
NODE_38_length_8281_cov_13.025177	7749	7829	0	5	80	0.0625000
NODE_38_length_8281_cov_13.025177	7749	7829	2	75	80	0.9375000
NODE_38_length_8281_cov_13.025177	7802	7882	0	44	80	0.5500000
NODE_38_length_8281_cov_13.025177	7802	7882	2	36	80	0.4500000
NODE_38_length_8281_cov_13.025177	7878	7958	0	80	80	1.0000000
NODE_38_length_8281_cov_13.025177	7931	8011	0	80	80	1.0000000
NODE_39_length_8259_cov_60.011152	1424	1504	0	4	80	0.0500000
NODE_39_length_8259_cov_60.011152	1424	1504	2	76	80	0.9500000
NODE_39_length_8259_cov_60.011152	1477	1549	2	72	72	1.0000000
NODE_40_length_8228_cov_17.079592	314	394	0	33	80	0.4125000
NODE_40_length_8228_cov_17.079592	314	394	2	47	80	0.5875000
NODE_40_length_8228_cov_17.079592	367	447	0	80	80	1.0000000
NODE_40_length_8228_cov_17.079592	443	523	0	60	80	0.7500000
NODE_40_length_8228_cov_17.079592	443	523	2	8	80	0.1000000
NODE_40_length_8228_cov_17.079592	443	523	4	12	80	0.1500000
NODE_40_length_8228_cov_17.079592	496	576	0	7	80	0.0875000
NODE_40_length_8228_cov_17.079592	496	576	2	8	80	0.1000000
NODE_40_length_8228_cov_17.079592	496	576	4	65	80	0.8125000
NODE_40_length_8228_cov_17.079592	3154	3217	120	1	63	0.0158730
NODE_40_length_8228_cov_17.079592	3154	3217	308	1	63	0.0158730
NODE_40_length_8228_cov_17.079592	3154	3217	336	1	63	0.0158730
NODE_40_length_8228_cov_17.079592	3154	3217	339	1	63	0.0158730
NODE_40_length_8228_cov_17.079592	3154	3217	347	1	63	0.0158730
NODE_40_length_8228_cov_17.079592	3154	3217	349	1	63	0.0158730
NODE_40_length_8228_cov_17.079592	3154	3217	360	1	63	0.0158730
NODE_40_length_8228_cov_17.079592	3154	3217	369	1	63	0.0158730
NODE_40_length_8228_cov_17.079592	3154	3217	378	1	63	0.0158730
NODE_40_length_8228_cov_17.079592	3154	3217	397	1	63	0.0158730
NODE_40_length_8228_cov_17.079592	3154	3217	405	1	63	0.0158730
NODE_40_length_8228_cov_17.079592	3154	3217	409	1	63	0.0158730
NODE_40_length_8228_cov_17.079592	3154	3217	419	1	63	0.0158730
NODE_40_length_8228_cov_17.079592	3154	3217	425	1	63	0.0158730
NODE_40_length_8228_cov_17.079592	3154	3217	426	1	63	0.0158730
NODE_40_length_8228_cov_17.079592	3154	3217	447	1	63	0.0158730
NODE_40_length_8228_cov_17.079592	3154	3217	450	1	63	0.0158730
NODE_40_length_8228_cov_17.079592	3154	3217	458	2	63	0.0317460
NODE_40_length_8228_cov_17.079592	3154	3217	461	1	63	0.0158730
NODE_40_length_8228_cov_17.079592	3154	3217	470	1	63	0.0158730
NODE_40_length_8228_cov_17.079592	3154	3217	472	1	63	0.0158730
NODE_40_length_8228_cov_17.079592	3154	3217	480	1	63	0.0158730
NODE_40_length_8228_cov_17.079592	3154	3217	482	1	63	0.0158730
NODE_40_length_8228_cov_17.079592	3154	3217	490	1	63	0.0158730
NODE_40_length_8228_cov_17.079592	3154	3217	510	1	63	0.0158730
NODE_40_length_8228_cov_17.079592	3154	3217	514	1	63	0.0158730
NODE_40_length_8228_cov_17.079592	3154	3217	530	1	63	0.0158730
NODE_40_length_8228_cov_17.079592	3154	3217	532	1	63	0.0158730
NODE_40_length_8228_cov_17.079592	3154	3217	538	1	63	0.0158730
NODE_40_length_8228_cov_17.079592	3154	3217	583	1	63	0.0158730
NODE_40_length_8228_cov_17.079592	3154	3217	588	1	63	0.0158730
NODE_40_length_8228_cov_17.079592	3154	3217	590	1	63	0.0158730
NODE_40_length_8228_cov_17.079592	3154	3217	600	1	63	0.0158730
NODE_40_length_8228_cov_17.079592	3154	3217	614	1	63	0.0158730
NODE_40_length_8228_cov_17.079592	3154	3217	630	1	63	0.0158730
NODE_40_length_8228_cov_17.079592	3154	3217	634	1	63	0.0158730
NODE_40_length_8228_cov_17.079592	3154	3217	656	1	63	0.0158730
NODE_40_length_8228_cov_17.079592	3154	3217	664	3	63	0.0476190
NODE_40_length_8228_cov_17.079592	3154	3217	666	2	63	0.0317460
NODE_40_length_8228_cov_17.079592	3154	3217	668	2	63	0.0317460
NODE_40_length_8228_cov_17.079592	3154	3217	672	4	63	0.0634921
NODE_40_length_8228_cov_17.079592	3154	3217	675	1	63	0.0158730
NODE_40_length_8228_cov_17.079592	3154	3217	678	12	63	0.1904762
NODE_40_length_8228_cov_17.079592	3154	3217	680	1	63	0.0158730
NODE_43_length_8100_cov_32.115236	501	581	4	16	80	0.2000000
NODE_43_length_8100_cov_32.115236	501	581	6	17	80	0.2125000
NODE_43_length_8100_cov_32.115236	501	581	8	28	80	0.3500000
NODE_43_length_8100_cov_32.115236	501	581	10	19	80	0.2375000
NODE_43_length_8100_cov_32.115236	554	634	2	20	80	0.2500000
NODE_43_length_8100_cov_32.115236	554	634	4	7	80	0.0875000
NODE_43_length_8100_cov_32.115236	554	634	6	1	80	0.0125000
NODE_43_length_8100_cov_32.115236	554	634	8	51	80	0.6375000
NODE_43_length_8100_cov_32.115236	554	634	10	1	80	0.0125000
NODE_43_length_8100_cov_32.115236	1383	1463	0	80	80	1.0000000
NODE_43_length_8100_cov_32.115236	1436	1516	0	80	80	1.0000000
NODE_43_length_8100_cov_32.115236	3391	3462	217	1	71	0.0140845
NODE_43_length_8100_cov_32.115236	3391	3462	221	1	71	0.0140845
NODE_43_length_8100_cov_32.115236	3391	3462	223	1	71	0.0140845
NODE_43_length_8100_cov_32.115236	3391	3462	225	1	71	0.0140845
NODE_43_length_8100_cov_32.115236	3391	3462	242	1	71	0.0140845
NODE_43_length_8100_cov_32.115236	3391	3462	255	1	71	0.0140845
NODE_43_length_8100_cov_32.115236	3391	3462	287	1	71	0.0140845
NODE_43_length_8100_cov_32.115236	3391	3462	297	1	71	0.0140845
NODE_43_length_8100_cov_32.115236	3391	3462	298	1	71	0.0140845
NODE_43_length_8100_cov_32.115236	3391	3462	316	1	71	0.0140845
NODE_43_length_8100_cov_32.115236	3391	3462	327	1	71	0.0140845
NODE_43_length_8100_cov_32.115236	3391	3462	331	2	71	0.0281690
NODE_43_length_8100_cov_32.115236	3391	3462	339	1	71	0.0140845
NODE_43_length_8100_cov_32.115236	3391	3462	356	1	71	0.0140845
NODE_43_length_8100_cov_32.115236	3391	3462	363	1	71	0.0140845
NODE_43_length_8100_cov_32.115236	3391	3462	366	1	71	0.0140845
NODE_43_length_8100_cov_32.115236	3391	3462	401	1	71	0.0140845
NODE_43_length_8100_cov_32.115236	3391	3462	417	1	71	0.0140845
NODE_43_length_8100_cov_32.115236	3391	3462	424	1	71	0.0140845
NODE_43_length_8100_cov_32.115236	3391	3462	440	1	71	0.0140845
NODE_43_length_8100_cov_32.115236	3391	3462	461	1	71	0.0140845
NODE_43_length_8100_cov_32.115236	3391	3462	468	1	71	0.0140845
NODE_43_length_8100_cov_32.115236	3391	3462	470	1	71	0.0140845
NODE_43_length_8100_cov_32.115236	3391	3462	491	2	71	0.0281690
NODE_43_length_8100_cov_32.115236	3391	3462	492	2	71	0.0281690
NODE_43_length_8100_cov_32.115236	3391	3462	493	1	71	0.0140845
NODE_43_length_8100_cov_32.115236	3391	3462	494	1	71	0.0140845
NODE_43_length_8100_cov_32.115236	3391	3462	495	2	71	0.0281690
NODE_43_length_8100_cov_32.115236	3391	3462	499	1	71	0.0140845
NODE_43_length_8100_cov_32.115236	3391	3462	503	1	71	0.0140845
NODE_43_length_8100_cov_32.115236	3391	3462	504	1	71	0.0140845
NODE_43_length_8100_cov_32.115236	3391	3462	510	1	71	0.0140845
NODE_43_length_8100_cov_32.115236	3391	3462	514	1	71	0.0140845
NODE_43_length_8100_cov_32.115236	3391	3462	516	1	71	0.0140845
NODE_43_length_8100_cov_32.115236	3391	3462	518	4	71	0.0563380
NODE_43_length_8100_cov_32.115236	3391	3462	520	2	71	0.0281690
NODE_43_length_8100_cov_32.115236	3391	3462	523	1	71	0.0140845
NODE_43_length_8100_cov_32.115236	3391	3462	524	1	71	0.0140845
NODE_43_length_8100_cov_32.115236	3391	3462	527	1	71	0.0140845
NODE_43_length_8100_cov_32.115236	3391	3462	529	1	71	0.0140845
NODE_43_length_8100_cov_32.115236	3391	3462	534	2	71	0.0281690
NODE_43_length_8100_cov_32.115236	3391	3462	538	3	71	0.0422535
NODE_43_length_8100_cov_32.115236	3391	3462	541	1	71	0.0140845
NODE_43_length_8100_cov_32.115236	3391	3462	544	1	71	0.0140845
NODE_43_length_8100_cov_32.115236	3391	3462	545	2	71	0.0281690
NODE_43_length_8100_cov_32.115236	3391	3462	547	1	71	0.0140845
NODE_43_length_8100_cov_32.115236	3391	3462	549	1	71	0.0140845
NODE_43_length_8100_cov_32.115236	3391	3462	551	1	71	0.0140845
NODE_43_length_8100_cov_32.115236	3391	3462	553	4	71	0.0563380
NODE_43_length_8100_cov_32.115236	3391	3462	555	2	71	0.0281690
NODE_43_length_8100_cov_32.115236	3391	3462	567	2	71	0.0281690
NODE_43_length_8100_cov_32.115236	3391	3462	569	3	71	0.0422535
NODE_43_length_8100_cov_32.115236	3435	3483	139	4	48	0.0833333
NODE_43_length_8100_cov_32.115236	3435	3483	140	1	48	0.0208333
NODE_43_length_8100_cov_32.115236	3435	3483	141	1	48	0.0208333
NODE_43_length_8100_cov_32.115236	3435	3483	149	1	48	0.0208333
NODE_43_length_8100_cov_32.115236	3435	3483	163	2	48	0.0416667
NODE_43_length_8100_cov_32.115236	3435	3483	166	2	48	0.0416667
NODE_43_length_8100_cov_32.115236	3435	3483	174	1	48	0.0208333
NODE_43_length_8100_cov_32.115236	3435	3483	184	1	48	0.0208333
NODE_43_length_8100_cov_32.115236	3435	3483	194	1	48	0.0208333
NODE_43_length_8100_cov_32.115236	3435	3483	199	1	48	0.0208333
NODE_43_length_8100_cov_32.115236	3435	3483	201	1	48	0.0208333
NODE_43_length_8100_cov_32.115236	3435	3483	209	2	48	0.0416667
NODE_43_length_8100_cov_32.115236	3435	3483	211	1	48	0.0208333
NODE_43_length_8100_cov_32.115236	3435	3483	214	1	48	0.0208333
NODE_43_length_8100_cov_32.115236	3435	3483	215	1	48	0.0208333
NODE_43_length_8100_cov_32.115236	3435	3483	217	1	48	0.0208333
NODE_43_length_8100_cov_32.115236	3435	3483	221	1	48	0.0208333
NODE_43_length_8100_cov_32.115236	3435	3483	223	1	48	0.0208333
NODE_43_length_8100_cov_32.115236	3435	3483	225	1	48	0.0208333
NODE_43_length_8100_cov_32.115236	3435	3483	242	1	48	0.0208333
NODE_43_length_8100_cov_32.115236	3435	3483	255	1	48	0.0208333
NODE_43_length_8100_cov_32.115236	3435	3483	287	1	48	0.0208333
NODE_43_length_8100_cov_32.115236	3435	3483	297	1	48	0.0208333
NODE_43_length_8100_cov_32.115236	3435	3483	298	1	48	0.0208333
NODE_43_length_8100_cov_32.115236	3435	3483	316	1	48	0.0208333
NODE_43_length_8100_cov_32.115236	3435	3483	327	1	48	0.0208333
NODE_43_length_8100_cov_32.115236	3435	3483	331	2	48	0.0416667
NODE_43_length_8100_cov_32.115236	3435	3483	339	1	48	0.0208333
NODE_43_length_8100_cov_32.115236	3435	3483	356	1	48	0.0208333
NODE_43_length_8100_cov_32.115236	3435	3483	363	1	48	0.0208333
NODE_43_length_8100_cov_32.115236	3435	3483	366	1	48	0.0208333
NODE_43_length_8100_cov_32.115236	3435	3483	401	1	48	0.0208333
NODE_43_length_8100_cov_32.115236	3435	3483	417	1	48	0.0208333
NODE_43_length_8100_cov_32.115236	3435	3483	424	1	48	0.0208333
NODE_43_length_8100_cov_32.115236	3435	3483	440	1	48	0.0208333
NODE_43_length_8100_cov_32.115236	3435	3483	461	1	48	0.0208333
NODE_43_length_8100_cov_32.115236	3435	3483	468	1	48	0.0208333
NODE_43_length_8100_cov_32.115236	3435	3483	470	1	48	0.0208333
NODE_43_length_8100_cov_32.115236	3435	3483	491	2	48	0.0416667
NODE_43_length_8100_cov_32.115236	3435	3483	493	1	48	0.0208333
NODE_46_length_7962_cov_31.622790	6281	6363	252	2	82	0.0243902
NODE_46_length_7962_cov_31.622790	6281	6363	253	1	82	0.0121951
NODE_46_length_7962_cov_31.622790	6281	6363	254	2	82	0.0243902
NODE_46_length_7962_cov_31.622790	6281	6363	255	1	82	0.0121951
NODE_46_length_7962_cov_31.622790	6281	6363	262	2	82	0.0243902
NODE_46_length_7962_cov_31.622790	6281	6363	263	3	82	0.0365854
NODE_46_length_7962_cov_31.622790	6281	6363	264	3	82	0.0365854
NODE_46_length_7962_cov_31.622790	6281	6363	265	1	82	0.0121951
NODE_46_length_7962_cov_31.622790	6281	6363	267	1	82	0.0121951
NODE_46_length_7962_cov_31.622790	6281	6363	268	1	82	0.0121951
NODE_46_length_7962_cov_31.622790	6281	6363	270	1	82	0.0121951
NODE_46_length_7962_cov_31.622790	6281	6363	275	1	82	0.0121951
NODE_46_length_7962_cov_31.622790	6281	6363	285	1	82	0.0121951
NODE_46_length_7962_cov_31.622790	6281	6363	292	1	82	0.0121951
NODE_46_length_7962_cov_31.622790	6281	6363	307	1	82	0.0121951
NODE_46_length_7962_cov_31.622790	6281	6363	311	1	82	0.0121951
NODE_46_length_7962_cov_31.622790	6281	6363	314	1	82	0.0121951
NODE_46_length_7962_cov_31.622790	6281	6363	315	2	82	0.0243902
NODE_46_length_7962_cov_31.622790	6281	6363	316	1	82	0.0121951
NODE_46_length_7962_cov_31.622790	6281	6363	317	1	82	0.0121951
NODE_46_length_7962_cov_31.622790	6281	6363	318	1	82	0.0121951
NODE_46_length_7962_cov_31.622790	6281	6363	320	2	82	0.0243902
NODE_46_length_7962_cov_31.622790	6281	6363	323	1	82	0.0121951
NODE_46_length_7962_cov_31.622790	6281	6363	329	1	82	0.0121951
NODE_46_length_7962_cov_31.622790	6281	6363	334	1	82	0.0121951
NODE_46_length_7962_cov_31.622790	6281	6363	345	1	82	0.0121951
NODE_46_length_7962_cov_31.622790	6281	6363	346	1	82	0.0121951
NODE_46_length_7962_cov_31.622790	6281	6363	348	1	82	0.0121951
NODE_46_length_7962_cov_31.622790	6281	6363	352	1	82	0.0121951
NODE_46_length_7962_cov_31.622790	6281	6363	354	2	82	0.0243902
NODE_46_length_7962_cov_31.622790	6281	6363	356	2	82	0.0243902
NODE_46_length_7962_cov_31.622790	6281	6363	358	1	82	0.0121951
NODE_46_length_7962_cov_31.622790	6281	6363	359	2	82	0.0243902
NODE_46_length_7962_cov_31.622790	6281	6363	360	5	82	0.0609756
NODE_46_length_7962_cov_31.622790	6281	6363	361	3	82	0.0365854
NODE_46_length_7962_cov_31.622790	6281	6363	362	4	82	0.0487805
NODE_46_length_7962_cov_31.622790	6281	6363	363	1	82	0.0121951
NODE_46_length_7962_cov_31.622790	6281	6363	364	1	82	0.0121951
NODE_46_length_7962_cov_31.622790	6281	6363	365	1	82	0.0121951
NODE_46_length_7962_cov_31.622790	6281	6363	367	3	82	0.0365854
NODE_46_length_7962_cov_31.622790	6281	6363	368	1	82	0.0121951
NODE_46_length_7962_cov_31.622790	6281	6363	371	1	82	0.0121951
NODE_46_length_7962_cov_31.622790	6281	6363	374	1	82	0.0121951
NODE_46_length_7962_cov_31.622790	6281	6363	376	2	82	0.0243902
NODE_46_length_7962_cov_31.622790	6281	6363	377	2	82	0.0243902
NODE_46_length_7962_cov_31.622790	6281	6363	378	2	82	0.0243902
NODE_46_length_7962_cov_31.622790	6281	6363	379	2	82	0.0243902
NODE_46_length_7962_cov_31.622790	6281	6363	380	2	82	0.0243902
NODE_46_length_7962_cov_31.622790	6281	6363	381	1	82	0.0121951
NODE_46_length_7962_cov_31.622790	6281	6363	382	3	82	0.0365854
NODE_46_length_7962_cov_31.622790	6281	6363	383	2	82	0.0243902
NODE_47_length_7944_cov_12.238496	348	419	4	20	71	0.2816902
NODE_47_length_7944_cov_12.238496	348	419	10	13	71	0.1830986
NODE_47_length_7944_cov_12.238496	348	419	16	11	71	0.1549296
NODE_47_length_7944_cov_12.238496	348	419	20	2	71	0.0281690
NODE_47_length_7944_cov_12.238496	348	419	21	4	71	0.0563380
NODE_47_length_7944_cov_12.238496	348	419	22	5	71	0.0704225
NODE_47_length_7944_cov_12.238496	348	419	23	4	71	0.0563380
NODE_47_length_7944_cov_12.238496	348	419	28	12	71	0.1690141
NODE_48_length_7919_cov_14.554859	2380	2460	2	46	80	0.5750000
NODE_48_length_7919_cov_14.554859	2380	2460	4	34	80	0.4250000
NODE_50_length_7830_cov_4.211098	0	52	0	18	52	0.3461539
NODE_50_length_7830_cov_4.211098	0	52	2	3	52	0.0576923
NODE_50_length_7830_cov_4.211098	0	52	10	31	52	0.5961539
NODE_50_length_7830_cov_4.211098	30	105	10	44	75	0.5866666
NODE_50_length_7830_cov_4.211098	30	105	12	31	75	0.4133333
NODE_52_length_7779_cov_20.230859	7691	7771	0	80	80	1.0000000
NODE_52_length_7779_cov_20.230859	7691	7771	0	80	80	1.0000000
NODE_52_length_7779_cov_20.230859	7691	7761	0	70	70	1.0000000
NODE_52_length_7779_cov_20.230859	7744	7779	0	35	35	1.0000000
NODE_53_length_7765_cov_18.871119	254	322	52	4	68	0.0588235
NODE_53_length_7765_cov_18.871119	254	322	54	5	68	0.0735294
NODE_53_length_7765_cov_18.871119	254	322	60	1	68	0.0147059
NODE_53_length_7765_cov_18.871119	254	322	62	1	68	0.0147059
NODE_53_length_7765_cov_18.871119	254	322	64	1	68	0.0147059
NODE_53_length_7765_cov_18.871119	254	322	65	2	68	0.0294118
NODE_53_length_7765_cov_18.871119	254	322	67	4	68	0.0588235
NODE_53_length_7765_cov_18.871119	254	322	68	1	68	0.0147059
NODE_53_length_7765_cov_18.871119	254	322	72	1	68	0.0147059
NODE_53_length_7765_cov_18.871119	254	322	78	1	68	0.0147059
NODE_53_length_7765_cov_18.871119	254	322	79	1	68	0.0147059
NODE_53_length_7765_cov_18.871119	254	322	85	1	68	0.0147059
NODE_53_length_7765_cov_18.871119	254	322	91	2	68	0.0294118
NODE_53_length_7765_cov_18.871119	254	322	93	7	68	0.1029412
NODE_53_length_7765_cov_18.871119	254	322	95	1	68	0.0147059
NODE_53_length_7765_cov_18.871119	254	322	98	1	68	0.0147059
NODE_53_length_7765_cov_18.871119	254	322	104	2	68	0.0294118
NODE_53_length_7765_cov_18.871119	254	322	106	1	68	0.0147059
NODE_53_length_7765_cov_18.871119	254	322	108	1	68	0.0147059
NODE_53_length_7765_cov_18.871119	254	322	111	1	68	0.0147059
NODE_53_length_7765_cov_18.871119	254	322	112	1	68	0.0147059
NODE_53_length_7765_cov_18.871119	254	322	116	3	68	0.0441176
NODE_53_length_7765_cov_18.871119	254	322	118	7	68	0.1029412
NODE_53_length_7765_cov_18.871119	254	322	119	5	68	0.0735294
NODE_53_length_7765_cov_18.871119	254	322	122	1	68	0.0147059
NODE_53_length_7765_cov_18.871119	254	322	130	1	68	0.0147059
NODE_53_length_7765_cov_18.871119	254	322	136	1	68	0.0147059
NODE_53_length_7765_cov_18.871119	254	322	138	2	68	0.0294118
NODE_53_length_7765_cov_18.871119	254	322	150	1	68	0.0147059
NODE_53_length_7765_cov_18.871119	254	322	154	1	68	0.0147059
NODE_53_length_7765_cov_18.871119	254	322	160	1	68	0.0147059
NODE_53_length_7765_cov_18.871119	254	322	170	1	68	0.0147059
NODE_53_length_7765_cov_18.871119	254	322	177	1	68	0.0147059
NODE_53_length_7765_cov_18.871119	254	322	201	1	68	0.0147059
NODE_53_length_7765_cov_18.871119	254	322	207	1	68	0.0147059
NODE_53_length_7765_cov_18.871119	254	322	226	1	68	0.0147059
NODE_53_length_7765_cov_18.871119	353	433	68	1	80	0.0125000
NODE_53_length_7765_cov_18.871119	353	433	70	1	80	0.0125000
NODE_53_length_7765_cov_18.871119	353	433	76	4	80	0.0500000
NODE_53_length_7765_cov_18.871119	353	433	86	1	80	0.0125000
NODE_53_length_7765_cov_18.871119	353	433	94	1	80	0.0125000
NODE_53_length_7765_cov_18.871119	353	433	96	2	80	0.0250000
NODE_53_length_7765_cov_18.871119	353	433	98	1	80	0.0125000
NODE_53_length_7765_cov_18.871119	353	433	100	3	80	0.0375000
NODE_53_length_7765_cov_18.871119	353	433	106	2	80	0.0250000
NODE_53_length_7765_cov_18.871119	353	433	114	1	80	0.0125000
NODE_53_length_7765_cov_18.871119	353	433	116	1	80	0.0125000
NODE_53_length_7765_cov_18.871119	353	433	118	1	80	0.0125000
NODE_53_length_7765_cov_18.871119	353	433	119	2	80	0.0250000
NODE_53_length_7765_cov_18.871119	353	433	123	1	80	0.0125000
NODE_53_length_7765_cov_18.871119	353	433	125	1	80	0.0125000
NODE_53_length_7765_cov_18.871119	353	433	127	1	80	0.0125000
NODE_53_length_7765_cov_18.871119	353	433	136	4	80	0.0500000
NODE_53_length_7765_cov_18.871119	353	433	142	4	80	0.0500000
NODE_53_length_7765_cov_18.871119	353	433	143	3	80	0.0375000
NODE_53_length_7765_cov_18.871119	353	433	144	1	80	0.0125000
NODE_53_length_7765_cov_18.871119	353	433	148	1	80	0.0125000
NODE_53_length_7765_cov_18.871119	353	433	150	2	80	0.0250000
NODE_53_length_7765_cov_18.871119	353	433	151	3	80	0.0375000
NODE_53_length_7765_cov_18.871119	353	433	152	1	80	0.0125000
NODE_53_length_7765_cov_18.871119	353	433	153	1	80	0.0125000
NODE_53_length_7765_cov_18.871119	353	433	154	1	80	0.0125000
NODE_53_length_7765_cov_18.871119	353	433	158	10	80	0.1250000
NODE_53_length_7765_cov_18.871119	353	433	159	1	80	0.0125000
NODE_53_length_7765_cov_18.871119	353	433	160	4	80	0.0500000
NODE_53_length_7765_cov_18.871119	353	433	163	1	80	0.0125000
NODE_53_length_7765_cov_18.871119	353	433	164	2	80	0.0250000
NODE_53_length_7765_cov_18.871119	353	433	167	1	80	0.0125000
NODE_53_length_7765_cov_18.871119	353	433	168	10	80	0.1250000
NODE_53_length_7765_cov_18.871119	353	433	170	4	80	0.0500000
NODE_53_length_7765_cov_18.871119	353	433	171	2	80	0.0250000
NODE_61_length_7411_cov_74.967314	2283	2347	0	64	64	1.0000000
NODE_61_length_7411_cov_74.967314	4725	4789	0	64	64	1.0000000
NODE_64_length_7305_cov_3.696087	971	1019	3	14	48	0.2916667
NODE_64_length_7305_cov_3.696087	971	1019	5	11	48	0.2291667
NODE_64_length_7305_cov_3.696087	971	1019	7	8	48	0.1666667
NODE_64_length_7305_cov_3.696087	971	1019	9	2	48	0.0416667
NODE_64_length_7305_cov_3.696087	971	1019	11	5	48	0.1041667
NODE_64_length_7305_cov_3.696087	971	1019	12	5	48	0.1041667
NODE_64_length_7305_cov_3.696087	971	1019	16	3	48	0.0625000
NODE_64_length_7305_cov_3.696087	7142	7190	6	48	48	1.0000000
NODE_66_length_7261_cov_12.433398	2313	2395	111	1	82	0.0121951
NODE_66_length_7261_cov_12.433398	2313	2395	114	6	82	0.0731707
NODE_66_length_7261_cov_12.433398	2313	2395	115	4	82	0.0487805
NODE_66_length_7261_cov_12.433398	2313	2395	117	4	82	0.0487805
NODE_66_length_7261_cov_12.433398	2313	2395	118	2	82	0.0243902
NODE_66_length_7261_cov_12.433398	2313	2395	119	6	82	0.0731707
NODE_66_length_7261_cov_12.433398	2313	2395	120	2	82	0.0243902
NODE_66_length_7261_cov_12.433398	2313	2395	121	1	82	0.0121951
NODE_66_length_7261_cov_12.433398	2313	2395	122	2	82	0.0243902
NODE_66_length_7261_cov_12.433398	2313	2395	123	1	82	0.0121951
NODE_66_length_7261_cov_12.433398	2313	2395	124	4	82	0.0487805
NODE_66_length_7261_cov_12.433398	2313	2395	125	2	82	0.0243902
NODE_66_length_7261_cov_12.433398	2313	2395	126	4	82	0.0487805
NODE_66_length_7261_cov_12.433398	2313	2395	127	4	82	0.0487805
NODE_66_length_7261_cov_12.433398	2313	2395	128	2	82	0.0243902
NODE_66_length_7261_cov_12.433398	2313	2395	129	2	82	0.0243902
NODE_66_length_7261_cov_12.433398	2313	2395	131	4	82	0.0487805
NODE_66_length_7261_cov_12.433398	2313	2395	132	1	82	0.0121951
NODE_66_length_7261_cov_12.433398	2313	2395	137	1	82	0.0121951
NODE_66_length_7261_cov_12.433398	2313	2395	140	1	82	0.0121951
NODE_66_length_7261_cov_12.433398	2313	2395	141	1	82	0.0121951
NODE_66_length_7261_cov_12.433398	2313	2395	142	2	82	0.0243902
NODE_66_length_7261_cov_12.433398	2313	2395	149	1	82	0.0121951
NODE_66_length_7261_cov_12.433398	2313	2395	150	2	82	0.0243902
NODE_66_length_7261_cov_12.433398	2313	2395	155	1	82	0.0121951
NODE_66_length_7261_cov_12.433398	2313	2395	161	1	82	0.0121951
NODE_66_length_7261_cov_12.433398	2313	2395	182	1	82	0.0121951
NODE_66_length_7261_cov_12.433398	2313	2395	183	2	82	0.0243902
NODE_66_length_7261_cov_12.433398	2313	2395	184	2	82	0.0243902
NODE_66_length_7261_cov_12.433398	2313	2395	207	2	82	0.0243902
NODE_66_length_7261_cov_12.433398	2313	2395	209	1	82	0.0121951
NODE_66_length_7261_cov_12.433398	2313	2395	210	2	82	0.0243902
NODE_66_length_7261_cov_12.433398	2313	2395	211	2	82	0.0243902
NODE_66_length_7261_cov_12.433398	2313	2395	213	1	82	0.0121951
NODE_66_length_7261_cov_12.433398	2313	2395	214	1	82	0.0121951
NODE_66_length_7261_cov_12.433398	2313	2395	218	1	82	0.0121951
NODE_66_length_7261_cov_12.433398	2313	2395	221	1	82	0.0121951
NODE_66_length_7261_cov_12.433398	2313	2395	223	2	82	0.0243902
NODE_66_length_7261_cov_12.433398	2313	2395	225	1	82	0.0121951
NODE_66_length_7261_cov_12.433398	2313	2395	243	1	82	0.0121951
NODE_73_length_7036_cov_65.961943	4375	4455	4	12	80	0.1500000
NODE_73_length_7036_cov_65.961943	4375	4455	6	56	80	0.7000000
NODE_73_length_7036_cov_65.961943	4375	4455	8	12	80	0.1500000
NODE_73_length_7036_cov_65.961943	5538	5618	346	1	80	0.0125000
NODE_73_length_7036_cov_65.961943	5538	5618	352	1	80	0.0125000
NODE_73_length_7036_cov_65.961943	5538	5618	358	1	80	0.0125000
NODE_73_length_7036_cov_65.961943	5538	5618	360	1	80	0.0125000
NODE_73_length_7036_cov_65.961943	5538	5618	363	1	80	0.0125000
NODE_73_length_7036_cov_65.961943	5538	5618	365	1	80	0.0125000
NODE_73_length_7036_cov_65.961943	5538	5618	371	1	80	0.0125000
NODE_73_length_7036_cov_65.961943	5538	5618	380	1	80	0.0125000
NODE_73_length_7036_cov_65.961943	5538	5618	396	1	80	0.0125000
NODE_73_length_7036_cov_65.961943	5538	5618	407	1	80	0.0125000
NODE_73_length_7036_cov_65.961943	5538	5618	416	1	80	0.0125000
NODE_73_length_7036_cov_65.961943	5538	5618	422	1	80	0.0125000
NODE_73_length_7036_cov_65.961943	5538	5618	440	1	80	0.0125000
NODE_73_length_7036_cov_65.961943	5538	5618	451	1	80	0.0125000
NODE_73_length_7036_cov_65.961943	5538	5618	467	1	80	0.0125000
NODE_73_length_7036_cov_65.961943	5538	5618	486	1	80	0.0125000
NODE_73_length_7036_cov_65.961943	5538	5618	514	1	80	0.0125000
NODE_73_length_7036_cov_65.961943	5538	5618	518	1	80	0.0125000
NODE_73_length_7036_cov_65.961943	5538	5618	532	1	80	0.0125000
NODE_73_length_7036_cov_65.961943	5538	5618	566	1	80	0.0125000
NODE_73_length_7036_cov_65.961943	5538	5618	569	1	80	0.0125000
NODE_73_length_7036_cov_65.961943	5538	5618	574	1	80	0.0125000
NODE_73_length_7036_cov_65.961943	5538	5618	578	2	80	0.0250000
NODE_73_length_7036_cov_65.961943	5538	5618	581	1	80	0.0125000
NODE_73_length_7036_cov_65.961943	5538	5618	605	1	80	0.0125000
NODE_73_length_7036_cov_65.961943	5538	5618	614	1	80	0.0125000
NODE_73_length_7036_cov_65.961943	5538	5618	616	1	80	0.0125000
NODE_73_length_7036_cov_65.961943	5538	5618	623	1	80	0.0125000
NODE_73_length_7036_cov_65.961943	5538	5618	633	1	80	0.0125000
NODE_73_length_7036_cov_65.961943	5538	5618	634	1	80	0.0125000
NODE_73_length_7036_cov_65.961943	5538	5618	643	1	80	0.0125000
NODE_73_length_7036_cov_65.961943	5538	5618	650	1	80	0.0125000
NODE_73_length_7036_cov_65.961943	5538	5618	660	1	80	0.0125000
NODE_73_length_7036_cov_65.961943	5538	5618	679	1	80	0.0125000
NODE_73_length_7036_cov_65.961943	5538	5618	690	1	80	0.0125000
NODE_73_length_7036_cov_65.961943	5538	5618	696	1	80	0.0125000
NODE_73_length_7036_cov_65.961943	5538	5618	698	1	80	0.0125000
NODE_73_length_7036_cov_65.961943	5538	5618	703	1	80	0.0125000
NODE_73_length_7036_cov_65.961943	5538	5618	706	1	80	0.0125000
NODE_73_length_7036_cov_65.961943	5538	5618	721	1	80	0.0125000
NODE_73_length_7036_cov_65.961943	5538	5618	733	1	80	0.0125000
NODE_73_length_7036_cov_65.961943	5538	5618	736	1	80	0.0125000
NODE_73_length_7036_cov_65.961943	5538	5618	740	1	80	0.0125000
NODE_73_length_7036_cov_65.961943	5538	5618	747	1	80	0.0125000
NODE_73_length_7036_cov_65.961943	5538	5618	749	1	80	0.0125000
NODE_73_length_7036_cov_65.961943	5538	5618	750	1	80	0.0125000
NODE_73_length_7036_cov_65.961943	5538	5618	760	1	80	0.0125000
NODE_73_length_7036_cov_65.961943	5538	5618	761	1	80	0.0125000
NODE_73_length_7036_cov_65.961943	5538	5618	762	2	80	0.0250000
NODE_73_length_7036_cov_65.961943	5538	5618	766	1	80	0.0125000
NODE_73_length_7036_cov_65.961943	5538	5618	768	1	80	0.0125000
NODE_73_length_7036_cov_65.961943	5538	5618	769	1	80	0.0125000
NODE_73_length_7036_cov_65.961943	5538	5618	770	1	80	0.0125000
NODE_73_length_7036_cov_65.961943	5538	5618	773	1	80	0.0125000
NODE_73_length_7036_cov_65.961943	5538	5618	786	1	80	0.0125000
NODE_73_length_7036_cov_65.961943	5538	5618	799	1	80	0.0125000
NODE_73_length_7036_cov_65.961943	5538	5618	811	1	80	0.0125000
NODE_73_length_7036_cov_65.961943	5538	5618	816	1	80	0.0125000
NODE_73_length_7036_cov_65.961943	5538	5618	822	1	80	0.0125000
NODE_73_length_7036_cov_65.961943	5538	5618	824	1	80	0.0125000
NODE_73_length_7036_cov_65.961943	5538	5618	826	1	80	0.0125000
NODE_73_length_7036_cov_65.961943	5538	5618	840	1	80	0.0125000
NODE_73_length_7036_cov_65.961943	5538	5618	856	1	80	0.0125000
NODE_73_length_7036_cov_65.961943	5538	5618	864	1	80	0.0125000
NODE_73_length_7036_cov_65.961943	5538	5618	869	1	80	0.0125000
NODE_73_length_7036_cov_65.961943	5538	5618	875	1	80	0.0125000
NODE_73_length_7036_cov_65.961943	5538	5618	877	1	80	0.0125000
NODE_73_length_7036_cov_65.961943	5538	5618	880	1	80	0.0125000
NODE_73_length_7036_cov_65.961943	5538	5618	882	1	80	0.0125000
NODE_73_length_7036_cov_65.961943	5538	5618	884	1	80	0.0125000
NODE_73_length_7036_cov_65.961943	5538	5618	889	1	80	0.0125000
NODE_73_length_7036_cov_65.961943	5538	5618	890	1	80	0.0125000
NODE_73_length_7036_cov_65.961943	5538	5618	891	1	80	0.0125000
NODE_73_length_7036_cov_65.961943	5538	5618	898	1	80	0.0125000
NODE_73_length_7036_cov_65.961943	5538	5618	903	1	80	0.0125000
NODE_73_length_7036_cov_65.961943	5538	5618	905	2	80	0.0250000
NODE_73_length_7036_cov_65.961943	5538	5618	909	1	80	0.0125000
NODE_73_length_7036_cov_65.961943	5591	5666	766	1	75	0.0133333
NODE_73_length_7036_cov_65.961943	5591	5666	769	1	75	0.0133333
NODE_73_length_7036_cov_65.961943	5591	5666	773	1	75	0.0133333
NODE_73_length_7036_cov_65.961943	5591	5666	786	1	75	0.0133333
NODE_73_length_7036_cov_65.961943	5591	5666	799	1	75	0.0133333
NODE_73_length_7036_cov_65.961943	5591	5666	811	1	75	0.0133333
NODE_73_length_7036_cov_65.961943	5591	5666	816	1	75	0.0133333
NODE_73_length_7036_cov_65.961943	5591	5666	822	1	75	0.0133333
NODE_73_length_7036_cov_65.961943	5591	5666	824	1	75	0.0133333
NODE_73_length_7036_cov_65.961943	5591	5666	826	1	75	0.0133333
NODE_73_length_7036_cov_65.961943	5591	5666	840	1	75	0.0133333
NODE_73_length_7036_cov_65.961943	5591	5666	856	1	75	0.0133333
NODE_73_length_7036_cov_65.961943	5591	5666	864	1	75	0.0133333
NODE_73_length_7036_cov_65.961943	5591	5666	869	1	75	0.0133333
NODE_73_length_7036_cov_65.961943	5591	5666	875	1	75	0.0133333
NODE_73_length_7036_cov_65.961943	5591	5666	877	1	75	0.0133333
NODE_73_length_7036_cov_65.961943	5591	5666	880	1	75	0.0133333
NODE_73_length_7036_cov_65.961943	5591	5666	882	1	75	0.0133333
NODE_73_length_7036_cov_65.961943	5591	5666	884	1	75	0.0133333
NODE_73_length_7036_cov_65.961943	5591	5666	889	1	75	0.0133333
NODE_73_length_7036_cov_65.961943	5591	5666	890	1	75	0.0133333
NODE_73_length_7036_cov_65.961943	5591	5666	891	1	75	0.0133333
NODE_73_length_7036_cov_65.961943	5591	5666	898	1	75	0.0133333
NODE_73_length_7036_cov_65.961943	5591	5666	903	1	75	0.0133333
NODE_73_length_7036_cov_65.961943	5591	5666	905	2	75	0.0266667
NODE_73_length_7036_cov_65.961943	5591	5666	909	1	75	0.0133333
NODE_73_length_7036_cov_65.961943	5591	5666	917	1	75	0.0133333
NODE_73_length_7036_cov_65.961943	5591	5666	935	1	75	0.0133333
NODE_73_length_7036_cov_65.961943	5591	5666	944	1	75	0.0133333
NODE_73_length_7036_cov_65.961943	5591	5666	946	1	75	0.0133333
NODE_73_length_7036_cov_65.961943	5591	5666	948	1	75	0.0133333
NODE_73_length_7036_cov_65.961943	5591	5666	957	1	75	0.0133333
NODE_73_length_7036_cov_65.961943	5591	5666	959	1	75	0.0133333
NODE_73_length_7036_cov_65.961943	5591	5666	963	1	75	0.0133333
NODE_73_length_7036_cov_65.961943	5591	5666	965	2	75	0.0266667
NODE_73_length_7036_cov_65.961943	5591	5666	969	1	75	0.0133333
NODE_73_length_7036_cov_65.961943	5591	5666	972	2	75	0.0266667
NODE_73_length_7036_cov_65.961943	5591	5666	973	3	75	0.0400000
NODE_73_length_7036_cov_65.961943	5591	5666	975	1	75	0.0133333
NODE_73_length_7036_cov_65.961943	5591	5666	976	1	75	0.0133333
NODE_73_length_7036_cov_65.961943	5591	5666	982	2	75	0.0266667
NODE_73_length_7036_cov_65.961943	5591	5666	985	1	75	0.0133333
NODE_73_length_7036_cov_65.961943	5591	5666	986	2	75	0.0266667
NODE_73_length_7036_cov_65.961943	5591	5666	988	1	75	0.0133333
NODE_73_length_7036_cov_65.961943	5591	5666	990	1	75	0.0133333
NODE_73_length_7036_cov_65.961943	5591	5666	992	1	75	0.0133333
NODE_73_length_7036_cov_65.961943	5591	5666	1001	1	75	0.0133333
NODE_73_length_7036_cov_65.961943	5591	5666	1002	1	75	0.0133333
NODE_73_length_7036_cov_65.961943	5591	5666	1009	1	75	0.0133333
NODE_73_length_7036_cov_65.961943	5591	5666	1020	1	75	0.0133333
NODE_73_length_7036_cov_65.961943	5591	5666	1028	1	75	0.0133333
NODE_73_length_7036_cov_65.961943	5591	5666	1032	1	75	0.0133333
NODE_73_length_7036_cov_65.961943	5591	5666	1042	1	75	0.0133333
NODE_73_length_7036_cov_65.961943	5591	5666	1047	1	75	0.0133333
NODE_73_length_7036_cov_65.961943	5591	5666	1087	1	75	0.0133333
NODE_73_length_7036_cov_65.961943	5591	5666	1090	1	75	0.0133333
NODE_73_length_7036_cov_65.961943	5591	5666	1103	1	75	0.0133333
NODE_73_length_7036_cov_65.961943	5591	5666	1105	1	75	0.0133333
NODE_73_length_7036_cov_65.961943	5591	5666	1112	1	75	0.0133333
NODE_73_length_7036_cov_65.961943	5591	5666	1127	1	75	0.0133333
NODE_73_length_7036_cov_65.961943	5591	5666	1153	1	75	0.0133333
NODE_73_length_7036_cov_65.961943	5591	5666	1169	1	75	0.0133333
NODE_73_length_7036_cov_65.961943	5591	5666	1182	1	75	0.0133333
NODE_73_length_7036_cov_65.961943	5591	5666	1192	1	75	0.0133333
NODE_73_length_7036_cov_65.961943	5591	5666	1198	1	75	0.0133333
NODE_73_length_7036_cov_65.961943	5591	5666	1200	1	75	0.0133333
NODE_73_length_7036_cov_65.961943	5591	5666	1206	1	75	0.0133333
NODE_73_length_7036_cov_65.961943	5591	5666	1220	1	75	0.0133333
NODE_73_length_7036_cov_65.961943	5690	5746	1338	1	56	0.0178571
NODE_73_length_7036_cov_65.961943	5690	5746	1348	1	56	0.0178571
NODE_73_length_7036_cov_65.961943	5690	5746	1352	1	56	0.0178571
NODE_73_length_7036_cov_65.961943	5690	5746	1384	1	56	0.0178571
NODE_73_length_7036_cov_65.961943	5690	5746	1400	1	56	0.0178571
NODE_73_length_7036_cov_65.961943	5690	5746	1408	1	56	0.0178571
NODE_73_length_7036_cov_65.961943	5690	5746	1425	1	56	0.0178571
NODE_73_length_7036_cov_65.961943	5690	5746	1432	1	56	0.0178571
NODE_73_length_7036_cov_65.961943	5690	5746	1448	1	56	0.0178571
NODE_73_length_7036_cov_65.961943	5690	5746	1452	1	56	0.0178571
NODE_73_length_7036_cov_65.961943	5690	5746	1454	1	56	0.0178571
NODE_73_length_7036_cov_65.961943	5690	5746	1455	1	56	0.0178571
NODE_73_length_7036_cov_65.961943	5690	5746	1458	1	56	0.0178571
NODE_73_length_7036_cov_65.961943	5690	5746	1461	1	56	0.0178571
NODE_73_length_7036_cov_65.961943	5690	5746	1462	1	56	0.0178571
NODE_73_length_7036_cov_65.961943	5690	5746	1468	1	56	0.0178571
NODE_73_length_7036_cov_65.961943	5690	5746	1473	1	56	0.0178571
NODE_73_length_7036_cov_65.961943	5690	5746	1476	1	56	0.0178571
NODE_73_length_7036_cov_65.961943	5690	5746	1485	1	56	0.0178571
NODE_73_length_7036_cov_65.961943	5690	5746	1498	2	56	0.0357143
NODE_73_length_7036_cov_65.961943	5690	5746	1500	1	56	0.0178571
NODE_73_length_7036_cov_65.961943	5690	5746	1511	1	56	0.0178571
NODE_73_length_7036_cov_65.961943	5690	5746	1514	1	56	0.0178571
NODE_73_length_7036_cov_65.961943	5690	5746	1517	1	56	0.0178571
NODE_73_length_7036_cov_65.961943	5690	5746	1518	1	56	0.0178571
NODE_73_length_7036_cov_65.961943	5690	5746	1519	2	56	0.0357143
NODE_73_length_7036_cov_65.961943	5690	5746	1526	1	56	0.0178571
NODE_73_length_7036_cov_65.961943	5690	5746	1536	2	56	0.0357143
NODE_73_length_7036_cov_65.961943	5690	5746	1537	1	56	0.0178571
NODE_73_length_7036_cov_65.961943	5690	5746	1538	2	56	0.0357143
NODE_73_length_7036_cov_65.961943	5690	5746	1539	1	56	0.0178571
NODE_73_length_7036_cov_65.961943	5690	5746	1541	1	56	0.0178571
NODE_73_length_7036_cov_65.961943	5690	5746	1557	1	56	0.0178571
NODE_73_length_7036_cov_65.961943	5690	5746	1571	2	56	0.0357143
NODE_73_length_7036_cov_65.961943	5690	5746	1572	1	56	0.0178571
NODE_73_length_7036_cov_65.961943	5690	5746	1579	1	56	0.0178571
NODE_73_length_7036_cov_65.961943	5690	5746	1583	1	56	0.0178571
NODE_73_length_7036_cov_65.961943	5690	5746	1588	1	56	0.0178571
NODE_73_length_7036_cov_65.961943	5690	5746	1591	1	56	0.0178571
NODE_73_length_7036_cov_65.961943	5690	5746	1594	1	56	0.0178571
NODE_73_length_7036_cov_65.961943	5690	5746	1603	1	56	0.0178571
NODE_73_length_7036_cov_65.961943	5690	5746	1606	1	56	0.0178571
NODE_73_length_7036_cov_65.961943	5690	5746	1608	1	56	0.0178571
NODE_73_length_7036_cov_65.961943	5690	5746	1615	1	56	0.0178571
NODE_73_length_7036_cov_65.961943	5690	5746	1618	2	56	0.0357143
NODE_73_length_7036_cov_65.961943	5690	5746	1628	1	56	0.0178571
NODE_73_length_7036_cov_65.961943	5690	5746	1632	2	56	0.0357143
NODE_73_length_7036_cov_65.961943	5690	5746	1638	1	56	0.0178571
NODE_73_length_7036_cov_65.961943	5690	5746	1660	1	56	0.0178571
NODE_73_length_7036_cov_65.961943	6373	6453	0	80	80	1.0000000
NODE_73_length_7036_cov_65.961943	6426	6506	0	80	80	1.0000000
NODE_74_length_6974_cov_16.058327	976	1056	2	12	80	0.1500000
NODE_74_length_6974_cov_16.058327	976	1056	4	16	80	0.2000000
NODE_74_length_6974_cov_16.058327	976	1056	6	52	80	0.6500000
NODE_74_length_6974_cov_16.058327	1029	1109	4	40	80	0.5000000
NODE_74_length_6974_cov_16.058327	1029	1109	5	7	80	0.0875000
NODE_74_length_6974_cov_16.058327	1029	1109	6	33	80	0.4125000
NODE_80_length_6826_cov_10.483574	4462	4542	0	10	80	0.1250000
NODE_80_length_6826_cov_10.483574	4462	4542	18	2	80	0.0250000
NODE_80_length_6826_cov_10.483574	4462	4542	23	1	80	0.0125000
NODE_80_length_6826_cov_10.483574	4462	4542	25	2	80	0.0250000
NODE_80_length_6826_cov_10.483574	4462	4542	31	2	80	0.0250000
NODE_80_length_6826_cov_10.483574	4462	4542	32	1	80	0.0125000
NODE_80_length_6826_cov_10.483574	4462	4542	34	2	80	0.0250000
NODE_80_length_6826_cov_10.483574	4462	4542	39	5	80	0.0625000
NODE_80_length_6826_cov_10.483574	4462	4542	41	2	80	0.0250000
NODE_80_length_6826_cov_10.483574	4462	4542	45	5	80	0.0625000
NODE_80_length_6826_cov_10.483574	4462	4542	49	1	80	0.0125000
NODE_80_length_6826_cov_10.483574	4462	4542	55	1	80	0.0125000
NODE_80_length_6826_cov_10.483574	4462	4542	57	1	80	0.0125000
NODE_80_length_6826_cov_10.483574	4462	4542	60	4	80	0.0500000
NODE_80_length_6826_cov_10.483574	4462	4542	61	10	80	0.1250000
NODE_80_length_6826_cov_10.483574	4462	4542	62	1	80	0.0125000
NODE_80_length_6826_cov_10.483574	4462	4542	64	1	80	0.0125000
NODE_80_length_6826_cov_10.483574	4462	4542	70	1	80	0.0125000
NODE_80_length_6826_cov_10.483574	4462	4542	71	10	80	0.1250000
NODE_80_length_6826_cov_10.483574	4462	4542	73	6	80	0.0750000
NODE_80_length_6826_cov_10.483574	4462	4542	75	2	80	0.0250000
NODE_80_length_6826_cov_10.483574	4462	4542	76	1	80	0.0125000
NODE_80_length_6826_cov_10.483574	4462	4542	78	3	80	0.0375000
NODE_80_length_6826_cov_10.483574	4462	4542	80	6	80	0.0750000
NODE_80_length_6826_cov_10.483574	4515	4595	71	9	80	0.1125000
NODE_80_length_6826_cov_10.483574	4515	4595	73	6	80	0.0750000
NODE_80_length_6826_cov_10.483574	4515	4595	75	2	80	0.0250000
NODE_80_length_6826_cov_10.483574	4515	4595	76	2	80	0.0250000
NODE_80_length_6826_cov_10.483574	4515	4595	78	4	80	0.0500000
NODE_80_length_6826_cov_10.483574	4515	4595	80	7	80	0.0875000
NODE_80_length_6826_cov_10.483574	4515	4595	86	2	80	0.0250000
NODE_80_length_6826_cov_10.483574	4515	4595	87	3	80	0.0375000
NODE_80_length_6826_cov_10.483574	4515	4595	88	4	80	0.0500000
NODE_80_length_6826_cov_10.483574	4515	4595	90	11	80	0.1375000
NODE_80_length_6826_cov_10.483574	4515	4595	92	1	80	0.0125000
NODE_80_length_6826_cov_10.483574	4515	4595	96	1	80	0.0125000
NODE_80_length_6826_cov_10.483574	4515	4595	98	28	80	0.3500000
NODE_81_length_6816_cov_2.820753	6726	6801	0	75	75	1.0000000
NODE_81_length_6816_cov_2.820753	6774	6816	0	42	42	1.0000000
NODE_84_length_6744_cov_6.222272	5	85	0	11	80	0.1375000
NODE_84_length_6744_cov_6.222272	5	85	2	69	80	0.8625000
NODE_84_length_6744_cov_6.222272	58	138	0	24	80	0.3000000
NODE_84_length_6744_cov_6.222272	58	138	2	56	80	0.7000000
NODE_84_length_6744_cov_6.222272	6650	6730	0	80	80	1.0000000
NODE_84_length_6744_cov_6.222272	6703	6744	0	41	41	1.0000000
NODE_86_length_6733_cov_88.965029	3141	3221	0	80	80	1.0000000
NODE_86_length_6733_cov_88.965029	3194	3274	0	80	80	1.0000000
NODE_86_length_6733_cov_88.965029	3270	3350	0	80	80	1.0000000
NODE_86_length_6733_cov_88.965029	3323	3403	0	80	80	1.0000000
NODE_90_length_6627_cov_9.440564	350	430	8	41	80	0.5125000
NODE_90_length_6627_cov_9.440564	350	430	10	39	80	0.4875000
NODE_90_length_6627_cov_9.440564	403	483	0	8	80	0.1000000
NODE_90_length_6627_cov_9.440564	403	483	8	72	80	0.9000000
NODE_95_length_6507_cov_95.786049	171	247	2	72	76	0.9473684
NODE_95_length_6507_cov_95.786049	171	247	4	1	76	0.0131579
NODE_95_length_6507_cov_95.786049	171	247	15	2	76	0.0263158
NODE_95_length_6507_cov_95.786049	171	247	64	1	76	0.0131579
NODE_96_length_6497_cov_2.677399	366	436	2	9	70	0.1285714
NODE_96_length_6497_cov_2.677399	366	436	4	3	70	0.0428571
NODE_96_length_6497_cov_2.677399	366	436	6	2	70	0.0285714
NODE_96_length_6497_cov_2.677399	366	436	8	5	70	0.0714286
NODE_96_length_6497_cov_2.677399	366	436	10	19	70	0.2714286
NODE_96_length_6497_cov_2.677399	366	436	11	19	70	0.2714286
NODE_96_length_6497_cov_2.677399	366	436	12	13	70	0.1857143
NODE_96_length_6497_cov_2.677399	409	444	0	4	35	0.1142857
NODE_96_length_6497_cov_2.677399	409	444	2	13	35	0.3714286
NODE_96_length_6497_cov_2.677399	409	444	4	3	35	0.0857143
NODE_96_length_6497_cov_2.677399	409	444	6	2	35	0.0571429
NODE_96_length_6497_cov_2.677399	409	444	8	5	35	0.1428571
NODE_96_length_6497_cov_2.677399	409	444	10	8	35	0.2285714
NODE_97_length_6450_cov_26.108172	5024	5104	6	41	80	0.5125000
NODE_97_length_6450_cov_26.108172	5024	5104	8	28	80	0.3500000
NODE_97_length_6450_cov_26.108172	5024	5104	10	11	80	0.1375000
NODE_109_length_6171_cov_36.061100	3743	3813	26	1	70	0.0142857
NODE_109_length_6171_cov_36.061100	3743	3813	30	2	70	0.0285714
NODE_109_length_6171_cov_36.061100	3743	3813	32	1	70	0.0142857
NODE_109_length_6171_cov_36.061100	3743	3813	34	1	70	0.0142857
NODE_109_length_6171_cov_36.061100	3743	3813	38	1	70	0.0142857
NODE_109_length_6171_cov_36.061100	3743	3813	44	1	70	0.0142857
NODE_109_length_6171_cov_36.061100	3743	3813	57	1	70	0.0142857
NODE_109_length_6171_cov_36.061100	3743	3813	65	1	70	0.0142857
NODE_109_length_6171_cov_36.061100	3743	3813	67	2	70	0.0285714
NODE_109_length_6171_cov_36.061100	3743	3813	71	9	70	0.1285714
NODE_109_length_6171_cov_36.061100	3743	3813	72	2	70	0.0285714
NODE_109_length_6171_cov_36.061100	3743	3813	73	6	70	0.0857143
NODE_109_length_6171_cov_36.061100	3743	3813	75	3	70	0.0428571
NODE_109_length_6171_cov_36.061100	3743	3813	79	5	70	0.0714286
NODE_109_length_6171_cov_36.061100	3743	3813	86	2	70	0.0285714
NODE_109_length_6171_cov_36.061100	3743	3813	88	6	70	0.0857143
NODE_109_length_6171_cov_36.061100	3743	3813	90	1	70	0.0142857
NODE_109_length_6171_cov_36.061100	3743	3813	92	2	70	0.0285714
NODE_109_length_6171_cov_36.061100	3743	3813	98	5	70	0.0714286
NODE_109_length_6171_cov_36.061100	3743	3813	102	5	70	0.0714286
NODE_109_length_6171_cov_36.061100	3743	3813	103	1	70	0.0142857
NODE_109_length_6171_cov_36.061100	3743	3813	107	4	70	0.0571429
NODE_109_length_6171_cov_36.061100	3743	3813	108	1	70	0.0142857
NODE_109_length_6171_cov_36.061100	3743	3813	109	1	70	0.0142857
NODE_109_length_6171_cov_36.061100	3743	3813	112	3	70	0.0428571
NODE_109_length_6171_cov_36.061100	3743	3813	114	1	70	0.0142857
NODE_109_length_6171_cov_36.061100	3743	3813	119	2	70	0.0285714
NODE_109_length_6171_cov_36.061100	3798	3851	78	1	53	0.0188679
NODE_109_length_6171_cov_36.061100	3798	3851	80	3	53	0.0566038
NODE_109_length_6171_cov_36.061100	3798	3851	81	1	53	0.0188679
NODE_109_length_6171_cov_36.061100	3798	3851	83	3	53	0.0566038
NODE_109_length_6171_cov_36.061100	3798	3851	84	1	53	0.0188679
NODE_109_length_6171_cov_36.061100	3798	3851	85	2	53	0.0377358
NODE_109_length_6171_cov_36.061100	3798	3851	87	1	53	0.0188679
NODE_109_length_6171_cov_36.061100	3798	3851	89	1	53	0.0188679
NODE_109_length_6171_cov_36.061100	3798	3851	91	1	53	0.0188679
NODE_109_length_6171_cov_36.061100	3798	3851	97	2	53	0.0377358
NODE_109_length_6171_cov_36.061100	3798	3851	101	1	53	0.0188679
NODE_109_length_6171_cov_36.061100	3798	3851	102	2	53	0.0377358
NODE_109_length_6171_cov_36.061100	3798	3851	103	1	53	0.0188679
NODE_109_length_6171_cov_36.061100	3798	3851	106	2	53	0.0377358
NODE_109_length_6171_cov_36.061100	3798	3851	107	4	53	0.0754717
NODE_109_length_6171_cov_36.061100	3798	3851	108	8	53	0.1509434
NODE_109_length_6171_cov_36.061100	3798	3851	109	1	53	0.0188679
NODE_109_length_6171_cov_36.061100	3798	3851	110	1	53	0.0188679
NODE_109_length_6171_cov_36.061100	3798	3851	112	3	53	0.0566038
NODE_109_length_6171_cov_36.061100	3798	3851	114	1	53	0.0188679
NODE_109_length_6171_cov_36.061100	3798	3851	118	3	53	0.0566038
NODE_109_length_6171_cov_36.061100	3798	3851	119	2	53	0.0377358
NODE_109_length_6171_cov_36.061100	3798	3851	120	8	53	0.1509434
NODE_109_length_6171_cov_36.061100	4552	4596	562	1	44	0.0227273
NODE_109_length_6171_cov_36.061100	4552	4596	564	1	44	0.0227273
NODE_109_length_6171_cov_36.061100	4552	4596	566	2	44	0.0454545
NODE_109_length_6171_cov_36.061100	4552	4596	567	1	44	0.0227273
NODE_109_length_6171_cov_36.061100	4552	4596	569	1	44	0.0227273
NODE_109_length_6171_cov_36.061100	4552	4596	574	1	44	0.0227273
NODE_109_length_6171_cov_36.061100	4552	4596	575	1	44	0.0227273
NODE_109_length_6171_cov_36.061100	4552	4596	579	1	44	0.0227273
NODE_109_length_6171_cov_36.061100	4552	4596	580	4	44	0.0909091
NODE_109_length_6171_cov_36.061100	4552	4596	581	1	44	0.0227273
NODE_109_length_6171_cov_36.061100	4552	4596	582	1	44	0.0227273
NODE_109_length_6171_cov_36.061100	4552	4596	584	3	44	0.0681818
NODE_109_length_6171_cov_36.061100	4552	4596	585	1	44	0.0227273
NODE_109_length_6171_cov_36.061100	4552	4596	586	2	44	0.0454545
NODE_109_length_6171_cov_36.061100	4552	4596	587	3	44	0.0681818
NODE_109_length_6171_cov_36.061100	4552	4596	588	2	44	0.0454545
NODE_109_length_6171_cov_36.061100	4552	4596	590	5	44	0.1136364
NODE_109_length_6171_cov_36.061100	4552	4596	591	3	44	0.0681818
NODE_109_length_6171_cov_36.061100	4552	4596	592	2	44	0.0454545
NODE_109_length_6171_cov_36.061100	4552	4596	593	1	44	0.0227273
NODE_109_length_6171_cov_36.061100	4552	4596	597	1	44	0.0227273
NODE_109_length_6171_cov_36.061100	4552	4596	600	1	44	0.0227273
NODE_109_length_6171_cov_36.061100	4552	4596	601	1	44	0.0227273
NODE_109_length_6171_cov_36.061100	4552	4596	607	1	44	0.0227273
NODE_109_length_6171_cov_36.061100	4552	4596	610	1	44	0.0227273
NODE_109_length_6171_cov_36.061100	4552	4596	628	1	44	0.0227273
NODE_109_length_6171_cov_36.061100	4552	4596	636	1	44	0.0227273
NODE_109_length_6171_cov_36.061100	4569	4649	553	1	80	0.0125000
NODE_109_length_6171_cov_36.061100	4569	4649	554	1	80	0.0125000
NODE_109_length_6171_cov_36.061100	4569	4649	555	1	80	0.0125000
NODE_109_length_6171_cov_36.061100	4569	4649	556	1	80	0.0125000
NODE_109_length_6171_cov_36.061100	4569	4649	559	1	80	0.0125000
NODE_109_length_6171_cov_36.061100	4569	4649	560	1	80	0.0125000
NODE_109_length_6171_cov_36.061100	4569	4649	562	1	80	0.0125000
NODE_109_length_6171_cov_36.061100	4569	4649	564	1	80	0.0125000
NODE_109_length_6171_cov_36.061100	4569	4649	566	2	80	0.0250000
NODE_109_length_6171_cov_36.061100	4569	4649	567	1	80	0.0125000
NODE_109_length_6171_cov_36.061100	4569	4649	569	1	80	0.0125000
NODE_109_length_6171_cov_36.061100	4569	4649	570	2	80	0.0250000
NODE_109_length_6171_cov_36.061100	4569	4649	571	1	80	0.0125000
NODE_109_length_6171_cov_36.061100	4569	4649	572	1	80	0.0125000
NODE_109_length_6171_cov_36.061100	4569	4649	573	1	80	0.0125000
NODE_109_length_6171_cov_36.061100	4569	4649	574	3	80	0.0375000
NODE_109_length_6171_cov_36.061100	4569	4649	575	1	80	0.0125000
NODE_109_length_6171_cov_36.061100	4569	4649	576	2	80	0.0250000
NODE_109_length_6171_cov_36.061100	4569	4649	577	2	80	0.0250000
NODE_109_length_6171_cov_36.061100	4569	4649	578	3	80	0.0375000
NODE_109_length_6171_cov_36.061100	4569	4649	579	1	80	0.0125000
NODE_109_length_6171_cov_36.061100	4569	4649	580	5	80	0.0625000
NODE_109_length_6171_cov_36.061100	4569	4649	581	2	80	0.0250000
NODE_109_length_6171_cov_36.061100	4569	4649	582	3	80	0.0375000
NODE_109_length_6171_cov_36.061100	4569	4649	583	3	80	0.0375000
NODE_109_length_6171_cov_36.061100	4569	4649	584	5	80	0.0625000
NODE_109_length_6171_cov_36.061100	4569	4649	585	3	80	0.0375000
NODE_109_length_6171_cov_36.061100	4569	4649	586	2	80	0.0250000
NODE_109_length_6171_cov_36.061100	4569	4649	587	1	80	0.0125000
NODE_109_length_6171_cov_36.061100	4569	4649	588	2	80	0.0250000
NODE_109_length_6171_cov_36.061100	4569	4649	590	4	80	0.0500000
NODE_109_length_6171_cov_36.061100	4569	4649	591	2	80	0.0250000
NODE_109_length_6171_cov_36.061100	4569	4649	592	1	80	0.0125000
NODE_109_length_6171_cov_36.061100	4569	4649	593	2	80	0.0250000
NODE_109_length_6171_cov_36.061100	4569	4649	594	2	80	0.0250000
NODE_109_length_6171_cov_36.061100	4569	4649	598	2	80	0.0250000
NODE_109_length_6171_cov_36.061100	4569	4649	599	1	80	0.0125000
NODE_109_length_6171_cov_36.061100	4569	4649	600	1	80	0.0125000
NODE_109_length_6171_cov_36.061100	4569	4649	601	1	80	0.0125000
NODE_109_length_6171_cov_36.061100	4569	4649	604	1	80	0.0125000
NODE_109_length_6171_cov_36.061100	4569	4649	605	2	80	0.0250000
NODE_109_length_6171_cov_36.061100	4569	4649	606	1	80	0.0125000
NODE_109_length_6171_cov_36.061100	4569	4649	607	1	80	0.0125000
NODE_109_length_6171_cov_36.061100	4569	4649	614	1	80	0.0125000
NODE_109_length_6171_cov_36.061100	4569	4649	616	2	80	0.0250000
NODE_109_length_6171_cov_36.061100	4569	4649	623	1	80	0.0125000
NODE_109_length_6171_cov_36.061100	5742	5788	0	46	46	1.0000000
NODE_109_length_6171_cov_36.061100	5761	5841	0	80	80	1.0000000
NODE_110_length_6148_cov_58.915358	5602	5682	0	80	80	1.0000000
NODE_110_length_6148_cov_58.915358	5655	5735	0	80	80	1.0000000
NODE_112_length_6026_cov_17.775772	4124	4204	0	34	80	0.4250000
NODE_112_length_6026_cov_17.775772	4124	4204	2	46	80	0.5750000
NODE_112_length_6026_cov_17.775772	4177	4257	2	31	80	0.3875000
NODE_112_length_6026_cov_17.775772	4177	4257	4	18	80	0.2250000
NODE_112_length_6026_cov_17.775772	4177	4257	6	4	80	0.0500000
NODE_112_length_6026_cov_17.775772	4177	4257	8	27	80	0.3375000
NODE_112_length_6026_cov_17.775772	4253	4333	8	10	80	0.1250000
NODE_112_length_6026_cov_17.775772	4253	4333	10	44	80	0.5500000
NODE_112_length_6026_cov_17.775772	4253	4333	14	11	80	0.1375000
NODE_112_length_6026_cov_17.775772	4253	4333	18	9	80	0.1125000
NODE_112_length_6026_cov_17.775772	4253	4333	20	4	80	0.0500000
NODE_112_length_6026_cov_17.775772	4253	4333	22	2	80	0.0250000
NODE_112_length_6026_cov_17.775772	4306	4386	10	1	80	0.0125000
NODE_112_length_6026_cov_17.775772	4306	4386	14	23	80	0.2875000
NODE_112_length_6026_cov_17.775772	4306	4386	18	22	80	0.2750000
NODE_112_length_6026_cov_17.775772	4306	4386	20	32	80	0.4000000
NODE_112_length_6026_cov_17.775772	4306	4386	22	2	80	0.0250000
NODE_124_length_5810_cov_24.750657	2064	2144	0	9	80	0.1125000
NODE_124_length_5810_cov_24.750657	2064	2144	2	10	80	0.1250000
NODE_124_length_5810_cov_24.750657	2064	2144	4	8	80	0.1000000
NODE_124_length_5810_cov_24.750657	2064	2144	8	28	80	0.3500000
NODE_124_length_5810_cov_24.750657	2064	2144	10	7	80	0.0875000
NODE_124_length_5810_cov_24.750657	2064	2144	12	16	80	0.2000000
NODE_124_length_5810_cov_24.750657	2064	2144	14	2	80	0.0250000
NODE_124_length_5810_cov_24.750657	2117	2194	0	10	77	0.1298701
NODE_124_length_5810_cov_24.750657	2117	2194	2	59	77	0.7662337
NODE_124_length_5810_cov_24.750657	2117	2194	4	8	77	0.1038961
NODE_127_length_5771_cov_10.854549	2814	2883	0	69	69	1.0000000
NODE_128_length_5769_cov_6.878483	5701	5731	2	30	30	1.0000000
NODE_133_length_5728_cov_16.351039	63	134	2	25	71	0.3521127
NODE_133_length_5728_cov_16.351039	63	134	4	39	71	0.5492958
NODE_133_length_5728_cov_16.351039	63	134	5	1	71	0.0140845
NODE_133_length_5728_cov_16.351039	63	134	6	6	71	0.0845070
NODE_133_length_5728_cov_16.351039	2960	3040	0	2	80	0.0250000
NODE_133_length_5728_cov_16.351039	2960	3040	2	6	80	0.0750000
NODE_133_length_5728_cov_16.351039	2960	3040	3	32	80	0.4000000
NODE_133_length_5728_cov_16.351039	2960	3040	7	7	80	0.0875000
NODE_133_length_5728_cov_16.351039	2960	3040	13	1	80	0.0125000
NODE_133_length_5728_cov_16.351039	2960	3040	14	9	80	0.1125000
NODE_133_length_5728_cov_16.351039	2960	3040	16	3	80	0.0375000
NODE_133_length_5728_cov_16.351039	2960	3040	17	11	80	0.1375000
NODE_133_length_5728_cov_16.351039	2960	3040	19	9	80	0.1125000
NODE_133_length_5728_cov_16.351039	5106	5172	101	1	66	0.0151515
NODE_133_length_5728_cov_16.351039	5106	5172	103	3	66	0.0454545
NODE_133_length_5728_cov_16.351039	5106	5172	105	5	66	0.0757576
NODE_133_length_5728_cov_16.351039	5106	5172	106	2	66	0.0303030
NODE_133_length_5728_cov_16.351039	5106	5172	107	1	66	0.0151515
NODE_133_length_5728_cov_16.351039	5106	5172	108	2	66	0.0303030
NODE_133_length_5728_cov_16.351039	5106	5172	114	1	66	0.0151515
NODE_133_length_5728_cov_16.351039	5106	5172	119	1	66	0.0151515
NODE_133_length_5728_cov_16.351039	5106	5172	121	3	66	0.0454545
NODE_133_length_5728_cov_16.351039	5106	5172	124	1	66	0.0151515
NODE_133_length_5728_cov_16.351039	5106	5172	126	2	66	0.0303030
NODE_133_length_5728_cov_16.351039	5106	5172	129	1	66	0.0151515
NODE_133_length_5728_cov_16.351039	5106	5172	131	4	66	0.0606061
NODE_133_length_5728_cov_16.351039	5106	5172	132	1	66	0.0151515
NODE_133_length_5728_cov_16.351039	5106	5172	135	2	66	0.0303030
NODE_133_length_5728_cov_16.351039	5106	5172	138	1	66	0.0151515
NODE_133_length_5728_cov_16.351039	5106	5172	140	3	66	0.0454545
NODE_133_length_5728_cov_16.351039	5106	5172	141	1	66	0.0151515
NODE_133_length_5728_cov_16.351039	5106	5172	142	1	66	0.0151515
NODE_133_length_5728_cov_16.351039	5106	5172	146	1	66	0.0151515
NODE_133_length_5728_cov_16.351039	5106	5172	147	3	66	0.0454545
NODE_133_length_5728_cov_16.351039	5106	5172	152	1	66	0.0151515
NODE_133_length_5728_cov_16.351039	5106	5172	159	1	66	0.0151515
NODE_133_length_5728_cov_16.351039	5106	5172	160	1	66	0.0151515
NODE_133_length_5728_cov_16.351039	5106	5172	161	4	66	0.0606061
NODE_133_length_5728_cov_16.351039	5106	5172	163	3	66	0.0454545
NODE_133_length_5728_cov_16.351039	5106	5172	166	1	66	0.0151515
NODE_133_length_5728_cov_16.351039	5106	5172	168	5	66	0.0757576
NODE_133_length_5728_cov_16.351039	5106	5172	173	1	66	0.0151515
NODE_133_length_5728_cov_16.351039	5106	5172	185	1	66	0.0151515
NODE_133_length_5728_cov_16.351039	5106	5172	189	1	66	0.0151515
NODE_133_length_5728_cov_16.351039	5106	5172	193	1	66	0.0151515
NODE_133_length_5728_cov_16.351039	5106	5172	195	1	66	0.0151515
NODE_133_length_5728_cov_16.351039	5106	5172	196	1	66	0.0151515
NODE_133_length_5728_cov_16.351039	5106	5172	198	3	66	0.0454545
NODE_133_length_5728_cov_16.351039	5106	5172	199	1	66	0.0151515
NODE_133_length_5728_cov_16.351039	5145	5225	147	1	80	0.0125000
NODE_133_length_5728_cov_16.351039	5145	5225	152	1	80	0.0125000
NODE_133_length_5728_cov_16.351039	5145	5225	159	1	80	0.0125000
NODE_133_length_5728_cov_16.351039	5145	5225	160	1	80	0.0125000
NODE_133_length_5728_cov_16.351039	5145	5225	161	4	80	0.0500000
NODE_133_length_5728_cov_16.351039	5145	5225	163	3	80	0.0375000
NODE_133_length_5728_cov_16.351039	5145	5225	166	1	80	0.0125000
NODE_133_length_5728_cov_16.351039	5145	5225	168	5	80	0.0625000
NODE_133_length_5728_cov_16.351039	5145	5225	173	1	80	0.0125000
NODE_133_length_5728_cov_16.351039	5145	5225	185	1	80	0.0125000
NODE_133_length_5728_cov_16.351039	5145	5225	189	1	80	0.0125000
NODE_133_length_5728_cov_16.351039	5145	5225	193	1	80	0.0125000
NODE_133_length_5728_cov_16.351039	5145	5225	195	1	80	0.0125000
NODE_133_length_5728_cov_16.351039	5145	5225	196	1	80	0.0125000
NODE_133_length_5728_cov_16.351039	5145	5225	198	3	80	0.0375000
NODE_133_length_5728_cov_16.351039	5145	5225	199	2	80	0.0250000
NODE_133_length_5728_cov_16.351039	5145	5225	203	1	80	0.0125000
NODE_133_length_5728_cov_16.351039	5145	5225	204	1	80	0.0125000
NODE_133_length_5728_cov_16.351039	5145	5225	207	1	80	0.0125000
NODE_133_length_5728_cov_16.351039	5145	5225	208	1	80	0.0125000
NODE_133_length_5728_cov_16.351039	5145	5225	210	1	80	0.0125000
NODE_133_length_5728_cov_16.351039	5145	5225	212	1	80	0.0125000
NODE_133_length_5728_cov_16.351039	5145	5225	213	1	80	0.0125000
NODE_133_length_5728_cov_16.351039	5145	5225	217	1	80	0.0125000
NODE_133_length_5728_cov_16.351039	5145	5225	220	1	80	0.0125000
NODE_133_length_5728_cov_16.351039	5145	5225	221	3	80	0.0375000
NODE_133_length_5728_cov_16.351039	5145	5225	224	1	80	0.0125000
NODE_133_length_5728_cov_16.351039	5145	5225	225	1	80	0.0125000
NODE_133_length_5728_cov_16.351039	5145	5225	226	1	80	0.0125000
NODE_133_length_5728_cov_16.351039	5145	5225	228	1	80	0.0125000
NODE_133_length_5728_cov_16.351039	5145	5225	230	1	80	0.0125000
NODE_133_length_5728_cov_16.351039	5145	5225	231	6	80	0.0750000
NODE_133_length_5728_cov_16.351039	5145	5225	233	3	80	0.0375000
NODE_133_length_5728_cov_16.351039	5145	5225	234	3	80	0.0375000
NODE_133_length_5728_cov_16.351039	5145	5225	235	5	80	0.0625000
NODE_133_length_5728_cov_16.351039	5145	5225	236	2	80	0.0250000
NODE_133_length_5728_cov_16.351039	5145	5225	237	5	80	0.0625000
NODE_133_length_5728_cov_16.351039	5145	5225	238	1	80	0.0125000
NODE_133_length_5728_cov_16.351039	5145	5225	241	1	80	0.0125000
NODE_133_length_5728_cov_16.351039	5145	5225	243	1	80	0.0125000
NODE_133_length_5728_cov_16.351039	5145	5225	246	1	80	0.0125000
NODE_133_length_5728_cov_16.351039	5145	5225	247	5	80	0.0625000
NODE_133_length_5728_cov_16.351039	5145	5225	248	2	80	0.0250000
NODE_137_length_5696_cov_20.656244	179	258	0	9	79	0.1139240
NODE_137_length_5696_cov_20.656244	179	258	4	3	79	0.0379747
NODE_137_length_5696_cov_20.656244	179	258	5	67	79	0.8481013
NODE_137_length_5696_cov_20.656244	231	311	0	62	80	0.7750000
NODE_137_length_5696_cov_20.656244	231	311	4	3	80	0.0375000
NODE_137_length_5696_cov_20.656244	231	311	5	15	80	0.1875000
NODE_137_length_5696_cov_20.656244	307	387	0	80	80	1.0000000
NODE_137_length_5696_cov_20.656244	360	440	0	80	80	1.0000000
NODE_137_length_5696_cov_20.656244	5100	5180	4	80	80	1.0000000
NODE_137_length_5696_cov_20.656244	5153	5233	0	6	80	0.0750000
NODE_137_length_5696_cov_20.656244	5153	5233	4	74	80	0.9250000
NODE_137_length_5696_cov_20.656244	5280	5360	0	3	80	0.0375000
NODE_137_length_5696_cov_20.656244	5280	5360	6	76	80	0.9500000
NODE_137_length_5696_cov_20.656244	5280	5360	8	1	80	0.0125000
NODE_137_length_5696_cov_20.656244	5333	5413	2	23	80	0.2875000
NODE_137_length_5696_cov_20.656244	5333	5413	6	26	80	0.3250000
NODE_137_length_5696_cov_20.656244	5333	5413	8	31	80	0.3875000
NODE_139_length_5681_cov_68.065030	253	333	8	15	80	0.1875000
NODE_139_length_5681_cov_68.065030	253	333	10	1	80	0.0125000
NODE_139_length_5681_cov_68.065030	253	333	11	4	80	0.0500000
NODE_139_length_5681_cov_68.065030	253	333	12	1	80	0.0125000
NODE_139_length_5681_cov_68.065030	253	333	13	19	80	0.2375000
NODE_139_length_5681_cov_68.065030	253	333	14	9	80	0.1125000
NODE_139_length_5681_cov_68.065030	253	333	16	28	80	0.3500000
NODE_139_length_5681_cov_68.065030	253	333	18	3	80	0.0375000
NODE_139_length_5681_cov_68.065030	306	386	2	7	80	0.0875000
NODE_139_length_5681_cov_68.065030	306	386	4	23	80	0.2875000
NODE_139_length_5681_cov_68.065030	306	386	9	23	80	0.2875000
NODE_139_length_5681_cov_68.065030	306	386	10	1	80	0.0125000
NODE_139_length_5681_cov_68.065030	306	386	11	4	80	0.0500000
NODE_139_length_5681_cov_68.065030	306	386	12	1	80	0.0125000
NODE_139_length_5681_cov_68.065030	306	386	13	19	80	0.2375000
NODE_139_length_5681_cov_68.065030	306	386	14	2	80	0.0250000
NODE_139_length_5681_cov_68.065030	4762	4842	75	6	80	0.0750000
NODE_139_length_5681_cov_68.065030	4762	4842	87	1	80	0.0125000
NODE_139_length_5681_cov_68.065030	4762	4842	88	10	80	0.1250000
NODE_139_length_5681_cov_68.065030	4762	4842	90	7	80	0.0875000
NODE_139_length_5681_cov_68.065030	4762	4842	92	3	80	0.0375000
NODE_139_length_5681_cov_68.065030	4762	4842	93	3	80	0.0375000
NODE_139_length_5681_cov_68.065030	4762	4842	97	1	80	0.0125000
NODE_139_length_5681_cov_68.065030	4762	4842	98	1	80	0.0125000
NODE_139_length_5681_cov_68.065030	4762	4842	101	6	80	0.0750000
NODE_139_length_5681_cov_68.065030	4762	4842	102	2	80	0.0250000
NODE_139_length_5681_cov_68.065030	4762	4842	103	16	80	0.2000000
NODE_139_length_5681_cov_68.065030	4762	4842	104	10	80	0.1250000
NODE_139_length_5681_cov_68.065030	4762	4842	105	9	80	0.1125000
NODE_139_length_5681_cov_68.065030	4762	4842	108	4	80	0.0500000
NODE_139_length_5681_cov_68.065030	4762	4842	109	1	80	0.0125000
NODE_139_length_5681_cov_68.065030	4762	4842	75	6	80	0.0750000
NODE_139_length_5681_cov_68.065030	4762	4842	87	1	80	0.0125000
NODE_139_length_5681_cov_68.065030	4762	4842	88	10	80	0.1250000
NODE_139_length_5681_cov_68.065030	4762	4842	90	7	80	0.0875000
NODE_139_length_5681_cov_68.065030	4762	4842	92	3	80	0.0375000
NODE_139_length_5681_cov_68.065030	4762	4842	93	3	80	0.0375000
NODE_139_length_5681_cov_68.065030	4762	4842	97	1	80	0.0125000
NODE_139_length_5681_cov_68.065030	4762	4842	98	1	80	0.0125000
NODE_139_length_5681_cov_68.065030	4762	4842	101	6	80	0.0750000
NODE_139_length_5681_cov_68.065030	4762	4842	102	2	80	0.0250000
NODE_139_length_5681_cov_68.065030	4762	4842	103	16	80	0.2000000
NODE_139_length_5681_cov_68.065030	4762	4842	104	10	80	0.1250000
NODE_139_length_5681_cov_68.065030	4762	4842	105	9	80	0.1125000
NODE_139_length_5681_cov_68.065030	4762	4842	108	4	80	0.0500000
NODE_139_length_5681_cov_68.065030	4762	4842	109	1	80	0.0125000
NODE_139_length_5681_cov_68.065030	4762	4842	75	6	80	0.0750000
NODE_139_length_5681_cov_68.065030	4762	4842	87	1	80	0.0125000
NODE_139_length_5681_cov_68.065030	4762	4842	88	10	80	0.1250000
NODE_139_length_5681_cov_68.065030	4762	4842	90	7	80	0.0875000
NODE_139_length_5681_cov_68.065030	4762	4842	92	3	80	0.0375000
NODE_139_length_5681_cov_68.065030	4762	4842	93	3	80	0.0375000
NODE_139_length_5681_cov_68.065030	4762	4842	97	1	80	0.0125000
NODE_139_length_5681_cov_68.065030	4762	4842	98	1	80	0.0125000
NODE_139_length_5681_cov_68.065030	4762	4842	101	6	80	0.0750000
NODE_139_length_5681_cov_68.065030	4762	4842	102	2	80	0.0250000
NODE_139_length_5681_cov_68.065030	4762	4842	103	16	80	0.2000000
NODE_139_length_5681_cov_68.065030	4762	4842	104	10	80	0.1250000
NODE_139_length_5681_cov_68.065030	4762	4842	105	9	80	0.1125000
NODE_139_length_5681_cov_68.065030	4762	4842	108	4	80	0.0500000
NODE_139_length_5681_cov_68.065030	4762	4842	109	1	80	0.0125000
NODE_139_length_5681_cov_68.065030	4762	4842	75	6	80	0.0750000
NODE_139_length_5681_cov_68.065030	4762	4842	87	1	80	0.0125000
NODE_139_length_5681_cov_68.065030	4762	4842	88	10	80	0.1250000
NODE_139_length_5681_cov_68.065030	4762	4842	90	7	80	0.0875000
NODE_139_length_5681_cov_68.065030	4762	4842	92	3	80	0.0375000
NODE_139_length_5681_cov_68.065030	4762	4842	93	3	80	0.0375000
NODE_139_length_5681_cov_68.065030	4762	4842	97	1	80	0.0125000
NODE_139_length_5681_cov_68.065030	4762	4842	98	1	80	0.0125000
NODE_139_length_5681_cov_68.065030	4762	4842	101	6	80	0.0750000
NODE_139_length_5681_cov_68.065030	4762	4842	102	2	80	0.0250000
NODE_139_length_5681_cov_68.065030	4762	4842	103	16	80	0.2000000
NODE_139_length_5681_cov_68.065030	4762	4842	104	10	80	0.1250000
NODE_139_length_5681_cov_68.065030	4762	4842	105	9	80	0.1125000
NODE_139_length_5681_cov_68.065030	4762	4842	108	4	80	0.0500000
NODE_139_length_5681_cov_68.065030	4762	4842	109	1	80	0.0125000
NODE_139_length_5681_cov_68.065030	4762	4842	75	6	80	0.0750000
NODE_139_length_5681_cov_68.065030	4762	4842	87	1	80	0.0125000
NODE_139_length_5681_cov_68.065030	4762	4842	88	10	80	0.1250000
NODE_139_length_5681_cov_68.065030	4762	4842	90	7	80	0.0875000
NODE_139_length_5681_cov_68.065030	4762	4842	92	3	80	0.0375000
NODE_139_length_5681_cov_68.065030	4762	4842	93	3	80	0.0375000
NODE_139_length_5681_cov_68.065030	4762	4842	97	1	80	0.0125000
NODE_139_length_5681_cov_68.065030	4762	4842	98	1	80	0.0125000
NODE_139_length_5681_cov_68.065030	4762	4842	101	6	80	0.0750000
NODE_139_length_5681_cov_68.065030	4762	4842	102	2	80	0.0250000
NODE_139_length_5681_cov_68.065030	4762	4842	103	16	80	0.2000000
NODE_139_length_5681_cov_68.065030	4762	4842	104	10	80	0.1250000
NODE_139_length_5681_cov_68.065030	4762	4842	105	9	80	0.1125000
NODE_139_length_5681_cov_68.065030	4762	4842	108	4	80	0.0500000
NODE_139_length_5681_cov_68.065030	4762	4842	109	1	80	0.0125000
NODE_139_length_5681_cov_68.065030	4762	4842	75	6	80	0.0750000
NODE_139_length_5681_cov_68.065030	4762	4842	87	1	80	0.0125000
NODE_139_length_5681_cov_68.065030	4762	4842	88	10	80	0.1250000
NODE_139_length_5681_cov_68.065030	4762	4842	90	7	80	0.0875000
NODE_139_length_5681_cov_68.065030	4762	4842	92	3	80	0.0375000
NODE_139_length_5681_cov_68.065030	4762	4842	93	3	80	0.0375000
NODE_139_length_5681_cov_68.065030	4762	4842	97	1	80	0.0125000
NODE_139_length_5681_cov_68.065030	4762	4842	98	1	80	0.0125000
NODE_139_length_5681_cov_68.065030	4762	4842	101	6	80	0.0750000
NODE_139_length_5681_cov_68.065030	4762	4842	102	2	80	0.0250000
NODE_139_length_5681_cov_68.065030	4762	4842	103	16	80	0.2000000
NODE_139_length_5681_cov_68.065030	4762	4842	104	10	80	0.1250000
NODE_139_length_5681_cov_68.065030	4762	4842	105	9	80	0.1125000
NODE_139_length_5681_cov_68.065030	4762	4842	108	4	80	0.0500000
NODE_139_length_5681_cov_68.065030	4762	4842	109	1	80	0.0125000
NODE_139_length_5681_cov_68.065030	4769	4839	88	8	70	0.1142857
NODE_139_length_5681_cov_68.065030	4769	4839	90	7	70	0.1000000
NODE_139_length_5681_cov_68.065030	4769	4839	92	3	70	0.0428571
NODE_139_length_5681_cov_68.065030	4769	4839	93	3	70	0.0428571
NODE_139_length_5681_cov_68.065030	4769	4839	97	1	70	0.0142857
NODE_139_length_5681_cov_68.065030	4769	4839	98	1	70	0.0142857
NODE_139_length_5681_cov_68.065030	4769	4839	101	6	70	0.0857143
NODE_139_length_5681_cov_68.065030	4769	4839	102	2	70	0.0285714
NODE_139_length_5681_cov_68.065030	4769	4839	103	15	70	0.2142857
NODE_139_length_5681_cov_68.065030	4769	4839	104	10	70	0.1428571
NODE_139_length_5681_cov_68.065030	4769	4839	105	9	70	0.1285714
NODE_139_length_5681_cov_68.065030	4769	4839	108	4	70	0.0571429
NODE_139_length_5681_cov_68.065030	4769	4839	109	1	70	0.0142857
NODE_139_length_5681_cov_68.065030	4771	4842	87	1	71	0.0140845
NODE_139_length_5681_cov_68.065030	4771	4842	88	10	71	0.1408451
NODE_139_length_5681_cov_68.065030	4771	4842	90	7	71	0.0985916
NODE_139_length_5681_cov_68.065030	4771	4842	92	3	71	0.0422535
NODE_139_length_5681_cov_68.065030	4771	4842	93	3	71	0.0422535
NODE_139_length_5681_cov_68.065030	4771	4842	97	1	71	0.0140845
NODE_139_length_5681_cov_68.065030	4771	4842	98	1	71	0.0140845
NODE_139_length_5681_cov_68.065030	4771	4842	101	6	71	0.0845070
NODE_139_length_5681_cov_68.065030	4771	4842	102	2	71	0.0281690
NODE_139_length_5681_cov_68.065030	4771	4842	103	13	71	0.1830986
NODE_139_length_5681_cov_68.065030	4771	4842	104	10	71	0.1408451
NODE_139_length_5681_cov_68.065030	4771	4842	105	9	71	0.1267606
NODE_139_length_5681_cov_68.065030	4771	4842	108	4	71	0.0563380
NODE_139_length_5681_cov_68.065030	4771	4842	109	1	71	0.0140845
NODE_139_length_5681_cov_68.065030	4815	4895	48	16	80	0.2000000
NODE_139_length_5681_cov_68.065030	4815	4895	51	1	80	0.0125000
NODE_139_length_5681_cov_68.065030	4815	4895	52	1	80	0.0125000
NODE_139_length_5681_cov_68.065030	4815	4895	53	14	80	0.1750000
NODE_139_length_5681_cov_68.065030	4815	4895	62	3	80	0.0375000
NODE_139_length_5681_cov_68.065030	4815	4895	67	3	80	0.0375000
NODE_139_length_5681_cov_68.065030	4815	4895	72	1	80	0.0125000
NODE_139_length_5681_cov_68.065030	4815	4895	78	6	80	0.0750000
NODE_139_length_5681_cov_68.065030	4815	4895	80	4	80	0.0500000
NODE_139_length_5681_cov_68.065030	4815	4895	84	2	80	0.0250000
NODE_139_length_5681_cov_68.065030	4815	4895	86	2	80	0.0250000
NODE_139_length_5681_cov_68.065030	4815	4895	87	1	80	0.0125000
NODE_139_length_5681_cov_68.065030	4815	4895	88	10	80	0.1250000
NODE_139_length_5681_cov_68.065030	4815	4895	90	7	80	0.0875000
NODE_139_length_5681_cov_68.065030	4815	4895	92	3	80	0.0375000
NODE_139_length_5681_cov_68.065030	4815	4895	93	3	80	0.0375000
NODE_139_length_5681_cov_68.065030	4815	4895	97	1	80	0.0125000
NODE_139_length_5681_cov_68.065030	4815	4895	98	1	80	0.0125000
NODE_139_length_5681_cov_68.065030	4815	4895	103	1	80	0.0125000
NODE_139_length_5681_cov_68.065030	4815	4895	48	16	80	0.2000000
NODE_139_length_5681_cov_68.065030	4815	4895	51	1	80	0.0125000
NODE_139_length_5681_cov_68.065030	4815	4895	52	1	80	0.0125000
NODE_139_length_5681_cov_68.065030	4815	4895	53	14	80	0.1750000
NODE_139_length_5681_cov_68.065030	4815	4895	62	3	80	0.0375000
NODE_139_length_5681_cov_68.065030	4815	4895	67	3	80	0.0375000
NODE_139_length_5681_cov_68.065030	4815	4895	72	1	80	0.0125000
NODE_139_length_5681_cov_68.065030	4815	4895	78	6	80	0.0750000
NODE_139_length_5681_cov_68.065030	4815	4895	80	4	80	0.0500000
NODE_139_length_5681_cov_68.065030	4815	4895	84	2	80	0.0250000
NODE_139_length_5681_cov_68.065030	4815	4895	86	2	80	0.0250000
NODE_139_length_5681_cov_68.065030	4815	4895	87	1	80	0.0125000
NODE_139_length_5681_cov_68.065030	4815	4895	88	10	80	0.1250000
NODE_139_length_5681_cov_68.065030	4815	4895	90	7	80	0.0875000
NODE_139_length_5681_cov_68.065030	4815	4895	92	3	80	0.0375000
NODE_139_length_5681_cov_68.065030	4815	4895	93	3	80	0.0375000
NODE_139_length_5681_cov_68.065030	4815	4895	97	1	80	0.0125000
NODE_139_length_5681_cov_68.065030	4815	4895	98	1	80	0.0125000
NODE_139_length_5681_cov_68.065030	4815	4895	103	1	80	0.0125000
NODE_139_length_5681_cov_68.065030	4815	4895	48	16	80	0.2000000
NODE_139_length_5681_cov_68.065030	4815	4895	51	1	80	0.0125000
NODE_139_length_5681_cov_68.065030	4815	4895	52	1	80	0.0125000
NODE_139_length_5681_cov_68.065030	4815	4895	53	14	80	0.1750000
NODE_139_length_5681_cov_68.065030	4815	4895	62	3	80	0.0375000
NODE_139_length_5681_cov_68.065030	4815	4895	67	3	80	0.0375000
NODE_139_length_5681_cov_68.065030	4815	4895	72	1	80	0.0125000
NODE_139_length_5681_cov_68.065030	4815	4895	78	6	80	0.0750000
NODE_139_length_5681_cov_68.065030	4815	4895	80	4	80	0.0500000
NODE_139_length_5681_cov_68.065030	4815	4895	84	2	80	0.0250000
NODE_139_length_5681_cov_68.065030	4815	4895	86	2	80	0.0250000
NODE_139_length_5681_cov_68.065030	4815	4895	87	1	80	0.0125000
NODE_139_length_5681_cov_68.065030	4815	4895	88	10	80	0.1250000
NODE_139_length_5681_cov_68.065030	4815	4895	90	7	80	0.0875000
NODE_139_length_5681_cov_68.065030	4815	4895	92	3	80	0.0375000
NODE_139_length_5681_cov_68.065030	4815	4895	93	3	80	0.0375000
NODE_139_length_5681_cov_68.065030	4815	4895	97	1	80	0.0125000
NODE_139_length_5681_cov_68.065030	4815	4895	98	1	80	0.0125000
NODE_139_length_5681_cov_68.065030	4815	4895	103	1	80	0.0125000
NODE_139_length_5681_cov_68.065030	4815	4895	48	16	80	0.2000000
NODE_139_length_5681_cov_68.065030	4815	4895	51	1	80	0.0125000
NODE_139_length_5681_cov_68.065030	4815	4895	52	1	80	0.0125000
NODE_139_length_5681_cov_68.065030	4815	4895	53	14	80	0.1750000
NODE_139_length_5681_cov_68.065030	4815	4895	62	3	80	0.0375000
NODE_139_length_5681_cov_68.065030	4815	4895	67	3	80	0.0375000
NODE_139_length_5681_cov_68.065030	4815	4895	72	1	80	0.0125000
NODE_139_length_5681_cov_68.065030	4815	4895	78	6	80	0.0750000
NODE_139_length_5681_cov_68.065030	4815	4895	80	4	80	0.0500000
NODE_139_length_5681_cov_68.065030	4815	4895	84	2	80	0.0250000
NODE_139_length_5681_cov_68.065030	4815	4895	86	2	80	0.0250000
NODE_139_length_5681_cov_68.065030	4815	4895	87	1	80	0.0125000
NODE_139_length_5681_cov_68.065030	4815	4895	88	10	80	0.1250000
NODE_139_length_5681_cov_68.065030	4815	4895	90	7	80	0.0875000
NODE_139_length_5681_cov_68.065030	4815	4895	92	3	80	0.0375000
NODE_139_length_5681_cov_68.065030	4815	4895	93	3	80	0.0375000
NODE_139_length_5681_cov_68.065030	4815	4895	97	1	80	0.0125000
NODE_139_length_5681_cov_68.065030	4815	4895	98	1	80	0.0125000
NODE_139_length_5681_cov_68.065030	4815	4895	103	1	80	0.0125000
NODE_139_length_5681_cov_68.065030	4815	4895	48	16	80	0.2000000
NODE_139_length_5681_cov_68.065030	4815	4895	51	1	80	0.0125000
NODE_139_length_5681_cov_68.065030	4815	4895	52	1	80	0.0125000
NODE_139_length_5681_cov_68.065030	4815	4895	53	14	80	0.1750000
NODE_139_length_5681_cov_68.065030	4815	4895	62	3	80	0.0375000
NODE_139_length_5681_cov_68.065030	4815	4895	67	3	80	0.0375000
NODE_139_length_5681_cov_68.065030	4815	4895	72	1	80	0.0125000
NODE_139_length_5681_cov_68.065030	4815	4895	78	6	80	0.0750000
NODE_139_length_5681_cov_68.065030	4815	4895	80	4	80	0.0500000
NODE_139_length_5681_cov_68.065030	4815	4895	84	2	80	0.0250000
NODE_139_length_5681_cov_68.065030	4815	4895	86	2	80	0.0250000
NODE_139_length_5681_cov_68.065030	4815	4895	87	1	80	0.0125000
NODE_139_length_5681_cov_68.065030	4815	4895	88	10	80	0.1250000
NODE_139_length_5681_cov_68.065030	4815	4895	90	7	80	0.0875000
NODE_139_length_5681_cov_68.065030	4815	4895	92	3	80	0.0375000
NODE_139_length_5681_cov_68.065030	4815	4895	93	3	80	0.0375000
NODE_139_length_5681_cov_68.065030	4815	4895	97	1	80	0.0125000
NODE_139_length_5681_cov_68.065030	4815	4895	98	1	80	0.0125000
NODE_139_length_5681_cov_68.065030	4815	4895	103	1	80	0.0125000
NODE_139_length_5681_cov_68.065030	4815	4895	48	16	80	0.2000000
NODE_139_length_5681_cov_68.065030	4815	4895	51	1	80	0.0125000
NODE_139_length_5681_cov_68.065030	4815	4895	52	1	80	0.0125000
NODE_139_length_5681_cov_68.065030	4815	4895	53	14	80	0.1750000
NODE_139_length_5681_cov_68.065030	4815	4895	62	3	80	0.0375000
NODE_139_length_5681_cov_68.065030	4815	4895	67	3	80	0.0375000
NODE_139_length_5681_cov_68.065030	4815	4895	72	1	80	0.0125000
NODE_139_length_5681_cov_68.065030	4815	4895	78	6	80	0.0750000
NODE_139_length_5681_cov_68.065030	4815	4895	80	4	80	0.0500000
NODE_139_length_5681_cov_68.065030	4815	4895	84	2	80	0.0250000
NODE_139_length_5681_cov_68.065030	4815	4895	86	2	80	0.0250000
NODE_139_length_5681_cov_68.065030	4815	4895	87	1	80	0.0125000
NODE_139_length_5681_cov_68.065030	4815	4895	88	10	80	0.1250000
NODE_139_length_5681_cov_68.065030	4815	4895	90	7	80	0.0875000
NODE_139_length_5681_cov_68.065030	4815	4895	92	3	80	0.0375000
NODE_139_length_5681_cov_68.065030	4815	4895	93	3	80	0.0375000
NODE_139_length_5681_cov_68.065030	4815	4895	97	1	80	0.0125000
NODE_139_length_5681_cov_68.065030	4815	4895	98	1	80	0.0125000
NODE_139_length_5681_cov_68.065030	4815	4895	103	1	80	0.0125000
NODE_139_length_5681_cov_68.065030	4891	4971	0	41	80	0.5125000
NODE_139_length_5681_cov_68.065030	4891	4971	1	4	80	0.0500000
NODE_139_length_5681_cov_68.065030	4891	4971	2	10	80	0.1250000
NODE_139_length_5681_cov_68.065030	4891	4971	10	2	80	0.0250000
NODE_139_length_5681_cov_68.065030	4891	4971	37	1	80	0.0125000
NODE_139_length_5681_cov_68.065030	4891	4971	38	1	80	0.0125000
NODE_139_length_5681_cov_68.065030	4891	4971	40	2	80	0.0250000
NODE_139_length_5681_cov_68.065030	4891	4971	44	13	80	0.1625000
NODE_139_length_5681_cov_68.065030	4891	4971	48	6	80	0.0750000
NODE_139_length_5681_cov_68.065030	4944	5007	0	63	63	1.0000000
NODE_139_length_5681_cov_68.065030	4944	5024	0	80	80	1.0000000
NODE_140_length_5677_cov_21.613482	1792	1863	16	1	71	0.0140845
NODE_140_length_5677_cov_21.613482	1792	1863	18	12	71	0.1690141
NODE_140_length_5677_cov_21.613482	1792	1863	19	11	71	0.1549296
NODE_140_length_5677_cov_21.613482	1792	1863	20	33	71	0.4647887
NODE_140_length_5677_cov_21.613482	1792	1863	21	7	71	0.0985916
NODE_140_length_5677_cov_21.613482	1792	1863	22	2	71	0.0281690
NODE_140_length_5677_cov_21.613482	1792	1863	23	1	71	0.0140845
NODE_140_length_5677_cov_21.613482	1792	1863	24	1	71	0.0140845
NODE_140_length_5677_cov_21.613482	1792	1863	25	1	71	0.0140845
NODE_140_length_5677_cov_21.613482	1792	1863	26	1	71	0.0140845
NODE_140_length_5677_cov_21.613482	1792	1863	27	1	71	0.0140845
NODE_140_length_5677_cov_21.613482	1845	1916	16	2	71	0.0281690
NODE_140_length_5677_cov_21.613482	1845	1916	18	7	71	0.0985916
NODE_140_length_5677_cov_21.613482	1845	1916	20	22	71	0.3098592
NODE_140_length_5677_cov_21.613482	1845	1916	21	9	71	0.1267606
NODE_140_length_5677_cov_21.613482	1845	1916	22	4	71	0.0563380
NODE_140_length_5677_cov_21.613482	1845	1916	23	27	71	0.3802817
NODE_142_length_5631_cov_25.927332	96	176	20	11	80	0.1375000
NODE_142_length_5631_cov_25.927332	96	176	22	11	80	0.1375000
NODE_142_length_5631_cov_25.927332	96	176	24	4	80	0.0500000
NODE_142_length_5631_cov_25.927332	96	176	28	29	80	0.3625000
NODE_142_length_5631_cov_25.927332	96	176	30	18	80	0.2250000
NODE_142_length_5631_cov_25.927332	96	176	32	7	80	0.0875000
NODE_142_length_5631_cov_25.927332	149	229	14	4	80	0.0500000
NODE_142_length_5631_cov_25.927332	149	229	20	20	80	0.2500000
NODE_142_length_5631_cov_25.927332	149	229	22	3	80	0.0375000
NODE_142_length_5631_cov_25.927332	149	229	24	13	80	0.1625000
NODE_142_length_5631_cov_25.927332	149	229	26	17	80	0.2125000
NODE_142_length_5631_cov_25.927332	149	229	30	16	80	0.2000000
NODE_142_length_5631_cov_25.927332	149	229	32	7	80	0.0875000
NODE_146_length_5588_cov_40.961377	2793	2873	46	5	80	0.0625000
NODE_146_length_5588_cov_40.961377	2793	2873	47	16	80	0.2000000
NODE_146_length_5588_cov_40.961377	2793	2873	48	16	80	0.2000000
NODE_146_length_5588_cov_40.961377	2793	2873	49	15	80	0.1875000
NODE_146_length_5588_cov_40.961377	2793	2873	50	15	80	0.1875000
NODE_146_length_5588_cov_40.961377	2793	2873	51	8	80	0.1000000
NODE_146_length_5588_cov_40.961377	2793	2873	52	1	80	0.0125000
NODE_146_length_5588_cov_40.961377	2793	2873	53	4	80	0.0500000
NODE_146_length_5588_cov_40.961377	2846	2926	2	13	80	0.1625000
NODE_146_length_5588_cov_40.961377	2846	2926	4	1	80	0.0125000
NODE_146_length_5588_cov_40.961377	2846	2926	10	6	80	0.0750000
NODE_146_length_5588_cov_40.961377	2846	2926	12	2	80	0.0250000
NODE_146_length_5588_cov_40.961377	2846	2926	14	1	80	0.0125000
NODE_146_length_5588_cov_40.961377	2846	2926	28	13	80	0.1625000
NODE_146_length_5588_cov_40.961377	2846	2926	32	6	80	0.0750000
NODE_146_length_5588_cov_40.961377	2846	2926	34	7	80	0.0875000
NODE_146_length_5588_cov_40.961377	2846	2926	38	3	80	0.0375000
NODE_146_length_5588_cov_40.961377	2846	2926	40	1	80	0.0125000
NODE_146_length_5588_cov_40.961377	2846	2926	46	1	80	0.0125000
NODE_146_length_5588_cov_40.961377	2846	2926	47	6	80	0.0750000
NODE_146_length_5588_cov_40.961377	2846	2926	48	14	80	0.1750000
NODE_146_length_5588_cov_40.961377	2846	2926	50	6	80	0.0750000
NODE_146_length_5588_cov_40.961377	2922	3002	10	3	80	0.0375000
NODE_146_length_5588_cov_40.961377	2922	3002	12	2	80	0.0250000
NODE_146_length_5588_cov_40.961377	2922	3002	14	23	80	0.2875000
NODE_146_length_5588_cov_40.961377	2922	3002	18	1	80	0.0125000
NODE_146_length_5588_cov_40.961377	2922	3002	22	12	80	0.1500000
NODE_146_length_5588_cov_40.961377	2922	3002	23	1	80	0.0125000
NODE_146_length_5588_cov_40.961377	2922	3002	26	2	80	0.0250000
NODE_146_length_5588_cov_40.961377	2922	3002	30	6	80	0.0750000
NODE_146_length_5588_cov_40.961377	2922	3002	34	10	80	0.1250000
NODE_146_length_5588_cov_40.961377	2922	3002	38	1	80	0.0125000
NODE_146_length_5588_cov_40.961377	2922	3002	39	1	80	0.0125000
NODE_146_length_5588_cov_40.961377	2922	3002	40	1	80	0.0125000
NODE_146_length_5588_cov_40.961377	2922	3002	41	9	80	0.1125000
NODE_146_length_5588_cov_40.961377	2922	3002	43	2	80	0.0250000
NODE_146_length_5588_cov_40.961377	2922	3002	45	6	80	0.0750000
NODE_146_length_5588_cov_40.961377	2975	3055	34	7	80	0.0875000
NODE_146_length_5588_cov_40.961377	2975	3055	37	3	80	0.0375000
NODE_146_length_5588_cov_40.961377	2975	3055	38	1	80	0.0125000
NODE_146_length_5588_cov_40.961377	2975	3055	39	5	80	0.0625000
NODE_146_length_5588_cov_40.961377	2975	3055	40	7	80	0.0875000
NODE_146_length_5588_cov_40.961377	2975	3055	41	21	80	0.2625000
NODE_146_length_5588_cov_40.961377	2975	3055	43	15	80	0.1875000
NODE_146_length_5588_cov_40.961377	2975	3055	45	21	80	0.2625000
NODE_149_length_5578_cov_5.173389	331	411	4	21	80	0.2625000
NODE_149_length_5578_cov_5.173389	331	411	8	6	80	0.0750000
NODE_149_length_5578_cov_5.173389	331	411	9	53	80	0.6625000
NODE_149_length_5578_cov_5.173389	388	464	9	46	76	0.6052632
NODE_149_length_5578_cov_5.173389	388	464	11	30	76	0.3947369
NODE_150_length_5572_cov_79.124246	1555	1627	54	1	72	0.0138889
NODE_150_length_5572_cov_79.124246	1555	1627	56	1	72	0.0138889
NODE_150_length_5572_cov_79.124246	1555	1627	57	1	72	0.0138889
NODE_150_length_5572_cov_79.124246	1555	1627	58	2	72	0.0277778
NODE_150_length_5572_cov_79.124246	1555	1627	59	3	72	0.0416667
NODE_150_length_5572_cov_79.124246	1555	1627	60	4	72	0.0555556
NODE_150_length_5572_cov_79.124246	1555	1627	61	3	72	0.0416667
NODE_150_length_5572_cov_79.124246	1555	1627	62	3	72	0.0416667
NODE_150_length_5572_cov_79.124246	1555	1627	63	5	72	0.0694444
NODE_150_length_5572_cov_79.124246	1555	1627	64	1	72	0.0138889
NODE_150_length_5572_cov_79.124246	1555	1627	65	2	72	0.0277778
NODE_150_length_5572_cov_79.124246	1555	1627	66	2	72	0.0277778
NODE_150_length_5572_cov_79.124246	1555	1627	67	1	72	0.0138889
NODE_150_length_5572_cov_79.124246	1555	1627	69	1	72	0.0138889
NODE_150_length_5572_cov_79.124246	1555	1627	72	1	72	0.0138889
NODE_150_length_5572_cov_79.124246	1555	1627	73	1	72	0.0138889
NODE_150_length_5572_cov_79.124246	1555	1627	74	2	72	0.0277778
NODE_150_length_5572_cov_79.124246	1555	1627	76	1	72	0.0138889
NODE_150_length_5572_cov_79.124246	1555	1627	77	1	72	0.0138889
NODE_150_length_5572_cov_79.124246	1555	1627	78	1	72	0.0138889
NODE_150_length_5572_cov_79.124246	1555	1627	79	1	72	0.0138889
NODE_150_length_5572_cov_79.124246	1555	1627	80	1	72	0.0138889
NODE_150_length_5572_cov_79.124246	1555	1627	92	1	72	0.0138889
NODE_150_length_5572_cov_79.124246	1555	1627	94	1	72	0.0138889
NODE_150_length_5572_cov_79.124246	1555	1627	97	2	72	0.0277778
NODE_150_length_5572_cov_79.124246	1555	1627	111	1	72	0.0138889
NODE_150_length_5572_cov_79.124246	1555	1627	113	1	72	0.0138889
NODE_150_length_5572_cov_79.124246	1555	1627	115	3	72	0.0416667
NODE_150_length_5572_cov_79.124246	1555	1627	120	1	72	0.0138889
NODE_150_length_5572_cov_79.124246	1555	1627	124	1	72	0.0138889
NODE_150_length_5572_cov_79.124246	1555	1627	126	1	72	0.0138889
NODE_150_length_5572_cov_79.124246	1555	1627	131	1	72	0.0138889
NODE_150_length_5572_cov_79.124246	1555	1627	146	1	72	0.0138889
NODE_150_length_5572_cov_79.124246	1555	1627	150	1	72	0.0138889
NODE_150_length_5572_cov_79.124246	1555	1627	155	1	72	0.0138889
NODE_150_length_5572_cov_79.124246	1555	1627	157	1	72	0.0138889
NODE_150_length_5572_cov_79.124246	1555	1627	162	1	72	0.0138889
NODE_150_length_5572_cov_79.124246	1555	1627	174	1	72	0.0138889
NODE_150_length_5572_cov_79.124246	1555	1627	179	1	72	0.0138889
NODE_150_length_5572_cov_79.124246	1555	1627	183	1	72	0.0138889
NODE_150_length_5572_cov_79.124246	1555	1627	188	1	72	0.0138889
NODE_150_length_5572_cov_79.124246	1555	1627	191	1	72	0.0138889
NODE_150_length_5572_cov_79.124246	1555	1627	196	1	72	0.0138889
NODE_150_length_5572_cov_79.124246	1555	1627	212	2	72	0.0277778
NODE_150_length_5572_cov_79.124246	1555	1627	214	1	72	0.0138889
NODE_150_length_5572_cov_79.124246	1555	1627	227	1	72	0.0138889
NODE_150_length_5572_cov_79.124246	1555	1627	235	1	72	0.0138889
NODE_150_length_5572_cov_79.124246	1555	1627	239	1	72	0.0138889
NODE_150_length_5572_cov_79.124246	1555	1627	244	1	72	0.0138889
NODE_150_length_5572_cov_79.124246	1555	1627	250	1	72	0.0138889
NODE_150_length_5572_cov_79.124246	1555	1627	256	1	72	0.0138889
NODE_150_length_5572_cov_79.124246	1603	1680	120	1	77	0.0129870
NODE_150_length_5572_cov_79.124246	1603	1680	124	1	77	0.0129870
NODE_150_length_5572_cov_79.124246	1603	1680	126	1	77	0.0129870
NODE_150_length_5572_cov_79.124246	1603	1680	131	1	77	0.0129870
NODE_150_length_5572_cov_79.124246	1603	1680	146	1	77	0.0129870
NODE_150_length_5572_cov_79.124246	1603	1680	150	1	77	0.0129870
NODE_150_length_5572_cov_79.124246	1603	1680	155	1	77	0.0129870
NODE_150_length_5572_cov_79.124246	1603	1680	157	1	77	0.0129870
NODE_150_length_5572_cov_79.124246	1603	1680	162	1	77	0.0129870
NODE_150_length_5572_cov_79.124246	1603	1680	174	1	77	0.0129870
NODE_150_length_5572_cov_79.124246	1603	1680	179	1	77	0.0129870
NODE_150_length_5572_cov_79.124246	1603	1680	183	1	77	0.0129870
NODE_150_length_5572_cov_79.124246	1603	1680	188	1	77	0.0129870
NODE_150_length_5572_cov_79.124246	1603	1680	191	1	77	0.0129870
NODE_150_length_5572_cov_79.124246	1603	1680	196	1	77	0.0129870
NODE_150_length_5572_cov_79.124246	1603	1680	212	2	77	0.0259740
NODE_150_length_5572_cov_79.124246	1603	1680	214	1	77	0.0129870
NODE_150_length_5572_cov_79.124246	1603	1680	227	1	77	0.0129870
NODE_150_length_5572_cov_79.124246	1603	1680	235	1	77	0.0129870
NODE_150_length_5572_cov_79.124246	1603	1680	239	1	77	0.0129870
NODE_150_length_5572_cov_79.124246	1603	1680	244	1	77	0.0129870
NODE_150_length_5572_cov_79.124246	1603	1680	250	1	77	0.0129870
NODE_150_length_5572_cov_79.124246	1603	1680	256	1	77	0.0129870
NODE_150_length_5572_cov_79.124246	1603	1680	257	1	77	0.0129870
NODE_150_length_5572_cov_79.124246	1603	1680	259	1	77	0.0129870
NODE_150_length_5572_cov_79.124246	1603	1680	271	1	77	0.0129870
NODE_150_length_5572_cov_79.124246	1603	1680	280	1	77	0.0129870
NODE_150_length_5572_cov_79.124246	1603	1680	288	1	77	0.0129870
NODE_150_length_5572_cov_79.124246	1603	1680	297	1	77	0.0129870
NODE_150_length_5572_cov_79.124246	1603	1680	303	1	77	0.0129870
NODE_150_length_5572_cov_79.124246	1603	1680	304	1	77	0.0129870
NODE_150_length_5572_cov_79.124246	1603	1680	312	1	77	0.0129870
NODE_150_length_5572_cov_79.124246	1603	1680	339	1	77	0.0129870
NODE_150_length_5572_cov_79.124246	1603	1680	351	1	77	0.0129870
NODE_150_length_5572_cov_79.124246	1603	1680	352	1	77	0.0129870
NODE_150_length_5572_cov_79.124246	1603	1680	363	1	77	0.0129870
NODE_150_length_5572_cov_79.124246	1603	1680	374	1	77	0.0129870
NODE_150_length_5572_cov_79.124246	1603	1680	394	1	77	0.0129870
NODE_150_length_5572_cov_79.124246	1603	1680	419	1	77	0.0129870
NODE_150_length_5572_cov_79.124246	1603	1680	437	1	77	0.0129870
NODE_150_length_5572_cov_79.124246	1603	1680	440	1	77	0.0129870
NODE_150_length_5572_cov_79.124246	1603	1680	477	1	77	0.0129870
NODE_150_length_5572_cov_79.124246	1603	1680	498	1	77	0.0129870
NODE_150_length_5572_cov_79.124246	1603	1680	541	1	77	0.0129870
NODE_150_length_5572_cov_79.124246	1603	1680	568	1	77	0.0129870
NODE_150_length_5572_cov_79.124246	1603	1680	580	1	77	0.0129870
NODE_150_length_5572_cov_79.124246	1603	1680	592	1	77	0.0129870
NODE_150_length_5572_cov_79.124246	1603	1680	603	1	77	0.0129870
NODE_150_length_5572_cov_79.124246	1603	1680	621	1	77	0.0129870
NODE_150_length_5572_cov_79.124246	1603	1680	641	1	77	0.0129870
NODE_150_length_5572_cov_79.124246	1603	1680	655	1	77	0.0129870
NODE_150_length_5572_cov_79.124246	1603	1680	681	1	77	0.0129870
NODE_150_length_5572_cov_79.124246	1603	1680	693	1	77	0.0129870
NODE_150_length_5572_cov_79.124246	1603	1680	705	1	77	0.0129870
NODE_150_length_5572_cov_79.124246	1603	1680	711	1	77	0.0129870
NODE_150_length_5572_cov_79.124246	1603	1680	717	1	77	0.0129870
NODE_150_length_5572_cov_79.124246	1603	1680	738	1	77	0.0129870
NODE_150_length_5572_cov_79.124246	1603	1680	751	1	77	0.0129870
NODE_150_length_5572_cov_79.124246	1603	1680	777	1	77	0.0129870
NODE_150_length_5572_cov_79.124246	1603	1680	782	1	77	0.0129870
NODE_150_length_5572_cov_79.124246	1603	1680	794	1	77	0.0129870
NODE_150_length_5572_cov_79.124246	1603	1680	796	1	77	0.0129870
NODE_150_length_5572_cov_79.124246	1603	1680	810	1	77	0.0129870
NODE_150_length_5572_cov_79.124246	1603	1680	821	1	77	0.0129870
NODE_150_length_5572_cov_79.124246	1603	1680	837	1	77	0.0129870
NODE_150_length_5572_cov_79.124246	1603	1680	838	2	77	0.0259740
NODE_150_length_5572_cov_79.124246	1603	1680	844	1	77	0.0129870
NODE_150_length_5572_cov_79.124246	1603	1680	856	1	77	0.0129870
NODE_150_length_5572_cov_79.124246	1603	1680	880	1	77	0.0129870
NODE_150_length_5572_cov_79.124246	1603	1680	917	1	77	0.0129870
NODE_150_length_5572_cov_79.124246	1603	1680	991	1	77	0.0129870
NODE_150_length_5572_cov_79.124246	1603	1680	1005	1	77	0.0129870
NODE_150_length_5572_cov_79.124246	1603	1680	1049	1	77	0.0129870
NODE_150_length_5572_cov_79.124246	1603	1680	1096	1	77	0.0129870
NODE_150_length_5572_cov_79.124246	1603	1680	1107	1	77	0.0129870
NODE_150_length_5572_cov_79.124246	1637	1717	351	1	80	0.0125000
NODE_150_length_5572_cov_79.124246	1637	1717	352	1	80	0.0125000
NODE_150_length_5572_cov_79.124246	1637	1717	363	1	80	0.0125000
NODE_150_length_5572_cov_79.124246	1637	1717	374	1	80	0.0125000
NODE_150_length_5572_cov_79.124246	1637	1717	394	1	80	0.0125000
NODE_150_length_5572_cov_79.124246	1637	1717	419	1	80	0.0125000
NODE_150_length_5572_cov_79.124246	1637	1717	437	1	80	0.0125000
NODE_150_length_5572_cov_79.124246	1637	1717	440	1	80	0.0125000
NODE_150_length_5572_cov_79.124246	1637	1717	477	1	80	0.0125000
NODE_150_length_5572_cov_79.124246	1637	1717	498	1	80	0.0125000
NODE_150_length_5572_cov_79.124246	1637	1717	541	1	80	0.0125000
NODE_150_length_5572_cov_79.124246	1637	1717	568	1	80	0.0125000
NODE_150_length_5572_cov_79.124246	1637	1717	580	1	80	0.0125000
NODE_150_length_5572_cov_79.124246	1637	1717	592	1	80	0.0125000
NODE_150_length_5572_cov_79.124246	1637	1717	603	1	80	0.0125000
NODE_150_length_5572_cov_79.124246	1637	1717	621	1	80	0.0125000
NODE_150_length_5572_cov_79.124246	1637	1717	641	1	80	0.0125000
NODE_150_length_5572_cov_79.124246	1637	1717	655	1	80	0.0125000
NODE_150_length_5572_cov_79.124246	1637	1717	681	1	80	0.0125000
NODE_150_length_5572_cov_79.124246	1637	1717	693	1	80	0.0125000
NODE_150_length_5572_cov_79.124246	1637	1717	705	1	80	0.0125000
NODE_150_length_5572_cov_79.124246	1637	1717	711	1	80	0.0125000
NODE_150_length_5572_cov_79.124246	1637	1717	717	1	80	0.0125000
NODE_150_length_5572_cov_79.124246	1637	1717	738	1	80	0.0125000
NODE_150_length_5572_cov_79.124246	1637	1717	751	1	80	0.0125000
NODE_150_length_5572_cov_79.124246	1637	1717	777	1	80	0.0125000
NODE_150_length_5572_cov_79.124246	1637	1717	782	1	80	0.0125000
NODE_150_length_5572_cov_79.124246	1637	1717	794	1	80	0.0125000
NODE_150_length_5572_cov_79.124246	1637	1717	796	1	80	0.0125000
NODE_150_length_5572_cov_79.124246	1637	1717	810	1	80	0.0125000
NODE_150_length_5572_cov_79.124246	1637	1717	821	1	80	0.0125000
NODE_150_length_5572_cov_79.124246	1637	1717	837	1	80	0.0125000
NODE_150_length_5572_cov_79.124246	1637	1717	838	2	80	0.0250000
NODE_150_length_5572_cov_79.124246	1637	1717	844	1	80	0.0125000
NODE_150_length_5572_cov_79.124246	1637	1717	856	1	80	0.0125000
NODE_150_length_5572_cov_79.124246	1637	1717	880	1	80	0.0125000
NODE_150_length_5572_cov_79.124246	1637	1717	917	1	80	0.0125000
NODE_150_length_5572_cov_79.124246	1637	1717	991	1	80	0.0125000
NODE_150_length_5572_cov_79.124246	1637	1717	1005	1	80	0.0125000
NODE_150_length_5572_cov_79.124246	1637	1717	1049	1	80	0.0125000
NODE_150_length_5572_cov_79.124246	1637	1717	1096	1	80	0.0125000
NODE_150_length_5572_cov_79.124246	1637	1717	1107	1	80	0.0125000
NODE_150_length_5572_cov_79.124246	1637	1717	1117	1	80	0.0125000
NODE_150_length_5572_cov_79.124246	1637	1717	1122	1	80	0.0125000
NODE_150_length_5572_cov_79.124246	1637	1717	1154	1	80	0.0125000
NODE_150_length_5572_cov_79.124246	1637	1717	1209	1	80	0.0125000
NODE_150_length_5572_cov_79.124246	1637	1717	1213	1	80	0.0125000
NODE_150_length_5572_cov_79.124246	1637	1717	1216	1	80	0.0125000
NODE_150_length_5572_cov_79.124246	1637	1717	1220	1	80	0.0125000
NODE_150_length_5572_cov_79.124246	1637	1717	1231	1	80	0.0125000
NODE_150_length_5572_cov_79.124246	1637	1717	1261	1	80	0.0125000
NODE_150_length_5572_cov_79.124246	1637	1717	1279	1	80	0.0125000
NODE_150_length_5572_cov_79.124246	1637	1717	1285	1	80	0.0125000
NODE_150_length_5572_cov_79.124246	1637	1717	1288	1	80	0.0125000
NODE_150_length_5572_cov_79.124246	1637	1717	1304	1	80	0.0125000
NODE_150_length_5572_cov_79.124246	1637	1717	1322	1	80	0.0125000
NODE_150_length_5572_cov_79.124246	1637	1717	1324	1	80	0.0125000
NODE_150_length_5572_cov_79.124246	1637	1717	1354	1	80	0.0125000
NODE_150_length_5572_cov_79.124246	1637	1717	1367	1	80	0.0125000
NODE_150_length_5572_cov_79.124246	1637	1717	1387	1	80	0.0125000
NODE_150_length_5572_cov_79.124246	1637	1717	1403	1	80	0.0125000
NODE_150_length_5572_cov_79.124246	1637	1717	1410	1	80	0.0125000
NODE_150_length_5572_cov_79.124246	1637	1717	1412	1	80	0.0125000
NODE_150_length_5572_cov_79.124246	1637	1717	1427	1	80	0.0125000
NODE_150_length_5572_cov_79.124246	1637	1717	1437	3	80	0.0375000
NODE_150_length_5572_cov_79.124246	1637	1717	1443	1	80	0.0125000
NODE_150_length_5572_cov_79.124246	1637	1717	1448	1	80	0.0125000
NODE_150_length_5572_cov_79.124246	1637	1717	1454	1	80	0.0125000
NODE_150_length_5572_cov_79.124246	1637	1717	1456	2	80	0.0250000
NODE_150_length_5572_cov_79.124246	1637	1717	1458	1	80	0.0125000
NODE_150_length_5572_cov_79.124246	1637	1717	1459	1	80	0.0125000
NODE_150_length_5572_cov_79.124246	1637	1717	1460	1	80	0.0125000
NODE_150_length_5572_cov_79.124246	1637	1717	1464	1	80	0.0125000
NODE_150_length_5572_cov_79.124246	1637	1717	1480	1	80	0.0125000
NODE_150_length_5572_cov_79.124246	1637	1717	1482	1	80	0.0125000
NODE_150_length_5572_cov_79.124246	1637	1717	1485	1	80	0.0125000
NODE_150_length_5572_cov_79.124246	1690	1770	876	1	80	0.0125000
NODE_150_length_5572_cov_79.124246	1690	1770	896	1	80	0.0125000
NODE_150_length_5572_cov_79.124246	1690	1770	936	1	80	0.0125000
NODE_150_length_5572_cov_79.124246	1690	1770	976	1	80	0.0125000
NODE_150_length_5572_cov_79.124246	1690	1770	1014	1	80	0.0125000
NODE_150_length_5572_cov_79.124246	1690	1770	1081	1	80	0.0125000
NODE_150_length_5572_cov_79.124246	1690	1770	1102	1	80	0.0125000
NODE_150_length_5572_cov_79.124246	1690	1770	1129	1	80	0.0125000
NODE_150_length_5572_cov_79.124246	1690	1770	1144	1	80	0.0125000
NODE_150_length_5572_cov_79.124246	1690	1770	1152	1	80	0.0125000
NODE_150_length_5572_cov_79.124246	1690	1770	1175	1	80	0.0125000
NODE_150_length_5572_cov_79.124246	1690	1770	1183	1	80	0.0125000
NODE_150_length_5572_cov_79.124246	1690	1770	1208	1	80	0.0125000
NODE_150_length_5572_cov_79.124246	1690	1770	1250	1	80	0.0125000
NODE_150_length_5572_cov_79.124246	1690	1770	1271	1	80	0.0125000
NODE_150_length_5572_cov_79.124246	1690	1770	1283	1	80	0.0125000
NODE_150_length_5572_cov_79.124246	1690	1770	1285	1	80	0.0125000
NODE_150_length_5572_cov_79.124246	1690	1770	1288	1	80	0.0125000
NODE_150_length_5572_cov_79.124246	1690	1770	1303	1	80	0.0125000
NODE_150_length_5572_cov_79.124246	1690	1770	1304	1	80	0.0125000
NODE_150_length_5572_cov_79.124246	1690	1770	1312	1	80	0.0125000
NODE_150_length_5572_cov_79.124246	1690	1770	1321	1	80	0.0125000
NODE_150_length_5572_cov_79.124246	1690	1770	1322	1	80	0.0125000
NODE_150_length_5572_cov_79.124246	1690	1770	1324	2	80	0.0250000
NODE_150_length_5572_cov_79.124246	1690	1770	1330	1	80	0.0125000
NODE_150_length_5572_cov_79.124246	1690	1770	1332	1	80	0.0125000
NODE_150_length_5572_cov_79.124246	1690	1770	1345	1	80	0.0125000
NODE_150_length_5572_cov_79.124246	1690	1770	1353	1	80	0.0125000
NODE_150_length_5572_cov_79.124246	1690	1770	1354	1	80	0.0125000
NODE_150_length_5572_cov_79.124246	1690	1770	1362	1	80	0.0125000
NODE_150_length_5572_cov_79.124246	1690	1770	1365	1	80	0.0125000
NODE_150_length_5572_cov_79.124246	1690	1770	1367	1	80	0.0125000
NODE_150_length_5572_cov_79.124246	1690	1770	1379	1	80	0.0125000
NODE_150_length_5572_cov_79.124246	1690	1770	1387	1	80	0.0125000
NODE_150_length_5572_cov_79.124246	1690	1770	1389	1	80	0.0125000
NODE_150_length_5572_cov_79.124246	1690	1770	1390	1	80	0.0125000
NODE_150_length_5572_cov_79.124246	1690	1770	1398	1	80	0.0125000
NODE_150_length_5572_cov_79.124246	1690	1770	1400	1	80	0.0125000
NODE_150_length_5572_cov_79.124246	1690	1770	1403	1	80	0.0125000
NODE_150_length_5572_cov_79.124246	1690	1770	1406	1	80	0.0125000
NODE_150_length_5572_cov_79.124246	1690	1770	1410	1	80	0.0125000
NODE_150_length_5572_cov_79.124246	1690	1770	1412	1	80	0.0125000
NODE_150_length_5572_cov_79.124246	1690	1770	1418	3	80	0.0375000
NODE_150_length_5572_cov_79.124246	1690	1770	1427	1	80	0.0125000
NODE_150_length_5572_cov_79.124246	1690	1770	1437	4	80	0.0500000
NODE_150_length_5572_cov_79.124246	1690	1770	1442	1	80	0.0125000
NODE_150_length_5572_cov_79.124246	1690	1770	1443	1	80	0.0125000
NODE_150_length_5572_cov_79.124246	1690	1770	1448	1	80	0.0125000
NODE_150_length_5572_cov_79.124246	1690	1770	1451	1	80	0.0125000
NODE_150_length_5572_cov_79.124246	1690	1770	1454	1	80	0.0125000
NODE_150_length_5572_cov_79.124246	1690	1770	1456	2	80	0.0250000
NODE_150_length_5572_cov_79.124246	1690	1770	1458	1	80	0.0125000
NODE_150_length_5572_cov_79.124246	1690	1770	1459	1	80	0.0125000
NODE_150_length_5572_cov_79.124246	1690	1770	1460	1	80	0.0125000
NODE_150_length_5572_cov_79.124246	1690	1770	1462	1	80	0.0125000
NODE_150_length_5572_cov_79.124246	1690	1770	1464	1	80	0.0125000
NODE_150_length_5572_cov_79.124246	1690	1770	1466	2	80	0.0250000
NODE_150_length_5572_cov_79.124246	1690	1770	1474	1	80	0.0125000
NODE_150_length_5572_cov_79.124246	1690	1770	1477	1	80	0.0125000
NODE_150_length_5572_cov_79.124246	1690	1770	1480	1	80	0.0125000
NODE_150_length_5572_cov_79.124246	1690	1770	1482	2	80	0.0250000
NODE_150_length_5572_cov_79.124246	1690	1770	1485	3	80	0.0375000
NODE_150_length_5572_cov_79.124246	1690	1770	1486	1	80	0.0125000
NODE_150_length_5572_cov_79.124246	1690	1770	1487	1	80	0.0125000
NODE_150_length_5572_cov_79.124246	1690	1770	1490	2	80	0.0250000
NODE_150_length_5572_cov_79.124246	1690	1770	1491	1	80	0.0125000
NODE_150_length_5572_cov_79.124246	1690	1770	1492	2	80	0.0250000
NODE_150_length_5572_cov_79.124246	5130	5210	0	25	80	0.3125000
NODE_150_length_5572_cov_79.124246	5130	5210	6	55	80	0.6875000
NODE_150_length_5572_cov_79.124246	5183	5263	0	16	80	0.2000000
NODE_150_length_5572_cov_79.124246	5183	5263	6	64	80	0.8000000
NODE_151_length_5557_cov_26.198241	341	414	0	73	73	1.0000000
NODE_151_length_5557_cov_26.198241	394	460	0	66	66	1.0000000
NODE_156_length_5500_cov_35.832438	81	161	0	79	80	0.9875000
NODE_156_length_5500_cov_35.832438	81	161	2	1	80	0.0125000
NODE_156_length_5500_cov_35.832438	134	214	0	26	80	0.3250000
NODE_156_length_5500_cov_35.832438	134	214	2	54	80	0.6750000
NODE_159_length_5470_cov_5.987526	5180	5249	0	8	69	0.1159420
NODE_159_length_5470_cov_5.987526	5180	5249	1	2	69	0.0289855
NODE_159_length_5470_cov_5.987526	5180	5249	3	22	69	0.3188406
NODE_159_length_5470_cov_5.987526	5180	5249	4	4	69	0.0579710
NODE_159_length_5470_cov_5.987526	5180	5249	5	11	69	0.1594203
NODE_159_length_5470_cov_5.987526	5180	5249	6	2	69	0.0289855
NODE_159_length_5470_cov_5.987526	5180	5249	7	1	69	0.0144928
NODE_159_length_5470_cov_5.987526	5180	5249	8	19	69	0.2753623
NODE_160_length_5434_cov_14.997751	541	621	4	68	80	0.8500000
NODE_160_length_5434_cov_14.997751	541	621	6	12	80	0.1500000
NODE_160_length_5434_cov_14.997751	594	674	2	11	80	0.1375000
NODE_160_length_5434_cov_14.997751	594	674	4	28	80	0.3500000
NODE_160_length_5434_cov_14.997751	594	674	6	41	80	0.5125000
NODE_160_length_5434_cov_14.997751	2664	2744	0	80	80	1.0000000
NODE_160_length_5434_cov_14.997751	2717	2797	0	80	80	1.0000000
NODE_160_length_5434_cov_14.997751	3041	3093	0	52	52	1.0000000
NODE_160_length_5434_cov_14.997751	3419	3467	7	48	48	1.0000000
NODE_161_length_5425_cov_15.812242	141	218	55	2	77	0.0259740
NODE_161_length_5425_cov_15.812242	141	218	57	1	77	0.0129870
NODE_161_length_5425_cov_15.812242	141	218	59	1	77	0.0129870
NODE_161_length_5425_cov_15.812242	141	218	60	1	77	0.0129870
NODE_161_length_5425_cov_15.812242	141	218	61	1	77	0.0129870
NODE_161_length_5425_cov_15.812242	141	218	63	1	77	0.0129870
NODE_161_length_5425_cov_15.812242	141	218	71	1	77	0.0129870
NODE_161_length_5425_cov_15.812242	141	218	74	1	77	0.0129870
NODE_161_length_5425_cov_15.812242	141	218	75	5	77	0.0649351
NODE_161_length_5425_cov_15.812242	141	218	76	1	77	0.0129870
NODE_161_length_5425_cov_15.812242	141	218	78	1	77	0.0129870
NODE_161_length_5425_cov_15.812242	141	218	80	4	77	0.0519481
NODE_161_length_5425_cov_15.812242	141	218	82	2	77	0.0259740
NODE_161_length_5425_cov_15.812242	141	218	85	4	77	0.0519481
NODE_161_length_5425_cov_15.812242	141	218	86	6	77	0.0779221
NODE_161_length_5425_cov_15.812242	141	218	87	10	77	0.1298701
NODE_161_length_5425_cov_15.812242	141	218	88	14	77	0.1818182
NODE_161_length_5425_cov_15.812242	141	218	89	8	77	0.1038961
NODE_161_length_5425_cov_15.812242	141	218	90	3	77	0.0389610
NODE_161_length_5425_cov_15.812242	141	218	91	9	77	0.1168831
NODE_161_length_5425_cov_15.812242	141	218	92	1	77	0.0129870
NODE_161_length_5425_cov_15.812242	841	921	4	6	80	0.0750000
NODE_161_length_5425_cov_15.812242	841	921	6	2	80	0.0250000
NODE_161_length_5425_cov_15.812242	841	921	7	4	80	0.0500000
NODE_161_length_5425_cov_15.812242	841	921	8	1	80	0.0125000
NODE_161_length_5425_cov_15.812242	841	921	9	20	80	0.2500000
NODE_161_length_5425_cov_15.812242	841	921	11	19	80	0.2375000
NODE_161_length_5425_cov_15.812242	841	921	13	28	80	0.3500000
NODE_161_length_5425_cov_15.812242	894	974	0	26	80	0.3250000
NODE_161_length_5425_cov_15.812242	894	974	2	23	80	0.2875000
NODE_161_length_5425_cov_15.812242	894	974	4	10	80	0.1250000
NODE_161_length_5425_cov_15.812242	894	974	6	2	80	0.0250000
NODE_161_length_5425_cov_15.812242	894	974	8	1	80	0.0125000
NODE_161_length_5425_cov_15.812242	894	974	9	18	80	0.2250000
NODE_163_length_5402_cov_5.397322	191	263	38	1	72	0.0138889
NODE_163_length_5402_cov_5.397322	191	263	43	7	72	0.0972222
NODE_163_length_5402_cov_5.397322	191	263	46	1	72	0.0138889
NODE_163_length_5402_cov_5.397322	191	263	49	2	72	0.0277778
NODE_163_length_5402_cov_5.397322	191	263	50	26	72	0.3611111
NODE_163_length_5402_cov_5.397322	191	263	51	2	72	0.0277778
NODE_163_length_5402_cov_5.397322	191	263	52	4	72	0.0555556
NODE_163_length_5402_cov_5.397322	191	263	53	29	72	0.4027778
NODE_163_length_5402_cov_5.397322	2305	2385	27	3	80	0.0375000
NODE_163_length_5402_cov_5.397322	2305	2385	29	16	80	0.2000000
NODE_163_length_5402_cov_5.397322	2305	2385	31	5	80	0.0625000
NODE_163_length_5402_cov_5.397322	2305	2385	33	10	80	0.1250000
NODE_163_length_5402_cov_5.397322	2305	2385	34	16	80	0.2000000
NODE_163_length_5402_cov_5.397322	2305	2385	35	6	80	0.0750000
NODE_163_length_5402_cov_5.397322	2305	2385	36	18	80	0.2250000
NODE_163_length_5402_cov_5.397322	2305	2385	38	6	80	0.0750000
NODE_163_length_5402_cov_5.397322	2358	2438	11	5	80	0.0625000
NODE_163_length_5402_cov_5.397322	2358	2438	13	2	80	0.0250000
NODE_163_length_5402_cov_5.397322	2358	2438	18	1	80	0.0125000
NODE_163_length_5402_cov_5.397322	2358	2438	19	18	80	0.2250000
NODE_163_length_5402_cov_5.397322	2358	2438	23	3	80	0.0375000
NODE_163_length_5402_cov_5.397322	2358	2438	24	8	80	0.1000000
NODE_163_length_5402_cov_5.397322	2358	2438	25	8	80	0.1000000
NODE_163_length_5402_cov_5.397322	2358	2438	27	11	80	0.1375000
NODE_163_length_5402_cov_5.397322	2358	2438	29	16	80	0.2000000
NODE_163_length_5402_cov_5.397322	2358	2438	31	5	80	0.0625000
NODE_163_length_5402_cov_5.397322	2358	2438	33	3	80	0.0375000
NODE_164_length_5383_cov_15.680545	205	285	0	80	80	1.0000000
NODE_164_length_5383_cov_15.680545	258	317	0	59	59	1.0000000
NODE_164_length_5383_cov_15.680545	2042	2122	26	11	80	0.1375000
NODE_164_length_5383_cov_15.680545	2042	2122	28	6	80	0.0750000
NODE_164_length_5383_cov_15.680545	2042	2122	30	6	80	0.0750000
NODE_164_length_5383_cov_15.680545	2042	2122	32	1	80	0.0125000
NODE_164_length_5383_cov_15.680545	2042	2122	36	6	80	0.0750000
NODE_164_length_5383_cov_15.680545	2042	2122	37	15	80	0.1875000
NODE_164_length_5383_cov_15.680545	2042	2122	38	35	80	0.4375000
NODE_164_length_5383_cov_15.680545	2095	2175	2	15	80	0.1875000
NODE_164_length_5383_cov_15.680545	2095	2175	3	1	80	0.0125000
NODE_164_length_5383_cov_15.680545	2095	2175	4	2	80	0.0250000
NODE_164_length_5383_cov_15.680545	2095	2175	8	9	80	0.1125000
NODE_164_length_5383_cov_15.680545	2095	2175	12	2	80	0.0250000
NODE_164_length_5383_cov_15.680545	2095	2175	14	8	80	0.1000000
NODE_164_length_5383_cov_15.680545	2095	2175	18	10	80	0.1250000
NODE_164_length_5383_cov_15.680545	2095	2175	20	3	80	0.0375000
NODE_164_length_5383_cov_15.680545	2095	2175	26	14	80	0.1750000
NODE_164_length_5383_cov_15.680545	2095	2175	28	6	80	0.0750000
NODE_164_length_5383_cov_15.680545	2095	2175	30	6	80	0.0750000
NODE_164_length_5383_cov_15.680545	2095	2175	32	1	80	0.0125000
NODE_164_length_5383_cov_15.680545	2095	2175	36	3	80	0.0375000
NODE_165_length_5382_cov_16.894378	1301	1347	2	25	46	0.5434783
NODE_165_length_5382_cov_16.894378	1301	1347	8	1	46	0.0217391
NODE_165_length_5382_cov_16.894378	1301	1347	9	7	46	0.1521739
NODE_165_length_5382_cov_16.894378	1301	1347	18	1	46	0.0217391
NODE_165_length_5382_cov_16.894378	1301	1347	22	3	46	0.0652174
NODE_165_length_5382_cov_16.894378	1301	1347	24	3	46	0.0652174
NODE_165_length_5382_cov_16.894378	1301	1347	30	6	46	0.1304348
NODE_165_length_5382_cov_16.894378	5056	5082	90	3	26	0.1153846
NODE_165_length_5382_cov_16.894378	5056	5082	91	1	26	0.0384615
NODE_165_length_5382_cov_16.894378	5056	5082	93	1	26	0.0384615
NODE_165_length_5382_cov_16.894378	5056	5082	94	2	26	0.0769231
NODE_165_length_5382_cov_16.894378	5056	5082	95	1	26	0.0384615
NODE_165_length_5382_cov_16.894378	5056	5082	98	3	26	0.1153846
NODE_165_length_5382_cov_16.894378	5056	5082	103	1	26	0.0384615
NODE_165_length_5382_cov_16.894378	5056	5082	115	1	26	0.0384615
NODE_165_length_5382_cov_16.894378	5056	5082	117	1	26	0.0384615
NODE_165_length_5382_cov_16.894378	5056	5082	118	1	26	0.0384615
NODE_165_length_5382_cov_16.894378	5056	5082	122	1	26	0.0384615
NODE_165_length_5382_cov_16.894378	5056	5082	125	1	26	0.0384615
NODE_165_length_5382_cov_16.894378	5056	5082	132	1	26	0.0384615
NODE_165_length_5382_cov_16.894378	5056	5082	141	1	26	0.0384615
NODE_165_length_5382_cov_16.894378	5056	5082	143	1	26	0.0384615
NODE_165_length_5382_cov_16.894378	5056	5082	148	1	26	0.0384615
NODE_165_length_5382_cov_16.894378	5056	5082	154	1	26	0.0384615
NODE_165_length_5382_cov_16.894378	5056	5082	165	1	26	0.0384615
NODE_165_length_5382_cov_16.894378	5056	5082	169	1	26	0.0384615
NODE_165_length_5382_cov_16.894378	5056	5082	178	1	26	0.0384615
NODE_165_length_5382_cov_16.894378	5056	5082	198	1	26	0.0384615
NODE_165_length_5382_cov_16.894378	5056	5115	90	3	59	0.0508475
NODE_165_length_5382_cov_16.894378	5056	5115	91	1	59	0.0169492
NODE_165_length_5382_cov_16.894378	5056	5115	93	1	59	0.0169492
NODE_165_length_5382_cov_16.894378	5056	5115	94	2	59	0.0338983
NODE_165_length_5382_cov_16.894378	5056	5115	95	1	59	0.0169492
NODE_165_length_5382_cov_16.894378	5056	5115	98	3	59	0.0508475
NODE_165_length_5382_cov_16.894378	5056	5115	103	1	59	0.0169492
NODE_165_length_5382_cov_16.894378	5056	5115	115	1	59	0.0169492
NODE_165_length_5382_cov_16.894378	5056	5115	117	1	59	0.0169492
NODE_165_length_5382_cov_16.894378	5056	5115	118	1	59	0.0169492
NODE_165_length_5382_cov_16.894378	5056	5115	122	1	59	0.0169492
NODE_165_length_5382_cov_16.894378	5056	5115	125	1	59	0.0169492
NODE_165_length_5382_cov_16.894378	5056	5115	132	1	59	0.0169492
NODE_165_length_5382_cov_16.894378	5056	5115	141	1	59	0.0169492
NODE_165_length_5382_cov_16.894378	5056	5115	143	1	59	0.0169492
NODE_165_length_5382_cov_16.894378	5056	5115	148	1	59	0.0169492
NODE_165_length_5382_cov_16.894378	5056	5115	154	1	59	0.0169492
NODE_165_length_5382_cov_16.894378	5056	5115	165	1	59	0.0169492
NODE_165_length_5382_cov_16.894378	5056	5115	169	1	59	0.0169492
NODE_165_length_5382_cov_16.894378	5056	5115	178	1	59	0.0169492
NODE_165_length_5382_cov_16.894378	5056	5115	197	1	59	0.0169492
NODE_165_length_5382_cov_16.894378	5056	5115	198	1	59	0.0169492
NODE_165_length_5382_cov_16.894378	5056	5115	203	1	59	0.0169492
NODE_165_length_5382_cov_16.894378	5056	5115	216	1	59	0.0169492
NODE_165_length_5382_cov_16.894378	5056	5115	218	1	59	0.0169492
NODE_165_length_5382_cov_16.894378	5056	5115	219	1	59	0.0169492
NODE_165_length_5382_cov_16.894378	5056	5115	220	1	59	0.0169492
NODE_165_length_5382_cov_16.894378	5056	5115	222	1	59	0.0169492
NODE_165_length_5382_cov_16.894378	5056	5115	224	1	59	0.0169492
NODE_165_length_5382_cov_16.894378	5056	5115	229	1	59	0.0169492
NODE_165_length_5382_cov_16.894378	5056	5115	236	2	59	0.0338983
NODE_165_length_5382_cov_16.894378	5056	5115	253	1	59	0.0169492
NODE_165_length_5382_cov_16.894378	5056	5115	261	1	59	0.0169492
NODE_165_length_5382_cov_16.894378	5056	5115	279	1	59	0.0169492
NODE_165_length_5382_cov_16.894378	5056	5115	283	1	59	0.0169492
NODE_165_length_5382_cov_16.894378	5056	5115	289	1	59	0.0169492
NODE_165_length_5382_cov_16.894378	5056	5115	294	1	59	0.0169492
NODE_165_length_5382_cov_16.894378	5056	5115	298	2	59	0.0338983
NODE_165_length_5382_cov_16.894378	5056	5115	310	1	59	0.0169492
NODE_165_length_5382_cov_16.894378	5056	5115	312	1	59	0.0169492
NODE_165_length_5382_cov_16.894378	5056	5115	313	1	59	0.0169492
NODE_165_length_5382_cov_16.894378	5056	5115	314	2	59	0.0338983
NODE_165_length_5382_cov_16.894378	5056	5115	315	1	59	0.0169492
NODE_165_length_5382_cov_16.894378	5056	5115	331	1	59	0.0169492
NODE_165_length_5382_cov_16.894378	5056	5115	340	1	59	0.0169492
NODE_165_length_5382_cov_16.894378	5056	5115	351	1	59	0.0169492
NODE_165_length_5382_cov_16.894378	5056	5115	358	1	59	0.0169492
NODE_165_length_5382_cov_16.894378	5056	5115	365	1	59	0.0169492
NODE_165_length_5382_cov_16.894378	5056	5115	380	1	59	0.0169492
NODE_165_length_5382_cov_16.894378	5056	5115	382	1	59	0.0169492
NODE_165_length_5382_cov_16.894378	5056	5115	390	1	59	0.0169492
NODE_167_length_5339_cov_28.708969	3375	3455	0	20	80	0.2500000
NODE_167_length_5339_cov_28.708969	3375	3455	2	15	80	0.1875000
NODE_167_length_5339_cov_28.708969	3375	3455	3	4	80	0.0500000
NODE_167_length_5339_cov_28.708969	3375	3455	5	3	80	0.0375000
NODE_167_length_5339_cov_28.708969	3375	3455	11	5	80	0.0625000
NODE_167_length_5339_cov_28.708969	3375	3455	12	9	80	0.1125000
NODE_167_length_5339_cov_28.708969	3375	3455	14	7	80	0.0875000
NODE_167_length_5339_cov_28.708969	3375	3455	16	17	80	0.2125000
NODE_167_length_5339_cov_28.708969	3428	3508	12	3	80	0.0375000
NODE_167_length_5339_cov_28.708969	3428	3508	14	8	80	0.1000000
NODE_167_length_5339_cov_28.708969	3428	3508	16	66	80	0.8250000
NODE_167_length_5339_cov_28.708969	3428	3508	18	2	80	0.0250000
NODE_167_length_5339_cov_28.708969	3428	3508	20	1	80	0.0125000
NODE_168_length_5336_cov_33.036471	3109	3189	34	1	80	0.0125000
NODE_168_length_5336_cov_33.036471	3109	3189	35	11	80	0.1375000
NODE_168_length_5336_cov_33.036471	3109	3189	39	3	80	0.0375000
NODE_168_length_5336_cov_33.036471	3109	3189	41	2	80	0.0250000
NODE_168_length_5336_cov_33.036471	3109	3189	42	14	80	0.1750000
NODE_168_length_5336_cov_33.036471	3109	3189	43	5	80	0.0625000
NODE_168_length_5336_cov_33.036471	3109	3189	44	5	80	0.0625000
NODE_168_length_5336_cov_33.036471	3109	3189	47	23	80	0.2875000
NODE_168_length_5336_cov_33.036471	3109	3189	48	13	80	0.1625000
NODE_168_length_5336_cov_33.036471	3109	3189	49	3	80	0.0375000
NODE_168_length_5336_cov_33.036471	3162	3242	9	17	80	0.2125000
NODE_168_length_5336_cov_33.036471	3162	3242	16	2	80	0.0250000
NODE_168_length_5336_cov_33.036471	3162	3242	18	1	80	0.0125000
NODE_168_length_5336_cov_33.036471	3162	3242	22	6	80	0.0750000
NODE_168_length_5336_cov_33.036471	3162	3242	31	6	80	0.0750000
NODE_168_length_5336_cov_33.036471	3162	3242	33	8	80	0.1000000
NODE_168_length_5336_cov_33.036471	3162	3242	39	16	80	0.2000000
NODE_168_length_5336_cov_33.036471	3162	3242	42	5	80	0.0625000
NODE_168_length_5336_cov_33.036471	3162	3242	44	5	80	0.0625000
NODE_168_length_5336_cov_33.036471	3162	3242	48	13	80	0.1625000
NODE_168_length_5336_cov_33.036471	3162	3242	49	1	80	0.0125000
NODE_179_length_5269_cov_23.392650	1905	1985	0	80	80	1.0000000
NODE_179_length_5269_cov_23.392650	1958	2038	0	80	80	1.0000000
NODE_181_length_5207_cov_31.352780	4588	4668	10	3	80	0.0375000
NODE_181_length_5207_cov_31.352780	4588	4668	16	77	80	0.9625000
NODE_181_length_5207_cov_31.352780	4641	4721	0	47	80	0.5875000
NODE_181_length_5207_cov_31.352780	4641	4721	10	9	80	0.1125000
NODE_181_length_5207_cov_31.352780	4641	4721	16	24	80	0.3000000
NODE_183_length_5193_cov_14.930506	4659	4739	0	67	80	0.8375000
NODE_183_length_5193_cov_14.930506	4659	4739	2	13	80	0.1625000
NODE_183_length_5193_cov_14.930506	4712	4792	0	14	80	0.1750000
NODE_183_length_5193_cov_14.930506	4712	4792	2	66	80	0.8250000
NODE_183_length_5193_cov_14.930506	4788	4868	0	53	80	0.6625000
NODE_183_length_5193_cov_14.930506	4788	4868	2	27	80	0.3375000
NODE_183_length_5193_cov_14.930506	4841	4921	0	30	80	0.3750000
NODE_183_length_5193_cov_14.930506	4841	4921	2	50	80	0.6250000
NODE_186_length_5159_cov_261.593676	158	227	315	1	69	0.0144928
NODE_186_length_5159_cov_261.593676	158	227	317	3	69	0.0434783
NODE_186_length_5159_cov_261.593676	158	227	318	2	69	0.0289855
NODE_186_length_5159_cov_261.593676	158	227	319	1	69	0.0144928
NODE_186_length_5159_cov_261.593676	158	227	321	1	69	0.0144928
NODE_186_length_5159_cov_261.593676	158	227	322	2	69	0.0289855
NODE_186_length_5159_cov_261.593676	158	227	323	6	69	0.0869565
NODE_186_length_5159_cov_261.593676	158	227	324	2	69	0.0289855
NODE_186_length_5159_cov_261.593676	158	227	325	2	69	0.0289855
NODE_186_length_5159_cov_261.593676	158	227	327	4	69	0.0579710
NODE_186_length_5159_cov_261.593676	158	227	328	2	69	0.0289855
NODE_186_length_5159_cov_261.593676	158	227	329	1	69	0.0144928
NODE_186_length_5159_cov_261.593676	158	227	330	5	69	0.0724638
NODE_186_length_5159_cov_261.593676	158	227	331	2	69	0.0289855
NODE_186_length_5159_cov_261.593676	158	227	332	3	69	0.0434783
NODE_186_length_5159_cov_261.593676	158	227	333	1	69	0.0144928
NODE_186_length_5159_cov_261.593676	158	227	335	2	69	0.0289855
NODE_186_length_5159_cov_261.593676	158	227	336	1	69	0.0144928
NODE_186_length_5159_cov_261.593676	158	227	338	1	69	0.0144928
NODE_186_length_5159_cov_261.593676	158	227	341	1	69	0.0144928
NODE_186_length_5159_cov_261.593676	158	227	342	1	69	0.0144928
NODE_186_length_5159_cov_261.593676	158	227	343	1	69	0.0144928
NODE_186_length_5159_cov_261.593676	158	227	350	1	69	0.0144928
NODE_186_length_5159_cov_261.593676	158	227	354	1	69	0.0144928
NODE_186_length_5159_cov_261.593676	158	227	358	1	69	0.0144928
NODE_186_length_5159_cov_261.593676	158	227	360	2	69	0.0289855
NODE_186_length_5159_cov_261.593676	158	227	364	2	69	0.0289855
NODE_186_length_5159_cov_261.593676	158	227	365	4	69	0.0579710
NODE_186_length_5159_cov_261.593676	158	227	367	1	69	0.0144928
NODE_186_length_5159_cov_261.593676	158	227	369	4	69	0.0579710
NODE_186_length_5159_cov_261.593676	158	227	370	1	69	0.0144928
NODE_186_length_5159_cov_261.593676	158	227	371	2	69	0.0289855
NODE_186_length_5159_cov_261.593676	158	227	373	1	69	0.0144928
NODE_186_length_5159_cov_261.593676	158	227	375	1	69	0.0144928
NODE_186_length_5159_cov_261.593676	158	227	376	2	69	0.0289855
NODE_186_length_5159_cov_261.593676	158	227	377	1	69	0.0144928
NODE_189_length_5138_cov_31.467355	3004	3075	0	1	71	0.0140845
NODE_189_length_5138_cov_31.467355	3004	3075	4	2	71	0.0281690
NODE_189_length_5138_cov_31.467355	3004	3075	6	2	71	0.0281690
NODE_189_length_5138_cov_31.467355	3004	3075	8	2	71	0.0281690
NODE_189_length_5138_cov_31.467355	3004	3075	13	3	71	0.0422535
NODE_189_length_5138_cov_31.467355	3004	3075	18	1	71	0.0140845
NODE_189_length_5138_cov_31.467355	3004	3075	20	7	71	0.0985916
NODE_189_length_5138_cov_31.467355	3004	3075	22	1	71	0.0140845
NODE_189_length_5138_cov_31.467355	3004	3075	23	4	71	0.0563380
NODE_189_length_5138_cov_31.467355	3004	3075	24	3	71	0.0422535
NODE_189_length_5138_cov_31.467355	3004	3075	25	3	71	0.0422535
NODE_189_length_5138_cov_31.467355	3004	3075	30	3	71	0.0422535
NODE_189_length_5138_cov_31.467355	3004	3075	32	2	71	0.0281690
NODE_189_length_5138_cov_31.467355	3004	3075	34	3	71	0.0422535
NODE_189_length_5138_cov_31.467355	3004	3075	35	1	71	0.0140845
NODE_189_length_5138_cov_31.467355	3004	3075	37	2	71	0.0281690
NODE_189_length_5138_cov_31.467355	3004	3075	55	1	71	0.0140845
NODE_189_length_5138_cov_31.467355	3004	3075	57	1	71	0.0140845
NODE_189_length_5138_cov_31.467355	3004	3075	61	3	71	0.0422535
NODE_189_length_5138_cov_31.467355	3004	3075	70	1	71	0.0140845
NODE_189_length_5138_cov_31.467355	3004	3075	73	1	71	0.0140845
NODE_189_length_5138_cov_31.467355	3004	3075	75	1	71	0.0140845
NODE_189_length_5138_cov_31.467355	3004	3075	77	1	71	0.0140845
NODE_189_length_5138_cov_31.467355	3004	3075	79	1	71	0.0140845
NODE_189_length_5138_cov_31.467355	3004	3075	82	1	71	0.0140845
NODE_189_length_5138_cov_31.467355	3004	3075	84	1	71	0.0140845
NODE_189_length_5138_cov_31.467355	3004	3075	86	1	71	0.0140845
NODE_189_length_5138_cov_31.467355	3004	3075	88	1	71	0.0140845
NODE_189_length_5138_cov_31.467355	3004	3075	91	1	71	0.0140845
NODE_189_length_5138_cov_31.467355	3004	3075	93	1	71	0.0140845
NODE_189_length_5138_cov_31.467355	3004	3075	95	1	71	0.0140845
NODE_189_length_5138_cov_31.467355	3004	3075	96	2	71	0.0281690
NODE_189_length_5138_cov_31.467355	3004	3075	98	1	71	0.0140845
NODE_189_length_5138_cov_31.467355	3004	3075	100	1	71	0.0140845
NODE_189_length_5138_cov_31.467355	3004	3075	103	2	71	0.0281690
NODE_189_length_5138_cov_31.467355	3004	3075	105	1	71	0.0140845
NODE_189_length_5138_cov_31.467355	3004	3075	108	1	71	0.0140845
NODE_189_length_5138_cov_31.467355	3004	3075	109	4	71	0.0563380
NODE_189_length_5138_cov_31.467355	3004	3075	111	1	71	0.0140845
NODE_189_length_5138_cov_31.467355	3004	3075	117	1	71	0.0140845
NODE_191_length_5126_cov_5.900935	731	811	2	15	80	0.1875000
NODE_191_length_5126_cov_5.900935	731	811	4	12	80	0.1500000
NODE_191_length_5126_cov_5.900935	731	811	6	7	80	0.0875000
NODE_191_length_5126_cov_5.900935	731	811	8	9	80	0.1125000
NODE_191_length_5126_cov_5.900935	731	811	10	28	80	0.3500000
NODE_191_length_5126_cov_5.900935	731	811	12	9	80	0.1125000
NODE_191_length_5126_cov_5.900935	784	864	2	22	80	0.2750000
NODE_191_length_5126_cov_5.900935	784	864	4	4	80	0.0500000
NODE_191_length_5126_cov_5.900935	784	864	6	15	80	0.1875000
NODE_191_length_5126_cov_5.900935	784	864	8	10	80	0.1250000
NODE_191_length_5126_cov_5.900935	784	864	10	20	80	0.2500000
NODE_191_length_5126_cov_5.900935	784	864	12	9	80	0.1125000
NODE_194_length_5102_cov_12.729962	367	447	0	9	80	0.1125000
NODE_194_length_5102_cov_12.729962	367	447	9	12	80	0.1500000
NODE_194_length_5102_cov_12.729962	367	447	13	6	80	0.0750000
NODE_194_length_5102_cov_12.729962	367	447	14	44	80	0.5500000
NODE_194_length_5102_cov_12.729962	367	447	16	9	80	0.1125000
NODE_194_length_5102_cov_12.729962	420	500	12	37	80	0.4625000
NODE_194_length_5102_cov_12.729962	420	500	14	18	80	0.2250000
NODE_194_length_5102_cov_12.729962	420	500	16	25	80	0.3125000
NODE_194_length_5102_cov_12.729962	496	576	0	62	80	0.7750000
NODE_194_length_5102_cov_12.729962	496	576	10	11	80	0.1375000
NODE_194_length_5102_cov_12.729962	496	576	12	7	80	0.0875000
NODE_194_length_5102_cov_12.729962	549	629	0	80	80	1.0000000
NODE_196_length_5079_cov_5.580522	875	940	64	3	65	0.0461538
NODE_196_length_5079_cov_5.580522	875	940	66	5	65	0.0769231
NODE_196_length_5079_cov_5.580522	875	940	67	1	65	0.0153846
NODE_196_length_5079_cov_5.580522	875	940	68	3	65	0.0461538
NODE_196_length_5079_cov_5.580522	875	940	70	7	65	0.1076923
NODE_196_length_5079_cov_5.580522	875	940	72	11	65	0.1692308
NODE_196_length_5079_cov_5.580522	875	940	74	3	65	0.0461538
NODE_196_length_5079_cov_5.580522	875	940	76	2	65	0.0307692
NODE_196_length_5079_cov_5.580522	875	940	77	3	65	0.0461538
NODE_196_length_5079_cov_5.580522	875	940	78	1	65	0.0153846
NODE_196_length_5079_cov_5.580522	875	940	82	3	65	0.0461538
NODE_196_length_5079_cov_5.580522	875	940	83	2	65	0.0307692
NODE_196_length_5079_cov_5.580522	875	940	84	1	65	0.0153846
NODE_196_length_5079_cov_5.580522	875	940	85	2	65	0.0307692
NODE_196_length_5079_cov_5.580522	875	940	86	1	65	0.0153846
NODE_196_length_5079_cov_5.580522	875	940	87	1	65	0.0153846
NODE_196_length_5079_cov_5.580522	875	940	88	1	65	0.0153846
NODE_196_length_5079_cov_5.580522	875	940	91	1	65	0.0153846
NODE_196_length_5079_cov_5.580522	875	940	92	2	65	0.0307692
NODE_196_length_5079_cov_5.580522	875	940	96	1	65	0.0153846
NODE_196_length_5079_cov_5.580522	875	940	103	2	65	0.0307692
NODE_196_length_5079_cov_5.580522	875	940	107	1	65	0.0153846
NODE_196_length_5079_cov_5.580522	875	940	110	1	65	0.0153846
NODE_196_length_5079_cov_5.580522	875	940	111	1	65	0.0153846
NODE_196_length_5079_cov_5.580522	875	940	113	2	65	0.0307692
NODE_196_length_5079_cov_5.580522	875	940	117	1	65	0.0153846
NODE_196_length_5079_cov_5.580522	875	940	121	2	65	0.0307692
NODE_196_length_5079_cov_5.580522	875	940	125	1	65	0.0153846
NODE_197_length_5057_cov_16.348729	2929	3000	159	1	71	0.0140845
NODE_197_length_5057_cov_16.348729	2929	3000	163	1	71	0.0140845
NODE_197_length_5057_cov_16.348729	2929	3000	175	1	71	0.0140845
NODE_197_length_5057_cov_16.348729	2929	3000	184	1	71	0.0140845
NODE_197_length_5057_cov_16.348729	2929	3000	186	1	71	0.0140845
NODE_197_length_5057_cov_16.348729	2929	3000	193	1	71	0.0140845
NODE_197_length_5057_cov_16.348729	2929	3000	195	1	71	0.0140845
NODE_197_length_5057_cov_16.348729	2929	3000	203	2	71	0.0281690
NODE_197_length_5057_cov_16.348729	2929	3000	206	1	71	0.0140845
NODE_197_length_5057_cov_16.348729	2929	3000	212	1	71	0.0140845
NODE_197_length_5057_cov_16.348729	2929	3000	214	1	71	0.0140845
NODE_197_length_5057_cov_16.348729	2929	3000	216	1	71	0.0140845
NODE_197_length_5057_cov_16.348729	2929	3000	222	1	71	0.0140845
NODE_197_length_5057_cov_16.348729	2929	3000	226	1	71	0.0140845
NODE_197_length_5057_cov_16.348729	2929	3000	228	2	71	0.0281690
NODE_197_length_5057_cov_16.348729	2929	3000	249	1	71	0.0140845
NODE_197_length_5057_cov_16.348729	2929	3000	259	1	71	0.0140845
NODE_197_length_5057_cov_16.348729	2929	3000	261	2	71	0.0281690
NODE_197_length_5057_cov_16.348729	2929	3000	273	1	71	0.0140845
NODE_197_length_5057_cov_16.348729	2929	3000	277	1	71	0.0140845
NODE_197_length_5057_cov_16.348729	2929	3000	287	2	71	0.0281690
NODE_197_length_5057_cov_16.348729	2929	3000	295	1	71	0.0140845
NODE_197_length_5057_cov_16.348729	2929	3000	305	1	71	0.0140845
NODE_197_length_5057_cov_16.348729	2929	3000	311	1	71	0.0140845
NODE_197_length_5057_cov_16.348729	2929	3000	313	2	71	0.0281690
NODE_197_length_5057_cov_16.348729	2929	3000	317	1	71	0.0140845
NODE_197_length_5057_cov_16.348729	2929	3000	321	1	71	0.0140845
NODE_197_length_5057_cov_16.348729	2929	3000	325	3	71	0.0422535
NODE_197_length_5057_cov_16.348729	2929	3000	331	1	71	0.0140845
NODE_197_length_5057_cov_16.348729	2929	3000	337	1	71	0.0140845
NODE_197_length_5057_cov_16.348729	2929	3000	339	3	71	0.0422535
NODE_197_length_5057_cov_16.348729	2929	3000	343	2	71	0.0281690
NODE_197_length_5057_cov_16.348729	2929	3000	345	1	71	0.0140845
NODE_197_length_5057_cov_16.348729	2929	3000	348	1	71	0.0140845
NODE_197_length_5057_cov_16.348729	2929	3000	353	1	71	0.0140845
NODE_197_length_5057_cov_16.348729	2929	3000	355	1	71	0.0140845
NODE_197_length_5057_cov_16.348729	2929	3000	357	1	71	0.0140845
NODE_197_length_5057_cov_16.348729	2929	3000	359	2	71	0.0281690
NODE_197_length_5057_cov_16.348729	2929	3000	361	1	71	0.0140845
NODE_197_length_5057_cov_16.348729	2929	3000	363	1	71	0.0140845
NODE_197_length_5057_cov_16.348729	2929	3000	365	4	71	0.0563380
NODE_197_length_5057_cov_16.348729	2929	3000	367	2	71	0.0281690
NODE_197_length_5057_cov_16.348729	2929	3000	370	1	71	0.0140845
NODE_197_length_5057_cov_16.348729	2929	3000	374	1	71	0.0140845
NODE_197_length_5057_cov_16.348729	2929	3000	376	2	71	0.0281690
NODE_197_length_5057_cov_16.348729	2929	3000	381	1	71	0.0140845
NODE_197_length_5057_cov_16.348729	2929	3000	384	1	71	0.0140845
NODE_197_length_5057_cov_16.348729	2929	3000	392	3	71	0.0422535
NODE_197_length_5057_cov_16.348729	2929	3000	393	5	71	0.0704225
NODE_197_length_5057_cov_16.348729	2973	3012	353	1	39	0.0256410
NODE_197_length_5057_cov_16.348729	2973	3012	355	1	39	0.0256410
NODE_197_length_5057_cov_16.348729	2973	3012	357	1	39	0.0256410
NODE_197_length_5057_cov_16.348729	2973	3012	359	2	39	0.0512821
NODE_197_length_5057_cov_16.348729	2973	3012	361	1	39	0.0256410
NODE_197_length_5057_cov_16.348729	2973	3012	363	1	39	0.0256410
NODE_197_length_5057_cov_16.348729	2973	3012	365	4	39	0.1025641
NODE_197_length_5057_cov_16.348729	2973	3012	367	2	39	0.0512821
NODE_197_length_5057_cov_16.348729	2973	3012	370	1	39	0.0256410
NODE_197_length_5057_cov_16.348729	2973	3012	371	1	39	0.0256410
NODE_197_length_5057_cov_16.348729	2973	3012	373	1	39	0.0256410
NODE_197_length_5057_cov_16.348729	2973	3012	374	1	39	0.0256410
NODE_197_length_5057_cov_16.348729	2973	3012	376	2	39	0.0512821
NODE_197_length_5057_cov_16.348729	2973	3012	379	1	39	0.0256410
NODE_197_length_5057_cov_16.348729	2973	3012	381	1	39	0.0256410
NODE_197_length_5057_cov_16.348729	2973	3012	383	2	39	0.0512821
NODE_197_length_5057_cov_16.348729	2973	3012	384	1	39	0.0256410
NODE_197_length_5057_cov_16.348729	2973	3012	389	1	39	0.0256410
NODE_197_length_5057_cov_16.348729	2973	3012	391	2	39	0.0512821
NODE_197_length_5057_cov_16.348729	2973	3012	392	3	39	0.0769231
NODE_197_length_5057_cov_16.348729	2973	3012	393	7	39	0.1794872
NODE_197_length_5057_cov_16.348729	2973	3012	395	2	39	0.0512821
NODE_198_length_5053_cov_11.281994	791	834	0	43	43	1.0000000
NODE_198_length_5053_cov_11.281994	807	887	0	80	80	1.0000000
NODE_198_length_5053_cov_11.281994	883	963	0	80	80	1.0000000
NODE_198_length_5053_cov_11.281994	936	999	0	63	63	1.0000000
NODE_204_length_4906_cov_37.988350	3170	3251	14	1	81	0.0123457
NODE_204_length_4906_cov_37.988350	3170	3251	16	1	81	0.0123457
NODE_204_length_4906_cov_37.988350	3170	3251	21	2	81	0.0246914
NODE_204_length_4906_cov_37.988350	3170	3251	29	2	81	0.0246914
NODE_204_length_4906_cov_37.988350	3170	3251	34	1	81	0.0123457
NODE_204_length_4906_cov_37.988350	3170	3251	37	1	81	0.0123457
NODE_204_length_4906_cov_37.988350	3170	3251	39	1	81	0.0123457
NODE_204_length_4906_cov_37.988350	3170	3251	45	1	81	0.0123457
NODE_204_length_4906_cov_37.988350	3170	3251	49	1	81	0.0123457
NODE_204_length_4906_cov_37.988350	3170	3251	54	1	81	0.0123457
NODE_204_length_4906_cov_37.988350	3170	3251	57	1	81	0.0123457
NODE_204_length_4906_cov_37.988350	3170	3251	61	3	81	0.0370370
NODE_204_length_4906_cov_37.988350	3170	3251	63	6	81	0.0740741
NODE_204_length_4906_cov_37.988350	3170	3251	65	1	81	0.0123457
NODE_204_length_4906_cov_37.988350	3170	3251	67	1	81	0.0123457
NODE_204_length_4906_cov_37.988350	3170	3251	70	1	81	0.0123457
NODE_204_length_4906_cov_37.988350	3170	3251	84	1	81	0.0123457
NODE_204_length_4906_cov_37.988350	3170	3251	86	1	81	0.0123457
NODE_204_length_4906_cov_37.988350	3170	3251	89	1	81	0.0123457
NODE_204_length_4906_cov_37.988350	3170	3251	91	1	81	0.0123457
NODE_204_length_4906_cov_37.988350	3170	3251	94	1	81	0.0123457
NODE_204_length_4906_cov_37.988350	3170	3251	99	3	81	0.0370370
NODE_204_length_4906_cov_37.988350	3170	3251	101	1	81	0.0123457
NODE_204_length_4906_cov_37.988350	3170	3251	103	1	81	0.0123457
NODE_204_length_4906_cov_37.988350	3170	3251	106	1	81	0.0123457
NODE_204_length_4906_cov_37.988350	3170	3251	110	1	81	0.0123457
NODE_204_length_4906_cov_37.988350	3170	3251	111	2	81	0.0246914
NODE_204_length_4906_cov_37.988350	3170	3251	112	3	81	0.0370370
NODE_204_length_4906_cov_37.988350	3170	3251	113	1	81	0.0123457
NODE_204_length_4906_cov_37.988350	3170	3251	117	1	81	0.0123457
NODE_204_length_4906_cov_37.988350	3170	3251	120	1	81	0.0123457
NODE_204_length_4906_cov_37.988350	3170	3251	122	1	81	0.0123457
NODE_204_length_4906_cov_37.988350	3170	3251	124	1	81	0.0123457
NODE_204_length_4906_cov_37.988350	3170	3251	133	1	81	0.0123457
NODE_204_length_4906_cov_37.988350	3170	3251	137	1	81	0.0123457
NODE_204_length_4906_cov_37.988350	3170	3251	139	1	81	0.0123457
NODE_204_length_4906_cov_37.988350	3170	3251	145	1	81	0.0123457
NODE_204_length_4906_cov_37.988350	3170	3251	156	1	81	0.0123457
NODE_204_length_4906_cov_37.988350	3170	3251	161	1	81	0.0123457
NODE_204_length_4906_cov_37.988350	3170	3251	166	1	81	0.0123457
NODE_204_length_4906_cov_37.988350	3170	3251	173	1	81	0.0123457
NODE_204_length_4906_cov_37.988350	3170	3251	176	1	81	0.0123457
NODE_204_length_4906_cov_37.988350	3170	3251	178	1	81	0.0123457
NODE_204_length_4906_cov_37.988350	3170	3251	194	2	81	0.0246914
NODE_204_length_4906_cov_37.988350	3170	3251	196	1	81	0.0123457
NODE_204_length_4906_cov_37.988350	3170	3251	198	1	81	0.0123457
NODE_204_length_4906_cov_37.988350	3170	3251	204	1	81	0.0123457
NODE_204_length_4906_cov_37.988350	3170	3251	216	2	81	0.0246914
NODE_204_length_4906_cov_37.988350	3170	3251	218	1	81	0.0123457
NODE_204_length_4906_cov_37.988350	3170	3251	222	1	81	0.0123457
NODE_204_length_4906_cov_37.988350	3170	3251	228	1	81	0.0123457
NODE_204_length_4906_cov_37.988350	3170	3251	239	1	81	0.0123457
NODE_204_length_4906_cov_37.988350	3170	3251	253	1	81	0.0123457
NODE_204_length_4906_cov_37.988350	3170	3251	258	2	81	0.0246914
NODE_204_length_4906_cov_37.988350	3170	3251	261	1	81	0.0123457
NODE_204_length_4906_cov_37.988350	3170	3251	262	1	81	0.0123457
NODE_204_length_4906_cov_37.988350	3170	3251	266	1	81	0.0123457
NODE_204_length_4906_cov_37.988350	3170	3251	269	1	81	0.0123457
NODE_204_length_4906_cov_37.988350	3170	3251	273	1	81	0.0123457
NODE_204_length_4906_cov_37.988350	3170	3251	283	1	81	0.0123457
NODE_204_length_4906_cov_37.988350	3170	3251	291	2	81	0.0246914
NODE_204_length_4906_cov_37.988350	3170	3251	294	1	81	0.0123457
NODE_204_length_4906_cov_37.988350	3170	3251	296	1	81	0.0123457
NODE_205_length_4888_cov_60.162247	4029	4068	0	3	39	0.0769231
NODE_205_length_4888_cov_60.162247	4029	4068	2	3	39	0.0769231
NODE_205_length_4888_cov_60.162247	4029	4068	4	33	39	0.8461539
NODE_205_length_4888_cov_60.162247	4041	4121	4	80	80	1.0000000
NODE_207_length_4875_cov_63.035176	2905	2985	0	80	80	1.0000000
NODE_207_length_4875_cov_63.035176	2958	3038	0	43	80	0.5375000
NODE_207_length_4875_cov_63.035176	2958	3038	2	1	80	0.0125000
NODE_207_length_4875_cov_63.035176	2958	3038	6	3	80	0.0375000
NODE_207_length_4875_cov_63.035176	2958	3038	7	16	80	0.2000000
NODE_207_length_4875_cov_63.035176	2958	3038	11	1	80	0.0125000
NODE_207_length_4875_cov_63.035176	2958	3038	13	10	80	0.1250000
NODE_207_length_4875_cov_63.035176	2958	3038	14	6	80	0.0750000
NODE_208_length_4875_cov_8.996859	4683	4760	0	27	77	0.3506494
NODE_208_length_4875_cov_8.996859	4683	4760	8	6	77	0.0779221
NODE_208_length_4875_cov_8.996859	4683	4760	10	16	77	0.2077922
NODE_208_length_4875_cov_8.996859	4683	4760	14	3	77	0.0389610
NODE_208_length_4875_cov_8.996859	4683	4760	16	25	77	0.3246753
NODE_208_length_4875_cov_8.996859	4736	4813	2	1	77	0.0129870
NODE_208_length_4875_cov_8.996859	4736	4813	6	8	77	0.1038961
NODE_208_length_4875_cov_8.996859	4736	4813	8	4	77	0.0519481
NODE_208_length_4875_cov_8.996859	4736	4813	15	4	77	0.0519481
NODE_208_length_4875_cov_8.996859	4736	4813	16	60	77	0.7792208
NODE_211_length_4827_cov_15.364636	1803	1865	48	5	62	0.0806452
NODE_211_length_4827_cov_15.364636	1803	1865	49	9	62	0.1451613
NODE_211_length_4827_cov_15.364636	1803	1865	53	6	62	0.0967742
NODE_211_length_4827_cov_15.364636	1803	1865	54	1	62	0.0161290
NODE_211_length_4827_cov_15.364636	1803	1865	55	1	62	0.0161290
NODE_211_length_4827_cov_15.364636	1803	1865	56	1	62	0.0161290
NODE_211_length_4827_cov_15.364636	1803	1865	59	4	62	0.0645161
NODE_211_length_4827_cov_15.364636	1803	1865	61	3	62	0.0483871
NODE_211_length_4827_cov_15.364636	1803	1865	63	2	62	0.0322581
NODE_211_length_4827_cov_15.364636	1803	1865	66	1	62	0.0161290
NODE_211_length_4827_cov_15.364636	1803	1865	68	3	62	0.0483871
NODE_211_length_4827_cov_15.364636	1803	1865	70	1	62	0.0161290
NODE_211_length_4827_cov_15.364636	1803	1865	72	2	62	0.0322581
NODE_211_length_4827_cov_15.364636	1803	1865	76	1	62	0.0161290
NODE_211_length_4827_cov_15.364636	1803	1865	78	1	62	0.0161290
NODE_211_length_4827_cov_15.364636	1803	1865	83	1	62	0.0161290
NODE_211_length_4827_cov_15.364636	1803	1865	84	1	62	0.0161290
NODE_211_length_4827_cov_15.364636	1803	1865	88	2	62	0.0322581
NODE_211_length_4827_cov_15.364636	1803	1865	92	1	62	0.0161290
NODE_211_length_4827_cov_15.364636	1803	1865	94	1	62	0.0161290
NODE_211_length_4827_cov_15.364636	1803	1865	100	2	62	0.0322581
NODE_211_length_4827_cov_15.364636	1803	1865	102	1	62	0.0161290
NODE_211_length_4827_cov_15.364636	1803	1865	108	2	62	0.0322581
NODE_211_length_4827_cov_15.364636	1803	1865	109	2	62	0.0322581
NODE_211_length_4827_cov_15.364636	1803	1865	111	2	62	0.0322581
NODE_211_length_4827_cov_15.364636	1803	1865	119	4	62	0.0645161
NODE_211_length_4827_cov_15.364636	1803	1865	121	2	62	0.0322581
NODE_211_length_4827_cov_15.364636	1899	1979	24	3	80	0.0375000
NODE_211_length_4827_cov_15.364636	1899	1979	26	7	80	0.0875000
NODE_211_length_4827_cov_15.364636	1899	1979	30	2	80	0.0250000
NODE_211_length_4827_cov_15.364636	1899	1979	32	4	80	0.0500000
NODE_211_length_4827_cov_15.364636	1899	1979	34	5	80	0.0625000
NODE_211_length_4827_cov_15.364636	1899	1979	36	2	80	0.0250000
NODE_211_length_4827_cov_15.364636	1899	1979	38	1	80	0.0125000
NODE_211_length_4827_cov_15.364636	1899	1979	39	2	80	0.0250000
NODE_211_length_4827_cov_15.364636	1899	1979	40	27	80	0.3375000
NODE_211_length_4827_cov_15.364636	1899	1979	42	26	80	0.3250000
NODE_211_length_4827_cov_15.364636	1899	1979	44	1	80	0.0125000
NODE_211_length_4827_cov_15.364636	1952	1996	16	1	44	0.0227273
NODE_211_length_4827_cov_15.364636	1952	1996	20	4	44	0.0909091
NODE_211_length_4827_cov_15.364636	1952	1996	22	4	44	0.0909091
NODE_211_length_4827_cov_15.364636	1952	1996	24	11	44	0.2500000
NODE_211_length_4827_cov_15.364636	1952	1996	26	7	44	0.1590909
NODE_211_length_4827_cov_15.364636	1952	1996	30	2	44	0.0454545
NODE_211_length_4827_cov_15.364636	1952	1996	32	4	44	0.0909091
NODE_211_length_4827_cov_15.364636	1952	1996	34	5	44	0.1136364
NODE_211_length_4827_cov_15.364636	1952	1996	39	1	44	0.0227273
NODE_211_length_4827_cov_15.364636	1952	1996	40	3	44	0.0681818
NODE_211_length_4827_cov_15.364636	1952	1996	42	2	44	0.0454545
NODE_212_length_4821_cov_10.856840	999	1061	0	45	62	0.7258065
NODE_212_length_4821_cov_10.856840	999	1061	2	7	62	0.1129032
NODE_212_length_4821_cov_10.856840	999	1061	4	10	62	0.1612903
NODE_213_length_4819_cov_16.363347	2392	2461	30	4	69	0.0579710
NODE_213_length_4819_cov_16.363347	2392	2461	34	13	69	0.1884058
NODE_213_length_4819_cov_16.363347	2392	2461	36	15	69	0.2173913
NODE_213_length_4819_cov_16.363347	2392	2461	37	10	69	0.1449275
NODE_213_length_4819_cov_16.363347	2392	2461	38	27	69	0.3913043
NODE_217_length_4794_cov_14.912886	657	737	71	2	80	0.0250000
NODE_217_length_4794_cov_14.912886	657	737	73	1	80	0.0125000
NODE_217_length_4794_cov_14.912886	657	737	81	1	80	0.0125000
NODE_217_length_4794_cov_14.912886	657	737	82	1	80	0.0125000
NODE_217_length_4794_cov_14.912886	657	737	86	1	80	0.0125000
NODE_217_length_4794_cov_14.912886	657	737	96	4	80	0.0500000
NODE_217_length_4794_cov_14.912886	657	737	100	2	80	0.0250000
NODE_217_length_4794_cov_14.912886	657	737	102	1	80	0.0125000
NODE_217_length_4794_cov_14.912886	657	737	104	1	80	0.0125000
NODE_217_length_4794_cov_14.912886	657	737	108	2	80	0.0250000
NODE_217_length_4794_cov_14.912886	657	737	111	5	80	0.0625000
NODE_217_length_4794_cov_14.912886	657	737	113	10	80	0.1250000
NODE_217_length_4794_cov_14.912886	657	737	119	1	80	0.0125000
NODE_217_length_4794_cov_14.912886	657	737	121	2	80	0.0250000
NODE_217_length_4794_cov_14.912886	657	737	125	3	80	0.0375000
NODE_217_length_4794_cov_14.912886	657	737	126	5	80	0.0625000
NODE_217_length_4794_cov_14.912886	657	737	127	2	80	0.0250000
NODE_217_length_4794_cov_14.912886	657	737	129	5	80	0.0625000
NODE_217_length_4794_cov_14.912886	657	737	130	2	80	0.0250000
NODE_217_length_4794_cov_14.912886	657	737	131	10	80	0.1250000
NODE_217_length_4794_cov_14.912886	657	737	132	4	80	0.0500000
NODE_217_length_4794_cov_14.912886	657	737	133	2	80	0.0250000
NODE_217_length_4794_cov_14.912886	657	737	135	8	80	0.1000000
NODE_217_length_4794_cov_14.912886	657	737	140	1	80	0.0125000
NODE_217_length_4794_cov_14.912886	657	737	144	1	80	0.0125000
NODE_217_length_4794_cov_14.912886	657	737	146	2	80	0.0250000
NODE_217_length_4794_cov_14.912886	657	737	147	1	80	0.0125000
NODE_217_length_4794_cov_14.912886	4240	4312	0	72	72	1.0000000
NODE_217_length_4794_cov_14.912886	4293	4312	0	19	19	1.0000000
NODE_217_length_4794_cov_14.912886	4345	4408	2	63	63	1.0000000
NODE_218_length_4791_cov_16.126172	2438	2518	0	80	80	1.0000000
NODE_218_length_4791_cov_16.126172	2491	2571	0	80	80	1.0000000
NODE_218_length_4791_cov_16.126172	2567	2647	0	80	80	1.0000000
NODE_218_length_4791_cov_16.126172	2620	2700	0	80	80	1.0000000
NODE_218_length_4791_cov_16.126172	4607	4687	0	54	80	0.6750000
NODE_218_length_4791_cov_16.126172	4607	4687	2	6	80	0.0750000
NODE_218_length_4791_cov_16.126172	4607	4687	4	20	80	0.2500000
NODE_219_length_4790_cov_9.713494	2159	2239	40	2	80	0.0250000
NODE_219_length_4790_cov_9.713494	2159	2239	48	1	80	0.0125000
NODE_219_length_4790_cov_9.713494	2159	2239	52	7	80	0.0875000
NODE_219_length_4790_cov_9.713494	2159	2239	54	5	80	0.0625000
NODE_219_length_4790_cov_9.713494	2159	2239	56	4	80	0.0500000
NODE_219_length_4790_cov_9.713494	2159	2239	62	1	80	0.0125000
NODE_219_length_4790_cov_9.713494	2159	2239	70	2	80	0.0250000
NODE_219_length_4790_cov_9.713494	2159	2239	72	7	80	0.0875000
NODE_219_length_4790_cov_9.713494	2159	2239	74	1	80	0.0125000
NODE_219_length_4790_cov_9.713494	2159	2239	76	7	80	0.0875000
NODE_219_length_4790_cov_9.713494	2159	2239	78	11	80	0.1375000
NODE_219_length_4790_cov_9.713494	2159	2239	79	1	80	0.0125000
NODE_219_length_4790_cov_9.713494	2159	2239	80	22	80	0.2750000
NODE_219_length_4790_cov_9.713494	2159	2239	82	9	80	0.1125000
NODE_219_length_4790_cov_9.713494	4273	4353	4	9	80	0.1125000
NODE_219_length_4790_cov_9.713494	4273	4353	6	14	80	0.1750000
NODE_219_length_4790_cov_9.713494	4273	4353	8	57	80	0.7125000
NODE_219_length_4790_cov_9.713494	4273	4335	6	5	62	0.0806452
NODE_219_length_4790_cov_9.713494	4273	4335	8	57	62	0.9193549
NODE_219_length_4790_cov_9.713494	4326	4406	0	4	80	0.0500000
NODE_219_length_4790_cov_9.713494	4326	4406	2	31	80	0.3875000
NODE_219_length_4790_cov_9.713494	4326	4406	4	27	80	0.3375000
NODE_219_length_4790_cov_9.713494	4326	4406	6	14	80	0.1750000
NODE_219_length_4790_cov_9.713494	4326	4406	8	4	80	0.0500000
NODE_221_length_4772_cov_10.560454	4281	4367	0	39	86	0.4534884
NODE_221_length_4772_cov_10.560454	4281	4367	2	47	86	0.5465117
NODE_222_length_4770_cov_106.953543	2778	2858	51	2	80	0.0250000
NODE_222_length_4770_cov_106.953543	2778	2858	53	1	80	0.0125000
NODE_222_length_4770_cov_106.953543	2778	2858	55	1	80	0.0125000
NODE_222_length_4770_cov_106.953543	2778	2858	57	2	80	0.0250000
NODE_222_length_4770_cov_106.953543	2778	2858	58	2	80	0.0250000
NODE_222_length_4770_cov_106.953543	2778	2858	60	3	80	0.0375000
NODE_222_length_4770_cov_106.953543	2778	2858	62	5	80	0.0625000
NODE_222_length_4770_cov_106.953543	2778	2858	63	9	80	0.1125000
NODE_222_length_4770_cov_106.953543	2778	2858	64	7	80	0.0875000
NODE_222_length_4770_cov_106.953543	2778	2858	65	2	80	0.0250000
NODE_222_length_4770_cov_106.953543	2778	2858	66	1	80	0.0125000
NODE_222_length_4770_cov_106.953543	2778	2858	67	3	80	0.0375000
NODE_222_length_4770_cov_106.953543	2778	2858	69	10	80	0.1250000
NODE_222_length_4770_cov_106.953543	2778	2858	70	5	80	0.0625000
NODE_222_length_4770_cov_106.953543	2778	2858	71	10	80	0.1250000
NODE_222_length_4770_cov_106.953543	2778	2858	72	1	80	0.0125000
NODE_222_length_4770_cov_106.953543	2778	2858	73	16	80	0.2000000
NODE_222_length_4770_cov_106.953543	2831	2911	55	1	80	0.0125000
NODE_222_length_4770_cov_106.953543	2831	2911	57	2	80	0.0250000
NODE_222_length_4770_cov_106.953543	2831	2911	58	2	80	0.0250000
NODE_222_length_4770_cov_106.953543	2831	2911	59	5	80	0.0625000
NODE_222_length_4770_cov_106.953543	2831	2911	61	7	80	0.0875000
NODE_222_length_4770_cov_106.953543	2831	2911	62	1	80	0.0125000
NODE_222_length_4770_cov_106.953543	2831	2911	63	8	80	0.1000000
NODE_222_length_4770_cov_106.953543	2831	2911	64	1	80	0.0125000
NODE_222_length_4770_cov_106.953543	2831	2911	65	4	80	0.0500000
NODE_222_length_4770_cov_106.953543	2831	2911	66	2	80	0.0250000
NODE_222_length_4770_cov_106.953543	2831	2911	67	5	80	0.0625000
NODE_222_length_4770_cov_106.953543	2831	2911	69	7	80	0.0875000
NODE_222_length_4770_cov_106.953543	2831	2911	70	4	80	0.0500000
NODE_222_length_4770_cov_106.953543	2831	2911	71	6	80	0.0750000
NODE_222_length_4770_cov_106.953543	2831	2911	72	1	80	0.0125000
NODE_222_length_4770_cov_106.953543	2831	2911	73	5	80	0.0625000
NODE_222_length_4770_cov_106.953543	2831	2911	78	1	80	0.0125000
NODE_222_length_4770_cov_106.953543	2831	2911	80	2	80	0.0250000
NODE_222_length_4770_cov_106.953543	2831	2911	82	1	80	0.0125000
NODE_222_length_4770_cov_106.953543	2831	2911	84	5	80	0.0625000
NODE_222_length_4770_cov_106.953543	2831	2911	92	1	80	0.0125000
NODE_222_length_4770_cov_106.953543	2831	2911	94	2	80	0.0250000
NODE_222_length_4770_cov_106.953543	2831	2911	95	1	80	0.0125000
NODE_222_length_4770_cov_106.953543	2831	2911	96	3	80	0.0375000
NODE_222_length_4770_cov_106.953543	2831	2911	98	2	80	0.0250000
NODE_222_length_4770_cov_106.953543	2831	2911	100	1	80	0.0125000
NODE_222_length_4770_cov_106.953543	2907	2987	96	3	80	0.0375000
NODE_222_length_4770_cov_106.953543	2907	2987	98	3	80	0.0375000
NODE_222_length_4770_cov_106.953543	2907	2987	100	1	80	0.0125000
NODE_222_length_4770_cov_106.953543	2907	2987	108	2	80	0.0250000
NODE_222_length_4770_cov_106.953543	2907	2987	112	2	80	0.0250000
NODE_222_length_4770_cov_106.953543	2907	2987	114	1	80	0.0125000
NODE_222_length_4770_cov_106.953543	2907	2987	115	2	80	0.0250000
NODE_222_length_4770_cov_106.953543	2907	2987	117	1	80	0.0125000
NODE_222_length_4770_cov_106.953543	2907	2987	129	1	80	0.0125000
NODE_222_length_4770_cov_106.953543	2907	2987	131	3	80	0.0375000
NODE_222_length_4770_cov_106.953543	2907	2987	133	1	80	0.0125000
NODE_222_length_4770_cov_106.953543	2907	2987	137	1	80	0.0125000
NODE_222_length_4770_cov_106.953543	2907	2987	153	1	80	0.0125000
NODE_222_length_4770_cov_106.953543	2907	2987	155	1	80	0.0125000
NODE_222_length_4770_cov_106.953543	2907	2987	157	1	80	0.0125000
NODE_222_length_4770_cov_106.953543	2907	2987	159	1	80	0.0125000
NODE_222_length_4770_cov_106.953543	2907	2987	166	2	80	0.0250000
NODE_222_length_4770_cov_106.953543	2907	2987	167	1	80	0.0125000
NODE_222_length_4770_cov_106.953543	2907	2987	171	2	80	0.0250000
NODE_222_length_4770_cov_106.953543	2907	2987	174	1	80	0.0125000
NODE_222_length_4770_cov_106.953543	2907	2987	179	1	80	0.0125000
NODE_222_length_4770_cov_106.953543	2907	2987	183	2	80	0.0250000
NODE_222_length_4770_cov_106.953543	2907	2987	184	3	80	0.0375000
NODE_222_length_4770_cov_106.953543	2907	2987	185	1	80	0.0125000
NODE_222_length_4770_cov_106.953543	2907	2987	186	3	80	0.0375000
NODE_222_length_4770_cov_106.953543	2907	2987	187	2	80	0.0250000
NODE_222_length_4770_cov_106.953543	2907	2987	188	1	80	0.0125000
NODE_222_length_4770_cov_106.953543	2907	2987	190	5	80	0.0625000
NODE_222_length_4770_cov_106.953543	2907	2987	191	2	80	0.0250000
NODE_222_length_4770_cov_106.953543	2907	2987	192	1	80	0.0125000
NODE_222_length_4770_cov_106.953543	2907	2987	193	6	80	0.0750000
NODE_222_length_4770_cov_106.953543	2907	2987	195	3	80	0.0375000
NODE_222_length_4770_cov_106.953543	2907	2987	196	4	80	0.0500000
NODE_222_length_4770_cov_106.953543	2907	2987	197	2	80	0.0250000
NODE_222_length_4770_cov_106.953543	2907	2987	198	5	80	0.0625000
NODE_222_length_4770_cov_106.953543	2907	2987	202	8	80	0.1000000
NODE_222_length_4770_cov_106.953543	2960	3040	150	1	80	0.0125000
NODE_222_length_4770_cov_106.953543	2960	3040	152	1	80	0.0125000
NODE_222_length_4770_cov_106.953543	2960	3040	154	2	80	0.0250000
NODE_222_length_4770_cov_106.953543	2960	3040	158	3	80	0.0375000
NODE_222_length_4770_cov_106.953543	2960	3040	166	1	80	0.0125000
NODE_222_length_4770_cov_106.953543	2960	3040	168	1	80	0.0125000
NODE_222_length_4770_cov_106.953543	2960	3040	173	3	80	0.0375000
NODE_222_length_4770_cov_106.953543	2960	3040	175	2	80	0.0250000
NODE_222_length_4770_cov_106.953543	2960	3040	184	5	80	0.0625000
NODE_222_length_4770_cov_106.953543	2960	3040	185	1	80	0.0125000
NODE_222_length_4770_cov_106.953543	2960	3040	186	3	80	0.0375000
NODE_222_length_4770_cov_106.953543	2960	3040	187	2	80	0.0250000
NODE_222_length_4770_cov_106.953543	2960	3040	188	1	80	0.0125000
NODE_222_length_4770_cov_106.953543	2960	3040	190	4	80	0.0500000
NODE_222_length_4770_cov_106.953543	2960	3040	191	2	80	0.0250000
NODE_222_length_4770_cov_106.953543	2960	3040	193	2	80	0.0250000
NODE_222_length_4770_cov_106.953543	2960	3040	195	7	80	0.0875000
NODE_222_length_4770_cov_106.953543	2960	3040	196	1	80	0.0125000
NODE_222_length_4770_cov_106.953543	2960	3040	197	4	80	0.0500000
NODE_222_length_4770_cov_106.953543	2960	3040	198	4	80	0.0500000
NODE_222_length_4770_cov_106.953543	2960	3040	199	2	80	0.0250000
NODE_222_length_4770_cov_106.953543	2960	3040	200	2	80	0.0250000
NODE_222_length_4770_cov_106.953543	2960	3040	202	4	80	0.0500000
NODE_222_length_4770_cov_106.953543	2960	3040	203	1	80	0.0125000
NODE_222_length_4770_cov_106.953543	2960	3040	204	2	80	0.0250000
NODE_222_length_4770_cov_106.953543	2960	3040	205	4	80	0.0500000
NODE_222_length_4770_cov_106.953543	2960	3040	206	3	80	0.0375000
NODE_222_length_4770_cov_106.953543	2960	3040	207	2	80	0.0250000
NODE_222_length_4770_cov_106.953543	2960	3040	208	1	80	0.0125000
NODE_222_length_4770_cov_106.953543	2960	3040	209	2	80	0.0250000
NODE_222_length_4770_cov_106.953543	2960	3040	212	2	80	0.0250000
NODE_222_length_4770_cov_106.953543	2960	3040	215	1	80	0.0125000
NODE_222_length_4770_cov_106.953543	2960	3040	216	1	80	0.0125000
NODE_222_length_4770_cov_106.953543	2960	3040	217	3	80	0.0375000
NODE_223_length_4768_cov_15.447205	1237	1317	48	5	80	0.0625000
NODE_223_length_4768_cov_15.447205	1237	1317	50	1	80	0.0125000
NODE_223_length_4768_cov_15.447205	1237	1317	52	2	80	0.0250000
NODE_223_length_4768_cov_15.447205	1237	1317	54	3	80	0.0375000
NODE_223_length_4768_cov_15.447205	1237	1317	58	3	80	0.0375000
NODE_223_length_4768_cov_15.447205	1237	1317	60	1	80	0.0125000
NODE_223_length_4768_cov_15.447205	1237	1317	64	1	80	0.0125000
NODE_223_length_4768_cov_15.447205	1237	1317	68	1	80	0.0125000
NODE_223_length_4768_cov_15.447205	1237	1317	76	6	80	0.0750000
NODE_223_length_4768_cov_15.447205	1237	1317	78	24	80	0.3000000
NODE_223_length_4768_cov_15.447205	1237	1317	80	15	80	0.1875000
NODE_223_length_4768_cov_15.447205	1237	1317	82	10	80	0.1250000
NODE_223_length_4768_cov_15.447205	1237	1317	84	2	80	0.0250000
NODE_223_length_4768_cov_15.447205	1237	1317	86	6	80	0.0750000
NODE_228_length_4730_cov_30.142734	256	336	0	59	80	0.7375000
NODE_228_length_4730_cov_30.142734	256	336	10	5	80	0.0625000
NODE_228_length_4730_cov_30.142734	256	336	18	16	80	0.2000000
NODE_228_length_4730_cov_30.142734	309	389	0	6	80	0.0750000
NODE_228_length_4730_cov_30.142734	309	389	10	5	80	0.0625000
NODE_228_length_4730_cov_30.142734	309	389	18	69	80	0.8625000
NODE_228_length_4730_cov_30.142734	4052	4132	0	49	80	0.6125000
NODE_228_length_4730_cov_30.142734	4052	4132	2	31	80	0.3875000
NODE_228_length_4730_cov_30.142734	4105	4185	2	31	80	0.3875000
NODE_228_length_4730_cov_30.142734	4105	4185	6	49	80	0.6125000
NODE_231_length_4706_cov_25.522683	2181	2261	55	3	80	0.0375000
NODE_231_length_4706_cov_25.522683	2181	2261	57	1	80	0.0125000
NODE_231_length_4706_cov_25.522683	2181	2261	59	4	80	0.0500000
NODE_231_length_4706_cov_25.522683	2181	2261	63	3	80	0.0375000
NODE_231_length_4706_cov_25.522683	2181	2261	65	2	80	0.0250000
NODE_231_length_4706_cov_25.522683	2181	2261	67	3	80	0.0375000
NODE_231_length_4706_cov_25.522683	2181	2261	70	5	80	0.0625000
NODE_231_length_4706_cov_25.522683	2181	2261	76	2	80	0.0250000
NODE_231_length_4706_cov_25.522683	2181	2261	81	1	80	0.0125000
NODE_231_length_4706_cov_25.522683	2181	2261	85	1	80	0.0125000
NODE_231_length_4706_cov_25.522683	2181	2261	88	4	80	0.0500000
NODE_231_length_4706_cov_25.522683	2181	2261	90	2	80	0.0250000
NODE_231_length_4706_cov_25.522683	2181	2261	91	5	80	0.0625000
NODE_231_length_4706_cov_25.522683	2181	2261	92	2	80	0.0250000
NODE_231_length_4706_cov_25.522683	2181	2261	96	2	80	0.0250000
NODE_231_length_4706_cov_25.522683	2181	2261	110	1	80	0.0125000
NODE_231_length_4706_cov_25.522683	2181	2261	117	2	80	0.0250000
NODE_231_length_4706_cov_25.522683	2181	2261	119	1	80	0.0125000
NODE_231_length_4706_cov_25.522683	2181	2261	125	2	80	0.0250000
NODE_231_length_4706_cov_25.522683	2181	2261	127	3	80	0.0375000
NODE_231_length_4706_cov_25.522683	2181	2261	131	1	80	0.0125000
NODE_231_length_4706_cov_25.522683	2181	2261	134	1	80	0.0125000
NODE_231_length_4706_cov_25.522683	2181	2261	143	3	80	0.0375000
NODE_231_length_4706_cov_25.522683	2181	2261	154	1	80	0.0125000
NODE_231_length_4706_cov_25.522683	2181	2261	162	1	80	0.0125000
NODE_231_length_4706_cov_25.522683	2181	2261	164	1	80	0.0125000
NODE_231_length_4706_cov_25.522683	2181	2261	170	3	80	0.0375000
NODE_231_length_4706_cov_25.522683	2181	2261	172	1	80	0.0125000
NODE_231_length_4706_cov_25.522683	2181	2261	175	1	80	0.0125000
NODE_231_length_4706_cov_25.522683	2181	2261	177	2	80	0.0250000
NODE_231_length_4706_cov_25.522683	2181	2261	178	1	80	0.0125000
NODE_231_length_4706_cov_25.522683	2181	2261	179	1	80	0.0125000
NODE_231_length_4706_cov_25.522683	2181	2261	180	3	80	0.0375000
NODE_231_length_4706_cov_25.522683	2181	2261	181	3	80	0.0375000
NODE_231_length_4706_cov_25.522683	2181	2261	182	3	80	0.0375000
NODE_231_length_4706_cov_25.522683	2181	2261	184	3	80	0.0375000
NODE_231_length_4706_cov_25.522683	2181	2261	186	2	80	0.0250000
NODE_231_length_4706_cov_25.522683	2234	2288	4	1	54	0.0185185
NODE_231_length_4706_cov_25.522683	2234	2288	5	1	54	0.0185185
NODE_231_length_4706_cov_25.522683	2234	2288	11	1	54	0.0185185
NODE_231_length_4706_cov_25.522683	2234	2288	12	2	54	0.0370370
NODE_231_length_4706_cov_25.522683	2234	2288	15	3	54	0.0555556
NODE_231_length_4706_cov_25.522683	2234	2288	26	5	54	0.0925926
NODE_231_length_4706_cov_25.522683	2234	2288	36	1	54	0.0185185
NODE_231_length_4706_cov_25.522683	2234	2288	37	2	54	0.0370370
NODE_231_length_4706_cov_25.522683	2234	2288	38	2	54	0.0370370
NODE_231_length_4706_cov_25.522683	2234	2288	40	3	54	0.0555556
NODE_231_length_4706_cov_25.522683	2234	2288	42	1	54	0.0185185
NODE_231_length_4706_cov_25.522683	2234	2288	48	1	54	0.0185185
NODE_231_length_4706_cov_25.522683	2234	2288	55	7	54	0.1296296
NODE_231_length_4706_cov_25.522683	2234	2288	57	1	54	0.0185185
NODE_231_length_4706_cov_25.522683	2234	2288	59	4	54	0.0740741
NODE_231_length_4706_cov_25.522683	2234	2288	63	3	54	0.0555556
NODE_231_length_4706_cov_25.522683	2234	2288	65	2	54	0.0370370
NODE_231_length_4706_cov_25.522683	2234	2288	67	3	54	0.0555556
NODE_231_length_4706_cov_25.522683	2234	2288	70	5	54	0.0925926
NODE_231_length_4706_cov_25.522683	2234	2288	76	2	54	0.0370370
NODE_231_length_4706_cov_25.522683	2234	2288	81	1	54	0.0185185
NODE_231_length_4706_cov_25.522683	2234	2288	85	1	54	0.0185185
NODE_231_length_4706_cov_25.522683	2234	2288	88	2	54	0.0370370
NODE_231_length_4706_cov_25.522683	3943	4026	136	1	83	0.0120482
NODE_231_length_4706_cov_25.522683	3943	4026	137	2	83	0.0240964
NODE_231_length_4706_cov_25.522683	3943	4026	139	3	83	0.0361446
NODE_231_length_4706_cov_25.522683	3943	4026	141	3	83	0.0361446
NODE_231_length_4706_cov_25.522683	3943	4026	142	1	83	0.0120482
NODE_231_length_4706_cov_25.522683	3943	4026	143	3	83	0.0361446
NODE_231_length_4706_cov_25.522683	3943	4026	144	3	83	0.0361446
NODE_231_length_4706_cov_25.522683	3943	4026	145	3	83	0.0361446
NODE_231_length_4706_cov_25.522683	3943	4026	146	5	83	0.0602410
NODE_231_length_4706_cov_25.522683	3943	4026	147	7	83	0.0843373
NODE_231_length_4706_cov_25.522683	3943	4026	149	8	83	0.0963855
NODE_231_length_4706_cov_25.522683	3943	4026	151	1	83	0.0120482
NODE_231_length_4706_cov_25.522683	3943	4026	152	1	83	0.0120482
NODE_231_length_4706_cov_25.522683	3943	4026	154	2	83	0.0240964
NODE_231_length_4706_cov_25.522683	3943	4026	155	2	83	0.0240964
NODE_231_length_4706_cov_25.522683	3943	4026	157	2	83	0.0240964
NODE_231_length_4706_cov_25.522683	3943	4026	158	2	83	0.0240964
NODE_231_length_4706_cov_25.522683	3943	4026	159	3	83	0.0361446
NODE_231_length_4706_cov_25.522683	3943	4026	160	4	83	0.0481928
NODE_231_length_4706_cov_25.522683	3943	4026	161	5	83	0.0602410
NODE_231_length_4706_cov_25.522683	3943	4026	162	3	83	0.0361446
NODE_231_length_4706_cov_25.522683	3943	4026	163	3	83	0.0361446
NODE_231_length_4706_cov_25.522683	3943	4026	164	4	83	0.0481928
NODE_231_length_4706_cov_25.522683	3943	4026	165	2	83	0.0240964
NODE_231_length_4706_cov_25.522683	3943	4026	166	2	83	0.0240964
NODE_231_length_4706_cov_25.522683	3943	4026	167	2	83	0.0240964
NODE_231_length_4706_cov_25.522683	3943	4026	168	4	83	0.0481928
NODE_231_length_4706_cov_25.522683	3943	4026	173	1	83	0.0120482
NODE_231_length_4706_cov_25.522683	3943	4026	177	1	83	0.0120482
NODE_235_length_4693_cov_16.973008	374	454	29	4	80	0.0500000
NODE_235_length_4693_cov_16.973008	374	454	30	3	80	0.0375000
NODE_235_length_4693_cov_16.973008	374	454	32	23	80	0.2875000
NODE_235_length_4693_cov_16.973008	374	454	33	2	80	0.0250000
NODE_235_length_4693_cov_16.973008	374	454	34	26	80	0.3250000
NODE_235_length_4693_cov_16.973008	374	454	35	6	80	0.0750000
NODE_235_length_4693_cov_16.973008	374	454	36	7	80	0.0875000
NODE_235_length_4693_cov_16.973008	374	454	38	4	80	0.0500000
NODE_235_length_4693_cov_16.973008	374	454	39	2	80	0.0250000
NODE_235_length_4693_cov_16.973008	374	454	40	1	80	0.0125000
NODE_235_length_4693_cov_16.973008	374	454	41	1	80	0.0125000
NODE_235_length_4693_cov_16.973008	374	454	42	1	80	0.0125000
NODE_235_length_4693_cov_16.973008	427	507	32	11	80	0.1375000
NODE_235_length_4693_cov_16.973008	427	507	33	1	80	0.0125000
NODE_235_length_4693_cov_16.973008	427	507	34	22	80	0.2750000
NODE_235_length_4693_cov_16.973008	427	507	35	1	80	0.0125000
NODE_235_length_4693_cov_16.973008	427	507	36	11	80	0.1375000
NODE_235_length_4693_cov_16.973008	427	507	38	22	80	0.2750000
NODE_235_length_4693_cov_16.973008	427	507	39	1	80	0.0125000
NODE_235_length_4693_cov_16.973008	427	507	40	11	80	0.1375000
NODE_240_length_4672_cov_39.029084	1391	1470	284	1	79	0.0126582
NODE_240_length_4672_cov_39.029084	1391	1470	325	1	79	0.0126582
NODE_240_length_4672_cov_39.029084	1391	1470	359	1	79	0.0126582
NODE_240_length_4672_cov_39.029084	1391	1470	373	1	79	0.0126582
NODE_240_length_4672_cov_39.029084	1391	1470	387	1	79	0.0126582
NODE_240_length_4672_cov_39.029084	1391	1470	395	2	79	0.0253165
NODE_240_length_4672_cov_39.029084	1391	1470	396	2	79	0.0253165
NODE_240_length_4672_cov_39.029084	1391	1470	397	1	79	0.0126582
NODE_240_length_4672_cov_39.029084	1391	1470	413	1	79	0.0126582
NODE_240_length_4672_cov_39.029084	1391	1470	424	3	79	0.0379747
NODE_240_length_4672_cov_39.029084	1391	1470	429	2	79	0.0253165
NODE_240_length_4672_cov_39.029084	1391	1470	435	1	79	0.0126582
NODE_240_length_4672_cov_39.029084	1391	1470	441	1	79	0.0126582
NODE_240_length_4672_cov_39.029084	1391	1470	445	2	79	0.0253165
NODE_240_length_4672_cov_39.029084	1391	1470	456	2	79	0.0253165
NODE_240_length_4672_cov_39.029084	1391	1470	471	1	79	0.0126582
NODE_240_length_4672_cov_39.029084	1391	1470	495	1	79	0.0126582
NODE_240_length_4672_cov_39.029084	1391	1470	501	1	79	0.0126582
NODE_240_length_4672_cov_39.029084	1391	1470	511	1	79	0.0126582
NODE_240_length_4672_cov_39.029084	1391	1470	515	1	79	0.0126582
NODE_240_length_4672_cov_39.029084	1391	1470	517	1	79	0.0126582
NODE_240_length_4672_cov_39.029084	1391	1470	526	1	79	0.0126582
NODE_240_length_4672_cov_39.029084	1391	1470	529	1	79	0.0126582
NODE_240_length_4672_cov_39.029084	1391	1470	547	1	79	0.0126582
NODE_240_length_4672_cov_39.029084	1391	1470	572	1	79	0.0126582
NODE_240_length_4672_cov_39.029084	1391	1470	574	1	79	0.0126582
NODE_240_length_4672_cov_39.029084	1391	1470	588	1	79	0.0126582
NODE_240_length_4672_cov_39.029084	1391	1470	597	1	79	0.0126582
NODE_240_length_4672_cov_39.029084	1391	1470	606	2	79	0.0253165
NODE_240_length_4672_cov_39.029084	1391	1470	607	1	79	0.0126582
NODE_240_length_4672_cov_39.029084	1391	1470	613	1	79	0.0126582
NODE_240_length_4672_cov_39.029084	1391	1470	614	1	79	0.0126582
NODE_240_length_4672_cov_39.029084	1391	1470	620	1	79	0.0126582
NODE_240_length_4672_cov_39.029084	1391	1470	647	2	79	0.0253165
NODE_240_length_4672_cov_39.029084	1391	1470	648	1	79	0.0126582
NODE_240_length_4672_cov_39.029084	1391	1470	653	1	79	0.0126582
NODE_240_length_4672_cov_39.029084	1391	1470	659	1	79	0.0126582
NODE_240_length_4672_cov_39.029084	1391	1470	662	1	79	0.0126582
NODE_240_length_4672_cov_39.029084	1391	1470	666	1	79	0.0126582
NODE_240_length_4672_cov_39.029084	1391	1470	674	1	79	0.0126582
NODE_240_length_4672_cov_39.029084	1391	1470	680	2	79	0.0253165
NODE_240_length_4672_cov_39.029084	1391	1470	681	3	79	0.0379747
NODE_240_length_4672_cov_39.029084	1391	1470	683	1	79	0.0126582
NODE_240_length_4672_cov_39.029084	1391	1470	684	1	79	0.0126582
NODE_240_length_4672_cov_39.029084	1391	1470	685	1	79	0.0126582
NODE_240_length_4672_cov_39.029084	1391	1470	687	1	79	0.0126582
NODE_240_length_4672_cov_39.029084	1391	1470	688	4	79	0.0506329
NODE_240_length_4672_cov_39.029084	1391	1470	689	2	79	0.0253165
NODE_240_length_4672_cov_39.029084	1391	1470	690	2	79	0.0253165
NODE_240_length_4672_cov_39.029084	1391	1470	692	1	79	0.0126582
NODE_240_length_4672_cov_39.029084	1391	1470	693	2	79	0.0253165
NODE_240_length_4672_cov_39.029084	1391	1470	694	3	79	0.0379747
NODE_240_length_4672_cov_39.029084	1391	1470	696	1	79	0.0126582
NODE_240_length_4672_cov_39.029084	1391	1470	700	1	79	0.0126582
NODE_240_length_4672_cov_39.029084	1391	1470	704	3	79	0.0379747
NODE_240_length_4672_cov_39.029084	1391	1470	706	1	79	0.0126582
NODE_240_length_4672_cov_39.029084	1391	1470	710	1	79	0.0126582
NODE_240_length_4672_cov_39.029084	1444	1523	269	1	79	0.0126582
NODE_240_length_4672_cov_39.029084	1444	1523	271	1	79	0.0126582
NODE_240_length_4672_cov_39.029084	1444	1523	290	1	79	0.0126582
NODE_240_length_4672_cov_39.029084	1444	1523	294	1	79	0.0126582
NODE_240_length_4672_cov_39.029084	1444	1523	298	1	79	0.0126582
NODE_240_length_4672_cov_39.029084	1444	1523	312	1	79	0.0126582
NODE_240_length_4672_cov_39.029084	1444	1523	332	1	79	0.0126582
NODE_240_length_4672_cov_39.029084	1444	1523	352	1	79	0.0126582
NODE_240_length_4672_cov_39.029084	1444	1523	372	1	79	0.0126582
NODE_240_length_4672_cov_39.029084	1444	1523	374	2	79	0.0253165
NODE_240_length_4672_cov_39.029084	1444	1523	380	1	79	0.0126582
NODE_240_length_4672_cov_39.029084	1444	1523	394	1	79	0.0126582
NODE_240_length_4672_cov_39.029084	1444	1523	404	1	79	0.0126582
NODE_240_length_4672_cov_39.029084	1444	1523	423	1	79	0.0126582
NODE_240_length_4672_cov_39.029084	1444	1523	440	1	79	0.0126582
NODE_240_length_4672_cov_39.029084	1444	1523	457	1	79	0.0126582
NODE_240_length_4672_cov_39.029084	1444	1523	462	1	79	0.0126582
NODE_240_length_4672_cov_39.029084	1444	1523	478	1	79	0.0126582
NODE_240_length_4672_cov_39.029084	1444	1523	480	1	79	0.0126582
NODE_240_length_4672_cov_39.029084	1444	1523	487	1	79	0.0126582
NODE_240_length_4672_cov_39.029084	1444	1523	491	1	79	0.0126582
NODE_240_length_4672_cov_39.029084	1444	1523	493	1	79	0.0126582
NODE_240_length_4672_cov_39.029084	1444	1523	502	1	79	0.0126582
NODE_240_length_4672_cov_39.029084	1444	1523	511	1	79	0.0126582
NODE_240_length_4672_cov_39.029084	1444	1523	530	1	79	0.0126582
NODE_240_length_4672_cov_39.029084	1444	1523	532	1	79	0.0126582
NODE_240_length_4672_cov_39.029084	1444	1523	563	1	79	0.0126582
NODE_240_length_4672_cov_39.029084	1444	1523	570	1	79	0.0126582
NODE_240_length_4672_cov_39.029084	1444	1523	574	1	79	0.0126582
NODE_240_length_4672_cov_39.029084	1444	1523	576	1	79	0.0126582
NODE_240_length_4672_cov_39.029084	1444	1523	594	2	79	0.0253165
NODE_240_length_4672_cov_39.029084	1444	1523	601	2	79	0.0253165
NODE_240_length_4672_cov_39.029084	1444	1523	604	1	79	0.0126582
NODE_240_length_4672_cov_39.029084	1444	1523	621	2	79	0.0253165
NODE_240_length_4672_cov_39.029084	1444	1523	641	2	79	0.0253165
NODE_240_length_4672_cov_39.029084	1444	1523	646	1	79	0.0126582
NODE_240_length_4672_cov_39.029084	1444	1523	655	6	79	0.0759494
NODE_240_length_4672_cov_39.029084	1444	1523	657	2	79	0.0253165
NODE_240_length_4672_cov_39.029084	1444	1523	669	2	79	0.0253165
NODE_240_length_4672_cov_39.029084	1444	1523	675	1	79	0.0126582
NODE_240_length_4672_cov_39.029084	1444	1523	677	1	79	0.0126582
NODE_240_length_4672_cov_39.029084	1444	1523	681	3	79	0.0379747
NODE_240_length_4672_cov_39.029084	1444	1523	683	1	79	0.0126582
NODE_240_length_4672_cov_39.029084	1444	1523	684	1	79	0.0126582
NODE_240_length_4672_cov_39.029084	1444	1523	685	1	79	0.0126582
NODE_240_length_4672_cov_39.029084	1444	1523	687	1	79	0.0126582
NODE_240_length_4672_cov_39.029084	1444	1523	688	3	79	0.0379747
NODE_240_length_4672_cov_39.029084	1444	1523	689	2	79	0.0253165
NODE_240_length_4672_cov_39.029084	1444	1523	690	2	79	0.0253165
NODE_240_length_4672_cov_39.029084	1444	1523	692	1	79	0.0126582
NODE_240_length_4672_cov_39.029084	1444	1523	693	1	79	0.0126582
NODE_240_length_4672_cov_39.029084	1444	1523	694	3	79	0.0379747
NODE_240_length_4672_cov_39.029084	1444	1523	696	1	79	0.0126582
NODE_240_length_4672_cov_39.029084	1444	1523	700	1	79	0.0126582
NODE_240_length_4672_cov_39.029084	1444	1523	704	3	79	0.0379747
NODE_240_length_4672_cov_39.029084	1444	1523	706	1	79	0.0126582
NODE_240_length_4672_cov_39.029084	1444	1523	710	1	79	0.0126582
NODE_246_length_4602_cov_17.281368	3106	3186	38	16	80	0.2000000
NODE_246_length_4602_cov_17.281368	3106	3186	39	1	80	0.0125000
NODE_246_length_4602_cov_17.281368	3106	3186	44	3	80	0.0375000
NODE_246_length_4602_cov_17.281368	3106	3186	47	1	80	0.0125000
NODE_246_length_4602_cov_17.281368	3106	3186	48	12	80	0.1500000
NODE_246_length_4602_cov_17.281368	3106	3186	50	6	80	0.0750000
NODE_246_length_4602_cov_17.281368	3106	3186	52	9	80	0.1125000
NODE_246_length_4602_cov_17.281368	3106	3186	54	2	80	0.0250000
NODE_246_length_4602_cov_17.281368	3106	3186	56	5	80	0.0625000
NODE_246_length_4602_cov_17.281368	3106	3186	59	2	80	0.0250000
NODE_246_length_4602_cov_17.281368	3106	3186	63	1	80	0.0125000
NODE_246_length_4602_cov_17.281368	3106	3186	71	22	80	0.2750000
NODE_246_length_4602_cov_17.281368	3159	3239	25	1	80	0.0125000
NODE_246_length_4602_cov_17.281368	3159	3239	30	15	80	0.1875000
NODE_246_length_4602_cov_17.281368	3159	3239	32	4	80	0.0500000
NODE_246_length_4602_cov_17.281368	3159	3239	34	1	80	0.0125000
NODE_246_length_4602_cov_17.281368	3159	3239	42	12	80	0.1500000
NODE_246_length_4602_cov_17.281368	3159	3239	44	1	80	0.0125000
NODE_246_length_4602_cov_17.281368	3159	3239	45	2	80	0.0250000
NODE_246_length_4602_cov_17.281368	3159	3239	46	1	80	0.0125000
NODE_246_length_4602_cov_17.281368	3159	3239	47	3	80	0.0375000
NODE_246_length_4602_cov_17.281368	3159	3239	49	7	80	0.0875000
NODE_246_length_4602_cov_17.281368	3159	3239	51	3	80	0.0375000
NODE_246_length_4602_cov_17.281368	3159	3239	53	1	80	0.0125000
NODE_246_length_4602_cov_17.281368	3159	3239	56	2	80	0.0250000
NODE_246_length_4602_cov_17.281368	3159	3239	58	1	80	0.0125000
NODE_246_length_4602_cov_17.281368	3159	3239	59	3	80	0.0375000
NODE_246_length_4602_cov_17.281368	3159	3239	63	1	80	0.0125000
NODE_246_length_4602_cov_17.281368	3159	3239	71	22	80	0.2750000
NODE_248_length_4587_cov_14.431150	1294	1370	303	1	76	0.0131579
NODE_248_length_4587_cov_14.431150	1294	1370	304	1	76	0.0131579
NODE_248_length_4587_cov_14.431150	1294	1370	308	1	76	0.0131579
NODE_248_length_4587_cov_14.431150	1294	1370	309	6	76	0.0789474
NODE_248_length_4587_cov_14.431150	1294	1370	311	1	76	0.0131579
NODE_248_length_4587_cov_14.431150	1294	1370	317	1	76	0.0131579
NODE_248_length_4587_cov_14.431150	1294	1370	338	1	76	0.0131579
NODE_248_length_4587_cov_14.431150	1294	1370	344	1	76	0.0131579
NODE_248_length_4587_cov_14.431150	1294	1370	346	3	76	0.0394737
NODE_248_length_4587_cov_14.431150	1294	1370	347	1	76	0.0131579
NODE_248_length_4587_cov_14.431150	1294	1370	357	1	76	0.0131579
NODE_248_length_4587_cov_14.431150	1294	1370	363	2	76	0.0263158
NODE_248_length_4587_cov_14.431150	1294	1370	369	1	76	0.0131579
NODE_248_length_4587_cov_14.431150	1294	1370	388	1	76	0.0131579
NODE_248_length_4587_cov_14.431150	1294	1370	408	1	76	0.0131579
NODE_248_length_4587_cov_14.431150	1294	1370	409	1	76	0.0131579
NODE_248_length_4587_cov_14.431150	1294	1370	413	1	76	0.0131579
NODE_248_length_4587_cov_14.431150	1294	1370	423	1	76	0.0131579
NODE_248_length_4587_cov_14.431150	1294	1370	424	1	76	0.0131579
NODE_248_length_4587_cov_14.431150	1294	1370	428	1	76	0.0131579
NODE_248_length_4587_cov_14.431150	1294	1370	431	1	76	0.0131579
NODE_248_length_4587_cov_14.431150	1294	1370	432	2	76	0.0263158
NODE_248_length_4587_cov_14.431150	1294	1370	434	2	76	0.0263158
NODE_248_length_4587_cov_14.431150	1294	1370	435	1	76	0.0131579
NODE_248_length_4587_cov_14.431150	1294	1370	436	3	76	0.0394737
NODE_248_length_4587_cov_14.431150	1294	1370	437	2	76	0.0263158
NODE_248_length_4587_cov_14.431150	1294	1370	438	4	76	0.0526316
NODE_248_length_4587_cov_14.431150	1294	1370	440	1	76	0.0131579
NODE_248_length_4587_cov_14.431150	1294	1370	441	1	76	0.0131579
NODE_248_length_4587_cov_14.431150	1294	1370	442	2	76	0.0263158
NODE_248_length_4587_cov_14.431150	1294	1370	443	1	76	0.0131579
NODE_248_length_4587_cov_14.431150	1294	1370	444	1	76	0.0131579
NODE_248_length_4587_cov_14.431150	1294	1370	446	1	76	0.0131579
NODE_248_length_4587_cov_14.431150	1294	1370	447	1	76	0.0131579
NODE_248_length_4587_cov_14.431150	1294	1370	451	1	76	0.0131579
NODE_248_length_4587_cov_14.431150	1294	1370	453	4	76	0.0526316
NODE_248_length_4587_cov_14.431150	1294	1370	455	3	76	0.0394737
NODE_248_length_4587_cov_14.431150	1294	1370	460	1	76	0.0131579
NODE_248_length_4587_cov_14.431150	1294	1370	462	1	76	0.0131579
NODE_248_length_4587_cov_14.431150	1294	1370	464	2	76	0.0263158
NODE_248_length_4587_cov_14.431150	1294	1370	468	2	76	0.0263158
NODE_248_length_4587_cov_14.431150	1294	1370	472	3	76	0.0394737
NODE_248_length_4587_cov_14.431150	1294	1370	473	1	76	0.0131579
NODE_248_length_4587_cov_14.431150	1294	1370	474	2	76	0.0263158
NODE_248_length_4587_cov_14.431150	1294	1370	475	1	76	0.0131579
NODE_248_length_4587_cov_14.431150	1294	1370	476	2	76	0.0263158
NODE_248_length_4587_cov_14.431150	1294	1370	477	1	76	0.0131579
NODE_248_length_4587_cov_14.431150	1294	1370	478	1	76	0.0131579
NODE_248_length_4587_cov_14.431150	1347	1427	393	1	80	0.0125000
NODE_248_length_4587_cov_14.431150	1347	1427	395	1	80	0.0125000
NODE_248_length_4587_cov_14.431150	1347	1427	407	1	80	0.0125000
NODE_248_length_4587_cov_14.431150	1347	1427	411	1	80	0.0125000
NODE_248_length_4587_cov_14.431150	1347	1427	414	1	80	0.0125000
NODE_248_length_4587_cov_14.431150	1347	1427	419	1	80	0.0125000
NODE_248_length_4587_cov_14.431150	1347	1427	429	1	80	0.0125000
NODE_248_length_4587_cov_14.431150	1347	1427	430	1	80	0.0125000
NODE_248_length_4587_cov_14.431150	1347	1427	432	2	80	0.0250000
NODE_248_length_4587_cov_14.431150	1347	1427	434	1	80	0.0125000
NODE_248_length_4587_cov_14.431150	1347	1427	436	2	80	0.0250000
NODE_248_length_4587_cov_14.431150	1347	1427	439	2	80	0.0250000
NODE_248_length_4587_cov_14.431150	1347	1427	446	1	80	0.0125000
NODE_248_length_4587_cov_14.431150	1347	1427	451	1	80	0.0125000
NODE_248_length_4587_cov_14.431150	1347	1427	453	3	80	0.0375000
NODE_248_length_4587_cov_14.431150	1347	1427	455	3	80	0.0375000
NODE_248_length_4587_cov_14.431150	1347	1427	460	1	80	0.0125000
NODE_248_length_4587_cov_14.431150	1347	1427	462	3	80	0.0375000
NODE_248_length_4587_cov_14.431150	1347	1427	464	2	80	0.0250000
NODE_248_length_4587_cov_14.431150	1347	1427	466	2	80	0.0250000
NODE_248_length_4587_cov_14.431150	1347	1427	468	4	80	0.0500000
NODE_248_length_4587_cov_14.431150	1347	1427	469	1	80	0.0125000
NODE_248_length_4587_cov_14.431150	1347	1427	470	1	80	0.0125000
NODE_248_length_4587_cov_14.431150	1347	1427	472	7	80	0.0875000
NODE_248_length_4587_cov_14.431150	1347	1427	473	2	80	0.0250000
NODE_248_length_4587_cov_14.431150	1347	1427	474	2	80	0.0250000
NODE_248_length_4587_cov_14.431150	1347	1427	475	1	80	0.0125000
NODE_248_length_4587_cov_14.431150	1347	1427	476	4	80	0.0500000
NODE_248_length_4587_cov_14.431150	1347	1427	477	1	80	0.0125000
NODE_248_length_4587_cov_14.431150	1347	1427	478	1	80	0.0125000
NODE_248_length_4587_cov_14.431150	1347	1427	480	1	80	0.0125000
NODE_248_length_4587_cov_14.431150	1347	1427	481	1	80	0.0125000
NODE_248_length_4587_cov_14.431150	1347	1427	482	1	80	0.0125000
NODE_248_length_4587_cov_14.431150	1347	1427	483	1	80	0.0125000
NODE_248_length_4587_cov_14.431150	1347	1427	484	3	80	0.0375000
NODE_248_length_4587_cov_14.431150	1347	1427	488	1	80	0.0125000
NODE_248_length_4587_cov_14.431150	1347	1427	491	1	80	0.0125000
NODE_248_length_4587_cov_14.431150	1347	1427	493	1	80	0.0125000
NODE_248_length_4587_cov_14.431150	1347	1427	494	1	80	0.0125000
NODE_248_length_4587_cov_14.431150	1347	1427	495	1	80	0.0125000
NODE_248_length_4587_cov_14.431150	1347	1427	497	2	80	0.0250000
NODE_248_length_4587_cov_14.431150	1347	1427	498	2	80	0.0250000
NODE_248_length_4587_cov_14.431150	1347	1427	499	1	80	0.0125000
NODE_248_length_4587_cov_14.431150	1347	1427	500	3	80	0.0375000
NODE_248_length_4587_cov_14.431150	1347	1427	502	1	80	0.0125000
NODE_248_length_4587_cov_14.431150	1347	1427	506	1	80	0.0125000
NODE_248_length_4587_cov_14.431150	1347	1427	508	1	80	0.0125000
NODE_248_length_4587_cov_14.431150	1347	1427	513	1	80	0.0125000
NODE_248_length_4587_cov_14.431150	1347	1427	515	1	80	0.0125000
NODE_248_length_4587_cov_14.431150	1466	1533	140	2	67	0.0298507
NODE_248_length_4587_cov_14.431150	1466	1533	149	1	67	0.0149254
NODE_248_length_4587_cov_14.431150	1466	1533	150	2	67	0.0298507
NODE_248_length_4587_cov_14.431150	1466	1533	152	2	67	0.0298507
NODE_248_length_4587_cov_14.431150	1466	1533	154	2	67	0.0298507
NODE_248_length_4587_cov_14.431150	1466	1533	164	1	67	0.0149254
NODE_248_length_4587_cov_14.431150	1466	1533	165	1	67	0.0149254
NODE_248_length_4587_cov_14.431150	1466	1533	168	2	67	0.0298507
NODE_248_length_4587_cov_14.431150	1466	1533	170	1	67	0.0149254
NODE_248_length_4587_cov_14.431150	1466	1533	172	1	67	0.0149254
NODE_248_length_4587_cov_14.431150	1466	1533	177	3	67	0.0447761
NODE_248_length_4587_cov_14.431150	1466	1533	179	5	67	0.0746269
NODE_248_length_4587_cov_14.431150	1466	1533	181	3	67	0.0447761
NODE_248_length_4587_cov_14.431150	1466	1533	185	1	67	0.0149254
NODE_248_length_4587_cov_14.431150	1466	1533	188	1	67	0.0149254
NODE_248_length_4587_cov_14.431150	1466	1533	191	3	67	0.0447761
NODE_248_length_4587_cov_14.431150	1466	1533	197	1	67	0.0149254
NODE_248_length_4587_cov_14.431150	1466	1533	200	1	67	0.0149254
NODE_248_length_4587_cov_14.431150	1466	1533	206	2	67	0.0298507
NODE_248_length_4587_cov_14.431150	1466	1533	220	1	67	0.0149254
NODE_248_length_4587_cov_14.431150	1466	1533	221	1	67	0.0149254
NODE_248_length_4587_cov_14.431150	1466	1533	229	1	67	0.0149254
NODE_248_length_4587_cov_14.431150	1466	1533	231	1	67	0.0149254
NODE_248_length_4587_cov_14.431150	1466	1533	232	1	67	0.0149254
NODE_248_length_4587_cov_14.431150	1466	1533	234	2	67	0.0298507
NODE_248_length_4587_cov_14.431150	1466	1533	235	2	67	0.0298507
NODE_248_length_4587_cov_14.431150	1466	1533	237	2	67	0.0298507
NODE_248_length_4587_cov_14.431150	1466	1533	238	1	67	0.0149254
NODE_248_length_4587_cov_14.431150	1466	1533	239	1	67	0.0149254
NODE_248_length_4587_cov_14.431150	1466	1533	240	3	67	0.0447761
NODE_248_length_4587_cov_14.431150	1466	1533	241	1	67	0.0149254
NODE_248_length_4587_cov_14.431150	1466	1533	243	3	67	0.0447761
NODE_248_length_4587_cov_14.431150	1466	1533	246	1	67	0.0149254
NODE_248_length_4587_cov_14.431150	1466	1533	247	2	67	0.0298507
NODE_248_length_4587_cov_14.431150	1466	1533	249	3	67	0.0447761
NODE_248_length_4587_cov_14.431150	1466	1533	251	1	67	0.0149254
NODE_248_length_4587_cov_14.431150	1466	1533	254	1	67	0.0149254
NODE_248_length_4587_cov_14.431150	1466	1533	260	1	67	0.0149254
NODE_248_length_4587_cov_14.431150	1466	1533	263	1	67	0.0149254
NODE_248_length_4587_cov_14.431150	1466	1533	268	1	67	0.0149254
NODE_248_length_4587_cov_14.431150	1466	1533	274	1	67	0.0149254
NODE_248_length_4587_cov_14.431150	4316	4382	619	1	66	0.0151515
NODE_248_length_4587_cov_14.431150	4316	4382	638	1	66	0.0151515
NODE_248_length_4587_cov_14.431150	4316	4382	665	1	66	0.0151515
NODE_248_length_4587_cov_14.431150	4316	4382	680	1	66	0.0151515
NODE_248_length_4587_cov_14.431150	4316	4382	685	1	66	0.0151515
NODE_248_length_4587_cov_14.431150	4316	4382	700	1	66	0.0151515
NODE_248_length_4587_cov_14.431150	4316	4382	728	1	66	0.0151515
NODE_248_length_4587_cov_14.431150	4316	4382	736	1	66	0.0151515
NODE_248_length_4587_cov_14.431150	4316	4382	740	1	66	0.0151515
NODE_248_length_4587_cov_14.431150	4316	4382	744	1	66	0.0151515
NODE_248_length_4587_cov_14.431150	4316	4382	749	1	66	0.0151515
NODE_248_length_4587_cov_14.431150	4316	4382	756	1	66	0.0151515
NODE_248_length_4587_cov_14.431150	4316	4382	776	1	66	0.0151515
NODE_248_length_4587_cov_14.431150	4316	4382	825	1	66	0.0151515
NODE_248_length_4587_cov_14.431150	4316	4382	831	1	66	0.0151515
NODE_248_length_4587_cov_14.431150	4316	4382	851	1	66	0.0151515
NODE_248_length_4587_cov_14.431150	4316	4382	865	1	66	0.0151515
NODE_248_length_4587_cov_14.431150	4316	4382	873	1	66	0.0151515
NODE_248_length_4587_cov_14.431150	4316	4382	882	1	66	0.0151515
NODE_248_length_4587_cov_14.431150	4316	4382	897	1	66	0.0151515
NODE_248_length_4587_cov_14.431150	4316	4382	902	1	66	0.0151515
NODE_248_length_4587_cov_14.431150	4316	4382	916	1	66	0.0151515
NODE_248_length_4587_cov_14.431150	4316	4382	927	1	66	0.0151515
NODE_248_length_4587_cov_14.431150	4316	4382	936	1	66	0.0151515
NODE_248_length_4587_cov_14.431150	4316	4382	937	1	66	0.0151515
NODE_248_length_4587_cov_14.431150	4316	4382	942	1	66	0.0151515
NODE_248_length_4587_cov_14.431150	4316	4382	943	1	66	0.0151515
NODE_248_length_4587_cov_14.431150	4316	4382	962	1	66	0.0151515
NODE_248_length_4587_cov_14.431150	4316	4382	971	1	66	0.0151515
NODE_248_length_4587_cov_14.431150	4316	4382	996	1	66	0.0151515
NODE_248_length_4587_cov_14.431150	4316	4382	1002	1	66	0.0151515
NODE_248_length_4587_cov_14.431150	4316	4382	1006	1	66	0.0151515
NODE_248_length_4587_cov_14.431150	4316	4382	1007	1	66	0.0151515
NODE_248_length_4587_cov_14.431150	4316	4382	1014	1	66	0.0151515
NODE_248_length_4587_cov_14.431150	4316	4382	1025	2	66	0.0303030
NODE_248_length_4587_cov_14.431150	4316	4382	1032	1	66	0.0151515
NODE_248_length_4587_cov_14.431150	4316	4382	1037	1	66	0.0151515
NODE_248_length_4587_cov_14.431150	4316	4382	1043	1	66	0.0151515
NODE_248_length_4587_cov_14.431150	4316	4382	1047	1	66	0.0151515
NODE_248_length_4587_cov_14.431150	4316	4382	1049	1	66	0.0151515
NODE_248_length_4587_cov_14.431150	4316	4382	1051	1	66	0.0151515
NODE_248_length_4587_cov_14.431150	4316	4382	1054	1	66	0.0151515
NODE_248_length_4587_cov_14.431150	4316	4382	1056	3	66	0.0454545
NODE_248_length_4587_cov_14.431150	4316	4382	1058	3	66	0.0454545
NODE_248_length_4587_cov_14.431150	4316	4382	1059	1	66	0.0151515
NODE_248_length_4587_cov_14.431150	4316	4382	1076	1	66	0.0151515
NODE_248_length_4587_cov_14.431150	4316	4382	1083	1	66	0.0151515
NODE_248_length_4587_cov_14.431150	4316	4382	1085	1	66	0.0151515
NODE_248_length_4587_cov_14.431150	4316	4382	1089	1	66	0.0151515
NODE_248_length_4587_cov_14.431150	4316	4382	1090	1	66	0.0151515
NODE_248_length_4587_cov_14.431150	4316	4382	1092	1	66	0.0151515
NODE_248_length_4587_cov_14.431150	4316	4382	1094	3	66	0.0454545
NODE_248_length_4587_cov_14.431150	4316	4382	1095	1	66	0.0151515
NODE_248_length_4587_cov_14.431150	4316	4382	1096	2	66	0.0303030
NODE_248_length_4587_cov_14.431150	4316	4382	1097	1	66	0.0151515
NODE_248_length_4587_cov_14.431150	4316	4382	1098	1	66	0.0151515
NODE_248_length_4587_cov_14.431150	4316	4382	1100	2	66	0.0303030
NODE_248_length_4587_cov_14.431150	4355	4435	805	1	80	0.0125000
NODE_248_length_4587_cov_14.431150	4355	4435	810	1	80	0.0125000
NODE_248_length_4587_cov_14.431150	4355	4435	826	1	80	0.0125000
NODE_248_length_4587_cov_14.431150	4355	4435	857	1	80	0.0125000
NODE_248_length_4587_cov_14.431150	4355	4435	871	1	80	0.0125000
NODE_248_length_4587_cov_14.431150	4355	4435	886	1	80	0.0125000
NODE_248_length_4587_cov_14.431150	4355	4435	914	1	80	0.0125000
NODE_248_length_4587_cov_14.431150	4355	4435	922	1	80	0.0125000
NODE_248_length_4587_cov_14.431150	4355	4435	951	1	80	0.0125000
NODE_248_length_4587_cov_14.431150	4355	4435	961	1	80	0.0125000
NODE_248_length_4587_cov_14.431150	4355	4435	965	1	80	0.0125000
NODE_248_length_4587_cov_14.431150	4355	4435	978	1	80	0.0125000
NODE_248_length_4587_cov_14.431150	4355	4435	983	1	80	0.0125000
NODE_248_length_4587_cov_14.431150	4355	4435	997	1	80	0.0125000
NODE_248_length_4587_cov_14.431150	4355	4435	1004	1	80	0.0125000
NODE_248_length_4587_cov_14.431150	4355	4435	1010	1	80	0.0125000
NODE_248_length_4587_cov_14.431150	4355	4435	1014	1	80	0.0125000
NODE_248_length_4587_cov_14.431150	4355	4435	1027	1	80	0.0125000
NODE_248_length_4587_cov_14.431150	4355	4435	1047	1	80	0.0125000
NODE_248_length_4587_cov_14.431150	4355	4435	1049	1	80	0.0125000
NODE_248_length_4587_cov_14.431150	4355	4435	1051	1	80	0.0125000
NODE_248_length_4587_cov_14.431150	4355	4435	1054	1	80	0.0125000
NODE_248_length_4587_cov_14.431150	4355	4435	1056	3	80	0.0375000
NODE_248_length_4587_cov_14.431150	4355	4435	1058	3	80	0.0375000
NODE_248_length_4587_cov_14.431150	4355	4435	1059	1	80	0.0125000
NODE_248_length_4587_cov_14.431150	4355	4435	1063	1	80	0.0125000
NODE_248_length_4587_cov_14.431150	4355	4435	1067	1	80	0.0125000
NODE_248_length_4587_cov_14.431150	4355	4435	1072	2	80	0.0250000
NODE_248_length_4587_cov_14.431150	4355	4435	1076	1	80	0.0125000
NODE_248_length_4587_cov_14.431150	4355	4435	1079	1	80	0.0125000
NODE_248_length_4587_cov_14.431150	4355	4435	1082	1	80	0.0125000
NODE_248_length_4587_cov_14.431150	4355	4435	1083	1	80	0.0125000
NODE_248_length_4587_cov_14.431150	4355	4435	1085	2	80	0.0250000
NODE_248_length_4587_cov_14.431150	4355	4435	1088	1	80	0.0125000
NODE_248_length_4587_cov_14.431150	4355	4435	1089	3	80	0.0375000
NODE_248_length_4587_cov_14.431150	4355	4435	1090	2	80	0.0250000
NODE_248_length_4587_cov_14.431150	4355	4435	1091	1	80	0.0125000
NODE_248_length_4587_cov_14.431150	4355	4435	1092	3	80	0.0375000
NODE_248_length_4587_cov_14.431150	4355	4435	1094	3	80	0.0375000
NODE_248_length_4587_cov_14.431150	4355	4435	1095	1	80	0.0125000
NODE_248_length_4587_cov_14.431150	4355	4435	1096	2	80	0.0250000
NODE_248_length_4587_cov_14.431150	4355	4435	1097	4	80	0.0500000
NODE_248_length_4587_cov_14.431150	4355	4435	1098	1	80	0.0125000
NODE_248_length_4587_cov_14.431150	4355	4435	1099	1	80	0.0125000
NODE_248_length_4587_cov_14.431150	4355	4435	1100	2	80	0.0250000
NODE_248_length_4587_cov_14.431150	4355	4435	1101	2	80	0.0250000
NODE_248_length_4587_cov_14.431150	4355	4435	1102	2	80	0.0250000
NODE_248_length_4587_cov_14.431150	4355	4435	1106	3	80	0.0375000
NODE_248_length_4587_cov_14.431150	4355	4435	1107	1	80	0.0125000
NODE_248_length_4587_cov_14.431150	4355	4435	1108	3	80	0.0375000
NODE_248_length_4587_cov_14.431150	4355	4435	1109	1	80	0.0125000
NODE_248_length_4587_cov_14.431150	4355	4435	1110	3	80	0.0375000
NODE_248_length_4587_cov_14.431150	4355	4435	1111	2	80	0.0250000
NODE_249_length_4572_cov_50.244579	2406	2483	8	6	77	0.0779221
NODE_249_length_4572_cov_50.244579	2406	2483	10	24	77	0.3116883
NODE_249_length_4572_cov_50.244579	2406	2483	12	12	77	0.1558442
NODE_249_length_4572_cov_50.244579	2406	2483	16	22	77	0.2857143
NODE_249_length_4572_cov_50.244579	2406	2483	18	13	77	0.1688312
NODE_249_length_4572_cov_50.244579	2406	2483	8	6	77	0.0779221
NODE_249_length_4572_cov_50.244579	2406	2483	10	24	77	0.3116883
NODE_249_length_4572_cov_50.244579	2406	2483	12	12	77	0.1558442
NODE_249_length_4572_cov_50.244579	2406	2483	16	22	77	0.2857143
NODE_249_length_4572_cov_50.244579	2406	2483	18	13	77	0.1688312
NODE_251_length_4556_cov_14.556652	4229	4288	53	1	59	0.0169492
NODE_251_length_4556_cov_14.556652	4229	4288	55	4	59	0.0677966
NODE_251_length_4556_cov_14.556652	4229	4288	57	1	59	0.0169492
NODE_251_length_4556_cov_14.556652	4229	4288	61	11	59	0.1864407
NODE_251_length_4556_cov_14.556652	4229	4288	63	8	59	0.1355932
NODE_251_length_4556_cov_14.556652	4229	4288	65	15	59	0.2542373
NODE_251_length_4556_cov_14.556652	4229	4288	67	1	59	0.0169492
NODE_251_length_4556_cov_14.556652	4229	4288	72	2	59	0.0338983
NODE_251_length_4556_cov_14.556652	4229	4288	73	2	59	0.0338983
NODE_251_length_4556_cov_14.556652	4229	4288	74	1	59	0.0169492
NODE_251_length_4556_cov_14.556652	4229	4288	75	2	59	0.0338983
NODE_251_length_4556_cov_14.556652	4229	4288	76	1	59	0.0169492
NODE_251_length_4556_cov_14.556652	4229	4288	77	3	59	0.0508475
NODE_251_length_4556_cov_14.556652	4229	4288	78	4	59	0.0677966
NODE_251_length_4556_cov_14.556652	4229	4288	81	3	59	0.0508475
NODE_252_length_4550_cov_5.664120	3548	3628	0	80	80	1.0000000
NODE_252_length_4550_cov_5.664120	3601	3681	0	80	80	1.0000000
NODE_253_length_4544_cov_10.690439	353	433	0	9	80	0.1125000
NODE_253_length_4544_cov_10.690439	353	433	2	71	80	0.8875000
NODE_253_length_4544_cov_10.690439	406	486	0	48	80	0.6000000
NODE_253_length_4544_cov_10.690439	406	486	2	32	80	0.4000000
NODE_253_length_4544_cov_10.690439	4487	4544	0	55	57	0.9649123
NODE_253_length_4544_cov_10.690439	4487	4544	4	2	57	0.0350877
NODE_255_length_4535_cov_24.849188	675	755	0	80	80	1.0000000
NODE_255_length_4535_cov_24.849188	728	809	0	81	81	1.0000000
NODE_255_length_4535_cov_24.849188	1319	1399	0	14	80	0.1750000
NODE_255_length_4535_cov_24.849188	1319	1399	1	18	80	0.2250000
NODE_255_length_4535_cov_24.849188	1319	1399	2	48	80	0.6000000
NODE_255_length_4535_cov_24.849188	1372	1452	0	9	80	0.1125000
NODE_255_length_4535_cov_24.849188	1372	1452	1	25	80	0.3125000
NODE_255_length_4535_cov_24.849188	1372	1452	3	2	80	0.0250000
NODE_255_length_4535_cov_24.849188	1372	1452	4	3	80	0.0375000
NODE_255_length_4535_cov_24.849188	1372	1452	6	6	80	0.0750000
NODE_255_length_4535_cov_24.849188	1372	1452	9	1	80	0.0125000
NODE_255_length_4535_cov_24.849188	1372	1452	14	1	80	0.0125000
NODE_255_length_4535_cov_24.849188	1372	1452	16	1	80	0.0125000
NODE_255_length_4535_cov_24.849188	1372	1452	19	2	80	0.0250000
NODE_255_length_4535_cov_24.849188	1372	1452	25	1	80	0.0125000
NODE_255_length_4535_cov_24.849188	1372	1452	28	1	80	0.0125000
NODE_255_length_4535_cov_24.849188	1372	1452	29	1	80	0.0125000
NODE_255_length_4535_cov_24.849188	1372	1452	31	1	80	0.0125000
NODE_255_length_4535_cov_24.849188	1372	1452	33	3	80	0.0375000
NODE_255_length_4535_cov_24.849188	1372	1452	41	1	80	0.0125000
NODE_255_length_4535_cov_24.849188	1372	1452	42	1	80	0.0125000
NODE_255_length_4535_cov_24.849188	1372	1452	43	1	80	0.0125000
NODE_255_length_4535_cov_24.849188	1372	1452	62	1	80	0.0125000
NODE_255_length_4535_cov_24.849188	1372	1452	66	1	80	0.0125000
NODE_255_length_4535_cov_24.849188	1372	1452	67	1	80	0.0125000
NODE_255_length_4535_cov_24.849188	1372	1452	79	1	80	0.0125000
NODE_255_length_4535_cov_24.849188	1372	1452	83	1	80	0.0125000
NODE_255_length_4535_cov_24.849188	1372	1452	87	1	80	0.0125000
NODE_255_length_4535_cov_24.849188	1372	1452	88	1	80	0.0125000
NODE_255_length_4535_cov_24.849188	1372	1452	94	1	80	0.0125000
NODE_255_length_4535_cov_24.849188	1372	1452	104	1	80	0.0125000
NODE_255_length_4535_cov_24.849188	1372	1452	111	1	80	0.0125000
NODE_255_length_4535_cov_24.849188	1372	1452	114	2	80	0.0250000
NODE_255_length_4535_cov_24.849188	1372	1452	120	2	80	0.0250000
NODE_255_length_4535_cov_24.849188	1372	1452	121	2	80	0.0250000
NODE_255_length_4535_cov_24.849188	1372	1452	124	1	80	0.0125000
NODE_255_length_4535_cov_24.849188	1372	1452	136	1	80	0.0125000
NODE_255_length_4535_cov_24.849188	1372	1452	138	1	80	0.0125000
NODE_255_length_4535_cov_24.849188	1372	1452	141	1	80	0.0125000
NODE_258_length_4528_cov_19.736509	4295	4366	0	67	71	0.9436620
NODE_258_length_4528_cov_19.736509	4295	4366	2	2	71	0.0281690
NODE_258_length_4528_cov_19.736509	4295	4366	4	1	71	0.0140845
NODE_258_length_4528_cov_19.736509	4295	4366	6	1	71	0.0140845
NODE_259_length_4505_cov_10.409215	3166	3202	118	2	36	0.0555556
NODE_259_length_4505_cov_10.409215	3166	3202	120	1	36	0.0277778
NODE_259_length_4505_cov_10.409215	3166	3202	121	1	36	0.0277778
NODE_259_length_4505_cov_10.409215	3166	3202	122	2	36	0.0555556
NODE_259_length_4505_cov_10.409215	3166	3202	127	2	36	0.0555556
NODE_259_length_4505_cov_10.409215	3166	3202	129	7	36	0.1944444
NODE_259_length_4505_cov_10.409215	3166	3202	131	2	36	0.0555556
NODE_259_length_4505_cov_10.409215	3166	3202	133	2	36	0.0555556
NODE_259_length_4505_cov_10.409215	3166	3202	135	2	36	0.0555556
NODE_259_length_4505_cov_10.409215	3166	3202	137	3	36	0.0833333
NODE_259_length_4505_cov_10.409215	3166	3202	138	1	36	0.0277778
NODE_259_length_4505_cov_10.409215	3166	3202	140	1	36	0.0277778
NODE_259_length_4505_cov_10.409215	3166	3202	142	3	36	0.0833333
NODE_259_length_4505_cov_10.409215	3166	3202	143	1	36	0.0277778
NODE_259_length_4505_cov_10.409215	3166	3202	144	2	36	0.0555556
NODE_259_length_4505_cov_10.409215	3166	3202	146	1	36	0.0277778
NODE_259_length_4505_cov_10.409215	3166	3202	147	3	36	0.0833333
NODE_259_length_4505_cov_10.409215	3175	3255	113	1	80	0.0125000
NODE_259_length_4505_cov_10.409215	3175	3255	115	1	80	0.0125000
NODE_259_length_4505_cov_10.409215	3175	3255	116	1	80	0.0125000
NODE_259_length_4505_cov_10.409215	3175	3255	119	1	80	0.0125000
NODE_259_length_4505_cov_10.409215	3175	3255	123	1	80	0.0125000
NODE_259_length_4505_cov_10.409215	3175	3255	125	9	80	0.1125000
NODE_259_length_4505_cov_10.409215	3175	3255	127	4	80	0.0500000
NODE_259_length_4505_cov_10.409215	3175	3255	129	6	80	0.0750000
NODE_259_length_4505_cov_10.409215	3175	3255	131	2	80	0.0250000
NODE_259_length_4505_cov_10.409215	3175	3255	133	2	80	0.0250000
NODE_259_length_4505_cov_10.409215	3175	3255	135	2	80	0.0250000
NODE_259_length_4505_cov_10.409215	3175	3255	137	3	80	0.0375000
NODE_259_length_4505_cov_10.409215	3175	3255	138	1	80	0.0125000
NODE_259_length_4505_cov_10.409215	3175	3255	139	3	80	0.0375000
NODE_259_length_4505_cov_10.409215	3175	3255	140	2	80	0.0250000
NODE_259_length_4505_cov_10.409215	3175	3255	142	5	80	0.0625000
NODE_259_length_4505_cov_10.409215	3175	3255	143	1	80	0.0125000
NODE_259_length_4505_cov_10.409215	3175	3255	144	3	80	0.0375000
NODE_259_length_4505_cov_10.409215	3175	3255	146	4	80	0.0500000
NODE_259_length_4505_cov_10.409215	3175	3255	147	6	80	0.0750000
NODE_259_length_4505_cov_10.409215	3175	3255	148	8	80	0.1000000
NODE_259_length_4505_cov_10.409215	3175	3255	149	6	80	0.0750000
NODE_259_length_4505_cov_10.409215	3175	3255	150	1	80	0.0125000
NODE_259_length_4505_cov_10.409215	3175	3255	151	3	80	0.0375000
NODE_259_length_4505_cov_10.409215	3175	3255	153	4	80	0.0500000
NODE_260_length_4498_cov_8.216185	3161	3219	2	58	58	1.0000000
NODE_260_length_4498_cov_8.216185	4257	4314	0	57	57	1.0000000
NODE_263_length_4476_cov_29.825451	141	215	0	4	74	0.0540541
NODE_263_length_4476_cov_29.825451	141	215	4	1	74	0.0135135
NODE_263_length_4476_cov_29.825451	141	215	6	20	74	0.2702703
NODE_263_length_4476_cov_29.825451	141	215	8	34	74	0.4594595
NODE_263_length_4476_cov_29.825451	141	215	10	4	74	0.0540541
NODE_263_length_4476_cov_29.825451	141	215	12	11	74	0.1486486
NODE_263_length_4476_cov_29.825451	1890	1970	58	3	80	0.0375000
NODE_263_length_4476_cov_29.825451	1890	1970	65	1	80	0.0125000
NODE_263_length_4476_cov_29.825451	1890	1970	67	5	80	0.0625000
NODE_263_length_4476_cov_29.825451	1890	1970	69	3	80	0.0375000
NODE_263_length_4476_cov_29.825451	1890	1970	73	1	80	0.0125000
NODE_263_length_4476_cov_29.825451	1890	1970	77	2	80	0.0250000
NODE_263_length_4476_cov_29.825451	1890	1970	78	1	80	0.0125000
NODE_263_length_4476_cov_29.825451	1890	1970	79	1	80	0.0125000
NODE_263_length_4476_cov_29.825451	1890	1970	83	4	80	0.0500000
NODE_263_length_4476_cov_29.825451	1890	1970	85	2	80	0.0250000
NODE_263_length_4476_cov_29.825451	1890	1970	87	8	80	0.1000000
NODE_263_length_4476_cov_29.825451	1890	1970	89	8	80	0.1000000
NODE_263_length_4476_cov_29.825451	1890	1970	90	2	80	0.0250000
NODE_263_length_4476_cov_29.825451	1890	1970	93	13	80	0.1625000
NODE_263_length_4476_cov_29.825451	1890	1970	94	3	80	0.0375000
NODE_263_length_4476_cov_29.825451	1890	1970	98	3	80	0.0375000
NODE_263_length_4476_cov_29.825451	1890	1970	100	1	80	0.0125000
NODE_263_length_4476_cov_29.825451	1890	1970	102	5	80	0.0625000
NODE_263_length_4476_cov_29.825451	1890	1970	103	2	80	0.0250000
NODE_263_length_4476_cov_29.825451	1890	1970	104	2	80	0.0250000
NODE_263_length_4476_cov_29.825451	1890	1970	105	5	80	0.0625000
NODE_263_length_4476_cov_29.825451	1890	1970	107	2	80	0.0250000
NODE_263_length_4476_cov_29.825451	1890	1970	109	3	80	0.0375000
NODE_263_length_4476_cov_29.825451	1943	2023	39	5	80	0.0625000
NODE_263_length_4476_cov_29.825451	1943	2023	45	2	80	0.0250000
NODE_263_length_4476_cov_29.825451	1943	2023	47	6	80	0.0750000
NODE_263_length_4476_cov_29.825451	1943	2023	48	2	80	0.0250000
NODE_263_length_4476_cov_29.825451	1943	2023	49	1	80	0.0125000
NODE_263_length_4476_cov_29.825451	1943	2023	51	3	80	0.0375000
NODE_263_length_4476_cov_29.825451	1943	2023	55	1	80	0.0125000
NODE_263_length_4476_cov_29.825451	1943	2023	57	1	80	0.0125000
NODE_263_length_4476_cov_29.825451	1943	2023	61	4	80	0.0500000
NODE_263_length_4476_cov_29.825451	1943	2023	63	2	80	0.0250000
NODE_263_length_4476_cov_29.825451	1943	2023	65	5	80	0.0625000
NODE_263_length_4476_cov_29.825451	1943	2023	67	1	80	0.0125000
NODE_263_length_4476_cov_29.825451	1943	2023	71	4	80	0.0500000
NODE_263_length_4476_cov_29.825451	1943	2023	73	2	80	0.0250000
NODE_263_length_4476_cov_29.825451	1943	2023	74	2	80	0.0250000
NODE_263_length_4476_cov_29.825451	1943	2023	75	6	80	0.0750000
NODE_263_length_4476_cov_29.825451	1943	2023	77	2	80	0.0250000
NODE_263_length_4476_cov_29.825451	1943	2023	78	5	80	0.0625000
NODE_263_length_4476_cov_29.825451	1943	2023	90	2	80	0.0250000
NODE_263_length_4476_cov_29.825451	1943	2023	94	1	80	0.0125000
NODE_263_length_4476_cov_29.825451	1943	2023	98	3	80	0.0375000
NODE_263_length_4476_cov_29.825451	1943	2023	100	1	80	0.0125000
NODE_263_length_4476_cov_29.825451	1943	2023	102	5	80	0.0625000
NODE_263_length_4476_cov_29.825451	1943	2023	103	2	80	0.0250000
NODE_263_length_4476_cov_29.825451	1943	2023	104	2	80	0.0250000
NODE_263_length_4476_cov_29.825451	1943	2023	105	5	80	0.0625000
NODE_263_length_4476_cov_29.825451	1943	2023	107	2	80	0.0250000
NODE_263_length_4476_cov_29.825451	1943	2023	109	3	80	0.0375000
NODE_264_length_4474_cov_17.051886	23	99	0	76	76	1.0000000
NODE_264_length_4474_cov_17.051886	23	98	0	75	75	1.0000000
NODE_264_length_4474_cov_17.051886	23	99	0	76	76	1.0000000
NODE_264_length_4474_cov_17.051886	32	99	0	67	67	1.0000000
NODE_264_length_4474_cov_17.051886	76	140	0	64	64	1.0000000
NODE_264_length_4474_cov_17.051886	1528	1569	111	1	41	0.0243902
NODE_264_length_4474_cov_17.051886	1528	1569	112	3	41	0.0731707
NODE_264_length_4474_cov_17.051886	1528	1569	114	2	41	0.0487805
NODE_264_length_4474_cov_17.051886	1528	1569	115	3	41	0.0731707
NODE_264_length_4474_cov_17.051886	1528	1569	117	1	41	0.0243902
NODE_264_length_4474_cov_17.051886	1528	1569	118	1	41	0.0243902
NODE_264_length_4474_cov_17.051886	1528	1569	120	2	41	0.0487805
NODE_264_length_4474_cov_17.051886	1528	1569	124	1	41	0.0243902
NODE_264_length_4474_cov_17.051886	1528	1569	125	1	41	0.0243902
NODE_264_length_4474_cov_17.051886	1528	1569	129	1	41	0.0243902
NODE_264_length_4474_cov_17.051886	1528	1569	130	3	41	0.0731707
NODE_264_length_4474_cov_17.051886	1528	1569	131	1	41	0.0243902
NODE_264_length_4474_cov_17.051886	1528	1569	139	1	41	0.0243902
NODE_264_length_4474_cov_17.051886	1528	1569	147	1	41	0.0243902
NODE_264_length_4474_cov_17.051886	1528	1569	149	2	41	0.0487805
NODE_264_length_4474_cov_17.051886	1528	1569	150	1	41	0.0243902
NODE_264_length_4474_cov_17.051886	1528	1569	151	1	41	0.0243902
NODE_264_length_4474_cov_17.051886	1528	1569	157	1	41	0.0243902
NODE_264_length_4474_cov_17.051886	1528	1569	159	2	41	0.0487805
NODE_264_length_4474_cov_17.051886	1528	1569	161	2	41	0.0487805
NODE_264_length_4474_cov_17.051886	1528	1569	166	1	41	0.0243902
NODE_264_length_4474_cov_17.051886	1528	1569	168	1	41	0.0243902
NODE_264_length_4474_cov_17.051886	1528	1569	170	3	41	0.0731707
NODE_264_length_4474_cov_17.051886	1528	1569	171	3	41	0.0731707
NODE_264_length_4474_cov_17.051886	1528	1569	174	1	41	0.0243902
NODE_264_length_4474_cov_17.051886	1528	1569	178	1	41	0.0243902
NODE_264_length_4474_cov_17.051886	1536	1609	60	1	73	0.0136986
NODE_264_length_4474_cov_17.051886	1536	1609	64	1	73	0.0136986
NODE_264_length_4474_cov_17.051886	1536	1609	66	4	73	0.0547945
NODE_264_length_4474_cov_17.051886	1536	1609	67	1	73	0.0136986
NODE_264_length_4474_cov_17.051886	1536	1609	68	1	73	0.0136986
NODE_264_length_4474_cov_17.051886	1536	1609	70	1	73	0.0136986
NODE_264_length_4474_cov_17.051886	1536	1609	72	2	73	0.0273973
NODE_264_length_4474_cov_17.051886	1536	1609	74	3	73	0.0410959
NODE_264_length_4474_cov_17.051886	1536	1609	76	5	73	0.0684932
NODE_264_length_4474_cov_17.051886	1536	1609	78	2	73	0.0273973
NODE_264_length_4474_cov_17.051886	1536	1609	80	2	73	0.0273973
NODE_264_length_4474_cov_17.051886	1536	1609	83	2	73	0.0273973
NODE_264_length_4474_cov_17.051886	1536	1609	85	2	73	0.0273973
NODE_264_length_4474_cov_17.051886	1536	1609	88	2	73	0.0273973
NODE_264_length_4474_cov_17.051886	1536	1609	90	1	73	0.0136986
NODE_264_length_4474_cov_17.051886	1536	1609	97	1	73	0.0136986
NODE_264_length_4474_cov_17.051886	1536	1609	101	1	73	0.0136986
NODE_264_length_4474_cov_17.051886	1536	1609	104	3	73	0.0410959
NODE_264_length_4474_cov_17.051886	1536	1609	108	1	73	0.0136986
NODE_264_length_4474_cov_17.051886	1536	1609	110	3	73	0.0410959
NODE_264_length_4474_cov_17.051886	1536	1609	111	2	73	0.0273973
NODE_264_length_4474_cov_17.051886	1536	1609	112	3	73	0.0410959
NODE_264_length_4474_cov_17.051886	1536	1609	114	2	73	0.0273973
NODE_264_length_4474_cov_17.051886	1536	1609	115	3	73	0.0410959
NODE_264_length_4474_cov_17.051886	1536	1609	117	1	73	0.0136986
NODE_264_length_4474_cov_17.051886	1536	1609	118	1	73	0.0136986
NODE_264_length_4474_cov_17.051886	1536	1609	120	2	73	0.0273973
NODE_264_length_4474_cov_17.051886	1536	1609	124	1	73	0.0136986
NODE_264_length_4474_cov_17.051886	1536	1609	125	1	73	0.0136986
NODE_264_length_4474_cov_17.051886	1536	1609	129	1	73	0.0136986
NODE_264_length_4474_cov_17.051886	1536	1609	130	3	73	0.0410959
NODE_264_length_4474_cov_17.051886	1536	1609	131	1	73	0.0136986
NODE_264_length_4474_cov_17.051886	1536	1609	139	1	73	0.0136986
NODE_264_length_4474_cov_17.051886	1536	1609	147	1	73	0.0136986
NODE_264_length_4474_cov_17.051886	1536	1609	149	2	73	0.0273973
NODE_264_length_4474_cov_17.051886	1536	1609	150	1	73	0.0136986
NODE_264_length_4474_cov_17.051886	1536	1609	151	1	73	0.0136986
NODE_264_length_4474_cov_17.051886	1536	1609	157	1	73	0.0136986
NODE_264_length_4474_cov_17.051886	1536	1609	159	2	73	0.0273973
NODE_264_length_4474_cov_17.051886	1536	1609	161	2	73	0.0273973
NODE_264_length_4474_cov_17.051886	1536	1609	166	1	73	0.0136986
NODE_264_length_4474_cov_17.051886	1536	1609	170	1	73	0.0136986
NODE_264_length_4474_cov_17.051886	1618	1643	0	18	25	0.7200000
NODE_264_length_4474_cov_17.051886	1618	1643	2	1	25	0.0400000
NODE_264_length_4474_cov_17.051886	1618	1643	8	1	25	0.0400000
NODE_264_length_4474_cov_17.051886	1618	1643	18	1	25	0.0400000
NODE_264_length_4474_cov_17.051886	1618	1643	37	1	25	0.0400000
NODE_264_length_4474_cov_17.051886	1618	1643	41	1	25	0.0400000
NODE_264_length_4474_cov_17.051886	1618	1643	46	2	25	0.0800000
NODE_264_length_4474_cov_17.051886	1618	1696	0	71	78	0.9102564
NODE_264_length_4474_cov_17.051886	1618	1696	2	1	78	0.0128205
NODE_264_length_4474_cov_17.051886	1618	1696	8	1	78	0.0128205
NODE_264_length_4474_cov_17.051886	1618	1696	18	1	78	0.0128205
NODE_264_length_4474_cov_17.051886	1618	1696	37	1	78	0.0128205
NODE_264_length_4474_cov_17.051886	1618	1696	41	1	78	0.0128205
NODE_264_length_4474_cov_17.051886	1618	1696	46	2	78	0.0256410
NODE_265_length_4474_cov_14.441829	282	362	0	80	80	1.0000000
NODE_265_length_4474_cov_14.441829	335	415	0	76	80	0.9500000
NODE_265_length_4474_cov_14.441829	335	415	8	1	80	0.0125000
NODE_265_length_4474_cov_14.441829	335	415	11	1	80	0.0125000
NODE_265_length_4474_cov_14.441829	335	415	27	1	80	0.0125000
NODE_265_length_4474_cov_14.441829	335	415	45	1	80	0.0125000
NODE_265_length_4474_cov_14.441829	1522	1575	2	13	53	0.2452830
NODE_265_length_4474_cov_14.441829	1522	1575	3	4	53	0.0754717
NODE_265_length_4474_cov_14.441829	1522	1575	7	6	53	0.1132075
NODE_265_length_4474_cov_14.441829	1522	1575	10	14	53	0.2641509
NODE_265_length_4474_cov_14.441829	1522	1575	12	2	53	0.0377358
NODE_265_length_4474_cov_14.441829	1522	1575	14	5	53	0.0943396
NODE_265_length_4474_cov_14.441829	1522	1575	18	8	53	0.1509434
NODE_265_length_4474_cov_14.441829	1522	1575	24	1	53	0.0188679
NODE_265_length_4474_cov_14.441829	1548	1623	7	1	75	0.0133333
NODE_265_length_4474_cov_14.441829	1548	1623	10	14	75	0.1866667
NODE_265_length_4474_cov_14.441829	1548	1623	12	2	75	0.0266667
NODE_265_length_4474_cov_14.441829	1548	1623	14	5	75	0.0666667
NODE_265_length_4474_cov_14.441829	1548	1623	18	10	75	0.1333333
NODE_265_length_4474_cov_14.441829	1548	1623	22	6	75	0.0800000
NODE_265_length_4474_cov_14.441829	1548	1623	24	6	75	0.0800000
NODE_265_length_4474_cov_14.441829	1548	1623	30	1	75	0.0133333
NODE_265_length_4474_cov_14.441829	1548	1623	32	1	75	0.0133333
NODE_265_length_4474_cov_14.441829	1548	1623	34	4	75	0.0533333
NODE_265_length_4474_cov_14.441829	1548	1623	36	18	75	0.2400000
NODE_265_length_4474_cov_14.441829	1548	1623	38	1	75	0.0133333
NODE_265_length_4474_cov_14.441829	1548	1623	39	2	75	0.0266667
NODE_265_length_4474_cov_14.441829	1548	1623	43	2	75	0.0266667
NODE_265_length_4474_cov_14.441829	1548	1623	45	2	75	0.0266667
NODE_265_length_4474_cov_14.441829	3068	3121	8	32	53	0.6037736
NODE_265_length_4474_cov_14.441829	3068	3121	9	13	53	0.2452830
NODE_265_length_4474_cov_14.441829	3068	3121	10	4	53	0.0754717
NODE_265_length_4474_cov_14.441829	3068	3121	12	1	53	0.0188679
NODE_265_length_4474_cov_14.441829	3068	3121	14	1	53	0.0188679
NODE_265_length_4474_cov_14.441829	3068	3121	16	2	53	0.0377358
NODE_268_length_4463_cov_7.023144	119	168	0	44	49	0.8979592
NODE_268_length_4463_cov_7.023144	119	168	18	1	49	0.0204082
NODE_268_length_4463_cov_7.023144	119	168	22	4	49	0.0816327
NODE_270_length_4453_cov_16.820395	3383	3463	83	1	80	0.0125000
NODE_270_length_4453_cov_16.820395	3383	3463	88	1	80	0.0125000
NODE_270_length_4453_cov_16.820395	3383	3463	90	1	80	0.0125000
NODE_270_length_4453_cov_16.820395	3383	3463	99	1	80	0.0125000
NODE_270_length_4453_cov_16.820395	3383	3463	100	1	80	0.0125000
NODE_270_length_4453_cov_16.820395	3383	3463	102	1	80	0.0125000
NODE_270_length_4453_cov_16.820395	3383	3463	110	1	80	0.0125000
NODE_270_length_4453_cov_16.820395	3383	3463	114	1	80	0.0125000
NODE_270_length_4453_cov_16.820395	3383	3463	115	1	80	0.0125000
NODE_270_length_4453_cov_16.820395	3383	3463	124	1	80	0.0125000
NODE_270_length_4453_cov_16.820395	3383	3463	127	2	80	0.0250000
NODE_270_length_4453_cov_16.820395	3383	3463	135	1	80	0.0125000
NODE_270_length_4453_cov_16.820395	3383	3463	137	10	80	0.1250000
NODE_270_length_4453_cov_16.820395	3383	3463	142	3	80	0.0375000
NODE_270_length_4453_cov_16.820395	3383	3463	144	1	80	0.0125000
NODE_270_length_4453_cov_16.820395	3383	3463	150	5	80	0.0625000
NODE_270_length_4453_cov_16.820395	3383	3463	151	2	80	0.0250000
NODE_270_length_4453_cov_16.820395	3383	3463	153	5	80	0.0625000
NODE_270_length_4453_cov_16.820395	3383	3463	155	1	80	0.0125000
NODE_270_length_4453_cov_16.820395	3383	3463	157	4	80	0.0500000
NODE_270_length_4453_cov_16.820395	3383	3463	159	2	80	0.0250000
NODE_270_length_4453_cov_16.820395	3383	3463	161	1	80	0.0125000
NODE_270_length_4453_cov_16.820395	3383	3463	162	3	80	0.0375000
NODE_270_length_4453_cov_16.820395	3383	3463	163	3	80	0.0375000
NODE_270_length_4453_cov_16.820395	3383	3463	164	7	80	0.0875000
NODE_270_length_4453_cov_16.820395	3383	3463	165	1	80	0.0125000
NODE_270_length_4453_cov_16.820395	3383	3463	166	3	80	0.0375000
NODE_270_length_4453_cov_16.820395	3383	3463	169	1	80	0.0125000
NODE_270_length_4453_cov_16.820395	3383	3463	175	1	80	0.0125000
NODE_270_length_4453_cov_16.820395	3383	3463	177	1	80	0.0125000
NODE_270_length_4453_cov_16.820395	3383	3463	184	3	80	0.0375000
NODE_270_length_4453_cov_16.820395	3383	3463	185	2	80	0.0250000
NODE_270_length_4453_cov_16.820395	3383	3463	186	1	80	0.0125000
NODE_270_length_4453_cov_16.820395	3383	3463	188	1	80	0.0125000
NODE_270_length_4453_cov_16.820395	3383	3463	189	1	80	0.0125000
NODE_270_length_4453_cov_16.820395	3383	3463	190	2	80	0.0250000
NODE_270_length_4453_cov_16.820395	3383	3463	192	1	80	0.0125000
NODE_270_length_4453_cov_16.820395	3383	3463	194	1	80	0.0125000
NODE_270_length_4453_cov_16.820395	3383	3463	195	1	80	0.0125000
NODE_270_length_4453_cov_16.820395	3436	3496	31	1	60	0.0166667
NODE_270_length_4453_cov_16.820395	3436	3496	37	1	60	0.0166667
NODE_270_length_4453_cov_16.820395	3436	3496	39	3	60	0.0500000
NODE_270_length_4453_cov_16.820395	3436	3496	43	1	60	0.0166667
NODE_270_length_4453_cov_16.820395	3436	3496	47	1	60	0.0166667
NODE_270_length_4453_cov_16.820395	3436	3496	48	1	60	0.0166667
NODE_270_length_4453_cov_16.820395	3436	3496	52	1	60	0.0166667
NODE_270_length_4453_cov_16.820395	3436	3496	56	2	60	0.0333333
NODE_270_length_4453_cov_16.820395	3436	3496	57	2	60	0.0333333
NODE_270_length_4453_cov_16.820395	3436	3496	59	4	60	0.0666667
NODE_270_length_4453_cov_16.820395	3436	3496	61	5	60	0.0833333
NODE_270_length_4453_cov_16.820395	3436	3496	65	2	60	0.0333333
NODE_270_length_4453_cov_16.820395	3436	3496	67	4	60	0.0666667
NODE_270_length_4453_cov_16.820395	3436	3496	73	2	60	0.0333333
NODE_270_length_4453_cov_16.820395	3436	3496	79	2	60	0.0333333
NODE_270_length_4453_cov_16.820395	3436	3496	83	2	60	0.0333333
NODE_270_length_4453_cov_16.820395	3436	3496	88	1	60	0.0166667
NODE_270_length_4453_cov_16.820395	3436	3496	90	1	60	0.0166667
NODE_270_length_4453_cov_16.820395	3436	3496	99	1	60	0.0166667
NODE_270_length_4453_cov_16.820395	3436	3496	100	1	60	0.0166667
NODE_270_length_4453_cov_16.820395	3436	3496	102	1	60	0.0166667
NODE_270_length_4453_cov_16.820395	3436	3496	110	1	60	0.0166667
NODE_270_length_4453_cov_16.820395	3436	3496	114	1	60	0.0166667
NODE_270_length_4453_cov_16.820395	3436	3496	115	1	60	0.0166667
NODE_270_length_4453_cov_16.820395	3436	3496	124	1	60	0.0166667
NODE_270_length_4453_cov_16.820395	3436	3496	127	2	60	0.0333333
NODE_270_length_4453_cov_16.820395	3436	3496	135	1	60	0.0166667
NODE_270_length_4453_cov_16.820395	3436	3496	137	10	60	0.1666667
NODE_270_length_4453_cov_16.820395	3436	3496	142	3	60	0.0500000
NODE_270_length_4453_cov_16.820395	3436	3496	144	1	60	0.0166667
NODE_272_length_4436_cov_31.114595	2807	2871	8	3	64	0.0468750
NODE_272_length_4436_cov_31.114595	2807	2871	12	12	64	0.1875000
NODE_272_length_4436_cov_31.114595	2807	2871	14	9	64	0.1406250
NODE_272_length_4436_cov_31.114595	2807	2871	16	2	64	0.0312500
NODE_272_length_4436_cov_31.114595	2807	2871	18	3	64	0.0468750
NODE_272_length_4436_cov_31.114595	2807	2871	20	1	64	0.0156250
NODE_272_length_4436_cov_31.114595	2807	2871	22	2	64	0.0312500
NODE_272_length_4436_cov_31.114595	2807	2871	24	10	64	0.1562500
NODE_272_length_4436_cov_31.114595	2807	2871	28	21	64	0.3281250
NODE_272_length_4436_cov_31.114595	2807	2871	30	1	64	0.0156250
NODE_272_length_4436_cov_31.114595	2846	2906	0	28	60	0.4666667
NODE_272_length_4436_cov_31.114595	2846	2906	2	1	60	0.0166667
NODE_272_length_4436_cov_31.114595	2846	2906	4	4	60	0.0666667
NODE_272_length_4436_cov_31.114595	2846	2906	6	2	60	0.0333333
NODE_272_length_4436_cov_31.114595	2846	2906	8	3	60	0.0500000
NODE_272_length_4436_cov_31.114595	2846	2906	12	12	60	0.2000000
NODE_272_length_4436_cov_31.114595	2846	2906	14	9	60	0.1500000
NODE_272_length_4436_cov_31.114595	2846	2906	16	1	60	0.0166667
NODE_272_length_4436_cov_31.114595	2846	2898	0	20	52	0.3846154
NODE_272_length_4436_cov_31.114595	2846	2898	2	1	52	0.0192308
NODE_272_length_4436_cov_31.114595	2846	2898	4	4	52	0.0769231
NODE_272_length_4436_cov_31.114595	2846	2898	6	2	52	0.0384615
NODE_272_length_4436_cov_31.114595	2846	2898	8	3	52	0.0576923
NODE_272_length_4436_cov_31.114595	2846	2898	12	12	52	0.2307692
NODE_272_length_4436_cov_31.114595	2846	2898	14	9	52	0.1730769
NODE_272_length_4436_cov_31.114595	2846	2898	16	1	52	0.0192308
NODE_278_length_4391_cov_7.711323	66	141	0	75	75	1.0000000
NODE_278_length_4391_cov_7.711323	119	155	0	31	36	0.8611111
NODE_278_length_4391_cov_7.711323	119	155	2	5	36	0.1388889
NODE_279_length_4385_cov_6.067662	1556	1606	0	3	50	0.0600000
NODE_279_length_4385_cov_6.067662	1556	1606	2	1	50	0.0200000
NODE_279_length_4385_cov_6.067662	1556	1606	10	5	50	0.1000000
NODE_279_length_4385_cov_6.067662	1556	1606	12	1	50	0.0200000
NODE_279_length_4385_cov_6.067662	1556	1606	14	2	50	0.0400000
NODE_279_length_4385_cov_6.067662	1556	1606	16	4	50	0.0800000
NODE_279_length_4385_cov_6.067662	1556	1606	17	8	50	0.1600000
NODE_279_length_4385_cov_6.067662	1556	1606	23	2	50	0.0400000
NODE_279_length_4385_cov_6.067662	1556	1606	24	19	50	0.3800000
NODE_279_length_4385_cov_6.067662	1556	1606	26	3	50	0.0600000
NODE_279_length_4385_cov_6.067662	1556	1606	28	2	50	0.0400000
NODE_286_length_4331_cov_37.938800	1898	1978	12	3	80	0.0375000
NODE_286_length_4331_cov_37.938800	1898	1978	16	8	80	0.1000000
NODE_286_length_4331_cov_37.938800	1898	1978	19	5	80	0.0625000
NODE_286_length_4331_cov_37.938800	1898	1978	20	1	80	0.0125000
NODE_286_length_4331_cov_37.938800	1898	1978	21	1	80	0.0125000
NODE_286_length_4331_cov_37.938800	1898	1978	22	2	80	0.0250000
NODE_286_length_4331_cov_37.938800	1898	1978	23	1	80	0.0125000
NODE_286_length_4331_cov_37.938800	1898	1978	24	3	80	0.0375000
NODE_286_length_4331_cov_37.938800	1898	1978	25	2	80	0.0250000
NODE_286_length_4331_cov_37.938800	1898	1978	26	20	80	0.2500000
NODE_286_length_4331_cov_37.938800	1898	1978	27	9	80	0.1125000
NODE_286_length_4331_cov_37.938800	1898	1978	28	11	80	0.1375000
NODE_286_length_4331_cov_37.938800	1898	1978	32	6	80	0.0750000
NODE_286_length_4331_cov_37.938800	1898	1978	42	1	80	0.0125000
NODE_286_length_4331_cov_37.938800	1898	1978	45	2	80	0.0250000
NODE_286_length_4331_cov_37.938800	1898	1978	47	1	80	0.0125000
NODE_286_length_4331_cov_37.938800	1898	1978	49	4	80	0.0500000
NODE_286_length_4331_cov_37.938800	1951	2031	26	2	80	0.0250000
NODE_286_length_4331_cov_37.938800	1951	2031	28	11	80	0.1375000
NODE_286_length_4331_cov_37.938800	1951	2031	32	6	80	0.0750000
NODE_286_length_4331_cov_37.938800	1951	2031	42	2	80	0.0250000
NODE_286_length_4331_cov_37.938800	1951	2031	45	3	80	0.0375000
NODE_286_length_4331_cov_37.938800	1951	2031	47	3	80	0.0375000
NODE_286_length_4331_cov_37.938800	1951	2031	49	10	80	0.1250000
NODE_286_length_4331_cov_37.938800	1951	2031	53	11	80	0.1375000
NODE_286_length_4331_cov_37.938800	1951	2031	55	9	80	0.1125000
NODE_286_length_4331_cov_37.938800	1951	2031	69	1	80	0.0125000
NODE_286_length_4331_cov_37.938800	1951	2031	71	5	80	0.0625000
NODE_286_length_4331_cov_37.938800	1951	2031	75	1	80	0.0125000
NODE_286_length_4331_cov_37.938800	1951	2031	79	1	80	0.0125000
NODE_286_length_4331_cov_37.938800	1951	2031	83	1	80	0.0125000
NODE_286_length_4331_cov_37.938800	1951	2031	85	4	80	0.0500000
NODE_286_length_4331_cov_37.938800	1951	2031	89	3	80	0.0375000
NODE_286_length_4331_cov_37.938800	1951	2031	91	5	80	0.0625000
NODE_286_length_4331_cov_37.938800	1951	2031	93	2	80	0.0250000
NODE_286_length_4331_cov_37.938800	2027	2107	91	2	80	0.0250000
NODE_286_length_4331_cov_37.938800	2027	2107	93	3	80	0.0375000
NODE_286_length_4331_cov_37.938800	2027	2107	101	1	80	0.0125000
NODE_286_length_4331_cov_37.938800	2027	2107	109	1	80	0.0125000
NODE_286_length_4331_cov_37.938800	2027	2107	110	1	80	0.0125000
NODE_286_length_4331_cov_37.938800	2027	2107	118	3	80	0.0375000
NODE_286_length_4331_cov_37.938800	2027	2107	122	3	80	0.0375000
NODE_286_length_4331_cov_37.938800	2027	2107	124	2	80	0.0250000
NODE_286_length_4331_cov_37.938800	2027	2107	128	6	80	0.0750000
NODE_286_length_4331_cov_37.938800	2027	2107	130	1	80	0.0125000
NODE_286_length_4331_cov_37.938800	2027	2107	137	2	80	0.0250000
NODE_286_length_4331_cov_37.938800	2027	2107	141	3	80	0.0375000
NODE_286_length_4331_cov_37.938800	2027	2107	143	1	80	0.0125000
NODE_286_length_4331_cov_37.938800	2027	2107	156	1	80	0.0125000
NODE_286_length_4331_cov_37.938800	2027	2107	157	1	80	0.0125000
NODE_286_length_4331_cov_37.938800	2027	2107	165	1	80	0.0125000
NODE_286_length_4331_cov_37.938800	2027	2107	167	1	80	0.0125000
NODE_286_length_4331_cov_37.938800	2027	2107	176	1	80	0.0125000
NODE_286_length_4331_cov_37.938800	2027	2107	177	4	80	0.0500000
NODE_286_length_4331_cov_37.938800	2027	2107	179	3	80	0.0375000
NODE_286_length_4331_cov_37.938800	2027	2107	191	1	80	0.0125000
NODE_286_length_4331_cov_37.938800	2027	2107	193	7	80	0.0875000
NODE_286_length_4331_cov_37.938800	2027	2107	194	2	80	0.0250000
NODE_286_length_4331_cov_37.938800	2027	2107	195	1	80	0.0125000
NODE_286_length_4331_cov_37.938800	2027	2107	197	1	80	0.0125000
NODE_286_length_4331_cov_37.938800	2027	2107	199	4	80	0.0500000
NODE_286_length_4331_cov_37.938800	2027	2107	201	4	80	0.0500000
NODE_286_length_4331_cov_37.938800	2027	2107	205	1	80	0.0125000
NODE_286_length_4331_cov_37.938800	2027	2107	208	4	80	0.0500000
NODE_286_length_4331_cov_37.938800	2027	2107	216	2	80	0.0250000
NODE_286_length_4331_cov_37.938800	2027	2107	217	1	80	0.0125000
NODE_286_length_4331_cov_37.938800	2027	2107	218	1	80	0.0125000
NODE_286_length_4331_cov_37.938800	2027	2107	220	4	80	0.0500000
NODE_286_length_4331_cov_37.938800	2027	2107	226	1	80	0.0125000
NODE_286_length_4331_cov_37.938800	2027	2107	228	3	80	0.0375000
NODE_286_length_4331_cov_37.938800	2027	2107	234	2	80	0.0250000
NODE_286_length_4331_cov_37.938800	2080	2160	120	1	80	0.0125000
NODE_286_length_4331_cov_37.938800	2080	2160	122	1	80	0.0125000
NODE_286_length_4331_cov_37.938800	2080	2160	126	1	80	0.0125000
NODE_286_length_4331_cov_37.938800	2080	2160	128	1	80	0.0125000
NODE_286_length_4331_cov_37.938800	2080	2160	135	1	80	0.0125000
NODE_286_length_4331_cov_37.938800	2080	2160	142	1	80	0.0125000
NODE_286_length_4331_cov_37.938800	2080	2160	144	2	80	0.0250000
NODE_286_length_4331_cov_37.938800	2080	2160	146	1	80	0.0125000
NODE_286_length_4331_cov_37.938800	2080	2160	156	1	80	0.0125000
NODE_286_length_4331_cov_37.938800	2080	2160	157	1	80	0.0125000
NODE_286_length_4331_cov_37.938800	2080	2160	167	2	80	0.0250000
NODE_286_length_4331_cov_37.938800	2080	2160	171	3	80	0.0375000
NODE_286_length_4331_cov_37.938800	2080	2160	175	1	80	0.0125000
NODE_286_length_4331_cov_37.938800	2080	2160	179	1	80	0.0125000
NODE_286_length_4331_cov_37.938800	2080	2160	190	1	80	0.0125000
NODE_286_length_4331_cov_37.938800	2080	2160	191	3	80	0.0375000
NODE_286_length_4331_cov_37.938800	2080	2160	194	2	80	0.0250000
NODE_286_length_4331_cov_37.938800	2080	2160	196	1	80	0.0125000
NODE_286_length_4331_cov_37.938800	2080	2160	197	1	80	0.0125000
NODE_286_length_4331_cov_37.938800	2080	2160	199	4	80	0.0500000
NODE_286_length_4331_cov_37.938800	2080	2160	201	1	80	0.0125000
NODE_286_length_4331_cov_37.938800	2080	2160	204	3	80	0.0375000
NODE_286_length_4331_cov_37.938800	2080	2160	205	1	80	0.0125000
NODE_286_length_4331_cov_37.938800	2080	2160	206	1	80	0.0125000
NODE_286_length_4331_cov_37.938800	2080	2160	207	2	80	0.0250000
NODE_286_length_4331_cov_37.938800	2080	2160	208	4	80	0.0500000
NODE_286_length_4331_cov_37.938800	2080	2160	209	1	80	0.0125000
NODE_286_length_4331_cov_37.938800	2080	2160	216	2	80	0.0250000
NODE_286_length_4331_cov_37.938800	2080	2160	217	5	80	0.0625000
NODE_286_length_4331_cov_37.938800	2080	2160	218	1	80	0.0125000
NODE_286_length_4331_cov_37.938800	2080	2160	219	2	80	0.0250000
NODE_286_length_4331_cov_37.938800	2080	2160	220	4	80	0.0500000
NODE_286_length_4331_cov_37.938800	2080	2160	221	1	80	0.0125000
NODE_286_length_4331_cov_37.938800	2080	2160	225	1	80	0.0125000
NODE_286_length_4331_cov_37.938800	2080	2160	226	3	80	0.0375000
NODE_286_length_4331_cov_37.938800	2080	2160	228	3	80	0.0375000
NODE_286_length_4331_cov_37.938800	2080	2160	232	1	80	0.0125000
NODE_286_length_4331_cov_37.938800	2080	2160	233	1	80	0.0125000
NODE_286_length_4331_cov_37.938800	2080	2160	234	10	80	0.1250000
NODE_286_length_4331_cov_37.938800	2080	2160	235	3	80	0.0375000
NODE_289_length_4320_cov_7.680881	442	522	0	16	80	0.2000000
NODE_289_length_4320_cov_7.680881	442	522	1	22	80	0.2750000
NODE_289_length_4320_cov_7.680881	442	522	2	42	80	0.5250000
NODE_289_length_4320_cov_7.680881	495	575	0	69	80	0.8625000
NODE_289_length_4320_cov_7.680881	495	575	2	11	80	0.1375000
NODE_289_length_4320_cov_7.680881	571	651	0	80	80	1.0000000
NODE_289_length_4320_cov_7.680881	624	704	0	80	80	1.0000000
NODE_290_length_4314_cov_5.311507	1436	1516	2	21	80	0.2625000
NODE_290_length_4314_cov_5.311507	1436	1516	4	23	80	0.2875000
NODE_290_length_4314_cov_5.311507	1436	1516	5	1	80	0.0125000
NODE_290_length_4314_cov_5.311507	1436	1516	6	35	80	0.4375000
NODE_290_length_4314_cov_5.311507	1489	1569	2	23	80	0.2875000
NODE_290_length_4314_cov_5.311507	1489	1569	4	32	80	0.4000000
NODE_290_length_4314_cov_5.311507	1489	1569	6	25	80	0.3125000
NODE_290_length_4314_cov_5.311507	3331	3400	0	69	69	1.0000000
NODE_290_length_4314_cov_5.311507	3420	3482	0	20	62	0.3225806
NODE_290_length_4314_cov_5.311507	3420	3482	4	42	62	0.6774194
NODE_292_length_4311_cov_8.733381	92	171	24	3	79	0.0379747
NODE_292_length_4311_cov_8.733381	92	171	28	6	79	0.0759494
NODE_292_length_4311_cov_8.733381	92	171	30	24	79	0.3037975
NODE_292_length_4311_cov_8.733381	92	171	32	14	79	0.1772152
NODE_292_length_4311_cov_8.733381	92	171	34	10	79	0.1265823
NODE_292_length_4311_cov_8.733381	92	171	36	9	79	0.1139240
NODE_292_length_4311_cov_8.733381	92	171	37	2	79	0.0253165
NODE_292_length_4311_cov_8.733381	92	171	38	11	79	0.1392405
NODE_292_length_4311_cov_8.733381	1925	2005	0	19	80	0.2375000
NODE_292_length_4311_cov_8.733381	1925	2005	2	5	80	0.0625000
NODE_292_length_4311_cov_8.733381	1925	2005	4	56	80	0.7000000
NODE_292_length_4311_cov_8.733381	1978	2058	0	7	80	0.0875000
NODE_292_length_4311_cov_8.733381	1978	2058	2	25	80	0.3125000
NODE_292_length_4311_cov_8.733381	1978	2058	4	48	80	0.6000000
NODE_294_length_4293_cov_3.809251	244	326	2	82	82	1.0000000
NODE_294_length_4293_cov_3.809251	301	394	0	47	93	0.5053763
NODE_294_length_4293_cov_3.809251	301	394	2	46	93	0.4946237
NODE_295_length_4284_cov_15.940263	3726	3806	0	80	80	1.0000000
NODE_295_length_4284_cov_15.940263	3779	3858	0	79	79	1.0000000
NODE_299_length_4277_cov_5.451173	3818	3898	2	27	80	0.3375000
NODE_299_length_4277_cov_5.451173	3818	3898	4	42	80	0.5250000
NODE_299_length_4277_cov_5.451173	3818	3898	6	8	80	0.1000000
NODE_299_length_4277_cov_5.451173	3818	3898	8	3	80	0.0375000
NODE_299_length_4277_cov_5.451173	3927	3995	6	12	68	0.1764706
NODE_299_length_4277_cov_5.451173	3927	3995	8	56	68	0.8235294
NODE_299_length_4277_cov_5.451173	3968	4048	0	8	80	0.1000000
NODE_299_length_4277_cov_5.451173	3968	4048	2	36	80	0.4500000
NODE_299_length_4277_cov_5.451173	3968	4048	4	7	80	0.0875000
NODE_299_length_4277_cov_5.451173	3968	4048	6	14	80	0.1750000
NODE_299_length_4277_cov_5.451173	3968	4048	8	15	80	0.1875000
NODE_300_length_4274_cov_18.943234	591	671	0	80	80	1.0000000
NODE_300_length_4274_cov_18.943234	644	724	0	80	80	1.0000000
NODE_301_length_4274_cov_16.160958	416	496	0	40	80	0.5000000
NODE_301_length_4274_cov_16.160958	416	496	2	4	80	0.0500000
NODE_301_length_4274_cov_16.160958	416	496	3	6	80	0.0750000
NODE_301_length_4274_cov_16.160958	416	496	9	30	80	0.3750000
NODE_301_length_4274_cov_16.160958	1034	1114	0	80	80	1.0000000
NODE_301_length_4274_cov_16.160958	1087	1167	0	80	80	1.0000000
NODE_301_length_4274_cov_16.160958	1163	1243	0	80	80	1.0000000
NODE_301_length_4274_cov_16.160958	1216	1296	0	80	80	1.0000000
NODE_301_length_4274_cov_16.160958	3411	3491	0	1	80	0.0125000
NODE_301_length_4274_cov_16.160958	3411	3491	2	1	80	0.0125000
NODE_301_length_4274_cov_16.160958	3411	3491	4	21	80	0.2625000
NODE_301_length_4274_cov_16.160958	3411	3491	6	7	80	0.0875000
NODE_301_length_4274_cov_16.160958	3411	3491	11	5	80	0.0625000
NODE_301_length_4274_cov_16.160958	3411	3491	13	12	80	0.1500000
NODE_301_length_4274_cov_16.160958	3411	3491	15	17	80	0.2125000
NODE_301_length_4274_cov_16.160958	3411	3491	17	1	80	0.0125000
NODE_301_length_4274_cov_16.160958	3411	3491	18	4	80	0.0500000
NODE_301_length_4274_cov_16.160958	3411	3491	20	11	80	0.1375000
NODE_302_length_4270_cov_14.045792	3835	3915	233	1	80	0.0125000
NODE_302_length_4270_cov_14.045792	3835	3915	235	1	80	0.0125000
NODE_302_length_4270_cov_14.045792	3835	3915	236	1	80	0.0125000
NODE_302_length_4270_cov_14.045792	3835	3915	238	4	80	0.0500000
NODE_302_length_4270_cov_14.045792	3835	3915	240	1	80	0.0125000
NODE_302_length_4270_cov_14.045792	3835	3915	244	1	80	0.0125000
NODE_302_length_4270_cov_14.045792	3835	3915	246	1	80	0.0125000
NODE_302_length_4270_cov_14.045792	3835	3915	248	1	80	0.0125000
NODE_302_length_4270_cov_14.045792	3835	3915	250	1	80	0.0125000
NODE_302_length_4270_cov_14.045792	3835	3915	251	1	80	0.0125000
NODE_302_length_4270_cov_14.045792	3835	3915	252	1	80	0.0125000
NODE_302_length_4270_cov_14.045792	3835	3915	257	1	80	0.0125000
NODE_302_length_4270_cov_14.045792	3835	3915	259	1	80	0.0125000
NODE_302_length_4270_cov_14.045792	3835	3915	265	2	80	0.0250000
NODE_302_length_4270_cov_14.045792	3835	3915	268	1	80	0.0125000
NODE_302_length_4270_cov_14.045792	3835	3915	269	2	80	0.0250000
NODE_302_length_4270_cov_14.045792	3835	3915	271	1	80	0.0125000
NODE_302_length_4270_cov_14.045792	3835	3915	272	3	80	0.0375000
NODE_302_length_4270_cov_14.045792	3835	3915	273	6	80	0.0750000
NODE_302_length_4270_cov_14.045792	3835	3915	274	1	80	0.0125000
NODE_302_length_4270_cov_14.045792	3835	3915	275	3	80	0.0375000
NODE_302_length_4270_cov_14.045792	3835	3915	276	2	80	0.0250000
NODE_302_length_4270_cov_14.045792	3835	3915	277	5	80	0.0625000
NODE_302_length_4270_cov_14.045792	3835	3915	278	7	80	0.0875000
NODE_302_length_4270_cov_14.045792	3835	3915	279	5	80	0.0625000
NODE_302_length_4270_cov_14.045792	3835	3915	280	2	80	0.0250000
NODE_302_length_4270_cov_14.045792	3835	3915	281	3	80	0.0375000
NODE_302_length_4270_cov_14.045792	3835	3915	282	1	80	0.0125000
NODE_302_length_4270_cov_14.045792	3835	3915	283	1	80	0.0125000
NODE_302_length_4270_cov_14.045792	3835	3915	284	2	80	0.0250000
NODE_302_length_4270_cov_14.045792	3835	3915	285	5	80	0.0625000
NODE_302_length_4270_cov_14.045792	3835	3915	286	5	80	0.0625000
NODE_302_length_4270_cov_14.045792	3835	3915	287	4	80	0.0500000
NODE_302_length_4270_cov_14.045792	3835	3915	288	2	80	0.0250000
NODE_302_length_4270_cov_14.045792	3835	3915	289	1	80	0.0125000
NODE_302_length_4270_cov_14.045792	3888	3968	200	2	80	0.0250000
NODE_302_length_4270_cov_14.045792	3888	3968	202	2	80	0.0250000
NODE_302_length_4270_cov_14.045792	3888	3968	203	3	80	0.0375000
NODE_302_length_4270_cov_14.045792	3888	3968	204	3	80	0.0375000
NODE_302_length_4270_cov_14.045792	3888	3968	205	2	80	0.0250000
NODE_302_length_4270_cov_14.045792	3888	3968	207	2	80	0.0250000
NODE_302_length_4270_cov_14.045792	3888	3968	209	1	80	0.0125000
NODE_302_length_4270_cov_14.045792	3888	3968	210	4	80	0.0500000
NODE_302_length_4270_cov_14.045792	3888	3968	211	2	80	0.0250000
NODE_302_length_4270_cov_14.045792	3888	3968	212	3	80	0.0375000
NODE_302_length_4270_cov_14.045792	3888	3968	213	1	80	0.0125000
NODE_302_length_4270_cov_14.045792	3888	3968	215	2	80	0.0250000
NODE_302_length_4270_cov_14.045792	3888	3968	217	1	80	0.0125000
NODE_302_length_4270_cov_14.045792	3888	3968	228	1	80	0.0125000
NODE_302_length_4270_cov_14.045792	3888	3968	236	1	80	0.0125000
NODE_302_length_4270_cov_14.045792	3888	3968	241	1	80	0.0125000
NODE_302_length_4270_cov_14.045792	3888	3968	245	2	80	0.0250000
NODE_302_length_4270_cov_14.045792	3888	3968	247	1	80	0.0125000
NODE_302_length_4270_cov_14.045792	3888	3968	252	2	80	0.0250000
NODE_302_length_4270_cov_14.045792	3888	3968	254	1	80	0.0125000
NODE_302_length_4270_cov_14.045792	3888	3968	256	1	80	0.0125000
NODE_302_length_4270_cov_14.045792	3888	3968	263	1	80	0.0125000
NODE_302_length_4270_cov_14.045792	3888	3968	264	1	80	0.0125000
NODE_302_length_4270_cov_14.045792	3888	3968	266	1	80	0.0125000
NODE_302_length_4270_cov_14.045792	3888	3968	268	1	80	0.0125000
NODE_302_length_4270_cov_14.045792	3888	3968	269	1	80	0.0125000
NODE_302_length_4270_cov_14.045792	3888	3968	277	2	80	0.0250000
NODE_302_length_4270_cov_14.045792	3888	3968	279	4	80	0.0500000
NODE_302_length_4270_cov_14.045792	3888	3968	280	2	80	0.0250000
NODE_302_length_4270_cov_14.045792	3888	3968	281	7	80	0.0875000
NODE_302_length_4270_cov_14.045792	3888	3968	283	3	80	0.0375000
NODE_302_length_4270_cov_14.045792	3888	3968	284	2	80	0.0250000
NODE_302_length_4270_cov_14.045792	3888	3968	285	5	80	0.0625000
NODE_302_length_4270_cov_14.045792	3888	3968	286	5	80	0.0625000
NODE_302_length_4270_cov_14.045792	3888	3968	287	4	80	0.0500000
NODE_302_length_4270_cov_14.045792	3888	3968	288	2	80	0.0250000
NODE_302_length_4270_cov_14.045792	3888	3968	289	1	80	0.0125000
NODE_303_length_4260_cov_24.780822	244	311	32	10	67	0.1492537
NODE_303_length_4260_cov_24.780822	244	311	36	2	67	0.0298507
NODE_303_length_4260_cov_24.780822	244	311	52	1	67	0.0149254
NODE_303_length_4260_cov_24.780822	244	311	54	27	67	0.4029851
NODE_303_length_4260_cov_24.780822	244	311	56	2	67	0.0298507
NODE_303_length_4260_cov_24.780822	244	311	60	7	67	0.1044776
NODE_303_length_4260_cov_24.780822	244	311	63	13	67	0.1940299
NODE_303_length_4260_cov_24.780822	244	311	64	4	67	0.0597015
NODE_303_length_4260_cov_24.780822	244	311	65	1	67	0.0149254
NODE_303_length_4260_cov_24.780822	244	311	32	10	67	0.1492537
NODE_303_length_4260_cov_24.780822	244	311	36	2	67	0.0298507
NODE_303_length_4260_cov_24.780822	244	311	52	1	67	0.0149254
NODE_303_length_4260_cov_24.780822	244	311	54	27	67	0.4029851
NODE_303_length_4260_cov_24.780822	244	311	56	2	67	0.0298507
NODE_303_length_4260_cov_24.780822	244	311	60	7	67	0.1044776
NODE_303_length_4260_cov_24.780822	244	311	63	13	67	0.1940299
NODE_303_length_4260_cov_24.780822	244	311	64	4	67	0.0597015
NODE_303_length_4260_cov_24.780822	244	311	65	1	67	0.0149254
NODE_303_length_4260_cov_24.780822	263	311	32	10	48	0.2083333
NODE_303_length_4260_cov_24.780822	263	311	36	2	48	0.0416667
NODE_303_length_4260_cov_24.780822	263	311	52	1	48	0.0208333
NODE_303_length_4260_cov_24.780822	263	311	54	8	48	0.1666667
NODE_303_length_4260_cov_24.780822	263	311	56	2	48	0.0416667
NODE_303_length_4260_cov_24.780822	263	311	60	7	48	0.1458333
NODE_303_length_4260_cov_24.780822	263	311	63	13	48	0.2708333
NODE_303_length_4260_cov_24.780822	263	311	64	4	48	0.0833333
NODE_303_length_4260_cov_24.780822	263	311	65	1	48	0.0208333
NODE_303_length_4260_cov_24.780822	1605	1633	6	5	28	0.1785714
NODE_303_length_4260_cov_24.780822	1605	1633	7	1	28	0.0357143
NODE_303_length_4260_cov_24.780822	1605	1633	8	2	28	0.0714286
NODE_303_length_4260_cov_24.780822	1605	1633	9	1	28	0.0357143
NODE_303_length_4260_cov_24.780822	1605	1633	12	3	28	0.1071429
NODE_303_length_4260_cov_24.780822	1605	1633	14	7	28	0.2500000
NODE_303_length_4260_cov_24.780822	1605	1633	18	8	28	0.2857143
NODE_303_length_4260_cov_24.780822	1605	1633	30	1	28	0.0357143
NODE_303_length_4260_cov_24.780822	1660	1699	32	2	39	0.0512821
NODE_303_length_4260_cov_24.780822	1660	1699	34	2	39	0.0512821
NODE_303_length_4260_cov_24.780822	1660	1699	36	1	39	0.0256410
NODE_303_length_4260_cov_24.780822	1660	1699	42	1	39	0.0256410
NODE_303_length_4260_cov_24.780822	1660	1699	44	3	39	0.0769231
NODE_303_length_4260_cov_24.780822	1660	1699	46	1	39	0.0256410
NODE_303_length_4260_cov_24.780822	1660	1699	48	9	39	0.2307692
NODE_303_length_4260_cov_24.780822	1660	1699	54	1	39	0.0256410
NODE_303_length_4260_cov_24.780822	1660	1699	58	3	39	0.0769231
NODE_303_length_4260_cov_24.780822	1660	1699	60	6	39	0.1538462
NODE_303_length_4260_cov_24.780822	1660	1699	62	10	39	0.2564103
NODE_310_length_4207_cov_6.923564	3664	3722	10	1	58	0.0172414
NODE_310_length_4207_cov_6.923564	3664	3722	12	2	58	0.0344828
NODE_310_length_4207_cov_6.923564	3664	3722	13	1	58	0.0172414
NODE_310_length_4207_cov_6.923564	3664	3722	14	15	58	0.2586207
NODE_310_length_4207_cov_6.923564	3664	3722	16	4	58	0.0689655
NODE_310_length_4207_cov_6.923564	3664	3722	18	3	58	0.0517241
NODE_310_length_4207_cov_6.923564	3664	3722	19	9	58	0.1551724
NODE_310_length_4207_cov_6.923564	3664	3722	20	23	58	0.3965517
NODE_310_length_4207_cov_6.923564	3695	3775	4	1	80	0.0125000
NODE_310_length_4207_cov_6.923564	3695	3775	5	1	80	0.0125000
NODE_310_length_4207_cov_6.923564	3695	3775	6	31	80	0.3875000
NODE_310_length_4207_cov_6.923564	3695	3775	8	2	80	0.0250000
NODE_310_length_4207_cov_6.923564	3695	3775	10	19	80	0.2375000
NODE_310_length_4207_cov_6.923564	3695	3775	12	2	80	0.0250000
NODE_310_length_4207_cov_6.923564	3695	3775	13	1	80	0.0125000
NODE_310_length_4207_cov_6.923564	3695	3775	14	15	80	0.1875000
NODE_310_length_4207_cov_6.923564	3695	3775	16	4	80	0.0500000
NODE_310_length_4207_cov_6.923564	3695	3775	20	4	80	0.0500000
NODE_311_length_4205_cov_6.121042	592	632	4	21	40	0.5250000
NODE_311_length_4205_cov_6.121042	592	632	6	19	40	0.4750000
NODE_311_length_4205_cov_6.121042	605	685	0	8	80	0.1000000
NODE_311_length_4205_cov_6.121042	605	685	2	2	80	0.0250000
NODE_311_length_4205_cov_6.121042	605	685	4	18	80	0.2250000
NODE_311_length_4205_cov_6.121042	605	685	6	52	80	0.6500000
NODE_311_length_4205_cov_6.121042	681	745	0	64	64	1.0000000
NODE_312_length_4196_cov_4.170857	340	420	7	21	80	0.2625000
NODE_312_length_4196_cov_4.170857	340	420	8	36	80	0.4500000
NODE_312_length_4196_cov_4.170857	340	420	10	15	80	0.1875000
NODE_312_length_4196_cov_4.170857	340	420	11	8	80	0.1000000
NODE_312_length_4196_cov_4.170857	393	473	3	7	80	0.0875000
NODE_312_length_4196_cov_4.170857	393	473	5	36	80	0.4500000
NODE_312_length_4196_cov_4.170857	393	473	7	31	80	0.3875000
NODE_312_length_4196_cov_4.170857	393	473	8	6	80	0.0750000
NODE_316_length_4179_cov_6.655882	1	65	10	1	64	0.0156250
NODE_316_length_4179_cov_6.655882	1	65	12	1	64	0.0156250
NODE_316_length_4179_cov_6.655882	1	65	14	1	64	0.0156250
NODE_316_length_4179_cov_6.655882	1	65	16	1	64	0.0156250
NODE_316_length_4179_cov_6.655882	1	65	18	10	64	0.1562500
NODE_316_length_4179_cov_6.655882	1	65	20	4	64	0.0625000
NODE_316_length_4179_cov_6.655882	1	65	22	1	64	0.0156250
NODE_316_length_4179_cov_6.655882	1	65	24	6	64	0.0937500
NODE_316_length_4179_cov_6.655882	1	65	26	8	64	0.1250000
NODE_316_length_4179_cov_6.655882	1	65	28	2	64	0.0312500
NODE_316_length_4179_cov_6.655882	1	65	30	5	64	0.0781250
NODE_316_length_4179_cov_6.655882	1	65	32	24	64	0.3750000
NODE_316_length_4179_cov_6.655882	1087	1140	0	10	53	0.1886792
NODE_316_length_4179_cov_6.655882	1087	1140	2	43	53	0.8113208
NODE_316_length_4179_cov_6.655882	1818	1898	6	3	80	0.0375000
NODE_316_length_4179_cov_6.655882	1818	1898	8	65	80	0.8125000
NODE_316_length_4179_cov_6.655882	1818	1898	10	12	80	0.1500000
NODE_319_length_4150_cov_10.600099	2827	2849	18	1	22	0.0454545
NODE_319_length_4150_cov_10.600099	2827	2849	20	1	22	0.0454545
NODE_319_length_4150_cov_10.600099	2827	2849	26	11	22	0.5000000
NODE_319_length_4150_cov_10.600099	2827	2849	28	9	22	0.4090909
NODE_319_length_4150_cov_10.600099	2973	3053	0	42	80	0.5250000
NODE_319_length_4150_cov_10.600099	2973	3053	2	38	80	0.4750000
NODE_319_length_4150_cov_10.600099	3026	3106	0	11	80	0.1375000
NODE_319_length_4150_cov_10.600099	3026	3106	2	69	80	0.8625000
NODE_324_length_4119_cov_27.984328	2818	2898	128	1	80	0.0125000
NODE_324_length_4119_cov_27.984328	2818	2898	130	4	80	0.0500000
NODE_324_length_4119_cov_27.984328	2818	2898	131	4	80	0.0500000
NODE_324_length_4119_cov_27.984328	2818	2898	133	2	80	0.0250000
NODE_324_length_4119_cov_27.984328	2818	2898	135	1	80	0.0125000
NODE_324_length_4119_cov_27.984328	2818	2898	137	1	80	0.0125000
NODE_324_length_4119_cov_27.984328	2818	2898	140	1	80	0.0125000
NODE_324_length_4119_cov_27.984328	2818	2898	150	2	80	0.0250000
NODE_324_length_4119_cov_27.984328	2818	2898	155	1	80	0.0125000
NODE_324_length_4119_cov_27.984328	2818	2898	158	3	80	0.0375000
NODE_324_length_4119_cov_27.984328	2818	2898	163	5	80	0.0625000
NODE_324_length_4119_cov_27.984328	2818	2898	164	1	80	0.0125000
NODE_324_length_4119_cov_27.984328	2818	2898	166	5	80	0.0625000
NODE_324_length_4119_cov_27.984328	2818	2898	167	2	80	0.0250000
NODE_324_length_4119_cov_27.984328	2818	2898	169	1	80	0.0125000
NODE_324_length_4119_cov_27.984328	2818	2898	170	1	80	0.0125000
NODE_324_length_4119_cov_27.984328	2818	2898	171	3	80	0.0375000
NODE_324_length_4119_cov_27.984328	2818	2898	172	1	80	0.0125000
NODE_324_length_4119_cov_27.984328	2818	2898	173	2	80	0.0250000
NODE_324_length_4119_cov_27.984328	2818	2898	174	1	80	0.0125000
NODE_324_length_4119_cov_27.984328	2818	2898	175	3	80	0.0375000
NODE_324_length_4119_cov_27.984328	2818	2898	177	1	80	0.0125000
NODE_324_length_4119_cov_27.984328	2818	2898	179	2	80	0.0250000
NODE_324_length_4119_cov_27.984328	2818	2898	180	2	80	0.0250000
NODE_324_length_4119_cov_27.984328	2818	2898	182	5	80	0.0625000
NODE_324_length_4119_cov_27.984328	2818	2898	183	1	80	0.0125000
NODE_324_length_4119_cov_27.984328	2818	2898	184	3	80	0.0375000
NODE_324_length_4119_cov_27.984328	2818	2898	187	1	80	0.0125000
NODE_324_length_4119_cov_27.984328	2818	2898	188	1	80	0.0125000
NODE_324_length_4119_cov_27.984328	2818	2898	190	3	80	0.0375000
NODE_324_length_4119_cov_27.984328	2818	2898	192	3	80	0.0375000
NODE_324_length_4119_cov_27.984328	2818	2898	195	3	80	0.0375000
NODE_324_length_4119_cov_27.984328	2818	2898	197	2	80	0.0250000
NODE_324_length_4119_cov_27.984328	2818	2898	198	1	80	0.0125000
NODE_324_length_4119_cov_27.984328	2818	2898	200	7	80	0.0875000
NODE_325_length_4108_cov_14.755550	378	422	0	4	44	0.0909091
NODE_325_length_4108_cov_14.755550	378	422	1	40	44	0.9090909
NODE_325_length_4108_cov_14.755550	3537	3617	0	15	80	0.1875000
NODE_325_length_4108_cov_14.755550	3537	3617	4	7	80	0.0875000
NODE_325_length_4108_cov_14.755550	3537	3617	8	2	80	0.0250000
NODE_325_length_4108_cov_14.755550	3537	3617	10	12	80	0.1500000
NODE_325_length_4108_cov_14.755550	3537	3617	12	29	80	0.3625000
NODE_325_length_4108_cov_14.755550	3537	3617	14	15	80	0.1875000
NODE_325_length_4108_cov_14.755550	3590	3670	2	19	80	0.2375000
NODE_325_length_4108_cov_14.755550	3590	3670	5	1	80	0.0125000
NODE_325_length_4108_cov_14.755550	3590	3670	6	2	80	0.0250000
NODE_325_length_4108_cov_14.755550	3590	3670	8	5	80	0.0625000
NODE_325_length_4108_cov_14.755550	3590	3670	12	33	80	0.4125000
NODE_325_length_4108_cov_14.755550	3590	3670	14	20	80	0.2500000
NODE_326_length_4107_cov_1.855539	207	287	0	14	80	0.1750000
NODE_326_length_4107_cov_1.855539	207	287	2	66	80	0.8250000
NODE_328_length_4096_cov_31.197648	379	459	0	64	80	0.8000000
NODE_328_length_4096_cov_31.197648	379	459	2	16	80	0.2000000
NODE_328_length_4096_cov_31.197648	432	512	0	11	80	0.1375000
NODE_328_length_4096_cov_31.197648	432	512	2	69	80	0.8625000
NODE_328_length_4096_cov_31.197648	3305	3385	0	80	80	1.0000000
NODE_328_length_4096_cov_31.197648	3358	3438	0	80	80	1.0000000
NODE_329_length_4081_cov_20.248870	3673	3753	2	80	80	1.0000000
NODE_329_length_4081_cov_20.248870	3726	3806	0	31	80	0.3875000
NODE_329_length_4081_cov_20.248870	3726	3806	1	15	80	0.1875000
NODE_329_length_4081_cov_20.248870	3726	3806	2	34	80	0.4250000
NODE_330_length_4076_cov_15.138044	1062	1142	2	80	80	1.0000000
NODE_330_length_4076_cov_15.138044	1115	1195	0	45	80	0.5625000
NODE_330_length_4076_cov_15.138044	1115	1195	2	35	80	0.4375000
NODE_331_length_4069_cov_14.261209	3871	3936	0	3	65	0.0461538
NODE_331_length_4069_cov_14.261209	3871	3936	2	62	65	0.9538462
NODE_333_length_4050_cov_31.044039	1703	1783	0	3	80	0.0375000
NODE_333_length_4050_cov_31.044039	1703	1783	1	49	80	0.6125000
NODE_333_length_4050_cov_31.044039	1703	1783	2	28	80	0.3500000
NODE_335_length_4021_cov_34.619072	379	459	2	80	80	1.0000000
NODE_335_length_4021_cov_34.619072	432	512	0	52	80	0.6500000
NODE_335_length_4021_cov_34.619072	432	512	2	28	80	0.3500000
NODE_336_length_4020_cov_5.130834	3455	3535	0	80	80	1.0000000
NODE_336_length_4020_cov_5.130834	3508	3588	0	80	80	1.0000000
NODE_339_length_4004_cov_9.718054	387	467	0	80	80	1.0000000
NODE_339_length_4004_cov_9.718054	440	520	0	80	80	1.0000000
NODE_339_length_4004_cov_9.718054	516	596	0	42	80	0.5250000
NODE_339_length_4004_cov_9.718054	516	596	4	38	80	0.4750000
NODE_339_length_4004_cov_9.718054	569	649	4	80	80	1.0000000
NODE_341_length_3991_cov_18.617934	867	947	0	80	80	1.0000000
NODE_341_length_3991_cov_18.617934	920	1000	0	80	80	1.0000000
NODE_341_length_3991_cov_18.617934	996	1076	0	80	80	1.0000000
NODE_341_length_3991_cov_18.617934	1049	1124	0	74	75	0.9866667
NODE_341_length_3991_cov_18.617934	1049	1124	2	1	75	0.0133333
NODE_348_length_3973_cov_6.906298	17	65	0	47	48	0.9791667
NODE_348_length_3973_cov_6.906298	17	65	4	1	48	0.0208333
NODE_348_length_3973_cov_6.906298	1945	1995	11	3	50	0.0600000
NODE_348_length_3973_cov_6.906298	1945	1995	12	8	50	0.1600000
NODE_348_length_3973_cov_6.906298	1945	1995	22	2	50	0.0400000
NODE_348_length_3973_cov_6.906298	1945	1995	24	31	50	0.6200000
NODE_348_length_3973_cov_6.906298	1945	1995	26	2	50	0.0400000
NODE_348_length_3973_cov_6.906298	1945	1995	28	4	50	0.0800000
NODE_350_length_3960_cov_6.246827	2673	2761	0	84	88	0.9545454
NODE_350_length_3960_cov_6.246827	2673	2761	2	1	88	0.0113636
NODE_350_length_3960_cov_6.246827	2673	2761	4	3	88	0.0340909
NODE_350_length_3960_cov_6.246827	3520	3600	7	60	80	0.7500000
NODE_350_length_3960_cov_6.246827	3520	3600	8	2	80	0.0250000
NODE_350_length_3960_cov_6.246827	3520	3600	9	18	80	0.2250000
NODE_350_length_3960_cov_6.246827	3573	3653	0	27	80	0.3375000
NODE_350_length_3960_cov_6.246827	3573	3653	7	53	80	0.6625000
NODE_353_length_3952_cov_8.805346	826	906	0	29	80	0.3625000
NODE_353_length_3952_cov_8.805346	826	906	2	21	80	0.2625000
NODE_353_length_3952_cov_8.805346	826	906	4	30	80	0.3750000
NODE_353_length_3952_cov_8.805346	879	959	0	20	80	0.2500000
NODE_353_length_3952_cov_8.805346	879	959	2	24	80	0.3000000
NODE_353_length_3952_cov_8.805346	879	959	4	36	80	0.4500000
NODE_354_length_3928_cov_5.936798	2440	2521	2	36	81	0.4444444
NODE_354_length_3928_cov_5.936798	2440	2521	4	45	81	0.5555556
NODE_354_length_3928_cov_5.936798	2493	2574	2	74	81	0.9135802
NODE_354_length_3928_cov_5.936798	2493	2574	4	7	81	0.0864198
NODE_356_length_3923_cov_14.807793	3759	3800	0	14	41	0.3414634
NODE_356_length_3923_cov_14.807793	3759	3800	2	27	41	0.6585366
NODE_358_length_3922_cov_7.609731	1493	1573	67	1	80	0.0125000
NODE_358_length_3922_cov_7.609731	1493	1573	68	4	80	0.0500000
NODE_358_length_3922_cov_7.609731	1493	1573	70	5	80	0.0625000
NODE_358_length_3922_cov_7.609731	1493	1573	71	2	80	0.0250000
NODE_358_length_3922_cov_7.609731	1493	1573	72	2	80	0.0250000
NODE_358_length_3922_cov_7.609731	1493	1573	76	1	80	0.0125000
NODE_358_length_3922_cov_7.609731	1493	1573	80	4	80	0.0500000
NODE_358_length_3922_cov_7.609731	1493	1573	81	1	80	0.0125000
NODE_358_length_3922_cov_7.609731	1493	1573	82	4	80	0.0500000
NODE_358_length_3922_cov_7.609731	1493	1573	84	3	80	0.0375000
NODE_358_length_3922_cov_7.609731	1493	1573	86	4	80	0.0500000
NODE_358_length_3922_cov_7.609731	1493	1573	88	12	80	0.1500000
NODE_358_length_3922_cov_7.609731	1493	1573	90	1	80	0.0125000
NODE_358_length_3922_cov_7.609731	1493	1573	92	5	80	0.0625000
NODE_358_length_3922_cov_7.609731	1493	1573	97	1	80	0.0125000
NODE_358_length_3922_cov_7.609731	1493	1573	98	3	80	0.0375000
NODE_358_length_3922_cov_7.609731	1493	1573	99	1	80	0.0125000
NODE_358_length_3922_cov_7.609731	1493	1573	100	12	80	0.1500000
NODE_358_length_3922_cov_7.609731	1493	1573	102	1	80	0.0125000
NODE_358_length_3922_cov_7.609731	1493	1573	104	7	80	0.0875000
NODE_358_length_3922_cov_7.609731	1493	1573	106	6	80	0.0750000
NODE_358_length_3922_cov_7.609731	1546	1600	89	1	54	0.0185185
NODE_358_length_3922_cov_7.609731	1546	1600	90	2	54	0.0370370
NODE_358_length_3922_cov_7.609731	1546	1600	91	9	54	0.1666667
NODE_358_length_3922_cov_7.609731	1546	1600	92	1	54	0.0185185
NODE_358_length_3922_cov_7.609731	1546	1600	94	2	54	0.0370370
NODE_358_length_3922_cov_7.609731	1546	1600	95	2	54	0.0370370
NODE_358_length_3922_cov_7.609731	1546	1600	96	1	54	0.0185185
NODE_358_length_3922_cov_7.609731	1546	1600	97	1	54	0.0185185
NODE_358_length_3922_cov_7.609731	1546	1600	98	7	54	0.1296296
NODE_358_length_3922_cov_7.609731	1546	1600	99	2	54	0.0370370
NODE_358_length_3922_cov_7.609731	1546	1600	100	12	54	0.2222222
NODE_358_length_3922_cov_7.609731	1546	1600	102	1	54	0.0185185
NODE_358_length_3922_cov_7.609731	1546	1600	104	7	54	0.1296296
NODE_358_length_3922_cov_7.609731	1546	1600	106	6	54	0.1111111
NODE_359_length_3921_cov_9.943223	2936	3016	218	1	80	0.0125000
NODE_359_length_3921_cov_9.943223	2936	3016	220	1	80	0.0125000
NODE_359_length_3921_cov_9.943223	2936	3016	222	2	80	0.0250000
NODE_359_length_3921_cov_9.943223	2936	3016	223	1	80	0.0125000
NODE_359_length_3921_cov_9.943223	2936	3016	229	1	80	0.0125000
NODE_359_length_3921_cov_9.943223	2936	3016	231	2	80	0.0250000
NODE_359_length_3921_cov_9.943223	2936	3016	237	2	80	0.0250000
NODE_359_length_3921_cov_9.943223	2936	3016	239	1	80	0.0125000
NODE_359_length_3921_cov_9.943223	2936	3016	241	1	80	0.0125000
NODE_359_length_3921_cov_9.943223	2936	3016	242	1	80	0.0125000
NODE_359_length_3921_cov_9.943223	2936	3016	243	2	80	0.0250000
NODE_359_length_3921_cov_9.943223	2936	3016	245	3	80	0.0375000
NODE_359_length_3921_cov_9.943223	2936	3016	247	1	80	0.0125000
NODE_359_length_3921_cov_9.943223	2936	3016	248	2	80	0.0250000
NODE_359_length_3921_cov_9.943223	2936	3016	249	1	80	0.0125000
NODE_359_length_3921_cov_9.943223	2936	3016	250	2	80	0.0250000
NODE_359_length_3921_cov_9.943223	2936	3016	251	1	80	0.0125000
NODE_359_length_3921_cov_9.943223	2936	3016	252	1	80	0.0125000
NODE_359_length_3921_cov_9.943223	2936	3016	259	1	80	0.0125000
NODE_359_length_3921_cov_9.943223	2936	3016	263	2	80	0.0250000
NODE_359_length_3921_cov_9.943223	2936	3016	265	1	80	0.0125000
NODE_359_length_3921_cov_9.943223	2936	3016	273	1	80	0.0125000
NODE_359_length_3921_cov_9.943223	2936	3016	276	1	80	0.0125000
NODE_359_length_3921_cov_9.943223	2936	3016	278	1	80	0.0125000
NODE_359_length_3921_cov_9.943223	2936	3016	286	1	80	0.0125000
NODE_359_length_3921_cov_9.943223	2936	3016	292	1	80	0.0125000
NODE_359_length_3921_cov_9.943223	2936	3016	294	1	80	0.0125000
NODE_359_length_3921_cov_9.943223	2936	3016	295	1	80	0.0125000
NODE_359_length_3921_cov_9.943223	2936	3016	297	2	80	0.0250000
NODE_359_length_3921_cov_9.943223	2936	3016	299	1	80	0.0125000
NODE_359_length_3921_cov_9.943223	2936	3016	301	2	80	0.0250000
NODE_359_length_3921_cov_9.943223	2936	3016	308	1	80	0.0125000
NODE_359_length_3921_cov_9.943223	2936	3016	310	1	80	0.0125000
NODE_359_length_3921_cov_9.943223	2936	3016	311	1	80	0.0125000
NODE_359_length_3921_cov_9.943223	2936	3016	314	2	80	0.0250000
NODE_359_length_3921_cov_9.943223	2936	3016	316	1	80	0.0125000
NODE_359_length_3921_cov_9.943223	2936	3016	318	2	80	0.0250000
NODE_359_length_3921_cov_9.943223	2936	3016	320	1	80	0.0125000
NODE_359_length_3921_cov_9.943223	2936	3016	322	1	80	0.0125000
NODE_359_length_3921_cov_9.943223	2936	3016	323	1	80	0.0125000
NODE_359_length_3921_cov_9.943223	2936	3016	324	6	80	0.0750000
NODE_359_length_3921_cov_9.943223	2936	3016	325	1	80	0.0125000
NODE_359_length_3921_cov_9.943223	2936	3016	326	2	80	0.0250000
NODE_359_length_3921_cov_9.943223	2936	3016	327	2	80	0.0250000
NODE_359_length_3921_cov_9.943223	2936	3016	328	2	80	0.0250000
NODE_359_length_3921_cov_9.943223	2936	3016	329	5	80	0.0625000
NODE_359_length_3921_cov_9.943223	2936	3016	330	4	80	0.0500000
NODE_359_length_3921_cov_9.943223	2936	3016	331	1	80	0.0125000
NODE_359_length_3921_cov_9.943223	2936	3016	332	1	80	0.0125000
NODE_359_length_3921_cov_9.943223	2936	3016	333	1	80	0.0125000
NODE_359_length_3921_cov_9.943223	2936	3016	335	1	80	0.0125000
NODE_359_length_3921_cov_9.943223	2936	3016	338	1	80	0.0125000
NODE_359_length_3921_cov_9.943223	2989	3057	231	1	68	0.0147059
NODE_359_length_3921_cov_9.943223	2989	3057	233	3	68	0.0441176
NODE_359_length_3921_cov_9.943223	2989	3057	234	2	68	0.0294118
NODE_359_length_3921_cov_9.943223	2989	3057	235	1	68	0.0147059
NODE_359_length_3921_cov_9.943223	2989	3057	236	1	68	0.0147059
NODE_359_length_3921_cov_9.943223	2989	3057	237	3	68	0.0441176
NODE_359_length_3921_cov_9.943223	2989	3057	238	1	68	0.0147059
NODE_359_length_3921_cov_9.943223	2989	3057	239	1	68	0.0147059
NODE_359_length_3921_cov_9.943223	2989	3057	240	1	68	0.0147059
NODE_359_length_3921_cov_9.943223	2989	3057	248	1	68	0.0147059
NODE_359_length_3921_cov_9.943223	2989	3057	257	1	68	0.0147059
NODE_359_length_3921_cov_9.943223	2989	3057	261	1	68	0.0147059
NODE_359_length_3921_cov_9.943223	2989	3057	263	1	68	0.0147059
NODE_359_length_3921_cov_9.943223	2989	3057	273	2	68	0.0294118
NODE_359_length_3921_cov_9.943223	2989	3057	285	1	68	0.0147059
NODE_359_length_3921_cov_9.943223	2989	3057	287	2	68	0.0294118
NODE_359_length_3921_cov_9.943223	2989	3057	288	1	68	0.0147059
NODE_359_length_3921_cov_9.943223	2989	3057	289	1	68	0.0147059
NODE_359_length_3921_cov_9.943223	2989	3057	290	1	68	0.0147059
NODE_359_length_3921_cov_9.943223	2989	3057	296	1	68	0.0147059
NODE_359_length_3921_cov_9.943223	2989	3057	308	1	68	0.0147059
NODE_359_length_3921_cov_9.943223	2989	3057	310	1	68	0.0147059
NODE_359_length_3921_cov_9.943223	2989	3057	312	1	68	0.0147059
NODE_359_length_3921_cov_9.943223	2989	3057	314	2	68	0.0294118
NODE_359_length_3921_cov_9.943223	2989	3057	315	1	68	0.0147059
NODE_359_length_3921_cov_9.943223	2989	3057	316	1	68	0.0147059
NODE_359_length_3921_cov_9.943223	2989	3057	317	2	68	0.0294118
NODE_359_length_3921_cov_9.943223	2989	3057	318	3	68	0.0441176
NODE_359_length_3921_cov_9.943223	2989	3057	320	1	68	0.0147059
NODE_359_length_3921_cov_9.943223	2989	3057	321	1	68	0.0147059
NODE_359_length_3921_cov_9.943223	2989	3057	322	1	68	0.0147059
NODE_359_length_3921_cov_9.943223	2989	3057	323	1	68	0.0147059
NODE_359_length_3921_cov_9.943223	2989	3057	324	2	68	0.0294118
NODE_359_length_3921_cov_9.943223	2989	3057	325	3	68	0.0441176
NODE_359_length_3921_cov_9.943223	2989	3057	326	2	68	0.0294118
NODE_359_length_3921_cov_9.943223	2989	3057	327	2	68	0.0294118
NODE_359_length_3921_cov_9.943223	2989	3057	328	2	68	0.0294118
NODE_359_length_3921_cov_9.943223	2989	3057	329	5	68	0.0735294
NODE_359_length_3921_cov_9.943223	2989	3057	330	4	68	0.0588235
NODE_359_length_3921_cov_9.943223	2989	3057	331	1	68	0.0147059
NODE_359_length_3921_cov_9.943223	2989	3057	332	1	68	0.0147059
NODE_359_length_3921_cov_9.943223	2989	3057	333	1	68	0.0147059
NODE_359_length_3921_cov_9.943223	2989	3057	335	1	68	0.0147059
NODE_359_length_3921_cov_9.943223	2989	3057	338	1	68	0.0147059
NODE_359_length_3921_cov_9.943223	3047	3066	202	1	19	0.0526316
NODE_359_length_3921_cov_9.943223	3047	3066	209	1	19	0.0526316
NODE_359_length_3921_cov_9.943223	3047	3066	215	1	19	0.0526316
NODE_359_length_3921_cov_9.943223	3047	3066	216	1	19	0.0526316
NODE_359_length_3921_cov_9.943223	3047	3066	221	1	19	0.0526316
NODE_359_length_3921_cov_9.943223	3047	3066	223	1	19	0.0526316
NODE_359_length_3921_cov_9.943223	3047	3066	227	1	19	0.0526316
NODE_359_length_3921_cov_9.943223	3047	3066	231	1	19	0.0526316
NODE_359_length_3921_cov_9.943223	3047	3066	233	3	19	0.1578947
NODE_359_length_3921_cov_9.943223	3047	3066	234	2	19	0.1052632
NODE_359_length_3921_cov_9.943223	3047	3066	236	2	19	0.1052632
NODE_359_length_3921_cov_9.943223	3047	3066	237	2	19	0.1052632
NODE_359_length_3921_cov_9.943223	3047	3066	238	1	19	0.0526316
NODE_359_length_3921_cov_9.943223	3047	3066	240	1	19	0.0526316
NODE_363_length_3898_cov_40.033167	3296	3370	20	2	74	0.0270270
NODE_363_length_3898_cov_40.033167	3296	3370	22	1	74	0.0135135
NODE_363_length_3898_cov_40.033167	3296	3370	30	1	74	0.0135135
NODE_363_length_3898_cov_40.033167	3296	3370	32	3	74	0.0405405
NODE_363_length_3898_cov_40.033167	3296	3370	34	4	74	0.0540541
NODE_363_length_3898_cov_40.033167	3296	3370	38	2	74	0.0270270
NODE_363_length_3898_cov_40.033167	3296	3370	39	9	74	0.1216216
NODE_363_length_3898_cov_40.033167	3296	3370	40	1	74	0.0135135
NODE_363_length_3898_cov_40.033167	3296	3370	42	11	74	0.1486486
NODE_363_length_3898_cov_40.033167	3296	3370	43	3	74	0.0405405
NODE_363_length_3898_cov_40.033167	3296	3370	44	37	74	0.5000000
NODE_363_length_3898_cov_40.033167	3539	3619	10	2	80	0.0250000
NODE_363_length_3898_cov_40.033167	3539	3619	12	9	80	0.1125000
NODE_363_length_3898_cov_40.033167	3539	3619	16	23	80	0.2875000
NODE_363_length_3898_cov_40.033167	3539	3619	17	1	80	0.0125000
NODE_363_length_3898_cov_40.033167	3539	3619	18	25	80	0.3125000
NODE_363_length_3898_cov_40.033167	3539	3619	19	4	80	0.0500000
NODE_363_length_3898_cov_40.033167	3539	3619	20	14	80	0.1750000
NODE_363_length_3898_cov_40.033167	3539	3619	21	2	80	0.0250000
NODE_364_length_3898_cov_7.550145	668	748	0	25	80	0.3125000
NODE_364_length_3898_cov_7.550145	668	748	2	29	80	0.3625000
NODE_364_length_3898_cov_7.550145	668	748	6	26	80	0.3250000
NODE_364_length_3898_cov_7.550145	721	801	2	1	80	0.0125000
NODE_364_length_3898_cov_7.550145	721	801	6	33	80	0.4125000
NODE_364_length_3898_cov_7.550145	721	801	10	23	80	0.2875000
NODE_364_length_3898_cov_7.550145	721	801	12	18	80	0.2250000
NODE_364_length_3898_cov_7.550145	721	801	21	1	80	0.0125000
NODE_364_length_3898_cov_7.550145	721	801	23	1	80	0.0125000
NODE_364_length_3898_cov_7.550145	721	801	27	1	80	0.0125000
NODE_364_length_3898_cov_7.550145	721	801	28	1	80	0.0125000
NODE_364_length_3898_cov_7.550145	721	801	30	1	80	0.0125000
NODE_367_length_3882_cov_4.166006	3244	3324	0	4	80	0.0500000
NODE_367_length_3882_cov_4.166006	3244	3324	10	23	80	0.2875000
NODE_367_length_3882_cov_4.166006	3244	3324	12	53	80	0.6625000
NODE_367_length_3882_cov_4.166006	3282	3324	0	4	42	0.0952381
NODE_367_length_3882_cov_4.166006	3282	3324	10	23	42	0.5476190
NODE_367_length_3882_cov_4.166006	3282	3324	12	15	42	0.3571429
NODE_367_length_3882_cov_4.166006	3297	3377	0	29	80	0.3625000
NODE_367_length_3882_cov_4.166006	3297	3377	2	28	80	0.3500000
NODE_367_length_3882_cov_4.166006	3297	3377	10	23	80	0.2875000
NODE_367_length_3882_cov_4.166006	3297	3377	0	29	80	0.3625000
NODE_367_length_3882_cov_4.166006	3297	3377	2	28	80	0.3500000
NODE_367_length_3882_cov_4.166006	3297	3377	10	23	80	0.2875000
NODE_367_length_3882_cov_4.166006	3373	3450	0	25	77	0.3246753
NODE_367_length_3882_cov_4.166006	3373	3450	2	52	77	0.6753247
NODE_374_length_3853_cov_18.816196	524	579	4	55	55	1.0000000
NODE_374_length_3853_cov_18.816196	559	639	0	16	80	0.2000000
NODE_374_length_3853_cov_18.816196	559	639	2	41	80	0.5125000
NODE_374_length_3853_cov_18.816196	559	639	4	23	80	0.2875000
NODE_379_length_3829_cov_12.697319	515	595	0	19	80	0.2375000
NODE_379_length_3829_cov_12.697319	515	595	2	61	80	0.7625000
NODE_379_length_3829_cov_12.697319	568	648	0	17	80	0.2125000
NODE_379_length_3829_cov_12.697319	568	648	2	63	80	0.7875000
NODE_379_length_3829_cov_12.697319	644	724	0	80	80	1.0000000
NODE_379_length_3829_cov_12.697319	697	777	0	80	80	1.0000000
NODE_381_length_3815_cov_17.218784	399	479	7	15	80	0.1875000
NODE_381_length_3815_cov_17.218784	399	479	14	12	80	0.1500000
NODE_381_length_3815_cov_17.218784	399	479	15	34	80	0.4250000
NODE_381_length_3815_cov_17.218784	399	479	16	19	80	0.2375000
NODE_381_length_3815_cov_17.218784	452	532	0	20	80	0.2500000
NODE_381_length_3815_cov_17.218784	452	532	7	1	80	0.0125000
NODE_381_length_3815_cov_17.218784	452	532	8	6	80	0.0750000
NODE_381_length_3815_cov_17.218784	452	532	14	37	80	0.4625000
NODE_381_length_3815_cov_17.218784	452	532	16	16	80	0.2000000
NODE_383_length_3812_cov_65.007272	840	903	46	1	63	0.0158730
NODE_383_length_3812_cov_65.007272	840	903	64	1	63	0.0158730
NODE_383_length_3812_cov_65.007272	840	903	73	1	63	0.0158730
NODE_383_length_3812_cov_65.007272	840	903	77	1	63	0.0158730
NODE_383_length_3812_cov_65.007272	840	903	85	1	63	0.0158730
NODE_383_length_3812_cov_65.007272	840	903	105	1	63	0.0158730
NODE_383_length_3812_cov_65.007272	840	903	110	1	63	0.0158730
NODE_383_length_3812_cov_65.007272	840	903	113	1	63	0.0158730
NODE_383_length_3812_cov_65.007272	840	903	117	1	63	0.0158730
NODE_383_length_3812_cov_65.007272	840	903	126	1	63	0.0158730
NODE_383_length_3812_cov_65.007272	840	903	129	1	63	0.0158730
NODE_383_length_3812_cov_65.007272	840	903	134	1	63	0.0158730
NODE_383_length_3812_cov_65.007272	840	903	144	1	63	0.0158730
NODE_383_length_3812_cov_65.007272	840	903	149	2	63	0.0317460
NODE_383_length_3812_cov_65.007272	840	903	160	1	63	0.0158730
NODE_383_length_3812_cov_65.007272	840	903	164	1	63	0.0158730
NODE_383_length_3812_cov_65.007272	840	903	166	1	63	0.0158730
NODE_383_length_3812_cov_65.007272	840	903	170	1	63	0.0158730
NODE_383_length_3812_cov_65.007272	840	903	176	1	63	0.0158730
NODE_383_length_3812_cov_65.007272	840	903	180	1	63	0.0158730
NODE_383_length_3812_cov_65.007272	840	903	188	1	63	0.0158730
NODE_383_length_3812_cov_65.007272	840	903	194	1	63	0.0158730
NODE_383_length_3812_cov_65.007272	840	903	201	2	63	0.0317460
NODE_383_length_3812_cov_65.007272	840	903	214	1	63	0.0158730
NODE_383_length_3812_cov_65.007272	840	903	221	1	63	0.0158730
NODE_383_length_3812_cov_65.007272	840	903	228	1	63	0.0158730
NODE_383_length_3812_cov_65.007272	840	903	231	1	63	0.0158730
NODE_383_length_3812_cov_65.007272	840	903	235	1	63	0.0158730
NODE_383_length_3812_cov_65.007272	840	903	250	1	63	0.0158730
NODE_383_length_3812_cov_65.007272	840	903	261	1	63	0.0158730
NODE_383_length_3812_cov_65.007272	840	903	268	1	63	0.0158730
NODE_383_length_3812_cov_65.007272	840	903	269	1	63	0.0158730
NODE_383_length_3812_cov_65.007272	840	903	271	1	63	0.0158730
NODE_383_length_3812_cov_65.007272	840	903	272	1	63	0.0158730
NODE_383_length_3812_cov_65.007272	840	903	286	1	63	0.0158730
NODE_383_length_3812_cov_65.007272	840	903	288	1	63	0.0158730
NODE_383_length_3812_cov_65.007272	840	903	297	1	63	0.0158730
NODE_383_length_3812_cov_65.007272	840	903	306	1	63	0.0158730
NODE_383_length_3812_cov_65.007272	840	903	309	1	63	0.0158730
NODE_383_length_3812_cov_65.007272	840	903	339	1	63	0.0158730
NODE_383_length_3812_cov_65.007272	840	903	341	1	63	0.0158730
NODE_383_length_3812_cov_65.007272	840	903	347	1	63	0.0158730
NODE_383_length_3812_cov_65.007272	840	903	355	1	63	0.0158730
NODE_383_length_3812_cov_65.007272	840	903	358	1	63	0.0158730
NODE_383_length_3812_cov_65.007272	840	903	361	1	63	0.0158730
NODE_383_length_3812_cov_65.007272	840	903	372	1	63	0.0158730
NODE_383_length_3812_cov_65.007272	840	903	377	1	63	0.0158730
NODE_383_length_3812_cov_65.007272	840	903	380	1	63	0.0158730
NODE_383_length_3812_cov_65.007272	840	903	387	1	63	0.0158730
NODE_383_length_3812_cov_65.007272	840	903	392	1	63	0.0158730
NODE_383_length_3812_cov_65.007272	840	903	394	1	63	0.0158730
NODE_383_length_3812_cov_65.007272	840	903	400	1	63	0.0158730
NODE_383_length_3812_cov_65.007272	840	903	402	1	63	0.0158730
NODE_383_length_3812_cov_65.007272	840	903	407	1	63	0.0158730
NODE_383_length_3812_cov_65.007272	840	903	412	1	63	0.0158730
NODE_383_length_3812_cov_65.007272	840	903	421	1	63	0.0158730
NODE_383_length_3812_cov_65.007272	840	903	426	1	63	0.0158730
NODE_383_length_3812_cov_65.007272	840	903	435	1	63	0.0158730
NODE_383_length_3812_cov_65.007272	840	903	437	2	63	0.0317460
NODE_383_length_3812_cov_65.007272	840	903	452	1	63	0.0158730
NODE_384_length_3805_cov_9.533189	145	236	0	91	91	1.0000000
NODE_384_length_3805_cov_9.533189	209	279	0	70	70	1.0000000
NODE_386_length_3799_cov_10.046486	2944	3024	0	70	80	0.8750000
NODE_386_length_3799_cov_10.046486	2944	3024	4	6	80	0.0750000
NODE_386_length_3799_cov_10.046486	2944	3024	17	3	80	0.0375000
NODE_386_length_3799_cov_10.046486	2944	3024	19	1	80	0.0125000
NODE_386_length_3799_cov_10.046486	2997	3077	0	34	80	0.4250000
NODE_386_length_3799_cov_10.046486	2997	3077	2	35	80	0.4375000
NODE_386_length_3799_cov_10.046486	2997	3077	4	11	80	0.1375000
NODE_388_length_3795_cov_13.724297	3350	3430	2	67	80	0.8375000
NODE_388_length_3795_cov_13.724297	3350	3430	4	13	80	0.1625000
NODE_388_length_3795_cov_13.724297	3403	3483	2	63	80	0.7875000
NODE_388_length_3795_cov_13.724297	3403	3483	4	2	80	0.0250000
NODE_388_length_3795_cov_13.724297	3403	3483	6	13	80	0.1625000
NODE_388_length_3795_cov_13.724297	3403	3483	8	2	80	0.0250000
NODE_388_length_3795_cov_13.724297	3479	3562	6	2	83	0.0240964
NODE_388_length_3795_cov_13.724297	3479	3562	8	18	83	0.2168675
NODE_388_length_3795_cov_13.724297	3479	3562	9	4	83	0.0481928
NODE_388_length_3795_cov_13.724297	3479	3562	10	1	83	0.0120482
NODE_388_length_3795_cov_13.724297	3479	3562	12	2	83	0.0240964
NODE_388_length_3795_cov_13.724297	3479	3562	14	20	83	0.2409639
NODE_388_length_3795_cov_13.724297	3479	3562	16	11	83	0.1325301
NODE_388_length_3795_cov_13.724297	3479	3562	18	3	83	0.0361446
NODE_388_length_3795_cov_13.724297	3479	3562	20	22	83	0.2650602
NODE_388_length_3795_cov_13.724297	3479	3562	6	2	83	0.0240964
NODE_388_length_3795_cov_13.724297	3479	3562	8	18	83	0.2168675
NODE_388_length_3795_cov_13.724297	3479	3562	9	4	83	0.0481928
NODE_388_length_3795_cov_13.724297	3479	3562	10	1	83	0.0120482
NODE_388_length_3795_cov_13.724297	3479	3562	12	2	83	0.0240964
NODE_388_length_3795_cov_13.724297	3479	3562	14	20	83	0.2409639
NODE_388_length_3795_cov_13.724297	3479	3562	16	11	83	0.1325301
NODE_388_length_3795_cov_13.724297	3479	3562	18	3	83	0.0361446
NODE_388_length_3795_cov_13.724297	3479	3562	20	22	83	0.2650602
NODE_388_length_3795_cov_13.724297	3479	3552	6	2	73	0.0273973
NODE_388_length_3795_cov_13.724297	3479	3552	8	18	73	0.2465753
NODE_388_length_3795_cov_13.724297	3479	3552	9	4	73	0.0547945
NODE_388_length_3795_cov_13.724297	3479	3552	10	1	73	0.0136986
NODE_388_length_3795_cov_13.724297	3479	3552	12	2	73	0.0273973
NODE_388_length_3795_cov_13.724297	3479	3552	14	20	73	0.2739726
NODE_388_length_3795_cov_13.724297	3479	3552	16	11	73	0.1506849
NODE_388_length_3795_cov_13.724297	3479	3552	18	3	73	0.0410959
NODE_388_length_3795_cov_13.724297	3479	3552	20	12	73	0.1643836
NODE_388_length_3795_cov_13.724297	3535	3586	16	2	51	0.0392157
NODE_388_length_3795_cov_13.724297	3535	3586	18	16	51	0.3137255
NODE_388_length_3795_cov_13.724297	3535	3586	20	33	51	0.6470588
NODE_388_length_3795_cov_13.724297	3535	3584	16	2	49	0.0408163
NODE_388_length_3795_cov_13.724297	3535	3584	18	14	49	0.2857143
NODE_388_length_3795_cov_13.724297	3535	3584	20	33	49	0.6734694
NODE_388_length_3795_cov_13.724297	3698	3721	32	14	23	0.6086956
NODE_388_length_3795_cov_13.724297	3698	3721	34	9	23	0.3913043
NODE_394_length_3774_cov_7.720544	538	595	3	20	57	0.3508772
NODE_394_length_3774_cov_7.720544	538	595	4	1	57	0.0175439
NODE_394_length_3774_cov_7.720544	538	595	5	23	57	0.4035088
NODE_394_length_3774_cov_7.720544	538	595	7	13	57	0.2280702
NODE_404_length_3747_cov_3.328947	2230	2292	6	7	62	0.1129032
NODE_404_length_3747_cov_3.328947	2230	2292	8	15	62	0.2419355
NODE_404_length_3747_cov_3.328947	2230	2292	12	14	62	0.2258064
NODE_404_length_3747_cov_3.328947	2230	2292	14	26	62	0.4193548
NODE_406_length_3743_cov_38.767014	1354	1434	7	6	80	0.0750000
NODE_406_length_3743_cov_38.767014	1354	1434	9	19	80	0.2375000
NODE_406_length_3743_cov_38.767014	1354	1434	17	4	80	0.0500000
NODE_406_length_3743_cov_38.767014	1354	1434	20	5	80	0.0625000
NODE_406_length_3743_cov_38.767014	1354	1434	21	8	80	0.1000000
NODE_406_length_3743_cov_38.767014	1354	1434	22	10	80	0.1250000
NODE_406_length_3743_cov_38.767014	1354	1434	24	6	80	0.0750000
NODE_406_length_3743_cov_38.767014	1354	1434	26	22	80	0.2750000
NODE_406_length_3743_cov_38.767014	1407	1487	10	19	80	0.2375000
NODE_406_length_3743_cov_38.767014	1407	1487	16	14	80	0.1750000
NODE_406_length_3743_cov_38.767014	1407	1487	18	2	80	0.0250000
NODE_406_length_3743_cov_38.767014	1407	1487	20	4	80	0.0500000
NODE_406_length_3743_cov_38.767014	1407	1487	22	7	80	0.0875000
NODE_406_length_3743_cov_38.767014	1407	1487	24	5	80	0.0625000
NODE_406_length_3743_cov_38.767014	1407	1487	26	29	80	0.3625000
NODE_408_length_3733_cov_16.204458	186	249	2	6	63	0.0952381
NODE_408_length_3733_cov_16.204458	186	249	6	33	63	0.5238096
NODE_408_length_3733_cov_16.204458	186	249	8	14	63	0.2222222
NODE_408_length_3733_cov_16.204458	186	249	14	1	63	0.0158730
NODE_408_length_3733_cov_16.204458	186	249	18	3	63	0.0476190
NODE_408_length_3733_cov_16.204458	186	249	19	1	63	0.0158730
NODE_408_length_3733_cov_16.204458	186	249	36	1	63	0.0158730
NODE_408_length_3733_cov_16.204458	186	249	37	4	63	0.0634921
NODE_413_length_3707_cov_56.575665	2387	2467	9	7	80	0.0875000
NODE_413_length_3707_cov_56.575665	2387	2467	10	29	80	0.3625000
NODE_413_length_3707_cov_56.575665	2387	2467	12	5	80	0.0625000
NODE_413_length_3707_cov_56.575665	2387	2467	14	34	80	0.4250000
NODE_413_length_3707_cov_56.575665	2387	2467	16	5	80	0.0625000
NODE_413_length_3707_cov_56.575665	2440	2520	10	28	80	0.3500000
NODE_413_length_3707_cov_56.575665	2440	2520	11	6	80	0.0750000
NODE_413_length_3707_cov_56.575665	2440	2520	12	6	80	0.0750000
NODE_413_length_3707_cov_56.575665	2440	2520	14	20	80	0.2500000
NODE_413_length_3707_cov_56.575665	2440	2520	16	20	80	0.2500000
NODE_413_length_3707_cov_56.575665	2516	2596	13	22	80	0.2750000
NODE_413_length_3707_cov_56.575665	2516	2596	15	13	80	0.1625000
NODE_413_length_3707_cov_56.575665	2516	2596	16	9	80	0.1125000
NODE_413_length_3707_cov_56.575665	2516	2596	17	1	80	0.0125000
NODE_413_length_3707_cov_56.575665	2516	2596	18	19	80	0.2375000
NODE_413_length_3707_cov_56.575665	2516	2596	31	2	80	0.0250000
NODE_413_length_3707_cov_56.575665	2516	2596	32	14	80	0.1750000
NODE_413_length_3707_cov_56.575665	2569	2649	13	12	80	0.1500000
NODE_413_length_3707_cov_56.575665	2569	2649	15	3	80	0.0375000
NODE_413_length_3707_cov_56.575665	2569	2649	16	2	80	0.0250000
NODE_413_length_3707_cov_56.575665	2569	2649	17	1	80	0.0125000
NODE_413_length_3707_cov_56.575665	2569	2649	21	15	80	0.1875000
NODE_413_length_3707_cov_56.575665	2569	2649	22	13	80	0.1625000
NODE_413_length_3707_cov_56.575665	2569	2649	23	9	80	0.1125000
NODE_413_length_3707_cov_56.575665	2569	2649	25	2	80	0.0250000
NODE_413_length_3707_cov_56.575665	2569	2649	27	4	80	0.0500000
NODE_413_length_3707_cov_56.575665	2569	2649	31	5	80	0.0625000
NODE_413_length_3707_cov_56.575665	2569	2649	32	14	80	0.1750000
NODE_416_length_3690_cov_7.476190	723	792	0	69	69	1.0000000
NODE_416_length_3690_cov_7.476190	776	855	0	79	79	1.0000000
NODE_419_length_3685_cov_7.011154	1966	2046	152	2	80	0.0250000
NODE_419_length_3685_cov_7.011154	1966	2046	153	2	80	0.0250000
NODE_419_length_3685_cov_7.011154	1966	2046	154	1	80	0.0125000
NODE_419_length_3685_cov_7.011154	1966	2046	155	2	80	0.0250000
NODE_419_length_3685_cov_7.011154	1966	2046	156	1	80	0.0125000
NODE_419_length_3685_cov_7.011154	1966	2046	157	1	80	0.0125000
NODE_419_length_3685_cov_7.011154	1966	2046	160	1	80	0.0125000
NODE_419_length_3685_cov_7.011154	1966	2046	162	1	80	0.0125000
NODE_419_length_3685_cov_7.011154	1966	2046	166	2	80	0.0250000
NODE_419_length_3685_cov_7.011154	1966	2046	167	1	80	0.0125000
NODE_419_length_3685_cov_7.011154	1966	2046	168	4	80	0.0500000
NODE_419_length_3685_cov_7.011154	1966	2046	169	3	80	0.0375000
NODE_419_length_3685_cov_7.011154	1966	2046	170	4	80	0.0500000
NODE_419_length_3685_cov_7.011154	1966	2046	171	2	80	0.0250000
NODE_419_length_3685_cov_7.011154	1966	2046	182	2	80	0.0250000
NODE_419_length_3685_cov_7.011154	1966	2046	189	3	80	0.0375000
NODE_419_length_3685_cov_7.011154	1966	2046	190	3	80	0.0375000
NODE_419_length_3685_cov_7.011154	1966	2046	192	3	80	0.0375000
NODE_419_length_3685_cov_7.011154	1966	2046	194	2	80	0.0250000
NODE_419_length_3685_cov_7.011154	1966	2046	195	4	80	0.0500000
NODE_419_length_3685_cov_7.011154	1966	2046	196	6	80	0.0750000
NODE_419_length_3685_cov_7.011154	1966	2046	197	4	80	0.0500000
NODE_419_length_3685_cov_7.011154	1966	2046	198	5	80	0.0625000
NODE_419_length_3685_cov_7.011154	1966	2046	202	3	80	0.0375000
NODE_419_length_3685_cov_7.011154	1966	2046	207	3	80	0.0375000
NODE_419_length_3685_cov_7.011154	1966	2046	208	4	80	0.0500000
NODE_419_length_3685_cov_7.011154	1966	2046	210	9	80	0.1125000
NODE_419_length_3685_cov_7.011154	1966	2046	214	2	80	0.0250000
NODE_419_length_3685_cov_7.011154	2019	2086	133	3	67	0.0447761
NODE_419_length_3685_cov_7.011154	2019	2086	135	1	67	0.0149254
NODE_419_length_3685_cov_7.011154	2019	2086	137	1	67	0.0149254
NODE_419_length_3685_cov_7.011154	2019	2086	138	1	67	0.0149254
NODE_419_length_3685_cov_7.011154	2019	2086	147	1	67	0.0149254
NODE_419_length_3685_cov_7.011154	2019	2086	149	2	67	0.0298507
NODE_419_length_3685_cov_7.011154	2019	2086	153	1	67	0.0149254
NODE_419_length_3685_cov_7.011154	2019	2086	157	1	67	0.0149254
NODE_419_length_3685_cov_7.011154	2019	2086	158	1	67	0.0149254
NODE_419_length_3685_cov_7.011154	2019	2086	160	1	67	0.0149254
NODE_419_length_3685_cov_7.011154	2019	2086	166	2	67	0.0298507
NODE_419_length_3685_cov_7.011154	2019	2086	170	1	67	0.0149254
NODE_419_length_3685_cov_7.011154	2019	2086	172	2	67	0.0298507
NODE_419_length_3685_cov_7.011154	2019	2086	176	2	67	0.0298507
NODE_419_length_3685_cov_7.011154	2019	2086	178	1	67	0.0149254
NODE_419_length_3685_cov_7.011154	2019	2086	179	3	67	0.0447761
NODE_419_length_3685_cov_7.011154	2019	2086	180	4	67	0.0597015
NODE_419_length_3685_cov_7.011154	2019	2086	182	2	67	0.0298507
NODE_419_length_3685_cov_7.011154	2019	2086	184	2	67	0.0298507
NODE_419_length_3685_cov_7.011154	2019	2086	187	1	67	0.0149254
NODE_419_length_3685_cov_7.011154	2019	2086	189	5	67	0.0746269
NODE_419_length_3685_cov_7.011154	2019	2086	193	2	67	0.0298507
NODE_419_length_3685_cov_7.011154	2019	2086	194	2	67	0.0298507
NODE_419_length_3685_cov_7.011154	2019	2086	195	1	67	0.0149254
NODE_419_length_3685_cov_7.011154	2019	2086	196	1	67	0.0149254
NODE_419_length_3685_cov_7.011154	2019	2086	197	2	67	0.0298507
NODE_419_length_3685_cov_7.011154	2019	2086	198	2	67	0.0298507
NODE_419_length_3685_cov_7.011154	2019	2086	202	1	67	0.0149254
NODE_419_length_3685_cov_7.011154	2019	2086	207	3	67	0.0447761
NODE_419_length_3685_cov_7.011154	2019	2086	208	4	67	0.0597015
NODE_419_length_3685_cov_7.011154	2019	2086	210	9	67	0.1343284
NODE_419_length_3685_cov_7.011154	2019	2086	214	2	67	0.0298507
NODE_426_length_3667_cov_1089.047365	1634	1705	22	2	71	0.0281690
NODE_426_length_3667_cov_1089.047365	1634	1705	24	3	71	0.0422535
NODE_426_length_3667_cov_1089.047365	1634	1705	26	14	71	0.1971831
NODE_426_length_3667_cov_1089.047365	1634	1705	28	3	71	0.0422535
NODE_426_length_3667_cov_1089.047365	1634	1705	29	7	71	0.0985916
NODE_426_length_3667_cov_1089.047365	1634	1705	30	32	71	0.4507042
NODE_426_length_3667_cov_1089.047365	1634	1705	32	6	71	0.0845070
NODE_426_length_3667_cov_1089.047365	1634	1705	34	4	71	0.0563380
NODE_426_length_3667_cov_1089.047365	1678	1758	15	3	80	0.0375000
NODE_426_length_3667_cov_1089.047365	1678	1758	16	8	80	0.1000000
NODE_426_length_3667_cov_1089.047365	1678	1758	18	8	80	0.1000000
NODE_426_length_3667_cov_1089.047365	1678	1758	20	4	80	0.0500000
NODE_426_length_3667_cov_1089.047365	1678	1758	22	10	80	0.1250000
NODE_426_length_3667_cov_1089.047365	1678	1758	24	3	80	0.0375000
NODE_426_length_3667_cov_1089.047365	1678	1758	26	30	80	0.3750000
NODE_426_length_3667_cov_1089.047365	1678	1758	28	2	80	0.0250000
NODE_426_length_3667_cov_1089.047365	1678	1758	30	9	80	0.1125000
NODE_426_length_3667_cov_1089.047365	1678	1758	32	3	80	0.0375000
NODE_428_length_3660_cov_79.447627	1806	1870	166	1	64	0.0156250
NODE_428_length_3660_cov_79.447627	1806	1870	168	1	64	0.0156250
NODE_428_length_3660_cov_79.447627	1806	1870	169	4	64	0.0625000
NODE_428_length_3660_cov_79.447627	1806	1870	170	2	64	0.0312500
NODE_428_length_3660_cov_79.447627	1806	1870	174	2	64	0.0312500
NODE_428_length_3660_cov_79.447627	1806	1870	177	1	64	0.0156250
NODE_428_length_3660_cov_79.447627	1806	1870	179	1	64	0.0156250
NODE_428_length_3660_cov_79.447627	1806	1870	181	1	64	0.0156250
NODE_428_length_3660_cov_79.447627	1806	1870	183	1	64	0.0156250
NODE_428_length_3660_cov_79.447627	1806	1870	185	1	64	0.0156250
NODE_428_length_3660_cov_79.447627	1806	1870	187	2	64	0.0312500
NODE_428_length_3660_cov_79.447627	1806	1870	189	1	64	0.0156250
NODE_428_length_3660_cov_79.447627	1806	1870	197	1	64	0.0156250
NODE_428_length_3660_cov_79.447627	1806	1870	199	1	64	0.0156250
NODE_428_length_3660_cov_79.447627	1806	1870	210	1	64	0.0156250
NODE_428_length_3660_cov_79.447627	1806	1870	220	2	64	0.0312500
NODE_428_length_3660_cov_79.447627	1806	1870	222	2	64	0.0312500
NODE_428_length_3660_cov_79.447627	1806	1870	224	1	64	0.0156250
NODE_428_length_3660_cov_79.447627	1806	1870	226	2	64	0.0312500
NODE_428_length_3660_cov_79.447627	1806	1870	227	1	64	0.0156250
NODE_428_length_3660_cov_79.447627	1806	1870	229	1	64	0.0156250
NODE_428_length_3660_cov_79.447627	1806	1870	231	1	64	0.0156250
NODE_428_length_3660_cov_79.447627	1806	1870	235	2	64	0.0312500
NODE_428_length_3660_cov_79.447627	1806	1870	237	1	64	0.0156250
NODE_428_length_3660_cov_79.447627	1806	1870	239	1	64	0.0156250
NODE_428_length_3660_cov_79.447627	1806	1870	240	1	64	0.0156250
NODE_428_length_3660_cov_79.447627	1806	1870	241	2	64	0.0312500
NODE_428_length_3660_cov_79.447627	1806	1870	242	1	64	0.0156250
NODE_428_length_3660_cov_79.447627	1806	1870	243	1	64	0.0156250
NODE_428_length_3660_cov_79.447627	1806	1870	244	2	64	0.0312500
NODE_428_length_3660_cov_79.447627	1806	1870	245	2	64	0.0312500
NODE_428_length_3660_cov_79.447627	1806	1870	246	1	64	0.0156250
NODE_428_length_3660_cov_79.447627	1806	1870	247	2	64	0.0312500
NODE_428_length_3660_cov_79.447627	1806	1870	249	4	64	0.0625000
NODE_428_length_3660_cov_79.447627	1806	1870	250	2	64	0.0312500
NODE_428_length_3660_cov_79.447627	1806	1870	251	2	64	0.0312500
NODE_428_length_3660_cov_79.447627	1806	1870	252	1	64	0.0156250
NODE_428_length_3660_cov_79.447627	1806	1870	254	1	64	0.0156250
NODE_428_length_3660_cov_79.447627	1806	1870	261	1	64	0.0156250
NODE_428_length_3660_cov_79.447627	1806	1870	262	1	64	0.0156250
NODE_428_length_3660_cov_79.447627	1806	1870	271	1	64	0.0156250
NODE_428_length_3660_cov_79.447627	1806	1870	272	1	64	0.0156250
NODE_428_length_3660_cov_79.447627	1806	1870	273	2	64	0.0312500
NODE_428_length_3660_cov_79.447627	1806	1870	278	1	64	0.0156250
NODE_428_length_3660_cov_79.447627	1859	1906	249	1	47	0.0212766
NODE_428_length_3660_cov_79.447627	1859	1906	250	2	47	0.0425532
NODE_428_length_3660_cov_79.447627	1859	1906	252	1	47	0.0212766
NODE_428_length_3660_cov_79.447627	1859	1906	261	1	47	0.0212766
NODE_428_length_3660_cov_79.447627	1859	1906	262	1	47	0.0212766
NODE_428_length_3660_cov_79.447627	1859	1906	271	1	47	0.0212766
NODE_428_length_3660_cov_79.447627	1859	1906	272	1	47	0.0212766
NODE_428_length_3660_cov_79.447627	1859	1906	273	2	47	0.0425532
NODE_428_length_3660_cov_79.447627	1859	1906	278	1	47	0.0212766
NODE_428_length_3660_cov_79.447627	1859	1906	282	1	47	0.0212766
NODE_428_length_3660_cov_79.447627	1859	1906	288	1	47	0.0212766
NODE_428_length_3660_cov_79.447627	1859	1906	291	1	47	0.0212766
NODE_428_length_3660_cov_79.447627	1859	1906	303	1	47	0.0212766
NODE_428_length_3660_cov_79.447627	1859	1906	305	1	47	0.0212766
NODE_428_length_3660_cov_79.447627	1859	1906	309	1	47	0.0212766
NODE_428_length_3660_cov_79.447627	1859	1906	311	1	47	0.0212766
NODE_428_length_3660_cov_79.447627	1859	1906	318	1	47	0.0212766
NODE_428_length_3660_cov_79.447627	1859	1906	327	2	47	0.0425532
NODE_428_length_3660_cov_79.447627	1859	1906	328	1	47	0.0212766
NODE_428_length_3660_cov_79.447627	1859	1906	330	1	47	0.0212766
NODE_428_length_3660_cov_79.447627	1859	1906	331	2	47	0.0425532
NODE_428_length_3660_cov_79.447627	1859	1906	332	2	47	0.0425532
NODE_428_length_3660_cov_79.447627	1859	1906	333	1	47	0.0212766
NODE_428_length_3660_cov_79.447627	1859	1906	334	2	47	0.0425532
NODE_428_length_3660_cov_79.447627	1859	1906	335	1	47	0.0212766
NODE_428_length_3660_cov_79.447627	1859	1906	336	1	47	0.0212766
NODE_428_length_3660_cov_79.447627	1859	1906	337	2	47	0.0425532
NODE_428_length_3660_cov_79.447627	1859	1906	343	1	47	0.0212766
NODE_428_length_3660_cov_79.447627	1859	1906	345	1	47	0.0212766
NODE_428_length_3660_cov_79.447627	1859	1906	346	4	47	0.0851064
NODE_428_length_3660_cov_79.447627	1859	1906	347	1	47	0.0212766
NODE_428_length_3660_cov_79.447627	1859	1906	348	2	47	0.0425532
NODE_428_length_3660_cov_79.447627	1859	1906	349	2	47	0.0425532
NODE_428_length_3660_cov_79.447627	1859	1906	350	2	47	0.0425532
NODE_428_length_3660_cov_79.447627	2358	2438	0	80	80	1.0000000
NODE_428_length_3660_cov_79.447627	2411	2491	0	80	80	1.0000000
NODE_428_length_3660_cov_79.447627	2487	2567	0	80	80	1.0000000
NODE_428_length_3660_cov_79.447627	2540	2620	0	80	80	1.0000000
NODE_430_length_3634_cov_34.913154	1499	1544	75	1	45	0.0222222
NODE_430_length_3634_cov_34.913154	1499	1544	83	1	45	0.0222222
NODE_430_length_3634_cov_34.913154	1499	1544	84	1	45	0.0222222
NODE_430_length_3634_cov_34.913154	1499	1544	85	1	45	0.0222222
NODE_430_length_3634_cov_34.913154	1499	1544	89	1	45	0.0222222
NODE_430_length_3634_cov_34.913154	1499	1544	96	1	45	0.0222222
NODE_430_length_3634_cov_34.913154	1499	1544	101	1	45	0.0222222
NODE_430_length_3634_cov_34.913154	1499	1544	105	1	45	0.0222222
NODE_430_length_3634_cov_34.913154	1499	1544	107	2	45	0.0444444
NODE_430_length_3634_cov_34.913154	1499	1544	113	1	45	0.0222222
NODE_430_length_3634_cov_34.913154	1499	1544	115	1	45	0.0222222
NODE_430_length_3634_cov_34.913154	1499	1544	125	1	45	0.0222222
NODE_430_length_3634_cov_34.913154	1499	1544	129	1	45	0.0222222
NODE_430_length_3634_cov_34.913154	1499	1544	132	1	45	0.0222222
NODE_430_length_3634_cov_34.913154	1499	1544	136	1	45	0.0222222
NODE_430_length_3634_cov_34.913154	1499	1544	145	2	45	0.0444444
NODE_430_length_3634_cov_34.913154	1499	1544	151	1	45	0.0222222
NODE_430_length_3634_cov_34.913154	1499	1544	157	1	45	0.0222222
NODE_430_length_3634_cov_34.913154	1499	1544	161	1	45	0.0222222
NODE_430_length_3634_cov_34.913154	1499	1544	163	1	45	0.0222222
NODE_430_length_3634_cov_34.913154	1499	1544	168	1	45	0.0222222
NODE_430_length_3634_cov_34.913154	1499	1544	169	1	45	0.0222222
NODE_430_length_3634_cov_34.913154	1499	1544	172	1	45	0.0222222
NODE_430_length_3634_cov_34.913154	1499	1544	180	1	45	0.0222222
NODE_430_length_3634_cov_34.913154	1499	1544	188	1	45	0.0222222
NODE_430_length_3634_cov_34.913154	1499	1544	214	1	45	0.0222222
NODE_430_length_3634_cov_34.913154	1499	1544	216	1	45	0.0222222
NODE_430_length_3634_cov_34.913154	1499	1544	218	1	45	0.0222222
NODE_430_length_3634_cov_34.913154	1499	1544	221	1	45	0.0222222
NODE_430_length_3634_cov_34.913154	1499	1544	223	1	45	0.0222222
NODE_430_length_3634_cov_34.913154	1499	1544	234	1	45	0.0222222
NODE_430_length_3634_cov_34.913154	1499	1544	240	2	45	0.0444444
NODE_430_length_3634_cov_34.913154	1499	1544	247	1	45	0.0222222
NODE_430_length_3634_cov_34.913154	1499	1544	250	1	45	0.0222222
NODE_430_length_3634_cov_34.913154	1499	1544	259	1	45	0.0222222
NODE_430_length_3634_cov_34.913154	1499	1544	262	1	45	0.0222222
NODE_430_length_3634_cov_34.913154	1499	1544	270	1	45	0.0222222
NODE_430_length_3634_cov_34.913154	1499	1544	278	1	45	0.0222222
NODE_430_length_3634_cov_34.913154	1499	1544	279	1	45	0.0222222
NODE_430_length_3634_cov_34.913154	1499	1544	283	1	45	0.0222222
NODE_430_length_3634_cov_34.913154	1499	1544	285	2	45	0.0444444
NODE_430_length_3634_cov_34.913154	1517	1597	151	1	80	0.0125000
NODE_430_length_3634_cov_34.913154	1517	1597	157	1	80	0.0125000
NODE_430_length_3634_cov_34.913154	1517	1597	161	1	80	0.0125000
NODE_430_length_3634_cov_34.913154	1517	1597	163	1	80	0.0125000
NODE_430_length_3634_cov_34.913154	1517	1597	168	1	80	0.0125000
NODE_430_length_3634_cov_34.913154	1517	1597	169	1	80	0.0125000
NODE_430_length_3634_cov_34.913154	1517	1597	172	1	80	0.0125000
NODE_430_length_3634_cov_34.913154	1517	1597	180	1	80	0.0125000
NODE_430_length_3634_cov_34.913154	1517	1597	188	1	80	0.0125000
NODE_430_length_3634_cov_34.913154	1517	1597	214	1	80	0.0125000
NODE_430_length_3634_cov_34.913154	1517	1597	216	1	80	0.0125000
NODE_430_length_3634_cov_34.913154	1517	1597	218	1	80	0.0125000
NODE_430_length_3634_cov_34.913154	1517	1597	221	1	80	0.0125000
NODE_430_length_3634_cov_34.913154	1517	1597	223	1	80	0.0125000
NODE_430_length_3634_cov_34.913154	1517	1597	234	1	80	0.0125000
NODE_430_length_3634_cov_34.913154	1517	1597	240	2	80	0.0250000
NODE_430_length_3634_cov_34.913154	1517	1597	247	1	80	0.0125000
NODE_430_length_3634_cov_34.913154	1517	1597	250	1	80	0.0125000
NODE_430_length_3634_cov_34.913154	1517	1597	259	1	80	0.0125000
NODE_430_length_3634_cov_34.913154	1517	1597	262	1	80	0.0125000
NODE_430_length_3634_cov_34.913154	1517	1597	270	1	80	0.0125000
NODE_430_length_3634_cov_34.913154	1517	1597	278	1	80	0.0125000
NODE_430_length_3634_cov_34.913154	1517	1597	279	1	80	0.0125000
NODE_430_length_3634_cov_34.913154	1517	1597	283	1	80	0.0125000
NODE_430_length_3634_cov_34.913154	1517	1597	285	2	80	0.0250000
NODE_430_length_3634_cov_34.913154	1517	1597	290	3	80	0.0375000
NODE_430_length_3634_cov_34.913154	1517	1597	291	1	80	0.0125000
NODE_430_length_3634_cov_34.913154	1517	1597	298	1	80	0.0125000
NODE_430_length_3634_cov_34.913154	1517	1597	302	1	80	0.0125000
NODE_430_length_3634_cov_34.913154	1517	1597	303	1	80	0.0125000
NODE_430_length_3634_cov_34.913154	1517	1597	307	1	80	0.0125000
NODE_430_length_3634_cov_34.913154	1517	1597	309	1	80	0.0125000
NODE_430_length_3634_cov_34.913154	1517	1597	316	1	80	0.0125000
NODE_430_length_3634_cov_34.913154	1517	1597	318	1	80	0.0125000
NODE_430_length_3634_cov_34.913154	1517	1597	319	1	80	0.0125000
NODE_430_length_3634_cov_34.913154	1517	1597	325	1	80	0.0125000
NODE_430_length_3634_cov_34.913154	1517	1597	329	2	80	0.0250000
NODE_430_length_3634_cov_34.913154	1517	1597	334	1	80	0.0125000
NODE_430_length_3634_cov_34.913154	1517	1597	342	1	80	0.0125000
NODE_430_length_3634_cov_34.913154	1517	1597	351	1	80	0.0125000
NODE_430_length_3634_cov_34.913154	1517	1597	352	1	80	0.0125000
NODE_430_length_3634_cov_34.913154	1517	1597	356	1	80	0.0125000
NODE_430_length_3634_cov_34.913154	1517	1597	363	1	80	0.0125000
NODE_430_length_3634_cov_34.913154	1517	1597	369	1	80	0.0125000
NODE_430_length_3634_cov_34.913154	1517	1597	381	1	80	0.0125000
NODE_430_length_3634_cov_34.913154	1517	1597	383	1	80	0.0125000
NODE_430_length_3634_cov_34.913154	1517	1597	384	1	80	0.0125000
NODE_430_length_3634_cov_34.913154	1517	1597	386	1	80	0.0125000
NODE_430_length_3634_cov_34.913154	1517	1597	401	1	80	0.0125000
NODE_430_length_3634_cov_34.913154	1517	1597	404	1	80	0.0125000
NODE_430_length_3634_cov_34.913154	1517	1597	409	1	80	0.0125000
NODE_430_length_3634_cov_34.913154	1517	1597	418	1	80	0.0125000
NODE_430_length_3634_cov_34.913154	1517	1597	422	1	80	0.0125000
NODE_430_length_3634_cov_34.913154	1517	1597	437	1	80	0.0125000
NODE_430_length_3634_cov_34.913154	1517	1597	439	1	80	0.0125000
NODE_430_length_3634_cov_34.913154	1517	1597	450	1	80	0.0125000
NODE_430_length_3634_cov_34.913154	1517	1597	457	1	80	0.0125000
NODE_430_length_3634_cov_34.913154	1517	1597	461	1	80	0.0125000
NODE_430_length_3634_cov_34.913154	1517	1597	463	2	80	0.0250000
NODE_430_length_3634_cov_34.913154	1517	1597	468	1	80	0.0125000
NODE_430_length_3634_cov_34.913154	1517	1597	470	3	80	0.0375000
NODE_430_length_3634_cov_34.913154	1517	1597	471	4	80	0.0500000
NODE_430_length_3634_cov_34.913154	1517	1597	473	3	80	0.0375000
NODE_430_length_3634_cov_34.913154	1517	1597	474	3	80	0.0375000
NODE_430_length_3634_cov_34.913154	1517	1597	475	1	80	0.0125000
NODE_430_length_3634_cov_34.913154	1978	2058	97	1	80	0.0125000
NODE_430_length_3634_cov_34.913154	1978	2058	98	2	80	0.0250000
NODE_430_length_3634_cov_34.913154	1978	2058	107	1	80	0.0125000
NODE_430_length_3634_cov_34.913154	1978	2058	111	1	80	0.0125000
NODE_430_length_3634_cov_34.913154	1978	2058	116	1	80	0.0125000
NODE_430_length_3634_cov_34.913154	1978	2058	117	2	80	0.0250000
NODE_430_length_3634_cov_34.913154	1978	2058	121	1	80	0.0125000
NODE_430_length_3634_cov_34.913154	1978	2058	123	1	80	0.0125000
NODE_430_length_3634_cov_34.913154	1978	2058	125	1	80	0.0125000
NODE_430_length_3634_cov_34.913154	1978	2058	132	1	80	0.0125000
NODE_430_length_3634_cov_34.913154	1978	2058	133	1	80	0.0125000
NODE_430_length_3634_cov_34.913154	1978	2058	145	2	80	0.0250000
NODE_430_length_3634_cov_34.913154	1978	2058	151	2	80	0.0250000
NODE_430_length_3634_cov_34.913154	1978	2058	157	1	80	0.0125000
NODE_430_length_3634_cov_34.913154	1978	2058	164	1	80	0.0125000
NODE_430_length_3634_cov_34.913154	1978	2058	165	1	80	0.0125000
NODE_430_length_3634_cov_34.913154	1978	2058	173	1	80	0.0125000
NODE_430_length_3634_cov_34.913154	1978	2058	179	1	80	0.0125000
NODE_430_length_3634_cov_34.913154	1978	2058	185	2	80	0.0250000
NODE_430_length_3634_cov_34.913154	1978	2058	193	1	80	0.0125000
NODE_430_length_3634_cov_34.913154	1978	2058	197	1	80	0.0125000
NODE_430_length_3634_cov_34.913154	1978	2058	199	3	80	0.0375000
NODE_430_length_3634_cov_34.913154	1978	2058	200	2	80	0.0250000
NODE_430_length_3634_cov_34.913154	1978	2058	202	2	80	0.0250000
NODE_430_length_3634_cov_34.913154	1978	2058	206	1	80	0.0125000
NODE_430_length_3634_cov_34.913154	1978	2058	208	1	80	0.0125000
NODE_430_length_3634_cov_34.913154	1978	2058	211	1	80	0.0125000
NODE_430_length_3634_cov_34.913154	1978	2058	216	1	80	0.0125000
NODE_430_length_3634_cov_34.913154	1978	2058	217	1	80	0.0125000
NODE_430_length_3634_cov_34.913154	1978	2058	228	1	80	0.0125000
NODE_430_length_3634_cov_34.913154	1978	2058	230	3	80	0.0375000
NODE_430_length_3634_cov_34.913154	1978	2058	233	1	80	0.0125000
NODE_430_length_3634_cov_34.913154	1978	2058	237	1	80	0.0125000
NODE_430_length_3634_cov_34.913154	1978	2058	239	1	80	0.0125000
NODE_430_length_3634_cov_34.913154	1978	2058	241	1	80	0.0125000
NODE_430_length_3634_cov_34.913154	1978	2058	245	1	80	0.0125000
NODE_430_length_3634_cov_34.913154	1978	2058	247	1	80	0.0125000
NODE_430_length_3634_cov_34.913154	1978	2058	254	1	80	0.0125000
NODE_430_length_3634_cov_34.913154	1978	2058	259	1	80	0.0125000
NODE_430_length_3634_cov_34.913154	1978	2058	260	3	80	0.0375000
NODE_430_length_3634_cov_34.913154	1978	2058	264	1	80	0.0125000
NODE_430_length_3634_cov_34.913154	1978	2058	268	1	80	0.0125000
NODE_430_length_3634_cov_34.913154	1978	2058	269	1	80	0.0125000
NODE_430_length_3634_cov_34.913154	1978	2058	271	1	80	0.0125000
NODE_430_length_3634_cov_34.913154	1978	2058	275	1	80	0.0125000
NODE_430_length_3634_cov_34.913154	1978	2058	280	1	80	0.0125000
NODE_430_length_3634_cov_34.913154	1978	2058	282	1	80	0.0125000
NODE_430_length_3634_cov_34.913154	1978	2058	287	3	80	0.0375000
NODE_430_length_3634_cov_34.913154	1978	2058	294	1	80	0.0125000
NODE_430_length_3634_cov_34.913154	1978	2058	298	1	80	0.0125000
NODE_430_length_3634_cov_34.913154	1978	2058	309	1	80	0.0125000
NODE_430_length_3634_cov_34.913154	1978	2058	313	1	80	0.0125000
NODE_430_length_3634_cov_34.913154	1978	2058	315	3	80	0.0375000
NODE_430_length_3634_cov_34.913154	1978	2058	318	1	80	0.0125000
NODE_430_length_3634_cov_34.913154	1978	2058	329	1	80	0.0125000
NODE_430_length_3634_cov_34.913154	1978	2058	341	1	80	0.0125000
NODE_430_length_3634_cov_34.913154	1978	2058	347	1	80	0.0125000
NODE_430_length_3634_cov_34.913154	1978	2058	349	1	80	0.0125000
NODE_430_length_3634_cov_34.913154	1978	2058	351	1	80	0.0125000
NODE_430_length_3634_cov_34.913154	1978	2058	362	2	80	0.0250000
NODE_430_length_3634_cov_34.913154	1978	2058	364	1	80	0.0125000
NODE_430_length_3634_cov_34.913154	1978	2058	371	1	80	0.0125000
NODE_430_length_3634_cov_34.913154	2031	2077	31	1	46	0.0217391
NODE_430_length_3634_cov_34.913154	2031	2077	33	3	46	0.0652174
NODE_430_length_3634_cov_34.913154	2031	2077	38	1	46	0.0217391
NODE_430_length_3634_cov_34.913154	2031	2077	39	1	46	0.0217391
NODE_430_length_3634_cov_34.913154	2031	2077	44	1	46	0.0217391
NODE_430_length_3634_cov_34.913154	2031	2077	46	1	46	0.0217391
NODE_430_length_3634_cov_34.913154	2031	2077	52	1	46	0.0217391
NODE_430_length_3634_cov_34.913154	2031	2077	54	1	46	0.0217391
NODE_430_length_3634_cov_34.913154	2031	2077	60	1	46	0.0217391
NODE_430_length_3634_cov_34.913154	2031	2077	62	1	46	0.0217391
NODE_430_length_3634_cov_34.913154	2031	2077	64	1	46	0.0217391
NODE_430_length_3634_cov_34.913154	2031	2077	65	1	46	0.0217391
NODE_430_length_3634_cov_34.913154	2031	2077	70	1	46	0.0217391
NODE_430_length_3634_cov_34.913154	2031	2077	71	1	46	0.0217391
NODE_430_length_3634_cov_34.913154	2031	2077	76	1	46	0.0217391
NODE_430_length_3634_cov_34.913154	2031	2077	84	1	46	0.0217391
NODE_430_length_3634_cov_34.913154	2031	2077	91	1	46	0.0217391
NODE_430_length_3634_cov_34.913154	2031	2077	97	1	46	0.0217391
NODE_430_length_3634_cov_34.913154	2031	2077	98	2	46	0.0434783
NODE_430_length_3634_cov_34.913154	2031	2077	107	1	46	0.0217391
NODE_430_length_3634_cov_34.913154	2031	2077	111	1	46	0.0217391
NODE_430_length_3634_cov_34.913154	2031	2077	116	1	46	0.0217391
NODE_430_length_3634_cov_34.913154	2031	2077	117	2	46	0.0434783
NODE_430_length_3634_cov_34.913154	2031	2077	121	1	46	0.0217391
NODE_430_length_3634_cov_34.913154	2031	2077	123	1	46	0.0217391
NODE_430_length_3634_cov_34.913154	2031	2077	125	1	46	0.0217391
NODE_430_length_3634_cov_34.913154	2031	2077	132	1	46	0.0217391
NODE_430_length_3634_cov_34.913154	2031	2077	133	1	46	0.0217391
NODE_430_length_3634_cov_34.913154	2031	2077	145	2	46	0.0434783
NODE_430_length_3634_cov_34.913154	2031	2077	151	2	46	0.0434783
NODE_430_length_3634_cov_34.913154	2031	2077	157	1	46	0.0217391
NODE_430_length_3634_cov_34.913154	2031	2077	164	1	46	0.0217391
NODE_430_length_3634_cov_34.913154	2031	2077	165	1	46	0.0217391
NODE_430_length_3634_cov_34.913154	2031	2077	173	1	46	0.0217391
NODE_430_length_3634_cov_34.913154	2031	2077	179	1	46	0.0217391
NODE_430_length_3634_cov_34.913154	2031	2077	185	2	46	0.0434783
NODE_430_length_3634_cov_34.913154	2031	2077	193	1	46	0.0217391
NODE_430_length_3634_cov_34.913154	2031	2077	197	1	46	0.0217391
NODE_430_length_3634_cov_34.913154	2031	2077	199	1	46	0.0217391
NODE_435_length_3622_cov_29.112120	201	281	0	1	80	0.0125000
NODE_435_length_3622_cov_29.112120	201	281	2	33	80	0.4125000
NODE_435_length_3622_cov_29.112120	201	281	17	12	80	0.1500000
NODE_435_length_3622_cov_29.112120	201	281	19	34	80	0.4250000
NODE_435_length_3622_cov_29.112120	254	334	17	17	80	0.2125000
NODE_435_length_3622_cov_29.112120	254	334	19	16	80	0.2000000
NODE_435_length_3622_cov_29.112120	254	334	23	30	80	0.3750000
NODE_435_length_3622_cov_29.112120	254	334	24	17	80	0.2125000
NODE_435_length_3622_cov_29.112120	2310	2390	69	1	80	0.0125000
NODE_435_length_3622_cov_29.112120	2310	2390	71	2	80	0.0250000
NODE_435_length_3622_cov_29.112120	2310	2390	72	2	80	0.0250000
NODE_435_length_3622_cov_29.112120	2310	2390	73	2	80	0.0250000
NODE_435_length_3622_cov_29.112120	2310	2390	75	2	80	0.0250000
NODE_435_length_3622_cov_29.112120	2310	2390	77	3	80	0.0375000
NODE_435_length_3622_cov_29.112120	2310	2390	79	1	80	0.0125000
NODE_435_length_3622_cov_29.112120	2310	2390	85	1	80	0.0125000
NODE_435_length_3622_cov_29.112120	2310	2390	89	2	80	0.0250000
NODE_435_length_3622_cov_29.112120	2310	2390	90	1	80	0.0125000
NODE_435_length_3622_cov_29.112120	2310	2390	92	1	80	0.0125000
NODE_435_length_3622_cov_29.112120	2310	2390	94	1	80	0.0125000
NODE_435_length_3622_cov_29.112120	2310	2390	96	2	80	0.0250000
NODE_435_length_3622_cov_29.112120	2310	2390	97	2	80	0.0250000
NODE_435_length_3622_cov_29.112120	2310	2390	101	1	80	0.0125000
NODE_435_length_3622_cov_29.112120	2310	2390	108	1	80	0.0125000
NODE_435_length_3622_cov_29.112120	2310	2390	110	2	80	0.0250000
NODE_435_length_3622_cov_29.112120	2310	2390	111	3	80	0.0375000
NODE_435_length_3622_cov_29.112120	2310	2390	119	2	80	0.0250000
NODE_435_length_3622_cov_29.112120	2310	2390	123	2	80	0.0250000
NODE_435_length_3622_cov_29.112120	2310	2390	127	1	80	0.0125000
NODE_435_length_3622_cov_29.112120	2310	2390	128	2	80	0.0250000
NODE_435_length_3622_cov_29.112120	2310	2390	137	1	80	0.0125000
NODE_435_length_3622_cov_29.112120	2310	2390	139	4	80	0.0500000
NODE_435_length_3622_cov_29.112120	2310	2390	141	1	80	0.0125000
NODE_435_length_3622_cov_29.112120	2310	2390	144	3	80	0.0375000
NODE_435_length_3622_cov_29.112120	2310	2390	148	1	80	0.0125000
NODE_435_length_3622_cov_29.112120	2310	2390	150	3	80	0.0375000
NODE_435_length_3622_cov_29.112120	2310	2390	154	1	80	0.0125000
NODE_435_length_3622_cov_29.112120	2310	2390	157	2	80	0.0250000
NODE_435_length_3622_cov_29.112120	2310	2390	158	10	80	0.1250000
NODE_435_length_3622_cov_29.112120	2310	2390	160	2	80	0.0250000
NODE_435_length_3622_cov_29.112120	2310	2390	161	1	80	0.0125000
NODE_435_length_3622_cov_29.112120	2310	2390	163	6	80	0.0750000
NODE_435_length_3622_cov_29.112120	2310	2390	168	2	80	0.0250000
NODE_435_length_3622_cov_29.112120	2310	2390	169	1	80	0.0125000
NODE_435_length_3622_cov_29.112120	2310	2390	173	3	80	0.0375000
NODE_435_length_3622_cov_29.112120	2310	2390	174	1	80	0.0125000
NODE_435_length_3622_cov_29.112120	2310	2390	175	1	80	0.0125000
NODE_435_length_3622_cov_29.112120	2363	2441	11	1	78	0.0128205
NODE_435_length_3622_cov_29.112120	2363	2441	13	2	78	0.0256410
NODE_435_length_3622_cov_29.112120	2363	2441	14	2	78	0.0256410
NODE_435_length_3622_cov_29.112120	2363	2441	17	3	78	0.0384615
NODE_435_length_3622_cov_29.112120	2363	2441	25	1	78	0.0128205
NODE_435_length_3622_cov_29.112120	2363	2441	26	3	78	0.0384615
NODE_435_length_3622_cov_29.112120	2363	2441	28	1	78	0.0128205
NODE_435_length_3622_cov_29.112120	2363	2441	30	2	78	0.0256410
NODE_435_length_3622_cov_29.112120	2363	2441	31	1	78	0.0128205
NODE_435_length_3622_cov_29.112120	2363	2441	33	8	78	0.1025641
NODE_435_length_3622_cov_29.112120	2363	2441	37	2	78	0.0256410
NODE_435_length_3622_cov_29.112120	2363	2441	39	4	78	0.0512821
NODE_435_length_3622_cov_29.112120	2363	2441	40	2	78	0.0256410
NODE_435_length_3622_cov_29.112120	2363	2441	44	2	78	0.0256410
NODE_435_length_3622_cov_29.112120	2363	2441	46	4	78	0.0512821
NODE_435_length_3622_cov_29.112120	2363	2441	47	2	78	0.0256410
NODE_435_length_3622_cov_29.112120	2363	2441	49	1	78	0.0128205
NODE_435_length_3622_cov_29.112120	2363	2441	50	4	78	0.0512821
NODE_435_length_3622_cov_29.112120	2363	2441	54	2	78	0.0256410
NODE_435_length_3622_cov_29.112120	2363	2441	56	1	78	0.0128205
NODE_435_length_3622_cov_29.112120	2363	2441	65	2	78	0.0256410
NODE_435_length_3622_cov_29.112120	2363	2441	69	2	78	0.0256410
NODE_435_length_3622_cov_29.112120	2363	2441	71	2	78	0.0256410
NODE_435_length_3622_cov_29.112120	2363	2441	72	2	78	0.0256410
NODE_435_length_3622_cov_29.112120	2363	2441	73	2	78	0.0256410
NODE_435_length_3622_cov_29.112120	2363	2441	75	2	78	0.0256410
NODE_435_length_3622_cov_29.112120	2363	2441	77	3	78	0.0384615
NODE_435_length_3622_cov_29.112120	2363	2441	79	1	78	0.0128205
NODE_435_length_3622_cov_29.112120	2363	2441	85	1	78	0.0128205
NODE_435_length_3622_cov_29.112120	2363	2441	89	2	78	0.0256410
NODE_435_length_3622_cov_29.112120	2363	2441	90	1	78	0.0128205
NODE_435_length_3622_cov_29.112120	2363	2441	92	1	78	0.0128205
NODE_435_length_3622_cov_29.112120	2363	2441	94	1	78	0.0128205
NODE_435_length_3622_cov_29.112120	2363	2441	96	2	78	0.0256410
NODE_435_length_3622_cov_29.112120	2363	2441	97	2	78	0.0256410
NODE_435_length_3622_cov_29.112120	2363	2441	101	1	78	0.0128205
NODE_435_length_3622_cov_29.112120	2363	2441	108	1	78	0.0128205
NODE_435_length_3622_cov_29.112120	2363	2441	110	2	78	0.0256410
NODE_437_length_3610_cov_8.785816	294	340	4	4	46	0.0869565
NODE_437_length_3610_cov_8.785816	294	340	8	9	46	0.1956522
NODE_437_length_3610_cov_8.785816	294	340	10	33	46	0.7173913
NODE_437_length_3610_cov_8.785816	313	393	6	12	80	0.1500000
NODE_437_length_3610_cov_8.785816	313	393	10	68	80	0.8500000
NODE_444_length_3588_cov_16.296360	2421	2501	0	19	80	0.2375000
NODE_444_length_3588_cov_16.296360	2421	2501	2	5	80	0.0625000
NODE_444_length_3588_cov_16.296360	2421	2501	6	1	80	0.0125000
NODE_444_length_3588_cov_16.296360	2421	2501	8	43	80	0.5375000
NODE_444_length_3588_cov_16.296360	2421	2501	10	12	80	0.1500000
NODE_444_length_3588_cov_16.296360	2474	2539	8	19	65	0.2923077
NODE_444_length_3588_cov_16.296360	2474	2539	10	46	65	0.7076923
NODE_447_length_3585_cov_2.283419	605	668	0	63	63	1.0000000
NODE_451_length_3567_cov_16.283160	410	429	4	13	19	0.6842105
NODE_451_length_3567_cov_16.283160	410	429	6	2	19	0.1052632
NODE_451_length_3567_cov_16.283160	410	429	8	3	19	0.1578947
NODE_451_length_3567_cov_16.283160	410	429	10	1	19	0.0526316
NODE_451_length_3567_cov_16.283160	2259	2339	282	1	80	0.0125000
NODE_451_length_3567_cov_16.283160	2259	2339	294	1	80	0.0125000
NODE_451_length_3567_cov_16.283160	2259	2339	298	2	80	0.0250000
NODE_451_length_3567_cov_16.283160	2259	2339	300	1	80	0.0125000
NODE_451_length_3567_cov_16.283160	2259	2339	302	3	80	0.0375000
NODE_451_length_3567_cov_16.283160	2259	2339	304	1	80	0.0125000
NODE_451_length_3567_cov_16.283160	2259	2339	306	1	80	0.0125000
NODE_451_length_3567_cov_16.283160	2259	2339	308	1	80	0.0125000
NODE_451_length_3567_cov_16.283160	2259	2339	309	1	80	0.0125000
NODE_451_length_3567_cov_16.283160	2259	2339	311	2	80	0.0250000
NODE_451_length_3567_cov_16.283160	2259	2339	312	1	80	0.0125000
NODE_451_length_3567_cov_16.283160	2259	2339	314	1	80	0.0125000
NODE_451_length_3567_cov_16.283160	2259	2339	315	3	80	0.0375000
NODE_451_length_3567_cov_16.283160	2259	2339	316	2	80	0.0250000
NODE_451_length_3567_cov_16.283160	2259	2339	317	2	80	0.0250000
NODE_451_length_3567_cov_16.283160	2259	2339	318	2	80	0.0250000
NODE_451_length_3567_cov_16.283160	2259	2339	325	1	80	0.0125000
NODE_451_length_3567_cov_16.283160	2259	2339	326	3	80	0.0375000
NODE_451_length_3567_cov_16.283160	2259	2339	327	1	80	0.0125000
NODE_451_length_3567_cov_16.283160	2259	2339	329	2	80	0.0250000
NODE_451_length_3567_cov_16.283160	2259	2339	330	3	80	0.0375000
NODE_451_length_3567_cov_16.283160	2259	2339	331	4	80	0.0500000
NODE_451_length_3567_cov_16.283160	2259	2339	333	7	80	0.0875000
NODE_451_length_3567_cov_16.283160	2259	2339	334	3	80	0.0375000
NODE_451_length_3567_cov_16.283160	2259	2339	336	9	80	0.1125000
NODE_451_length_3567_cov_16.283160	2259	2339	338	1	80	0.0125000
NODE_451_length_3567_cov_16.283160	2259	2339	342	1	80	0.0125000
NODE_451_length_3567_cov_16.283160	2259	2339	343	1	80	0.0125000
NODE_451_length_3567_cov_16.283160	2259	2339	345	1	80	0.0125000
NODE_451_length_3567_cov_16.283160	2259	2339	347	2	80	0.0250000
NODE_451_length_3567_cov_16.283160	2259	2339	348	1	80	0.0125000
NODE_451_length_3567_cov_16.283160	2259	2339	349	2	80	0.0250000
NODE_451_length_3567_cov_16.283160	2259	2339	352	1	80	0.0125000
NODE_451_length_3567_cov_16.283160	2259	2339	354	1	80	0.0125000
NODE_451_length_3567_cov_16.283160	2259	2339	356	3	80	0.0375000
NODE_451_length_3567_cov_16.283160	2259	2339	357	1	80	0.0125000
NODE_451_length_3567_cov_16.283160	2259	2339	358	1	80	0.0125000
NODE_451_length_3567_cov_16.283160	2259	2339	359	1	80	0.0125000
NODE_451_length_3567_cov_16.283160	2259	2339	360	5	80	0.0625000
NODE_451_length_3567_cov_16.283160	2312	2379	15	1	67	0.0149254
NODE_451_length_3567_cov_16.283160	2312	2379	42	1	67	0.0149254
NODE_451_length_3567_cov_16.283160	2312	2379	46	1	67	0.0149254
NODE_451_length_3567_cov_16.283160	2312	2379	47	1	67	0.0149254
NODE_451_length_3567_cov_16.283160	2312	2379	55	1	67	0.0149254
NODE_451_length_3567_cov_16.283160	2312	2379	66	2	67	0.0298507
NODE_451_length_3567_cov_16.283160	2312	2379	72	1	67	0.0149254
NODE_451_length_3567_cov_16.283160	2312	2379	78	2	67	0.0298507
NODE_451_length_3567_cov_16.283160	2312	2379	99	1	67	0.0149254
NODE_451_length_3567_cov_16.283160	2312	2379	106	1	67	0.0149254
NODE_451_length_3567_cov_16.283160	2312	2379	120	1	67	0.0149254
NODE_451_length_3567_cov_16.283160	2312	2379	138	3	67	0.0447761
NODE_451_length_3567_cov_16.283160	2312	2379	140	1	67	0.0149254
NODE_451_length_3567_cov_16.283160	2312	2379	146	1	67	0.0149254
NODE_451_length_3567_cov_16.283160	2312	2379	154	1	67	0.0149254
NODE_451_length_3567_cov_16.283160	2312	2379	164	1	67	0.0149254
NODE_451_length_3567_cov_16.283160	2312	2379	167	1	67	0.0149254
NODE_451_length_3567_cov_16.283160	2312	2379	188	1	67	0.0149254
NODE_451_length_3567_cov_16.283160	2312	2379	192	1	67	0.0149254
NODE_451_length_3567_cov_16.283160	2312	2379	199	1	67	0.0149254
NODE_451_length_3567_cov_16.283160	2312	2379	207	1	67	0.0149254
NODE_451_length_3567_cov_16.283160	2312	2379	222	1	67	0.0149254
NODE_451_length_3567_cov_16.283160	2312	2379	227	1	67	0.0149254
NODE_451_length_3567_cov_16.283160	2312	2379	229	1	67	0.0149254
NODE_451_length_3567_cov_16.283160	2312	2379	232	1	67	0.0149254
NODE_451_length_3567_cov_16.283160	2312	2379	233	2	67	0.0298507
NODE_451_length_3567_cov_16.283160	2312	2379	242	1	67	0.0149254
NODE_451_length_3567_cov_16.283160	2312	2379	244	1	67	0.0149254
NODE_451_length_3567_cov_16.283160	2312	2379	251	1	67	0.0149254
NODE_451_length_3567_cov_16.283160	2312	2379	254	1	67	0.0149254
NODE_451_length_3567_cov_16.283160	2312	2379	261	2	67	0.0298507
NODE_451_length_3567_cov_16.283160	2312	2379	279	1	67	0.0149254
NODE_451_length_3567_cov_16.283160	2312	2379	282	3	67	0.0447761
NODE_451_length_3567_cov_16.283160	2312	2379	294	1	67	0.0149254
NODE_451_length_3567_cov_16.283160	2312	2379	298	2	67	0.0298507
NODE_451_length_3567_cov_16.283160	2312	2379	300	1	67	0.0149254
NODE_451_length_3567_cov_16.283160	2312	2379	302	3	67	0.0447761
NODE_451_length_3567_cov_16.283160	2312	2379	304	1	67	0.0149254
NODE_451_length_3567_cov_16.283160	2312	2379	308	1	67	0.0149254
NODE_451_length_3567_cov_16.283160	2312	2379	309	1	67	0.0149254
NODE_451_length_3567_cov_16.283160	2312	2379	311	2	67	0.0298507
NODE_451_length_3567_cov_16.283160	2312	2379	312	1	67	0.0149254
NODE_451_length_3567_cov_16.283160	2312	2379	314	1	67	0.0149254
NODE_451_length_3567_cov_16.283160	2312	2379	316	2	67	0.0298507
NODE_451_length_3567_cov_16.283160	2312	2379	318	2	67	0.0298507
NODE_451_length_3567_cov_16.283160	2312	2379	326	2	67	0.0298507
NODE_451_length_3567_cov_16.283160	2312	2379	327	1	67	0.0149254
NODE_451_length_3567_cov_16.283160	2312	2379	329	2	67	0.0298507
NODE_451_length_3567_cov_16.283160	2312	2379	331	1	67	0.0149254
NODE_451_length_3567_cov_16.283160	2312	2379	333	2	67	0.0298507
NODE_454_length_3557_cov_12.423077	640	718	4	5	78	0.0641026
NODE_454_length_3557_cov_12.423077	640	718	6	65	78	0.8333333
NODE_454_length_3557_cov_12.423077	640	718	8	8	78	0.1025641
NODE_454_length_3557_cov_12.423077	640	688	4	5	48	0.1041667
NODE_454_length_3557_cov_12.423077	640	688	6	43	48	0.8958333
NODE_454_length_3557_cov_12.423077	640	688	4	5	48	0.1041667
NODE_454_length_3557_cov_12.423077	640	688	6	43	48	0.8958333
NODE_454_length_3557_cov_12.423077	640	688	4	5	48	0.1041667
NODE_454_length_3557_cov_12.423077	640	688	6	43	48	0.8958333
NODE_454_length_3557_cov_12.423077	640	688	4	5	48	0.1041667
NODE_454_length_3557_cov_12.423077	640	688	6	43	48	0.8958333
NODE_454_length_3557_cov_12.423077	693	771	2	32	78	0.4102564
NODE_454_length_3557_cov_12.423077	693	771	4	12	78	0.1538462
NODE_454_length_3557_cov_12.423077	693	771	6	23	78	0.2948718
NODE_454_length_3557_cov_12.423077	693	771	8	11	78	0.1410256
NODE_455_length_3548_cov_7.216295	554	634	0	31	80	0.3875000
NODE_455_length_3548_cov_7.216295	554	634	1	2	80	0.0250000
NODE_455_length_3548_cov_7.216295	554	634	2	47	80	0.5875000
NODE_455_length_3548_cov_7.216295	607	687	0	8	80	0.1000000
NODE_455_length_3548_cov_7.216295	607	687	2	72	80	0.9000000
NODE_461_length_3518_cov_40.508336	1320	1400	0	21	80	0.2625000
NODE_461_length_3518_cov_40.508336	1320	1400	4	59	80	0.7375000
NODE_461_length_3518_cov_40.508336	1373	1453	0	8	80	0.1000000
NODE_461_length_3518_cov_40.508336	1373	1453	4	72	80	0.9000000
NODE_465_length_3497_cov_65.791348	3062	3142	447	1	80	0.0125000
NODE_465_length_3497_cov_65.791348	3062	3142	456	1	80	0.0125000
NODE_465_length_3497_cov_65.791348	3062	3142	460	1	80	0.0125000
NODE_465_length_3497_cov_65.791348	3062	3142	470	2	80	0.0250000
NODE_465_length_3497_cov_65.791348	3062	3142	472	1	80	0.0125000
NODE_465_length_3497_cov_65.791348	3062	3142	475	1	80	0.0125000
NODE_465_length_3497_cov_65.791348	3062	3142	477	1	80	0.0125000
NODE_465_length_3497_cov_65.791348	3062	3142	478	1	80	0.0125000
NODE_465_length_3497_cov_65.791348	3062	3142	488	1	80	0.0125000
NODE_465_length_3497_cov_65.791348	3062	3142	489	1	80	0.0125000
NODE_465_length_3497_cov_65.791348	3062	3142	493	1	80	0.0125000
NODE_465_length_3497_cov_65.791348	3062	3142	495	1	80	0.0125000
NODE_465_length_3497_cov_65.791348	3062	3142	496	1	80	0.0125000
NODE_465_length_3497_cov_65.791348	3062	3142	506	1	80	0.0125000
NODE_465_length_3497_cov_65.791348	3062	3142	514	1	80	0.0125000
NODE_465_length_3497_cov_65.791348	3062	3142	537	1	80	0.0125000
NODE_465_length_3497_cov_65.791348	3062	3142	538	2	80	0.0250000
NODE_465_length_3497_cov_65.791348	3062	3142	540	1	80	0.0125000
NODE_465_length_3497_cov_65.791348	3062	3142	542	1	80	0.0125000
NODE_465_length_3497_cov_65.791348	3062	3142	560	1	80	0.0125000
NODE_465_length_3497_cov_65.791348	3062	3142	562	1	80	0.0125000
NODE_465_length_3497_cov_65.791348	3062	3142	564	1	80	0.0125000
NODE_465_length_3497_cov_65.791348	3062	3142	567	1	80	0.0125000
NODE_465_length_3497_cov_65.791348	3062	3142	575	1	80	0.0125000
NODE_465_length_3497_cov_65.791348	3062	3142	582	1	80	0.0125000
NODE_465_length_3497_cov_65.791348	3062	3142	584	1	80	0.0125000
NODE_465_length_3497_cov_65.791348	3062	3142	586	1	80	0.0125000
NODE_465_length_3497_cov_65.791348	3062	3142	587	2	80	0.0250000
NODE_465_length_3497_cov_65.791348	3062	3142	588	1	80	0.0125000
NODE_465_length_3497_cov_65.791348	3062	3142	599	1	80	0.0125000
NODE_465_length_3497_cov_65.791348	3062	3142	600	1	80	0.0125000
NODE_465_length_3497_cov_65.791348	3062	3142	602	1	80	0.0125000
NODE_465_length_3497_cov_65.791348	3062	3142	605	1	80	0.0125000
NODE_465_length_3497_cov_65.791348	3062	3142	608	2	80	0.0250000
NODE_465_length_3497_cov_65.791348	3062	3142	610	2	80	0.0250000
NODE_465_length_3497_cov_65.791348	3062	3142	611	4	80	0.0500000
NODE_465_length_3497_cov_65.791348	3062	3142	612	2	80	0.0250000
NODE_465_length_3497_cov_65.791348	3062	3142	613	1	80	0.0125000
NODE_465_length_3497_cov_65.791348	3062	3142	614	4	80	0.0500000
NODE_465_length_3497_cov_65.791348	3062	3142	615	1	80	0.0125000
NODE_465_length_3497_cov_65.791348	3062	3142	617	2	80	0.0250000
NODE_465_length_3497_cov_65.791348	3062	3142	618	3	80	0.0375000
NODE_465_length_3497_cov_65.791348	3062	3142	622	1	80	0.0125000
NODE_465_length_3497_cov_65.791348	3062	3142	625	2	80	0.0250000
NODE_465_length_3497_cov_65.791348	3062	3142	627	1	80	0.0125000
NODE_465_length_3497_cov_65.791348	3062	3142	629	1	80	0.0125000
NODE_465_length_3497_cov_65.791348	3062	3142	630	1	80	0.0125000
NODE_465_length_3497_cov_65.791348	3062	3142	633	2	80	0.0250000
NODE_465_length_3497_cov_65.791348	3062	3142	634	3	80	0.0375000
NODE_465_length_3497_cov_65.791348	3062	3142	636	2	80	0.0250000
NODE_465_length_3497_cov_65.791348	3062	3142	637	1	80	0.0125000
NODE_465_length_3497_cov_65.791348	3062	3142	639	3	80	0.0375000
NODE_465_length_3497_cov_65.791348	3062	3142	642	1	80	0.0125000
NODE_465_length_3497_cov_65.791348	3062	3142	643	1	80	0.0125000
NODE_465_length_3497_cov_65.791348	3062	3142	644	1	80	0.0125000
NODE_465_length_3497_cov_65.791348	3062	3142	645	1	80	0.0125000
NODE_465_length_3497_cov_65.791348	3062	3142	646	1	80	0.0125000
NODE_465_length_3497_cov_65.791348	3062	3142	650	1	80	0.0125000
NODE_466_length_3488_cov_2.243730	506	529	0	23	23	1.0000000
NODE_470_length_3483_cov_14.759456	360	440	0	77	80	0.9625000
NODE_470_length_3483_cov_14.759456	360	440	2	3	80	0.0375000
NODE_470_length_3483_cov_14.759456	413	493	0	24	80	0.3000000
NODE_470_length_3483_cov_14.759456	413	493	2	56	80	0.7000000
NODE_474_length_3471_cov_37.887604	2795	2875	0	80	80	1.0000000
NODE_474_length_3471_cov_37.887604	2848	2928	0	80	80	1.0000000
NODE_474_length_3471_cov_37.887604	2924	2943	0	19	19	1.0000000
NODE_474_length_3471_cov_37.887604	2924	3004	0	80	80	1.0000000
NODE_474_length_3471_cov_37.887604	2977	3057	0	80	80	1.0000000
NODE_479_length_3451_cov_29.833234	2973	3053	2	28	80	0.3500000
NODE_479_length_3451_cov_29.833234	2973	3053	4	52	80	0.6500000
NODE_479_length_3451_cov_29.833234	3026	3106	0	6	80	0.0750000
NODE_479_length_3451_cov_29.833234	3026	3106	2	73	80	0.9125000
NODE_479_length_3451_cov_29.833234	3026	3106	4	1	80	0.0125000
NODE_481_length_3446_cov_32.421273	3181	3261	16	7	80	0.0875000
NODE_481_length_3446_cov_32.421273	3181	3261	18	2	80	0.0250000
NODE_481_length_3446_cov_32.421273	3181	3261	20	1	80	0.0125000
NODE_481_length_3446_cov_32.421273	3181	3261	22	3	80	0.0375000
NODE_481_length_3446_cov_32.421273	3181	3261	24	30	80	0.3750000
NODE_481_length_3446_cov_32.421273	3181	3261	25	1	80	0.0125000
NODE_481_length_3446_cov_32.421273	3181	3261	26	13	80	0.1625000
NODE_481_length_3446_cov_32.421273	3181	3261	28	2	80	0.0250000
NODE_481_length_3446_cov_32.421273	3181	3261	30	11	80	0.1375000
NODE_481_length_3446_cov_32.421273	3181	3261	32	1	80	0.0125000
NODE_481_length_3446_cov_32.421273	3181	3261	33	1	80	0.0125000
NODE_481_length_3446_cov_32.421273	3181	3261	34	8	80	0.1000000
NODE_482_length_3444_cov_29.954858	792	872	4	13	80	0.1625000
NODE_482_length_3444_cov_29.954858	792	872	6	2	80	0.0250000
NODE_482_length_3444_cov_29.954858	792	872	8	50	80	0.6250000
NODE_482_length_3444_cov_29.954858	792	872	10	15	80	0.1875000
NODE_482_length_3444_cov_29.954858	845	925	4	37	80	0.4625000
NODE_482_length_3444_cov_29.954858	845	925	6	8	80	0.1000000
NODE_482_length_3444_cov_29.954858	845	925	8	20	80	0.2500000
NODE_482_length_3444_cov_29.954858	845	925	10	15	80	0.1875000
NODE_483_length_3442_cov_17.799880	3155	3220	11	1	65	0.0153846
NODE_483_length_3442_cov_17.799880	3155	3220	27	1	65	0.0153846
NODE_483_length_3442_cov_17.799880	3155	3220	29	2	65	0.0307692
NODE_483_length_3442_cov_17.799880	3155	3220	31	1	65	0.0153846
NODE_483_length_3442_cov_17.799880	3155	3220	33	2	65	0.0307692
NODE_483_length_3442_cov_17.799880	3155	3220	35	1	65	0.0153846
NODE_483_length_3442_cov_17.799880	3155	3220	37	1	65	0.0153846
NODE_483_length_3442_cov_17.799880	3155	3220	41	1	65	0.0153846
NODE_483_length_3442_cov_17.799880	3155	3220	48	1	65	0.0153846
NODE_483_length_3442_cov_17.799880	3155	3220	52	3	65	0.0461538
NODE_483_length_3442_cov_17.799880	3155	3220	56	1	65	0.0153846
NODE_483_length_3442_cov_17.799880	3155	3220	58	1	65	0.0153846
NODE_483_length_3442_cov_17.799880	3155	3220	60	1	65	0.0153846
NODE_483_length_3442_cov_17.799880	3155	3220	81	1	65	0.0153846
NODE_483_length_3442_cov_17.799880	3155	3220	92	1	65	0.0153846
NODE_483_length_3442_cov_17.799880	3155	3220	96	1	65	0.0153846
NODE_483_length_3442_cov_17.799880	3155	3220	102	1	65	0.0153846
NODE_483_length_3442_cov_17.799880	3155	3220	107	2	65	0.0307692
NODE_483_length_3442_cov_17.799880	3155	3220	115	2	65	0.0307692
NODE_483_length_3442_cov_17.799880	3155	3220	117	1	65	0.0153846
NODE_483_length_3442_cov_17.799880	3155	3220	119	1	65	0.0153846
NODE_483_length_3442_cov_17.799880	3155	3220	123	1	65	0.0153846
NODE_483_length_3442_cov_17.799880	3155	3220	129	1	65	0.0153846
NODE_483_length_3442_cov_17.799880	3155	3220	132	1	65	0.0153846
NODE_483_length_3442_cov_17.799880	3155	3220	143	1	65	0.0153846
NODE_483_length_3442_cov_17.799880	3155	3220	153	2	65	0.0307692
NODE_483_length_3442_cov_17.799880	3155	3220	167	1	65	0.0153846
NODE_483_length_3442_cov_17.799880	3155	3220	169	1	65	0.0153846
NODE_483_length_3442_cov_17.799880	3155	3220	171	1	65	0.0153846
NODE_483_length_3442_cov_17.799880	3155	3220	177	1	65	0.0153846
NODE_483_length_3442_cov_17.799880	3155	3220	183	7	65	0.1076923
NODE_483_length_3442_cov_17.799880	3155	3220	185	1	65	0.0153846
NODE_483_length_3442_cov_17.799880	3155	3220	186	1	65	0.0153846
NODE_483_length_3442_cov_17.799880	3155	3220	187	3	65	0.0461538
NODE_483_length_3442_cov_17.799880	3155	3220	191	3	65	0.0461538
NODE_483_length_3442_cov_17.799880	3155	3220	193	2	65	0.0307692
NODE_483_length_3442_cov_17.799880	3155	3220	195	4	65	0.0615385
NODE_483_length_3442_cov_17.799880	3155	3220	197	2	65	0.0307692
NODE_483_length_3442_cov_17.799880	3155	3220	199	5	65	0.0769231
NODE_483_length_3442_cov_17.799880	3208	3273	193	1	65	0.0153846
NODE_483_length_3442_cov_17.799880	3208	3273	195	4	65	0.0615385
NODE_483_length_3442_cov_17.799880	3208	3273	197	2	65	0.0307692
NODE_483_length_3442_cov_17.799880	3208	3273	199	8	65	0.1230769
NODE_483_length_3442_cov_17.799880	3208	3273	201	8	65	0.1230769
NODE_483_length_3442_cov_17.799880	3208	3273	206	4	65	0.0615385
NODE_483_length_3442_cov_17.799880	3208	3273	208	1	65	0.0153846
NODE_483_length_3442_cov_17.799880	3208	3273	216	3	65	0.0461538
NODE_483_length_3442_cov_17.799880	3208	3273	220	1	65	0.0153846
NODE_483_length_3442_cov_17.799880	3208	3273	222	1	65	0.0153846
NODE_483_length_3442_cov_17.799880	3208	3273	228	7	65	0.1076923
NODE_483_length_3442_cov_17.799880	3208	3273	230	1	65	0.0153846
NODE_483_length_3442_cov_17.799880	3208	3273	235	2	65	0.0307692
NODE_483_length_3442_cov_17.799880	3208	3273	236	2	65	0.0307692
NODE_483_length_3442_cov_17.799880	3208	3273	239	3	65	0.0461538
NODE_483_length_3442_cov_17.799880	3208	3273	240	4	65	0.0615385
NODE_483_length_3442_cov_17.799880	3208	3273	241	3	65	0.0461538
NODE_483_length_3442_cov_17.799880	3208	3273	242	8	65	0.1230769
NODE_483_length_3442_cov_17.799880	3208	3273	244	2	65	0.0307692
NODE_486_length_3429_cov_5.070270	125	148	44	5	23	0.2173913
NODE_486_length_3429_cov_5.070270	125	148	46	7	23	0.3043478
NODE_486_length_3429_cov_5.070270	125	148	48	11	23	0.4782609
NODE_493_length_3408_cov_2.406769	0	45	0	45	45	1.0000000
NODE_495_length_3405_cov_44.930127	2683	2759	0	65	76	0.8552632
NODE_495_length_3405_cov_44.930127	2683	2759	2	11	76	0.1447368
NODE_495_length_3405_cov_44.930127	3116	3164	2	48	48	1.0000000
NODE_496_length_3402_cov_28.961550	128	183	0	55	55	1.0000000
NODE_496_length_3402_cov_28.961550	3154	3234	33	1	80	0.0125000
NODE_496_length_3402_cov_28.961550	3154	3234	35	1	80	0.0125000
NODE_496_length_3402_cov_28.961550	3154	3234	37	2	80	0.0250000
NODE_496_length_3402_cov_28.961550	3154	3234	39	1	80	0.0125000
NODE_496_length_3402_cov_28.961550	3154	3234	43	13	80	0.1625000
NODE_496_length_3402_cov_28.961550	3154	3234	45	27	80	0.3375000
NODE_496_length_3402_cov_28.961550	3154	3234	46	4	80	0.0500000
NODE_496_length_3402_cov_28.961550	3154	3234	47	31	80	0.3875000
NODE_496_length_3402_cov_28.961550	3207	3287	0	2	80	0.0250000
NODE_496_length_3402_cov_28.961550	3207	3287	2	1	80	0.0125000
NODE_496_length_3402_cov_28.961550	3207	3287	6	3	80	0.0375000
NODE_496_length_3402_cov_28.961550	3207	3287	8	4	80	0.0500000
NODE_496_length_3402_cov_28.961550	3207	3287	12	17	80	0.2125000
NODE_496_length_3402_cov_28.961550	3207	3287	13	7	80	0.0875000
NODE_496_length_3402_cov_28.961550	3207	3287	15	2	80	0.0250000
NODE_496_length_3402_cov_28.961550	3207	3287	16	4	80	0.0500000
NODE_496_length_3402_cov_28.961550	3207	3287	18	1	80	0.0125000
NODE_496_length_3402_cov_28.961550	3207	3287	22	9	80	0.1125000
NODE_496_length_3402_cov_28.961550	3207	3287	24	1	80	0.0125000
NODE_496_length_3402_cov_28.961550	3207	3287	30	1	80	0.0125000
NODE_496_length_3402_cov_28.961550	3207	3287	32	1	80	0.0125000
NODE_496_length_3402_cov_28.961550	3207	3287	33	1	80	0.0125000
NODE_496_length_3402_cov_28.961550	3207	3287	35	1	80	0.0125000
NODE_496_length_3402_cov_28.961550	3207	3287	37	2	80	0.0250000
NODE_496_length_3402_cov_28.961550	3207	3287	39	1	80	0.0125000
NODE_496_length_3402_cov_28.961550	3207	3287	43	12	80	0.1500000
NODE_496_length_3402_cov_28.961550	3207	3287	45	3	80	0.0375000
NODE_496_length_3402_cov_28.961550	3207	3287	46	4	80	0.0500000
NODE_496_length_3402_cov_28.961550	3207	3287	47	3	80	0.0375000
NODE_498_length_3393_cov_43.623558	1009	1075	19	1	66	0.0151515
NODE_498_length_3393_cov_43.623558	1009	1075	26	1	66	0.0151515
NODE_498_length_3393_cov_43.623558	1009	1075	30	1	66	0.0151515
NODE_498_length_3393_cov_43.623558	1009	1075	39	1	66	0.0151515
NODE_498_length_3393_cov_43.623558	1009	1075	43	1	66	0.0151515
NODE_498_length_3393_cov_43.623558	1009	1075	47	1	66	0.0151515
NODE_498_length_3393_cov_43.623558	1009	1075	53	2	66	0.0303030
NODE_498_length_3393_cov_43.623558	1009	1075	57	1	66	0.0151515
NODE_498_length_3393_cov_43.623558	1009	1075	62	1	66	0.0151515
NODE_498_length_3393_cov_43.623558	1009	1075	75	2	66	0.0303030
NODE_498_length_3393_cov_43.623558	1009	1075	79	1	66	0.0151515
NODE_498_length_3393_cov_43.623558	1009	1075	85	1	66	0.0151515
NODE_498_length_3393_cov_43.623558	1009	1075	88	5	66	0.0757576
NODE_498_length_3393_cov_43.623558	1009	1075	89	1	66	0.0151515
NODE_498_length_3393_cov_43.623558	1009	1075	99	1	66	0.0151515
NODE_498_length_3393_cov_43.623558	1009	1075	110	1	66	0.0151515
NODE_498_length_3393_cov_43.623558	1009	1075	114	1	66	0.0151515
NODE_498_length_3393_cov_43.623558	1009	1075	120	1	66	0.0151515
NODE_498_length_3393_cov_43.623558	1009	1075	124	1	66	0.0151515
NODE_498_length_3393_cov_43.623558	1009	1075	126	1	66	0.0151515
NODE_498_length_3393_cov_43.623558	1009	1075	135	1	66	0.0151515
NODE_498_length_3393_cov_43.623558	1009	1075	143	1	66	0.0151515
NODE_498_length_3393_cov_43.623558	1009	1075	145	1	66	0.0151515
NODE_498_length_3393_cov_43.623558	1009	1075	152	1	66	0.0151515
NODE_498_length_3393_cov_43.623558	1009	1075	157	1	66	0.0151515
NODE_498_length_3393_cov_43.623558	1009	1075	174	1	66	0.0151515
NODE_498_length_3393_cov_43.623558	1009	1075	176	1	66	0.0151515
NODE_498_length_3393_cov_43.623558	1009	1075	180	1	66	0.0151515
NODE_498_length_3393_cov_43.623558	1009	1075	182	1	66	0.0151515
NODE_498_length_3393_cov_43.623558	1009	1075	184	1	66	0.0151515
NODE_498_length_3393_cov_43.623558	1009	1075	191	1	66	0.0151515
NODE_498_length_3393_cov_43.623558	1009	1075	192	1	66	0.0151515
NODE_498_length_3393_cov_43.623558	1009	1075	193	1	66	0.0151515
NODE_498_length_3393_cov_43.623558	1009	1075	196	1	66	0.0151515
NODE_498_length_3393_cov_43.623558	1009	1075	210	1	66	0.0151515
NODE_498_length_3393_cov_43.623558	1009	1075	220	1	66	0.0151515
NODE_498_length_3393_cov_43.623558	1009	1075	225	1	66	0.0151515
NODE_498_length_3393_cov_43.623558	1009	1075	226	1	66	0.0151515
NODE_498_length_3393_cov_43.623558	1009	1075	230	1	66	0.0151515
NODE_498_length_3393_cov_43.623558	1009	1075	232	1	66	0.0151515
NODE_498_length_3393_cov_43.623558	1009	1075	234	1	66	0.0151515
NODE_498_length_3393_cov_43.623558	1009	1075	238	1	66	0.0151515
NODE_498_length_3393_cov_43.623558	1009	1075	239	2	66	0.0303030
NODE_498_length_3393_cov_43.623558	1009	1075	241	2	66	0.0303030
NODE_498_length_3393_cov_43.623558	1009	1075	242	1	66	0.0151515
NODE_498_length_3393_cov_43.623558	1009	1075	249	1	66	0.0151515
NODE_498_length_3393_cov_43.623558	1009	1075	250	2	66	0.0303030
NODE_498_length_3393_cov_43.623558	1009	1075	251	1	66	0.0151515
NODE_498_length_3393_cov_43.623558	1009	1075	252	1	66	0.0151515
NODE_498_length_3393_cov_43.623558	1009	1075	254	1	66	0.0151515
NODE_498_length_3393_cov_43.623558	1009	1075	256	2	66	0.0303030
NODE_498_length_3393_cov_43.623558	1009	1075	258	1	66	0.0151515
NODE_498_length_3393_cov_43.623558	1009	1075	266	3	66	0.0454545
NODE_498_length_3393_cov_43.623558	1009	1075	271	1	66	0.0151515
NODE_498_length_3393_cov_43.623558	1048	1128	4	9	80	0.1125000
NODE_498_length_3393_cov_43.623558	1048	1128	5	3	80	0.0375000
NODE_498_length_3393_cov_43.623558	1048	1128	6	35	80	0.4375000
NODE_498_length_3393_cov_43.623558	1048	1128	7	1	80	0.0125000
NODE_498_length_3393_cov_43.623558	1048	1128	8	3	80	0.0375000
NODE_498_length_3393_cov_43.623558	1048	1128	12	1	80	0.0125000
NODE_498_length_3393_cov_43.623558	1048	1128	18	1	80	0.0125000
NODE_498_length_3393_cov_43.623558	1048	1128	19	1	80	0.0125000
NODE_498_length_3393_cov_43.623558	1048	1128	26	1	80	0.0125000
NODE_498_length_3393_cov_43.623558	1048	1128	30	1	80	0.0125000
NODE_498_length_3393_cov_43.623558	1048	1128	39	1	80	0.0125000
NODE_498_length_3393_cov_43.623558	1048	1128	43	1	80	0.0125000
NODE_498_length_3393_cov_43.623558	1048	1128	47	1	80	0.0125000
NODE_498_length_3393_cov_43.623558	1048	1128	53	2	80	0.0250000
NODE_498_length_3393_cov_43.623558	1048	1128	57	1	80	0.0125000
NODE_498_length_3393_cov_43.623558	1048	1128	62	1	80	0.0125000
NODE_498_length_3393_cov_43.623558	1048	1128	75	2	80	0.0250000
NODE_498_length_3393_cov_43.623558	1048	1128	79	1	80	0.0125000
NODE_498_length_3393_cov_43.623558	1048	1128	85	1	80	0.0125000
NODE_498_length_3393_cov_43.623558	1048	1128	88	5	80	0.0625000
NODE_498_length_3393_cov_43.623558	1048	1128	89	1	80	0.0125000
NODE_498_length_3393_cov_43.623558	1048	1128	99	1	80	0.0125000
NODE_498_length_3393_cov_43.623558	1048	1128	110	1	80	0.0125000
NODE_498_length_3393_cov_43.623558	1048	1128	114	1	80	0.0125000
NODE_498_length_3393_cov_43.623558	1048	1128	120	1	80	0.0125000
NODE_498_length_3393_cov_43.623558	1048	1128	124	1	80	0.0125000
NODE_498_length_3393_cov_43.623558	1048	1128	126	1	80	0.0125000
NODE_498_length_3393_cov_43.623558	1048	1128	135	1	80	0.0125000
NODE_498_length_3393_cov_43.623558	3086	3128	23	1	42	0.0238095
NODE_498_length_3393_cov_43.623558	3086	3128	45	1	42	0.0238095
NODE_498_length_3393_cov_43.623558	3086	3128	47	1	42	0.0238095
NODE_498_length_3393_cov_43.623558	3086	3128	68	1	42	0.0238095
NODE_498_length_3393_cov_43.623558	3086	3128	73	1	42	0.0238095
NODE_498_length_3393_cov_43.623558	3086	3128	95	1	42	0.0238095
NODE_498_length_3393_cov_43.623558	3086	3128	99	1	42	0.0238095
NODE_498_length_3393_cov_43.623558	3086	3128	109	1	42	0.0238095
NODE_498_length_3393_cov_43.623558	3086	3128	117	1	42	0.0238095
NODE_498_length_3393_cov_43.623558	3086	3128	119	1	42	0.0238095
NODE_498_length_3393_cov_43.623558	3086	3128	121	1	42	0.0238095
NODE_498_length_3393_cov_43.623558	3086	3128	122	2	42	0.0476190
NODE_498_length_3393_cov_43.623558	3086	3128	124	1	42	0.0238095
NODE_498_length_3393_cov_43.623558	3086	3128	126	1	42	0.0238095
NODE_498_length_3393_cov_43.623558	3086	3128	134	1	42	0.0238095
NODE_498_length_3393_cov_43.623558	3086	3128	140	1	42	0.0238095
NODE_498_length_3393_cov_43.623558	3086	3128	142	1	42	0.0238095
NODE_498_length_3393_cov_43.623558	3086	3128	147	1	42	0.0238095
NODE_498_length_3393_cov_43.623558	3086	3128	149	1	42	0.0238095
NODE_498_length_3393_cov_43.623558	3086	3128	160	1	42	0.0238095
NODE_498_length_3393_cov_43.623558	3086	3128	170	1	42	0.0238095
NODE_498_length_3393_cov_43.623558	3086	3128	176	1	42	0.0238095
NODE_498_length_3393_cov_43.623558	3086	3128	178	1	42	0.0238095
NODE_498_length_3393_cov_43.623558	3086	3128	185	1	42	0.0238095
NODE_498_length_3393_cov_43.623558	3086	3128	193	1	42	0.0238095
NODE_498_length_3393_cov_43.623558	3086	3128	207	1	42	0.0238095
NODE_498_length_3393_cov_43.623558	3086	3128	208	2	42	0.0476190
NODE_498_length_3393_cov_43.623558	3086	3128	212	1	42	0.0238095
NODE_498_length_3393_cov_43.623558	3086	3128	215	1	42	0.0238095
NODE_498_length_3393_cov_43.623558	3086	3128	227	1	42	0.0238095
NODE_498_length_3393_cov_43.623558	3086	3128	234	2	42	0.0476190
NODE_498_length_3393_cov_43.623558	3086	3128	236	1	42	0.0238095
NODE_498_length_3393_cov_43.623558	3086	3128	255	1	42	0.0238095
NODE_498_length_3393_cov_43.623558	3086	3128	257	1	42	0.0238095
NODE_498_length_3393_cov_43.623558	3086	3128	270	1	42	0.0238095
NODE_498_length_3393_cov_43.623558	3086	3128	276	1	42	0.0238095
NODE_498_length_3393_cov_43.623558	3086	3128	281	2	42	0.0476190
NODE_498_length_3393_cov_43.623558	3086	3128	283	1	42	0.0238095
NODE_498_length_3393_cov_43.623558	3293	3373	137	1	80	0.0125000
NODE_498_length_3393_cov_43.623558	3293	3373	138	1	80	0.0125000
NODE_498_length_3393_cov_43.623558	3293	3373	155	1	80	0.0125000
NODE_498_length_3393_cov_43.623558	3293	3373	167	1	80	0.0125000
NODE_498_length_3393_cov_43.623558	3293	3373	182	1	80	0.0125000
NODE_498_length_3393_cov_43.623558	3293	3373	206	1	80	0.0125000
NODE_498_length_3393_cov_43.623558	3293	3373	209	1	80	0.0125000
NODE_498_length_3393_cov_43.623558	3293	3373	210	1	80	0.0125000
NODE_498_length_3393_cov_43.623558	3293	3373	216	1	80	0.0125000
NODE_498_length_3393_cov_43.623558	3293	3373	221	1	80	0.0125000
NODE_498_length_3393_cov_43.623558	3293	3373	235	2	80	0.0250000
NODE_498_length_3393_cov_43.623558	3293	3373	255	1	80	0.0125000
NODE_498_length_3393_cov_43.623558	3293	3373	257	1	80	0.0125000
NODE_498_length_3393_cov_43.623558	3293	3373	272	1	80	0.0125000
NODE_498_length_3393_cov_43.623558	3293	3373	273	1	80	0.0125000
NODE_498_length_3393_cov_43.623558	3293	3373	285	1	80	0.0125000
NODE_498_length_3393_cov_43.623558	3293	3373	296	1	80	0.0125000
NODE_498_length_3393_cov_43.623558	3293	3373	316	1	80	0.0125000
NODE_498_length_3393_cov_43.623558	3293	3373	321	1	80	0.0125000
NODE_498_length_3393_cov_43.623558	3293	3373	334	1	80	0.0125000
NODE_498_length_3393_cov_43.623558	3293	3373	354	1	80	0.0125000
NODE_498_length_3393_cov_43.623558	3293	3373	359	1	80	0.0125000
NODE_498_length_3393_cov_43.623558	3293	3373	364	1	80	0.0125000
NODE_498_length_3393_cov_43.623558	3293	3373	380	1	80	0.0125000
NODE_498_length_3393_cov_43.623558	3293	3373	410	1	80	0.0125000
NODE_498_length_3393_cov_43.623558	3293	3373	420	1	80	0.0125000
NODE_498_length_3393_cov_43.623558	3293	3373	426	1	80	0.0125000
NODE_498_length_3393_cov_43.623558	3293	3373	428	2	80	0.0250000
NODE_498_length_3393_cov_43.623558	3293	3373	430	1	80	0.0125000
NODE_498_length_3393_cov_43.623558	3293	3373	432	1	80	0.0125000
NODE_498_length_3393_cov_43.623558	3293	3373	438	1	80	0.0125000
NODE_498_length_3393_cov_43.623558	3293	3373	440	1	80	0.0125000
NODE_498_length_3393_cov_43.623558	3293	3373	458	1	80	0.0125000
NODE_498_length_3393_cov_43.623558	3293	3373	465	1	80	0.0125000
NODE_498_length_3393_cov_43.623558	3293	3373	474	2	80	0.0250000
NODE_498_length_3393_cov_43.623558	3293	3373	489	1	80	0.0125000
NODE_498_length_3393_cov_43.623558	3293	3373	493	1	80	0.0125000
NODE_498_length_3393_cov_43.623558	3293	3373	495	2	80	0.0250000
NODE_498_length_3393_cov_43.623558	3293	3373	497	2	80	0.0250000
NODE_498_length_3393_cov_43.623558	3293	3373	498	1	80	0.0125000
NODE_498_length_3393_cov_43.623558	3293	3373	499	1	80	0.0125000
NODE_498_length_3393_cov_43.623558	3293	3373	507	1	80	0.0125000
NODE_498_length_3393_cov_43.623558	3293	3373	509	1	80	0.0125000
NODE_498_length_3393_cov_43.623558	3293	3373	515	1	80	0.0125000
NODE_498_length_3393_cov_43.623558	3293	3373	516	1	80	0.0125000
NODE_498_length_3393_cov_43.623558	3293	3373	524	2	80	0.0250000
NODE_498_length_3393_cov_43.623558	3293	3373	528	1	80	0.0125000
NODE_498_length_3393_cov_43.623558	3293	3373	529	1	80	0.0125000
NODE_498_length_3393_cov_43.623558	3293	3373	535	2	80	0.0250000
NODE_498_length_3393_cov_43.623558	3293	3373	540	1	80	0.0125000
NODE_498_length_3393_cov_43.623558	3293	3373	542	1	80	0.0125000
NODE_498_length_3393_cov_43.623558	3293	3373	547	2	80	0.0250000
NODE_498_length_3393_cov_43.623558	3293	3373	549	1	80	0.0125000
NODE_498_length_3393_cov_43.623558	3293	3373	551	1	80	0.0125000
NODE_498_length_3393_cov_43.623558	3293	3373	555	1	80	0.0125000
NODE_498_length_3393_cov_43.623558	3293	3373	559	1	80	0.0125000
NODE_498_length_3393_cov_43.623558	3293	3373	565	1	80	0.0125000
NODE_498_length_3393_cov_43.623558	3293	3373	570	1	80	0.0125000
NODE_498_length_3393_cov_43.623558	3293	3373	571	1	80	0.0125000
NODE_498_length_3393_cov_43.623558	3293	3373	579	1	80	0.0125000
NODE_498_length_3393_cov_43.623558	3293	3373	581	1	80	0.0125000
NODE_498_length_3393_cov_43.623558	3293	3373	589	1	80	0.0125000
NODE_498_length_3393_cov_43.623558	3293	3373	590	1	80	0.0125000
NODE_498_length_3393_cov_43.623558	3293	3373	598	1	80	0.0125000
NODE_498_length_3393_cov_43.623558	3293	3373	604	1	80	0.0125000
NODE_498_length_3393_cov_43.623558	3293	3373	608	1	80	0.0125000
NODE_498_length_3393_cov_43.623558	3293	3373	613	1	80	0.0125000
NODE_498_length_3393_cov_43.623558	3293	3373	617	1	80	0.0125000
NODE_498_length_3393_cov_43.623558	3293	3373	620	1	80	0.0125000
NODE_498_length_3393_cov_43.623558	3293	3373	622	1	80	0.0125000
NODE_498_length_3393_cov_43.623558	3293	3373	629	1	80	0.0125000
NODE_498_length_3393_cov_43.623558	3293	3373	631	1	80	0.0125000
NODE_499_length_3392_cov_41.514728	255	335	0	80	80	1.0000000
NODE_499_length_3392_cov_41.514728	308	388	0	80	80	1.0000000
NODE_499_length_3392_cov_41.514728	917	997	182	2	80	0.0250000
NODE_499_length_3392_cov_41.514728	917	997	183	1	80	0.0125000
NODE_499_length_3392_cov_41.514728	917	997	190	1	80	0.0125000
NODE_499_length_3392_cov_41.514728	917	997	206	1	80	0.0125000
NODE_499_length_3392_cov_41.514728	917	997	216	2	80	0.0250000
NODE_499_length_3392_cov_41.514728	917	997	218	1	80	0.0125000
NODE_499_length_3392_cov_41.514728	917	997	219	1	80	0.0125000
NODE_499_length_3392_cov_41.514728	917	997	222	1	80	0.0125000
NODE_499_length_3392_cov_41.514728	917	997	231	2	80	0.0250000
NODE_499_length_3392_cov_41.514728	917	997	243	1	80	0.0125000
NODE_499_length_3392_cov_41.514728	917	997	251	2	80	0.0250000
NODE_499_length_3392_cov_41.514728	917	997	255	1	80	0.0125000
NODE_499_length_3392_cov_41.514728	917	997	261	1	80	0.0125000
NODE_499_length_3392_cov_41.514728	917	997	269	1	80	0.0125000
NODE_499_length_3392_cov_41.514728	917	997	286	1	80	0.0125000
NODE_499_length_3392_cov_41.514728	917	997	311	1	80	0.0125000
NODE_499_length_3392_cov_41.514728	917	997	314	2	80	0.0250000
NODE_499_length_3392_cov_41.514728	917	997	317	1	80	0.0125000
NODE_499_length_3392_cov_41.514728	917	997	321	1	80	0.0125000
NODE_499_length_3392_cov_41.514728	917	997	334	1	80	0.0125000
NODE_499_length_3392_cov_41.514728	917	997	335	1	80	0.0125000
NODE_499_length_3392_cov_41.514728	917	997	340	1	80	0.0125000
NODE_499_length_3392_cov_41.514728	917	997	350	2	80	0.0250000
NODE_499_length_3392_cov_41.514728	917	997	363	2	80	0.0250000
NODE_499_length_3392_cov_41.514728	917	997	364	1	80	0.0125000
NODE_499_length_3392_cov_41.514728	917	997	377	1	80	0.0125000
NODE_499_length_3392_cov_41.514728	917	997	381	1	80	0.0125000
NODE_499_length_3392_cov_41.514728	917	997	386	1	80	0.0125000
NODE_499_length_3392_cov_41.514728	917	997	391	1	80	0.0125000
NODE_499_length_3392_cov_41.514728	917	997	404	1	80	0.0125000
NODE_499_length_3392_cov_41.514728	917	997	408	1	80	0.0125000
NODE_499_length_3392_cov_41.514728	917	997	414	1	80	0.0125000
NODE_499_length_3392_cov_41.514728	917	997	425	1	80	0.0125000
NODE_499_length_3392_cov_41.514728	917	997	432	1	80	0.0125000
NODE_499_length_3392_cov_41.514728	917	997	435	1	80	0.0125000
NODE_499_length_3392_cov_41.514728	917	997	440	2	80	0.0250000
NODE_499_length_3392_cov_41.514728	917	997	442	1	80	0.0125000
NODE_499_length_3392_cov_41.514728	917	997	451	1	80	0.0125000
NODE_499_length_3392_cov_41.514728	917	997	466	1	80	0.0125000
NODE_499_length_3392_cov_41.514728	917	997	467	1	80	0.0125000
NODE_499_length_3392_cov_41.514728	917	997	468	1	80	0.0125000
NODE_499_length_3392_cov_41.514728	917	997	470	2	80	0.0250000
NODE_499_length_3392_cov_41.514728	917	997	481	1	80	0.0125000
NODE_499_length_3392_cov_41.514728	917	997	489	2	80	0.0250000
NODE_499_length_3392_cov_41.514728	917	997	491	1	80	0.0125000
NODE_499_length_3392_cov_41.514728	917	997	503	1	80	0.0125000
NODE_499_length_3392_cov_41.514728	917	997	508	1	80	0.0125000
NODE_499_length_3392_cov_41.514728	917	997	517	1	80	0.0125000
NODE_499_length_3392_cov_41.514728	917	997	523	1	80	0.0125000
NODE_499_length_3392_cov_41.514728	917	997	529	1	80	0.0125000
NODE_499_length_3392_cov_41.514728	917	997	530	1	80	0.0125000
NODE_499_length_3392_cov_41.514728	917	997	536	1	80	0.0125000
NODE_499_length_3392_cov_41.514728	917	997	541	1	80	0.0125000
NODE_499_length_3392_cov_41.514728	917	997	551	1	80	0.0125000
NODE_499_length_3392_cov_41.514728	917	997	552	1	80	0.0125000
NODE_499_length_3392_cov_41.514728	917	997	557	1	80	0.0125000
NODE_499_length_3392_cov_41.514728	917	997	563	1	80	0.0125000
NODE_499_length_3392_cov_41.514728	917	997	568	1	80	0.0125000
NODE_499_length_3392_cov_41.514728	917	997	574	1	80	0.0125000
NODE_499_length_3392_cov_41.514728	917	997	579	1	80	0.0125000
NODE_499_length_3392_cov_41.514728	917	997	581	1	80	0.0125000
NODE_499_length_3392_cov_41.514728	917	997	582	1	80	0.0125000
NODE_499_length_3392_cov_41.514728	917	997	583	1	80	0.0125000
NODE_499_length_3392_cov_41.514728	917	997	584	1	80	0.0125000
NODE_499_length_3392_cov_41.514728	917	997	589	1	80	0.0125000
NODE_499_length_3392_cov_41.514728	917	997	593	1	80	0.0125000
NODE_499_length_3392_cov_41.514728	917	997	594	2	80	0.0250000
NODE_499_length_3392_cov_41.514728	917	997	595	1	80	0.0125000
NODE_499_length_3392_cov_41.514728	917	997	596	1	80	0.0125000
NODE_499_length_3392_cov_41.514728	970	1053	116	1	83	0.0120482
NODE_499_length_3392_cov_41.514728	970	1053	118	1	83	0.0120482
NODE_499_length_3392_cov_41.514728	970	1053	119	2	83	0.0240964
NODE_499_length_3392_cov_41.514728	970	1053	120	5	83	0.0602410
NODE_499_length_3392_cov_41.514728	970	1053	121	7	83	0.0843373
NODE_499_length_3392_cov_41.514728	970	1053	123	2	83	0.0240964
NODE_499_length_3392_cov_41.514728	970	1053	124	2	83	0.0240964
NODE_499_length_3392_cov_41.514728	970	1053	125	4	83	0.0481928
NODE_499_length_3392_cov_41.514728	970	1053	126	1	83	0.0120482
NODE_499_length_3392_cov_41.514728	970	1053	127	3	83	0.0361446
NODE_499_length_3392_cov_41.514728	970	1053	128	1	83	0.0120482
NODE_499_length_3392_cov_41.514728	970	1053	130	1	83	0.0120482
NODE_499_length_3392_cov_41.514728	970	1053	132	3	83	0.0361446
NODE_499_length_3392_cov_41.514728	970	1053	133	1	83	0.0120482
NODE_499_length_3392_cov_41.514728	970	1053	136	1	83	0.0120482
NODE_499_length_3392_cov_41.514728	970	1053	140	1	83	0.0120482
NODE_499_length_3392_cov_41.514728	970	1053	141	4	83	0.0481928
NODE_499_length_3392_cov_41.514728	970	1053	147	1	83	0.0120482
NODE_499_length_3392_cov_41.514728	970	1053	149	1	83	0.0120482
NODE_499_length_3392_cov_41.514728	970	1053	150	1	83	0.0120482
NODE_499_length_3392_cov_41.514728	970	1053	154	1	83	0.0120482
NODE_499_length_3392_cov_41.514728	970	1053	156	1	83	0.0120482
NODE_499_length_3392_cov_41.514728	970	1053	157	3	83	0.0361446
NODE_499_length_3392_cov_41.514728	970	1053	161	4	83	0.0481928
NODE_499_length_3392_cov_41.514728	970	1053	163	1	83	0.0120482
NODE_499_length_3392_cov_41.514728	970	1053	165	1	83	0.0120482
NODE_499_length_3392_cov_41.514728	970	1053	172	1	83	0.0120482
NODE_499_length_3392_cov_41.514728	970	1053	179	1	83	0.0120482
NODE_499_length_3392_cov_41.514728	970	1053	182	2	83	0.0240964
NODE_499_length_3392_cov_41.514728	970	1053	183	1	83	0.0120482
NODE_499_length_3392_cov_41.514728	970	1053	190	1	83	0.0120482
NODE_499_length_3392_cov_41.514728	970	1053	206	1	83	0.0120482
NODE_499_length_3392_cov_41.514728	970	1053	216	2	83	0.0240964
NODE_499_length_3392_cov_41.514728	970	1053	218	1	83	0.0120482
NODE_499_length_3392_cov_41.514728	970	1053	219	1	83	0.0120482
NODE_499_length_3392_cov_41.514728	970	1053	222	1	83	0.0120482
NODE_499_length_3392_cov_41.514728	970	1053	231	2	83	0.0240964
NODE_499_length_3392_cov_41.514728	970	1053	243	1	83	0.0120482
NODE_499_length_3392_cov_41.514728	970	1053	251	2	83	0.0240964
NODE_499_length_3392_cov_41.514728	970	1053	255	1	83	0.0120482
NODE_499_length_3392_cov_41.514728	970	1053	261	1	83	0.0120482
NODE_499_length_3392_cov_41.514728	970	1053	269	1	83	0.0120482
NODE_499_length_3392_cov_41.514728	970	1053	286	1	83	0.0120482
NODE_499_length_3392_cov_41.514728	970	1053	311	1	83	0.0120482
NODE_499_length_3392_cov_41.514728	970	1053	314	2	83	0.0240964
NODE_499_length_3392_cov_41.514728	970	1053	317	1	83	0.0120482
NODE_499_length_3392_cov_41.514728	970	1053	321	1	83	0.0120482
NODE_499_length_3392_cov_41.514728	970	1053	334	1	83	0.0120482
NODE_499_length_3392_cov_41.514728	970	1053	335	1	83	0.0120482
NODE_499_length_3392_cov_41.514728	970	1053	340	1	83	0.0120482
NODE_501_length_3389_cov_8.244073	2159	2239	0	4	80	0.0500000
NODE_501_length_3389_cov_8.244073	2159	2239	4	76	80	0.9500000
NODE_501_length_3389_cov_8.244073	2212	2292	0	16	80	0.2000000
NODE_501_length_3389_cov_8.244073	2212	2292	4	64	80	0.8000000
NODE_506_length_3363_cov_4.412684	56	124	18	1	68	0.0147059
NODE_506_length_3363_cov_4.412684	56	124	20	1	68	0.0147059
NODE_506_length_3363_cov_4.412684	56	124	22	1	68	0.0147059
NODE_506_length_3363_cov_4.412684	56	124	30	1	68	0.0147059
NODE_506_length_3363_cov_4.412684	56	124	42	3	68	0.0441176
NODE_506_length_3363_cov_4.412684	56	124	44	2	68	0.0294118
NODE_506_length_3363_cov_4.412684	56	124	54	1	68	0.0147059
NODE_506_length_3363_cov_4.412684	56	124	70	1	68	0.0147059
NODE_506_length_3363_cov_4.412684	56	124	74	1	68	0.0147059
NODE_506_length_3363_cov_4.412684	56	124	76	2	68	0.0294118
NODE_506_length_3363_cov_4.412684	56	124	78	1	68	0.0147059
NODE_506_length_3363_cov_4.412684	56	124	80	53	68	0.7794118
NODE_510_length_3353_cov_2.687462	0	61	0	61	61	1.0000000
NODE_510_length_3353_cov_2.687462	0	61	0	61	61	1.0000000
NODE_510_length_3353_cov_2.687462	34	99	0	65	65	1.0000000
NODE_513_length_3348_cov_243.959372	2473	2553	490	1	80	0.0125000
NODE_513_length_3348_cov_243.959372	2473	2553	495	1	80	0.0125000
NODE_513_length_3348_cov_243.959372	2473	2553	496	1	80	0.0125000
NODE_513_length_3348_cov_243.959372	2473	2553	498	1	80	0.0125000
NODE_513_length_3348_cov_243.959372	2473	2553	499	1	80	0.0125000
NODE_513_length_3348_cov_243.959372	2473	2553	501	1	80	0.0125000
NODE_513_length_3348_cov_243.959372	2473	2553	504	1	80	0.0125000
NODE_513_length_3348_cov_243.959372	2473	2553	507	1	80	0.0125000
NODE_513_length_3348_cov_243.959372	2473	2553	508	2	80	0.0250000
NODE_513_length_3348_cov_243.959372	2473	2553	509	1	80	0.0125000
NODE_513_length_3348_cov_243.959372	2473	2553	510	2	80	0.0250000
NODE_513_length_3348_cov_243.959372	2473	2553	514	1	80	0.0125000
NODE_513_length_3348_cov_243.959372	2473	2553	515	1	80	0.0125000
NODE_513_length_3348_cov_243.959372	2473	2553	516	2	80	0.0250000
NODE_513_length_3348_cov_243.959372	2473	2553	517	1	80	0.0125000
NODE_513_length_3348_cov_243.959372	2473	2553	518	2	80	0.0250000
NODE_513_length_3348_cov_243.959372	2473	2553	519	2	80	0.0250000
NODE_513_length_3348_cov_243.959372	2473	2553	520	3	80	0.0375000
NODE_513_length_3348_cov_243.959372	2473	2553	528	1	80	0.0125000
NODE_513_length_3348_cov_243.959372	2473	2553	529	2	80	0.0250000
NODE_513_length_3348_cov_243.959372	2473	2553	530	2	80	0.0250000
NODE_513_length_3348_cov_243.959372	2473	2553	531	2	80	0.0250000
NODE_513_length_3348_cov_243.959372	2473	2553	532	1	80	0.0125000
NODE_513_length_3348_cov_243.959372	2473	2553	533	1	80	0.0125000
NODE_513_length_3348_cov_243.959372	2473	2553	534	2	80	0.0250000
NODE_513_length_3348_cov_243.959372	2473	2553	535	1	80	0.0125000
NODE_513_length_3348_cov_243.959372	2473	2553	536	5	80	0.0625000
NODE_513_length_3348_cov_243.959372	2473	2553	537	2	80	0.0250000
NODE_513_length_3348_cov_243.959372	2473	2553	538	2	80	0.0250000
NODE_513_length_3348_cov_243.959372	2473	2553	539	4	80	0.0500000
NODE_513_length_3348_cov_243.959372	2473	2553	540	1	80	0.0125000
NODE_513_length_3348_cov_243.959372	2473	2553	541	3	80	0.0375000
NODE_513_length_3348_cov_243.959372	2473	2553	542	1	80	0.0125000
NODE_513_length_3348_cov_243.959372	2473	2553	543	1	80	0.0125000
NODE_513_length_3348_cov_243.959372	2473	2553	544	1	80	0.0125000
NODE_513_length_3348_cov_243.959372	2473	2553	545	1	80	0.0125000
NODE_513_length_3348_cov_243.959372	2473	2553	547	1	80	0.0125000
NODE_513_length_3348_cov_243.959372	2473	2553	548	1	80	0.0125000
NODE_513_length_3348_cov_243.959372	2473	2553	549	1	80	0.0125000
NODE_513_length_3348_cov_243.959372	2473	2553	550	2	80	0.0250000
NODE_513_length_3348_cov_243.959372	2473	2553	551	3	80	0.0375000
NODE_513_length_3348_cov_243.959372	2473	2553	553	1	80	0.0125000
NODE_513_length_3348_cov_243.959372	2473	2553	554	2	80	0.0250000
NODE_513_length_3348_cov_243.959372	2473	2553	568	1	80	0.0125000
NODE_513_length_3348_cov_243.959372	2473	2553	570	1	80	0.0125000
NODE_513_length_3348_cov_243.959372	2473	2553	571	1	80	0.0125000
NODE_513_length_3348_cov_243.959372	2473	2553	572	1	80	0.0125000
NODE_513_length_3348_cov_243.959372	2473	2553	606	1	80	0.0125000
NODE_513_length_3348_cov_243.959372	2473	2553	616	1	80	0.0125000
NODE_513_length_3348_cov_243.959372	2473	2553	617	1	80	0.0125000
NODE_513_length_3348_cov_243.959372	2473	2553	618	1	80	0.0125000
NODE_513_length_3348_cov_243.959372	2473	2553	620	1	80	0.0125000
NODE_513_length_3348_cov_243.959372	2473	2553	622	1	80	0.0125000
NODE_513_length_3348_cov_243.959372	2473	2553	624	1	80	0.0125000
NODE_513_length_3348_cov_243.959372	2526	2606	498	1	80	0.0125000
NODE_513_length_3348_cov_243.959372	2526	2606	510	1	80	0.0125000
NODE_513_length_3348_cov_243.959372	2526	2606	516	1	80	0.0125000
NODE_513_length_3348_cov_243.959372	2526	2606	519	1	80	0.0125000
NODE_513_length_3348_cov_243.959372	2526	2606	520	1	80	0.0125000
NODE_513_length_3348_cov_243.959372	2526	2606	533	1	80	0.0125000
NODE_513_length_3348_cov_243.959372	2526	2606	536	4	80	0.0500000
NODE_513_length_3348_cov_243.959372	2526	2606	537	2	80	0.0250000
NODE_513_length_3348_cov_243.959372	2526	2606	538	1	80	0.0125000
NODE_513_length_3348_cov_243.959372	2526	2606	539	2	80	0.0250000
NODE_513_length_3348_cov_243.959372	2526	2606	540	2	80	0.0250000
NODE_513_length_3348_cov_243.959372	2526	2606	541	1	80	0.0125000
NODE_513_length_3348_cov_243.959372	2526	2606	542	2	80	0.0250000
NODE_513_length_3348_cov_243.959372	2526	2606	543	1	80	0.0125000
NODE_513_length_3348_cov_243.959372	2526	2606	544	2	80	0.0250000
NODE_513_length_3348_cov_243.959372	2526	2606	545	1	80	0.0125000
NODE_513_length_3348_cov_243.959372	2526	2606	546	1	80	0.0125000
NODE_513_length_3348_cov_243.959372	2526	2606	547	2	80	0.0250000
NODE_513_length_3348_cov_243.959372	2526	2606	548	1	80	0.0125000
NODE_513_length_3348_cov_243.959372	2526	2606	549	1	80	0.0125000
NODE_513_length_3348_cov_243.959372	2526	2606	550	1	80	0.0125000
NODE_513_length_3348_cov_243.959372	2526	2606	551	2	80	0.0250000
NODE_513_length_3348_cov_243.959372	2526	2606	552	1	80	0.0125000
NODE_513_length_3348_cov_243.959372	2526	2606	553	2	80	0.0250000
NODE_513_length_3348_cov_243.959372	2526	2606	554	3	80	0.0375000
NODE_513_length_3348_cov_243.959372	2526	2606	555	1	80	0.0125000
NODE_513_length_3348_cov_243.959372	2526	2606	557	3	80	0.0375000
NODE_513_length_3348_cov_243.959372	2526	2606	558	3	80	0.0375000
NODE_513_length_3348_cov_243.959372	2526	2606	560	1	80	0.0125000
NODE_513_length_3348_cov_243.959372	2526	2606	562	4	80	0.0500000
NODE_513_length_3348_cov_243.959372	2526	2606	563	2	80	0.0250000
NODE_513_length_3348_cov_243.959372	2526	2606	564	2	80	0.0250000
NODE_513_length_3348_cov_243.959372	2526	2606	567	1	80	0.0125000
NODE_513_length_3348_cov_243.959372	2526	2606	568	1	80	0.0125000
NODE_513_length_3348_cov_243.959372	2526	2606	572	1	80	0.0125000
NODE_513_length_3348_cov_243.959372	2526	2606	574	1	80	0.0125000
NODE_513_length_3348_cov_243.959372	2526	2606	576	1	80	0.0125000
NODE_513_length_3348_cov_243.959372	2526	2606	577	1	80	0.0125000
NODE_513_length_3348_cov_243.959372	2526	2606	578	1	80	0.0125000
NODE_513_length_3348_cov_243.959372	2526	2606	583	1	80	0.0125000
NODE_513_length_3348_cov_243.959372	2526	2606	589	3	80	0.0375000
NODE_513_length_3348_cov_243.959372	2526	2606	594	1	80	0.0125000
NODE_513_length_3348_cov_243.959372	2526	2606	595	3	80	0.0375000
NODE_513_length_3348_cov_243.959372	2526	2606	596	1	80	0.0125000
NODE_513_length_3348_cov_243.959372	2526	2606	597	3	80	0.0375000
NODE_513_length_3348_cov_243.959372	2526	2606	599	1	80	0.0125000
NODE_513_length_3348_cov_243.959372	2526	2606	600	2	80	0.0250000
NODE_513_length_3348_cov_243.959372	2526	2606	601	2	80	0.0250000
NODE_513_length_3348_cov_243.959372	2526	2606	602	2	80	0.0250000
NODE_514_length_3348_cov_31.953216	103	183	0	7	80	0.0875000
NODE_514_length_3348_cov_31.953216	103	183	1	21	80	0.2625000
NODE_514_length_3348_cov_31.953216	103	183	3	41	80	0.5125000
NODE_514_length_3348_cov_31.953216	103	183	5	11	80	0.1375000
NODE_514_length_3348_cov_31.953216	105	179	0	5	74	0.0675676
NODE_514_length_3348_cov_31.953216	105	179	1	21	74	0.2837838
NODE_514_length_3348_cov_31.953216	105	179	3	41	74	0.5540541
NODE_514_length_3348_cov_31.953216	105	179	5	7	74	0.0945946
NODE_514_length_3348_cov_31.953216	156	236	3	16	80	0.2000000
NODE_514_length_3348_cov_31.953216	156	236	4	14	80	0.1750000
NODE_514_length_3348_cov_31.953216	156	236	5	27	80	0.3375000
NODE_514_length_3348_cov_31.953216	156	236	6	23	80	0.2875000
NODE_514_length_3348_cov_31.953216	156	236	3	16	80	0.2000000
NODE_514_length_3348_cov_31.953216	156	236	4	14	80	0.1750000
NODE_514_length_3348_cov_31.953216	156	236	5	27	80	0.3375000
NODE_514_length_3348_cov_31.953216	156	236	6	23	80	0.2875000
NODE_514_length_3348_cov_31.953216	2405	2476	93	2	71	0.0281690
NODE_514_length_3348_cov_31.953216	2405	2476	96	1	71	0.0140845
NODE_514_length_3348_cov_31.953216	2405	2476	97	1	71	0.0140845
NODE_514_length_3348_cov_31.953216	2405	2476	98	2	71	0.0281690
NODE_514_length_3348_cov_31.953216	2405	2476	99	2	71	0.0281690
NODE_514_length_3348_cov_31.953216	2405	2476	100	1	71	0.0140845
NODE_514_length_3348_cov_31.953216	2405	2476	101	3	71	0.0422535
NODE_514_length_3348_cov_31.953216	2405	2476	103	2	71	0.0281690
NODE_514_length_3348_cov_31.953216	2405	2476	105	1	71	0.0140845
NODE_514_length_3348_cov_31.953216	2405	2476	108	1	71	0.0140845
NODE_514_length_3348_cov_31.953216	2405	2476	112	1	71	0.0140845
NODE_514_length_3348_cov_31.953216	2405	2476	116	1	71	0.0140845
NODE_514_length_3348_cov_31.953216	2405	2476	119	1	71	0.0140845
NODE_514_length_3348_cov_31.953216	2405	2476	121	3	71	0.0422535
NODE_514_length_3348_cov_31.953216	2405	2476	125	1	71	0.0140845
NODE_514_length_3348_cov_31.953216	2405	2476	127	5	71	0.0704225
NODE_514_length_3348_cov_31.953216	2405	2476	131	2	71	0.0281690
NODE_514_length_3348_cov_31.953216	2405	2476	132	1	71	0.0140845
NODE_514_length_3348_cov_31.953216	2405	2476	133	2	71	0.0281690
NODE_514_length_3348_cov_31.953216	2405	2476	138	1	71	0.0140845
NODE_514_length_3348_cov_31.953216	2405	2476	140	1	71	0.0140845
NODE_514_length_3348_cov_31.953216	2405	2476	146	1	71	0.0140845
NODE_514_length_3348_cov_31.953216	2405	2476	154	1	71	0.0140845
NODE_514_length_3348_cov_31.953216	2405	2476	155	1	71	0.0140845
NODE_514_length_3348_cov_31.953216	2405	2476	159	1	71	0.0140845
NODE_514_length_3348_cov_31.953216	2405	2476	163	2	71	0.0281690
NODE_514_length_3348_cov_31.953216	2405	2476	164	1	71	0.0140845
NODE_514_length_3348_cov_31.953216	2405	2476	172	1	71	0.0140845
NODE_514_length_3348_cov_31.953216	2405	2476	176	1	71	0.0140845
NODE_514_length_3348_cov_31.953216	2405	2476	180	1	71	0.0140845
NODE_514_length_3348_cov_31.953216	2405	2476	182	1	71	0.0140845
NODE_514_length_3348_cov_31.953216	2405	2476	185	1	71	0.0140845
NODE_514_length_3348_cov_31.953216	2405	2476	204	1	71	0.0140845
NODE_514_length_3348_cov_31.953216	2405	2476	207	1	71	0.0140845
NODE_514_length_3348_cov_31.953216	2405	2476	209	1	71	0.0140845
NODE_514_length_3348_cov_31.953216	2405	2476	210	1	71	0.0140845
NODE_514_length_3348_cov_31.953216	2405	2476	215	1	71	0.0140845
NODE_514_length_3348_cov_31.953216	2405	2476	219	1	71	0.0140845
NODE_514_length_3348_cov_31.953216	2405	2476	224	2	71	0.0281690
NODE_514_length_3348_cov_31.953216	2405	2476	225	1	71	0.0140845
NODE_514_length_3348_cov_31.953216	2405	2476	227	6	71	0.0845070
NODE_514_length_3348_cov_31.953216	2405	2476	228	1	71	0.0140845
NODE_514_length_3348_cov_31.953216	2405	2476	238	1	71	0.0140845
NODE_514_length_3348_cov_31.953216	2405	2476	248	1	71	0.0140845
NODE_514_length_3348_cov_31.953216	2405	2476	251	1	71	0.0140845
NODE_514_length_3348_cov_31.953216	2405	2476	264	1	71	0.0140845
NODE_514_length_3348_cov_31.953216	2405	2476	268	1	71	0.0140845
NODE_514_length_3348_cov_31.953216	2405	2476	273	1	71	0.0140845
NODE_514_length_3348_cov_31.953216	2405	2476	275	1	71	0.0140845
NODE_514_length_3348_cov_31.953216	2405	2476	280	1	71	0.0140845
NODE_514_length_3348_cov_31.953216	2458	2529	224	2	71	0.0281690
NODE_514_length_3348_cov_31.953216	2458	2529	225	1	71	0.0140845
NODE_514_length_3348_cov_31.953216	2458	2529	227	6	71	0.0845070
NODE_514_length_3348_cov_31.953216	2458	2529	228	1	71	0.0140845
NODE_514_length_3348_cov_31.953216	2458	2529	238	1	71	0.0140845
NODE_514_length_3348_cov_31.953216	2458	2529	248	1	71	0.0140845
NODE_514_length_3348_cov_31.953216	2458	2529	251	1	71	0.0140845
NODE_514_length_3348_cov_31.953216	2458	2529	264	1	71	0.0140845
NODE_514_length_3348_cov_31.953216	2458	2529	268	1	71	0.0140845
NODE_514_length_3348_cov_31.953216	2458	2529	273	1	71	0.0140845
NODE_514_length_3348_cov_31.953216	2458	2529	275	1	71	0.0140845
NODE_514_length_3348_cov_31.953216	2458	2529	280	5	71	0.0704225
NODE_514_length_3348_cov_31.953216	2458	2529	281	2	71	0.0281690
NODE_514_length_3348_cov_31.953216	2458	2529	282	2	71	0.0281690
NODE_514_length_3348_cov_31.953216	2458	2529	285	1	71	0.0140845
NODE_514_length_3348_cov_31.953216	2458	2529	288	1	71	0.0140845
NODE_514_length_3348_cov_31.953216	2458	2529	290	1	71	0.0140845
NODE_514_length_3348_cov_31.953216	2458	2529	292	4	71	0.0563380
NODE_514_length_3348_cov_31.953216	2458	2529	294	1	71	0.0140845
NODE_514_length_3348_cov_31.953216	2458	2529	298	1	71	0.0140845
NODE_514_length_3348_cov_31.953216	2458	2529	299	1	71	0.0140845
NODE_514_length_3348_cov_31.953216	2458	2529	301	1	71	0.0140845
NODE_514_length_3348_cov_31.953216	2458	2529	305	1	71	0.0140845
NODE_514_length_3348_cov_31.953216	2458	2529	307	2	71	0.0281690
NODE_514_length_3348_cov_31.953216	2458	2529	309	2	71	0.0281690
NODE_514_length_3348_cov_31.953216	2458	2529	311	2	71	0.0281690
NODE_514_length_3348_cov_31.953216	2458	2529	312	2	71	0.0281690
NODE_514_length_3348_cov_31.953216	2458	2529	316	2	71	0.0281690
NODE_514_length_3348_cov_31.953216	2458	2529	317	2	71	0.0281690
NODE_514_length_3348_cov_31.953216	2458	2529	318	1	71	0.0140845
NODE_514_length_3348_cov_31.953216	2458	2529	320	1	71	0.0140845
NODE_514_length_3348_cov_31.953216	2458	2529	321	1	71	0.0140845
NODE_514_length_3348_cov_31.953216	2458	2529	322	2	71	0.0281690
NODE_514_length_3348_cov_31.953216	2458	2529	323	1	71	0.0140845
NODE_514_length_3348_cov_31.953216	2458	2529	324	4	71	0.0563380
NODE_514_length_3348_cov_31.953216	2458	2529	325	3	71	0.0422535
NODE_514_length_3348_cov_31.953216	2458	2529	326	2	71	0.0281690
NODE_514_length_3348_cov_31.953216	2458	2529	327	3	71	0.0422535
NODE_514_length_3348_cov_31.953216	2458	2529	330	2	71	0.0281690
NODE_514_length_3348_cov_31.953216	2458	2529	331	1	71	0.0140845
NODE_517_length_3335_cov_19.649567	2100	2180	10	25	80	0.3125000
NODE_517_length_3335_cov_19.649567	2100	2180	12	6	80	0.0750000
NODE_517_length_3335_cov_19.649567	2100	2180	13	1	80	0.0125000
NODE_517_length_3335_cov_19.649567	2100	2180	14	25	80	0.3125000
NODE_517_length_3335_cov_19.649567	2100	2180	16	23	80	0.2875000
NODE_517_length_3335_cov_19.649567	2153	2233	0	8	80	0.1000000
NODE_517_length_3335_cov_19.649567	2153	2233	6	1	80	0.0125000
NODE_517_length_3335_cov_19.649567	2153	2233	8	11	80	0.1375000
NODE_517_length_3335_cov_19.649567	2153	2233	11	1	80	0.0125000
NODE_517_length_3335_cov_19.649567	2153	2233	12	5	80	0.0625000
NODE_517_length_3335_cov_19.649567	2153	2233	14	13	80	0.1625000
NODE_517_length_3335_cov_19.649567	2153	2233	16	41	80	0.5125000
NODE_517_length_3335_cov_19.649567	2229	2309	0	38	80	0.4750000
NODE_517_length_3335_cov_19.649567	2229	2309	2	42	80	0.5250000
NODE_517_length_3335_cov_19.649567	2282	2362	2	80	80	1.0000000
NODE_518_length_3333_cov_24.805504	734	814	0	80	80	1.0000000
NODE_518_length_3333_cov_24.805504	787	867	0	38	80	0.4750000
NODE_518_length_3333_cov_24.805504	787	867	2	42	80	0.5250000
NODE_523_length_3312_cov_6.996576	85	165	0	80	80	1.0000000
NODE_523_length_3312_cov_6.996576	138	218	0	80	80	1.0000000
NODE_525_length_3302_cov_3.859195	3184	3262	18	17	78	0.2179487
NODE_525_length_3302_cov_3.859195	3184	3262	20	61	78	0.7820513
NODE_525_length_3302_cov_3.859195	3184	3253	18	8	69	0.1159420
NODE_525_length_3302_cov_3.859195	3184	3253	20	61	69	0.8840580
NODE_526_length_3299_cov_6.014687	1632	1688	0	44	56	0.7857143
NODE_526_length_3299_cov_6.014687	1632	1688	2	12	56	0.2142857
NODE_530_length_3290_cov_17.805390	773	853	0	7	80	0.0875000
NODE_530_length_3290_cov_17.805390	773	853	2	3	80	0.0375000
NODE_530_length_3290_cov_17.805390	773	853	4	70	80	0.8750000
NODE_530_length_3290_cov_17.805390	826	906	0	16	80	0.2000000
NODE_530_length_3290_cov_17.805390	826	906	2	47	80	0.5875000
NODE_530_length_3290_cov_17.805390	826	906	4	17	80	0.2125000
NODE_531_length_3290_cov_12.352554	2749	2829	0	80	80	1.0000000
NODE_531_length_3290_cov_12.352554	2802	2882	0	80	80	1.0000000
NODE_532_length_3286_cov_5.973015	0	50	0	50	50	1.0000000
NODE_532_length_3286_cov_5.973015	0	50	0	50	50	1.0000000
NODE_532_length_3286_cov_5.973015	0	50	0	50	50	1.0000000
NODE_532_length_3286_cov_5.973015	23	89	0	38	66	0.5757576
NODE_532_length_3286_cov_5.973015	23	89	2	28	66	0.4242424
NODE_532_length_3286_cov_5.973015	23	94	0	38	71	0.5352113
NODE_532_length_3286_cov_5.973015	23	94	2	33	71	0.4647887
NODE_533_length_3284_cov_6.453689	313	392	1	79	79	1.0000000
NODE_533_length_3284_cov_6.453689	365	445	0	29	80	0.3625000
NODE_533_length_3284_cov_6.453689	365	445	1	51	80	0.6375000
NODE_541_length_3267_cov_12.768624	11	91	6	15	80	0.1875000
NODE_541_length_3267_cov_12.768624	11	91	8	7	80	0.0875000
NODE_541_length_3267_cov_12.768624	11	91	10	1	80	0.0125000
NODE_541_length_3267_cov_12.768624	11	91	12	21	80	0.2625000
NODE_541_length_3267_cov_12.768624	11	91	14	18	80	0.2250000
NODE_541_length_3267_cov_12.768624	11	91	16	18	80	0.2250000
NODE_542_length_3266_cov_14.108304	2620	2684	54	2	64	0.0312500
NODE_542_length_3266_cov_14.108304	2620	2684	58	2	64	0.0312500
NODE_542_length_3266_cov_14.108304	2620	2684	59	10	64	0.1562500
NODE_542_length_3266_cov_14.108304	2620	2684	61	9	64	0.1406250
NODE_542_length_3266_cov_14.108304	2620	2684	63	41	64	0.6406250
NODE_542_length_3266_cov_14.108304	2620	2684	54	2	64	0.0312500
NODE_542_length_3266_cov_14.108304	2620	2684	58	2	64	0.0312500
NODE_542_length_3266_cov_14.108304	2620	2684	59	10	64	0.1562500
NODE_542_length_3266_cov_14.108304	2620	2684	61	9	64	0.1406250
NODE_542_length_3266_cov_14.108304	2620	2684	63	41	64	0.6406250
NODE_542_length_3266_cov_14.108304	2620	2684	54	2	64	0.0312500
NODE_542_length_3266_cov_14.108304	2620	2684	58	2	64	0.0312500
NODE_542_length_3266_cov_14.108304	2620	2684	59	10	64	0.1562500
NODE_542_length_3266_cov_14.108304	2620	2684	61	9	64	0.1406250
NODE_542_length_3266_cov_14.108304	2620	2684	63	41	64	0.6406250
NODE_547_length_3242_cov_12.407891	391	471	0	79	80	0.9875000
NODE_547_length_3242_cov_12.407891	391	471	2	1	80	0.0125000
NODE_547_length_3242_cov_12.407891	444	524	0	26	80	0.3250000
NODE_547_length_3242_cov_12.407891	444	524	2	54	80	0.6750000
NODE_550_length_3233_cov_19.903957	411	491	0	80	80	1.0000000
NODE_550_length_3233_cov_19.903957	411	491	0	80	80	1.0000000
NODE_550_length_3233_cov_19.903957	464	544	0	80	80	1.0000000
NODE_552_length_3232_cov_11.378870	2586	2621	1	35	35	1.0000000
NODE_555_length_3214_cov_22.853291	2090	2170	32	4	80	0.0500000
NODE_555_length_3214_cov_22.853291	2090	2170	34	2	80	0.0250000
NODE_555_length_3214_cov_22.853291	2090	2170	36	5	80	0.0625000
NODE_555_length_3214_cov_22.853291	2090	2170	37	1	80	0.0125000
NODE_555_length_3214_cov_22.853291	2090	2170	39	1	80	0.0125000
NODE_555_length_3214_cov_22.853291	2090	2170	41	1	80	0.0125000
NODE_555_length_3214_cov_22.853291	2090	2170	42	3	80	0.0375000
NODE_555_length_3214_cov_22.853291	2090	2170	44	20	80	0.2500000
NODE_555_length_3214_cov_22.853291	2090	2170	45	2	80	0.0250000
NODE_555_length_3214_cov_22.853291	2090	2170	46	3	80	0.0375000
NODE_555_length_3214_cov_22.853291	2090	2170	47	4	80	0.0500000
NODE_555_length_3214_cov_22.853291	2090	2170	48	3	80	0.0375000
NODE_555_length_3214_cov_22.853291	2090	2170	50	1	80	0.0125000
NODE_555_length_3214_cov_22.853291	2090	2170	52	3	80	0.0375000
NODE_555_length_3214_cov_22.853291	2090	2170	53	4	80	0.0500000
NODE_555_length_3214_cov_22.853291	2090	2170	54	1	80	0.0125000
NODE_555_length_3214_cov_22.853291	2090	2170	55	6	80	0.0750000
NODE_555_length_3214_cov_22.853291	2090	2170	56	1	80	0.0125000
NODE_555_length_3214_cov_22.853291	2090	2170	59	4	80	0.0500000
NODE_555_length_3214_cov_22.853291	2090	2170	60	2	80	0.0250000
NODE_555_length_3214_cov_22.853291	2090	2170	64	4	80	0.0500000
NODE_555_length_3214_cov_22.853291	2090	2170	67	5	80	0.0625000
NODE_555_length_3214_cov_22.853291	2143	2223	52	1	80	0.0125000
NODE_555_length_3214_cov_22.853291	2143	2223	53	4	80	0.0500000
NODE_555_length_3214_cov_22.853291	2143	2223	55	6	80	0.0750000
NODE_555_length_3214_cov_22.853291	2143	2223	56	1	80	0.0125000
NODE_555_length_3214_cov_22.853291	2143	2223	59	4	80	0.0500000
NODE_555_length_3214_cov_22.853291	2143	2223	60	2	80	0.0250000
NODE_555_length_3214_cov_22.853291	2143	2223	63	2	80	0.0250000
NODE_555_length_3214_cov_22.853291	2143	2223	64	4	80	0.0500000
NODE_555_length_3214_cov_22.853291	2143	2223	65	9	80	0.1125000
NODE_555_length_3214_cov_22.853291	2143	2223	66	1	80	0.0125000
NODE_555_length_3214_cov_22.853291	2143	2223	67	29	80	0.3625000
NODE_555_length_3214_cov_22.853291	2143	2223	69	16	80	0.2000000
NODE_555_length_3214_cov_22.853291	2143	2223	71	1	80	0.0125000
NODE_555_length_3214_cov_22.853291	3028	3086	0	6	58	0.1034483
NODE_555_length_3214_cov_22.853291	3028	3086	2	17	58	0.2931035
NODE_555_length_3214_cov_22.853291	3028	3086	4	5	58	0.0862069
NODE_555_length_3214_cov_22.853291	3028	3086	6	27	58	0.4655173
NODE_555_length_3214_cov_22.853291	3028	3086	7	2	58	0.0344828
NODE_555_length_3214_cov_22.853291	3028	3086	16	1	58	0.0172414
NODE_556_length_3211_cov_1.921915	95	175	2	4	80	0.0500000
NODE_556_length_3211_cov_1.921915	95	175	4	4	80	0.0500000
NODE_556_length_3211_cov_1.921915	95	175	8	24	80	0.3000000
NODE_556_length_3211_cov_1.921915	95	175	10	38	80	0.4750000
NODE_556_length_3211_cov_1.921915	95	175	12	10	80	0.1250000
NODE_556_length_3211_cov_1.921915	148	178	2	7	30	0.2333333
NODE_556_length_3211_cov_1.921915	148	178	4	4	30	0.1333333
NODE_556_length_3211_cov_1.921915	148	178	8	19	30	0.6333333
NODE_557_length_3210_cov_7.428480	2040	2111	18	38	71	0.5352113
NODE_557_length_3210_cov_7.428480	2040	2111	20	12	71	0.1690141
NODE_557_length_3210_cov_7.428480	2040	2111	26	21	71	0.2957746
NODE_557_length_3210_cov_7.428480	2084	2164	8	6	80	0.0750000
NODE_557_length_3210_cov_7.428480	2084	2164	17	1	80	0.0125000
NODE_557_length_3210_cov_7.428480	2084	2164	18	2	80	0.0250000
NODE_557_length_3210_cov_7.428480	2084	2164	20	6	80	0.0750000
NODE_557_length_3210_cov_7.428480	2084	2164	22	15	80	0.1875000
NODE_557_length_3210_cov_7.428480	2084	2164	26	50	80	0.6250000
NODE_557_length_3210_cov_7.428480	2715	2797	0	82	82	1.0000000
NODE_557_length_3210_cov_7.428480	2770	2850	0	80	80	1.0000000
NODE_562_length_3201_cov_3.591231	3120	3200	0	80	80	1.0000000
NODE_566_length_3189_cov_69.446602	137	188	4	39	51	0.7647059
NODE_566_length_3189_cov_69.446602	137	188	6	12	51	0.2352941
NODE_567_length_3188_cov_7.233085	1663	1743	0	13	80	0.1625000
NODE_567_length_3188_cov_7.233085	1663	1743	2	24	80	0.3000000
NODE_567_length_3188_cov_7.233085	1663	1743	4	43	80	0.5375000
NODE_567_length_3188_cov_7.233085	1716	1796	0	28	80	0.3500000
NODE_567_length_3188_cov_7.233085	1716	1796	2	52	80	0.6500000
NODE_570_length_3177_cov_2.789474	2021	2042	0	21	21	1.0000000
NODE_575_length_3158_cov_19.018960	840	920	2	32	80	0.4000000
NODE_575_length_3158_cov_19.018960	840	920	4	32	80	0.4000000
NODE_575_length_3158_cov_19.018960	840	920	6	16	80	0.2000000
NODE_575_length_3158_cov_19.018960	893	973	0	5	80	0.0625000
NODE_575_length_3158_cov_19.018960	893	973	2	75	80	0.9375000
NODE_575_length_3158_cov_19.018960	2833	2915	0	1	82	0.0121951
NODE_575_length_3158_cov_19.018960	2833	2915	4	81	82	0.9878049
NODE_575_length_3158_cov_19.018960	2888	2959	0	45	71	0.6338028
NODE_575_length_3158_cov_19.018960	2888	2959	4	26	71	0.3661972
NODE_576_length_3150_cov_26.520813	770	850	10	5	80	0.0625000
NODE_576_length_3150_cov_26.520813	770	850	12	7	80	0.0875000
NODE_576_length_3150_cov_26.520813	770	850	13	3	80	0.0375000
NODE_576_length_3150_cov_26.520813	770	850	14	2	80	0.0250000
NODE_576_length_3150_cov_26.520813	770	850	15	58	80	0.7250000
NODE_576_length_3150_cov_26.520813	770	850	16	5	80	0.0625000
NODE_576_length_3150_cov_26.520813	823	901	0	15	78	0.1923077
NODE_576_length_3150_cov_26.520813	823	901	2	1	78	0.0128205
NODE_576_length_3150_cov_26.520813	823	901	4	3	78	0.0384615
NODE_576_length_3150_cov_26.520813	823	901	5	1	78	0.0128205
NODE_576_length_3150_cov_26.520813	823	901	6	21	78	0.2692308
NODE_576_length_3150_cov_26.520813	823	901	12	17	78	0.2179487
NODE_576_length_3150_cov_26.520813	823	901	14	1	78	0.0128205
NODE_576_length_3150_cov_26.520813	823	901	15	19	78	0.2435897
NODE_576_length_3150_cov_26.520813	2616	2696	0	18	80	0.2250000
NODE_576_length_3150_cov_26.520813	2616	2696	2	18	80	0.2250000
NODE_576_length_3150_cov_26.520813	2616	2696	6	31	80	0.3875000
NODE_576_length_3150_cov_26.520813	2616	2696	8	12	80	0.1500000
NODE_576_length_3150_cov_26.520813	2616	2696	10	1	80	0.0125000
NODE_576_length_3150_cov_26.520813	2669	2749	6	14	80	0.1750000
NODE_576_length_3150_cov_26.520813	2669	2749	8	12	80	0.1500000
NODE_576_length_3150_cov_26.520813	2669	2749	10	28	80	0.3500000
NODE_576_length_3150_cov_26.520813	2669	2749	12	26	80	0.3250000
NODE_577_length_3150_cov_5.923959	2313	2393	0	80	80	1.0000000
NODE_579_length_3148_cov_2.313873	3053	3105	0	52	52	1.0000000
NODE_581_length_3146_cov_18.277322	2418	2498	0	29	80	0.3625000
NODE_581_length_3146_cov_18.277322	2418	2498	6	30	80	0.3750000
NODE_581_length_3146_cov_18.277322	2418	2498	8	21	80	0.2625000
NODE_581_length_3146_cov_18.277322	2471	2551	6	6	80	0.0750000
NODE_581_length_3146_cov_18.277322	2471	2551	8	40	80	0.5000000
NODE_581_length_3146_cov_18.277322	2471	2551	10	15	80	0.1875000
NODE_581_length_3146_cov_18.277322	2471	2551	14	19	80	0.2375000
NODE_581_length_3146_cov_18.277322	2547	2627	10	25	80	0.3125000
NODE_581_length_3146_cov_18.277322	2547	2627	12	18	80	0.2250000
NODE_581_length_3146_cov_18.277322	2547	2627	14	37	80	0.4625000
NODE_581_length_3146_cov_18.277322	2600	2680	6	9	80	0.1125000
NODE_581_length_3146_cov_18.277322	2600	2680	10	2	80	0.0250000
NODE_581_length_3146_cov_18.277322	2600	2680	12	11	80	0.1375000
NODE_581_length_3146_cov_18.277322	2600	2680	14	43	80	0.5375000
NODE_581_length_3146_cov_18.277322	2600	2680	16	15	80	0.1875000
NODE_581_length_3146_cov_18.277322	2975	3055	6	5	80	0.0625000
NODE_581_length_3146_cov_18.277322	2975	3055	8	4	80	0.0500000
NODE_581_length_3146_cov_18.277322	2975	3055	9	1	80	0.0125000
NODE_581_length_3146_cov_18.277322	2975	3055	10	3	80	0.0375000
NODE_581_length_3146_cov_18.277322	2975	3055	11	2	80	0.0250000
NODE_581_length_3146_cov_18.277322	2975	3055	12	65	80	0.8125000
NODE_585_length_3134_cov_8.717957	1290	1362	40	8	72	0.1111111
NODE_585_length_3134_cov_8.717957	1290	1362	42	3	72	0.0416667
NODE_585_length_3134_cov_8.717957	1290	1362	44	3	72	0.0416667
NODE_585_length_3134_cov_8.717957	1290	1362	46	12	72	0.1666667
NODE_585_length_3134_cov_8.717957	1290	1362	54	3	72	0.0416667
NODE_585_length_3134_cov_8.717957	1290	1362	56	4	72	0.0555556
NODE_585_length_3134_cov_8.717957	1290	1362	64	3	72	0.0416667
NODE_585_length_3134_cov_8.717957	1290	1362	66	5	72	0.0694444
NODE_585_length_3134_cov_8.717957	1290	1362	68	2	72	0.0277778
NODE_585_length_3134_cov_8.717957	1290	1362	74	2	72	0.0277778
NODE_585_length_3134_cov_8.717957	1290	1362	78	2	72	0.0277778
NODE_585_length_3134_cov_8.717957	1290	1362	80	2	72	0.0277778
NODE_585_length_3134_cov_8.717957	1290	1362	82	1	72	0.0138889
NODE_585_length_3134_cov_8.717957	1290	1362	84	3	72	0.0416667
NODE_585_length_3134_cov_8.717957	1290	1362	86	5	72	0.0694444
NODE_585_length_3134_cov_8.717957	1290	1362	88	6	72	0.0833333
NODE_585_length_3134_cov_8.717957	1290	1362	90	6	72	0.0833333
NODE_585_length_3134_cov_8.717957	1290	1362	92	2	72	0.0277778
NODE_585_length_3134_cov_8.717957	1335	1415	64	2	80	0.0250000
NODE_585_length_3134_cov_8.717957	1335	1415	67	2	80	0.0250000
NODE_585_length_3134_cov_8.717957	1335	1415	69	5	80	0.0625000
NODE_585_length_3134_cov_8.717957	1335	1415	70	3	80	0.0375000
NODE_585_length_3134_cov_8.717957	1335	1415	72	2	80	0.0250000
NODE_585_length_3134_cov_8.717957	1335	1415	73	3	80	0.0375000
NODE_585_length_3134_cov_8.717957	1335	1415	75	2	80	0.0250000
NODE_585_length_3134_cov_8.717957	1335	1415	76	1	80	0.0125000
NODE_585_length_3134_cov_8.717957	1335	1415	77	10	80	0.1250000
NODE_585_length_3134_cov_8.717957	1335	1415	78	12	80	0.1500000
NODE_585_length_3134_cov_8.717957	1335	1415	79	3	80	0.0375000
NODE_585_length_3134_cov_8.717957	1335	1415	80	6	80	0.0750000
NODE_585_length_3134_cov_8.717957	1335	1415	82	2	80	0.0250000
NODE_585_length_3134_cov_8.717957	1335	1415	84	3	80	0.0375000
NODE_585_length_3134_cov_8.717957	1335	1415	86	5	80	0.0625000
NODE_585_length_3134_cov_8.717957	1335	1415	88	8	80	0.1000000
NODE_585_length_3134_cov_8.717957	1335	1415	90	6	80	0.0750000
NODE_585_length_3134_cov_8.717957	1335	1415	92	4	80	0.0500000
NODE_585_length_3134_cov_8.717957	1335	1415	94	1	80	0.0125000
NODE_586_length_3131_cov_26.910620	232	312	0	22	80	0.2750000
NODE_586_length_3131_cov_26.910620	232	312	2	58	80	0.7250000
NODE_586_length_3131_cov_26.910620	285	364	0	53	79	0.6708861
NODE_586_length_3131_cov_26.910620	285	364	2	26	79	0.3291139
NODE_586_length_3131_cov_26.910620	2151	2231	0	10	80	0.1250000
NODE_586_length_3131_cov_26.910620	2151	2231	2	70	80	0.8750000
NODE_586_length_3131_cov_26.910620	2155	2227	0	6	72	0.0833333
NODE_586_length_3131_cov_26.910620	2155	2227	2	66	72	0.9166667
NODE_586_length_3131_cov_26.910620	2204	2284	0	47	80	0.5875000
NODE_586_length_3131_cov_26.910620	2204	2284	2	33	80	0.4125000
NODE_586_length_3131_cov_26.910620	2208	2284	0	47	76	0.6184211
NODE_586_length_3131_cov_26.910620	2208	2284	2	29	76	0.3815790
NODE_586_length_3131_cov_26.910620	2280	2360	0	80	80	1.0000000
NODE_586_length_3131_cov_26.910620	2333	2413	0	38	80	0.4750000
NODE_586_length_3131_cov_26.910620	2333	2413	2	42	80	0.5250000
NODE_590_length_3118_cov_5.059622	367	445	0	11	78	0.1410256
NODE_590_length_3118_cov_5.059622	367	445	2	25	78	0.3205128
NODE_590_length_3118_cov_5.059622	367	445	4	42	78	0.5384616
NODE_590_length_3118_cov_5.059622	418	498	0	20	80	0.2500000
NODE_590_length_3118_cov_5.059622	418	498	2	60	80	0.7500000
NODE_591_length_3117_cov_5.938038	2525	2605	0	80	80	1.0000000
NODE_591_length_3117_cov_5.938038	2578	2658	0	80	80	1.0000000
NODE_595_length_3110_cov_31.733643	2864	2923	0	59	59	1.0000000
NODE_602_length_3093_cov_54.559786	571	651	0	80	80	1.0000000
NODE_602_length_3093_cov_54.559786	624	704	0	80	80	1.0000000
NODE_602_length_3093_cov_54.559786	2901	2981	0	8	80	0.1000000
NODE_602_length_3093_cov_54.559786	2901	2981	4	11	80	0.1375000
NODE_602_length_3093_cov_54.559786	2901	2981	6	3	80	0.0375000
NODE_602_length_3093_cov_54.559786	2901	2981	8	58	80	0.7250000
NODE_602_length_3093_cov_54.559786	2954	3034	2	26	80	0.3250000
NODE_602_length_3093_cov_54.559786	2954	3034	5	6	80	0.0750000
NODE_602_length_3093_cov_54.559786	2954	3034	7	3	80	0.0375000
NODE_602_length_3093_cov_54.559786	2954	3034	8	45	80	0.5625000
NODE_603_length_3091_cov_35.895722	1743	1804	0	9	61	0.1475410
NODE_603_length_3091_cov_35.895722	1743	1804	2	13	61	0.2131148
NODE_603_length_3091_cov_35.895722	1743	1804	4	39	61	0.6393443
NODE_603_length_3091_cov_35.895722	1777	1857	0	2	80	0.0250000
NODE_603_length_3091_cov_35.895722	1777	1857	2	25	80	0.3125000
NODE_603_length_3091_cov_35.895722	1777	1857	4	53	80	0.6625000
NODE_603_length_3091_cov_35.895722	2472	2535	0	46	63	0.7301587
NODE_603_length_3091_cov_35.895722	2472	2535	2	14	63	0.2222222
NODE_603_length_3091_cov_35.895722	2472	2535	4	1	63	0.0158730
NODE_603_length_3091_cov_35.895722	2472	2535	6	1	63	0.0158730
NODE_603_length_3091_cov_35.895722	2472	2535	8	1	63	0.0158730
NODE_603_length_3091_cov_35.895722	2508	2553	0	10	45	0.2222222
NODE_603_length_3091_cov_35.895722	2508	2553	2	14	45	0.3111111
NODE_603_length_3091_cov_35.895722	2508	2553	4	1	45	0.0222222
NODE_603_length_3091_cov_35.895722	2508	2553	6	1	45	0.0222222
NODE_603_length_3091_cov_35.895722	2508	2553	8	3	45	0.0666667
NODE_603_length_3091_cov_35.895722	2508	2553	10	14	45	0.3111111
NODE_603_length_3091_cov_35.895722	2508	2553	12	1	45	0.0222222
NODE_603_length_3091_cov_35.895722	2508	2553	14	1	45	0.0222222
NODE_603_length_3091_cov_35.895722	2534	2604	8	3	70	0.0428571
NODE_603_length_3091_cov_35.895722	2534	2604	10	14	70	0.2000000
NODE_603_length_3091_cov_35.895722	2534	2604	12	1	70	0.0142857
NODE_603_length_3091_cov_35.895722	2534	2604	14	3	70	0.0428571
NODE_603_length_3091_cov_35.895722	2534	2604	18	5	70	0.0714286
NODE_603_length_3091_cov_35.895722	2534	2604	20	2	70	0.0285714
NODE_603_length_3091_cov_35.895722	2534	2604	22	10	70	0.1428571
NODE_603_length_3091_cov_35.895722	2534	2604	24	11	70	0.1571429
NODE_603_length_3091_cov_35.895722	2534	2604	26	21	70	0.3000000
NODE_603_length_3091_cov_35.895722	2578	2618	24	5	40	0.1250000
NODE_603_length_3091_cov_35.895722	2578	2618	26	35	40	0.8750000
NODE_603_length_3091_cov_35.895722	2586	2623	26	37	37	1.0000000
NODE_603_length_3091_cov_35.895722	2626	2671	12	1	45	0.0222222
NODE_603_length_3091_cov_35.895722	2626	2671	14	1	45	0.0222222
NODE_603_length_3091_cov_35.895722	2626	2671	16	22	45	0.4888889
NODE_603_length_3091_cov_35.895722	2626	2671	18	3	45	0.0666667
NODE_603_length_3091_cov_35.895722	2626	2671	20	2	45	0.0444444
NODE_603_length_3091_cov_35.895722	2626	2671	22	5	45	0.1111111
NODE_603_length_3091_cov_35.895722	2626	2671	24	8	45	0.1777778
NODE_603_length_3091_cov_35.895722	2626	2671	26	3	45	0.0666667
NODE_603_length_3091_cov_35.895722	2682	2730	2	35	48	0.7291667
NODE_603_length_3091_cov_35.895722	2682	2730	4	1	48	0.0208333
NODE_603_length_3091_cov_35.895722	2682	2730	6	4	48	0.0833333
NODE_603_length_3091_cov_35.895722	2682	2730	8	8	48	0.1666667
NODE_603_length_3091_cov_35.895722	2918	2969	0	51	51	1.0000000
NODE_603_length_3091_cov_35.895722	2942	2987	0	45	45	1.0000000
NODE_603_length_3091_cov_35.895722	2994	3039	0	45	45	1.0000000
NODE_607_length_3079_cov_7.081879	2340	2420	4	38	80	0.4750000
NODE_607_length_3079_cov_7.081879	2340	2420	6	42	80	0.5250000
NODE_607_length_3079_cov_7.081879	2886	2938	6	6	52	0.1153846
NODE_607_length_3079_cov_7.081879	2886	2938	8	1	52	0.0192308
NODE_607_length_3079_cov_7.081879	2886	2938	10	12	52	0.2307692
NODE_607_length_3079_cov_7.081879	2886	2938	11	6	52	0.1153846
NODE_607_length_3079_cov_7.081879	2886	2938	13	13	52	0.2500000
NODE_607_length_3079_cov_7.081879	2886	2938	14	4	52	0.0769231
NODE_607_length_3079_cov_7.081879	2886	2938	15	1	52	0.0192308
NODE_607_length_3079_cov_7.081879	2886	2938	24	6	52	0.1153846
NODE_607_length_3079_cov_7.081879	2886	2938	25	3	52	0.0576923
NODE_607_length_3079_cov_7.081879	2893	2959	10	12	66	0.1818182
NODE_607_length_3079_cov_7.081879	2893	2959	11	6	66	0.0909091
NODE_607_length_3079_cov_7.081879	2893	2959	13	13	66	0.1969697
NODE_607_length_3079_cov_7.081879	2893	2959	14	4	66	0.0606061
NODE_607_length_3079_cov_7.081879	2893	2959	15	1	66	0.0151515
NODE_607_length_3079_cov_7.081879	2893	2959	24	6	66	0.0909091
NODE_607_length_3079_cov_7.081879	2893	2959	25	3	66	0.0454545
NODE_607_length_3079_cov_7.081879	2893	2959	27	1	66	0.0151515
NODE_607_length_3079_cov_7.081879	2893	2959	28	1	66	0.0151515
NODE_607_length_3079_cov_7.081879	2893	2959	30	2	66	0.0303030
NODE_607_length_3079_cov_7.081879	2893	2959	32	6	66	0.0909091
NODE_607_length_3079_cov_7.081879	2893	2959	33	1	66	0.0151515
NODE_607_length_3079_cov_7.081879	2893	2959	35	2	66	0.0303030
NODE_607_length_3079_cov_7.081879	2893	2959	37	2	66	0.0303030
NODE_607_length_3079_cov_7.081879	2893	2959	39	1	66	0.0151515
NODE_607_length_3079_cov_7.081879	2893	2959	47	5	66	0.0757576
NODE_607_length_3079_cov_7.081879	2932	2993	24	6	61	0.0983607
NODE_607_length_3079_cov_7.081879	2932	2993	27	1	61	0.0163934
NODE_607_length_3079_cov_7.081879	2932	2993	28	1	61	0.0163934
NODE_607_length_3079_cov_7.081879	2932	2993	30	2	61	0.0327869
NODE_607_length_3079_cov_7.081879	2932	2993	32	6	61	0.0983607
NODE_607_length_3079_cov_7.081879	2932	2993	33	1	61	0.0163934
NODE_607_length_3079_cov_7.081879	2932	2993	35	2	61	0.0327869
NODE_607_length_3079_cov_7.081879	2932	2993	37	2	61	0.0327869
NODE_607_length_3079_cov_7.081879	2932	2993	39	1	61	0.0163934
NODE_607_length_3079_cov_7.081879	2932	2993	47	6	61	0.0983607
NODE_607_length_3079_cov_7.081879	2932	2993	49	6	61	0.0983607
NODE_607_length_3079_cov_7.081879	2932	2993	51	1	61	0.0163934
NODE_607_length_3079_cov_7.081879	2932	2993	57	10	61	0.1639344
NODE_607_length_3079_cov_7.081879	2932	2993	61	16	61	0.2622951
NODE_607_length_3079_cov_7.081879	2932	2995	24	6	63	0.0952381
NODE_607_length_3079_cov_7.081879	2932	2995	27	1	63	0.0158730
NODE_607_length_3079_cov_7.081879	2932	2995	28	1	63	0.0158730
NODE_607_length_3079_cov_7.081879	2932	2995	30	2	63	0.0317460
NODE_607_length_3079_cov_7.081879	2932	2995	32	6	63	0.0952381
NODE_607_length_3079_cov_7.081879	2932	2995	33	1	63	0.0158730
NODE_607_length_3079_cov_7.081879	2932	2995	35	2	63	0.0317460
NODE_607_length_3079_cov_7.081879	2932	2995	37	2	63	0.0317460
NODE_607_length_3079_cov_7.081879	2932	2995	39	1	63	0.0158730
NODE_607_length_3079_cov_7.081879	2932	2995	47	6	63	0.0952381
NODE_607_length_3079_cov_7.081879	2932	2995	49	6	63	0.0952381
NODE_607_length_3079_cov_7.081879	2932	2995	51	1	63	0.0158730
NODE_607_length_3079_cov_7.081879	2932	2995	57	10	63	0.1587302
NODE_607_length_3079_cov_7.081879	2932	2995	61	18	63	0.2857143
NODE_607_length_3079_cov_7.081879	2932	2995	24	6	63	0.0952381
NODE_607_length_3079_cov_7.081879	2932	2995	27	1	63	0.0158730
NODE_607_length_3079_cov_7.081879	2932	2995	28	1	63	0.0158730
NODE_607_length_3079_cov_7.081879	2932	2995	30	2	63	0.0317460
NODE_607_length_3079_cov_7.081879	2932	2995	32	6	63	0.0952381
NODE_607_length_3079_cov_7.081879	2932	2995	33	1	63	0.0158730
NODE_607_length_3079_cov_7.081879	2932	2995	35	2	63	0.0317460
NODE_607_length_3079_cov_7.081879	2932	2995	37	2	63	0.0317460
NODE_607_length_3079_cov_7.081879	2932	2995	39	1	63	0.0158730
NODE_607_length_3079_cov_7.081879	2932	2995	47	6	63	0.0952381
NODE_607_length_3079_cov_7.081879	2932	2995	49	6	63	0.0952381
NODE_607_length_3079_cov_7.081879	2932	2995	51	1	63	0.0158730
NODE_607_length_3079_cov_7.081879	2932	2995	57	10	63	0.1587302
NODE_607_length_3079_cov_7.081879	2932	2995	61	18	63	0.2857143
NODE_608_length_3077_cov_23.535259	1244	1321	2	68	77	0.8831169
NODE_608_length_3077_cov_23.535259	1244	1321	4	9	77	0.1168831
NODE_608_length_3077_cov_23.535259	1911	1991	0	9	80	0.1125000
NODE_608_length_3077_cov_23.535259	1911	1991	2	71	80	0.8875000
NODE_608_length_3077_cov_23.535259	1964	2016	2	52	52	1.0000000
NODE_608_length_3077_cov_23.535259	2028	2114	0	65	86	0.7558140
NODE_608_length_3077_cov_23.535259	2028	2114	2	2	86	0.0232558
NODE_608_length_3077_cov_23.535259	2028	2114	4	1	86	0.0116279
NODE_608_length_3077_cov_23.535259	2028	2114	8	2	86	0.0232558
NODE_608_length_3077_cov_23.535259	2028	2114	10	1	86	0.0116279
NODE_608_length_3077_cov_23.535259	2028	2114	14	14	86	0.1627907
NODE_608_length_3077_cov_23.535259	2028	2114	16	1	86	0.0116279
NODE_609_length_3077_cov_8.693083	1157	1237	8	3	80	0.0375000
NODE_609_length_3077_cov_8.693083	1157	1237	10	5	80	0.0625000
NODE_609_length_3077_cov_8.693083	1157	1237	12	17	80	0.2125000
NODE_609_length_3077_cov_8.693083	1157	1237	14	18	80	0.2250000
NODE_609_length_3077_cov_8.693083	1157	1237	18	10	80	0.1250000
NODE_609_length_3077_cov_8.693083	1157	1237	20	16	80	0.2000000
NODE_609_length_3077_cov_8.693083	1157	1237	22	4	80	0.0500000
NODE_609_length_3077_cov_8.693083	1157	1237	24	7	80	0.0875000
NODE_609_length_3077_cov_8.693083	1161	1184	8	3	23	0.1304348
NODE_609_length_3077_cov_8.693083	1161	1184	10	1	23	0.0434783
NODE_609_length_3077_cov_8.693083	1161	1184	12	17	23	0.7391304
NODE_609_length_3077_cov_8.693083	1161	1184	14	2	23	0.0869565
NODE_609_length_3077_cov_8.693083	1233	1313	20	3	80	0.0375000
NODE_609_length_3077_cov_8.693083	1233	1313	22	3	80	0.0375000
NODE_609_length_3077_cov_8.693083	1233	1313	26	4	80	0.0500000
NODE_609_length_3077_cov_8.693083	1233	1313	30	1	80	0.0125000
NODE_609_length_3077_cov_8.693083	1233	1313	32	3	80	0.0375000
NODE_609_length_3077_cov_8.693083	1233	1313	34	9	80	0.1125000
NODE_609_length_3077_cov_8.693083	1233	1313	38	2	80	0.0250000
NODE_609_length_3077_cov_8.693083	1233	1313	40	3	80	0.0375000
NODE_609_length_3077_cov_8.693083	1233	1313	42	8	80	0.1000000
NODE_609_length_3077_cov_8.693083	1233	1313	44	1	80	0.0125000
NODE_609_length_3077_cov_8.693083	1233	1313	46	3	80	0.0375000
NODE_609_length_3077_cov_8.693083	1233	1313	48	2	80	0.0250000
NODE_609_length_3077_cov_8.693083	1233	1313	50	2	80	0.0250000
NODE_609_length_3077_cov_8.693083	1233	1313	52	1	80	0.0125000
NODE_609_length_3077_cov_8.693083	1233	1313	56	1	80	0.0125000
NODE_609_length_3077_cov_8.693083	1233	1313	58	11	80	0.1375000
NODE_609_length_3077_cov_8.693083	1233	1313	60	3	80	0.0375000
NODE_609_length_3077_cov_8.693083	1233	1313	62	9	80	0.1125000
NODE_609_length_3077_cov_8.693083	1233	1313	64	10	80	0.1250000
NODE_609_length_3077_cov_8.693083	1233	1313	66	1	80	0.0125000
NODE_609_length_3077_cov_8.693083	1286	1352	52	4	66	0.0606061
NODE_609_length_3077_cov_8.693083	1286	1352	54	1	66	0.0151515
NODE_609_length_3077_cov_8.693083	1286	1352	56	2	66	0.0303030
NODE_609_length_3077_cov_8.693083	1286	1352	58	21	66	0.3181818
NODE_609_length_3077_cov_8.693083	1286	1352	60	9	66	0.1363636
NODE_609_length_3077_cov_8.693083	1286	1352	62	10	66	0.1515152
NODE_609_length_3077_cov_8.693083	1286	1352	64	18	66	0.2727273
NODE_609_length_3077_cov_8.693083	1286	1352	66	1	66	0.0151515
NODE_609_length_3077_cov_8.693083	2672	2757	10	8	85	0.0941176
NODE_609_length_3077_cov_8.693083	2672	2757	16	5	85	0.0588235
NODE_609_length_3077_cov_8.693083	2672	2757	18	12	85	0.1411765
NODE_609_length_3077_cov_8.693083	2672	2757	20	28	85	0.3294118
NODE_609_length_3077_cov_8.693083	2672	2757	22	15	85	0.1764706
NODE_609_length_3077_cov_8.693083	2672	2757	24	17	85	0.2000000
NODE_611_length_3074_cov_2.996303	2561	2629	57	1	68	0.0147059
NODE_611_length_3074_cov_2.996303	2561	2629	59	1	68	0.0147059
NODE_611_length_3074_cov_2.996303	2561	2629	62	1	68	0.0147059
NODE_611_length_3074_cov_2.996303	2561	2629	70	1	68	0.0147059
NODE_611_length_3074_cov_2.996303	2561	2629	75	1	68	0.0147059
NODE_611_length_3074_cov_2.996303	2561	2629	77	1	68	0.0147059
NODE_611_length_3074_cov_2.996303	2561	2629	82	1	68	0.0147059
NODE_611_length_3074_cov_2.996303	2561	2629	88	1	68	0.0147059
NODE_611_length_3074_cov_2.996303	2561	2629	91	1	68	0.0147059
NODE_611_length_3074_cov_2.996303	2561	2629	95	1	68	0.0147059
NODE_611_length_3074_cov_2.996303	2561	2629	99	1	68	0.0147059
NODE_611_length_3074_cov_2.996303	2561	2629	106	2	68	0.0294118
NODE_611_length_3074_cov_2.996303	2561	2629	109	1	68	0.0147059
NODE_611_length_3074_cov_2.996303	2561	2629	114	1	68	0.0147059
NODE_611_length_3074_cov_2.996303	2561	2629	119	1	68	0.0147059
NODE_611_length_3074_cov_2.996303	2561	2629	123	1	68	0.0147059
NODE_611_length_3074_cov_2.996303	2561	2629	127	1	68	0.0147059
NODE_611_length_3074_cov_2.996303	2561	2629	131	1	68	0.0147059
NODE_611_length_3074_cov_2.996303	2561	2629	136	1	68	0.0147059
NODE_611_length_3074_cov_2.996303	2561	2629	143	1	68	0.0147059
NODE_611_length_3074_cov_2.996303	2561	2629	148	1	68	0.0147059
NODE_611_length_3074_cov_2.996303	2561	2629	157	1	68	0.0147059
NODE_611_length_3074_cov_2.996303	2561	2629	159	1	68	0.0147059
NODE_611_length_3074_cov_2.996303	2561	2629	167	1	68	0.0147059
NODE_611_length_3074_cov_2.996303	2561	2629	176	2	68	0.0294118
NODE_611_length_3074_cov_2.996303	2561	2629	187	1	68	0.0147059
NODE_611_length_3074_cov_2.996303	2561	2629	193	1	68	0.0147059
NODE_611_length_3074_cov_2.996303	2561	2629	199	1	68	0.0147059
NODE_611_length_3074_cov_2.996303	2561	2629	205	1	68	0.0147059
NODE_611_length_3074_cov_2.996303	2561	2629	207	3	68	0.0441176
NODE_611_length_3074_cov_2.996303	2561	2629	211	1	68	0.0147059
NODE_611_length_3074_cov_2.996303	2561	2629	215	1	68	0.0147059
NODE_611_length_3074_cov_2.996303	2561	2629	221	1	68	0.0147059
NODE_611_length_3074_cov_2.996303	2561	2629	229	1	68	0.0147059
NODE_611_length_3074_cov_2.996303	2561	2629	243	1	68	0.0147059
NODE_611_length_3074_cov_2.996303	2561	2629	249	2	68	0.0294118
NODE_611_length_3074_cov_2.996303	2561	2629	253	1	68	0.0147059
NODE_611_length_3074_cov_2.996303	2561	2629	256	1	68	0.0147059
NODE_611_length_3074_cov_2.996303	2561	2629	267	1	68	0.0147059
NODE_611_length_3074_cov_2.996303	2561	2629	273	1	68	0.0147059
NODE_611_length_3074_cov_2.996303	2561	2629	274	1	68	0.0147059
NODE_611_length_3074_cov_2.996303	2561	2629	276	2	68	0.0294118
NODE_611_length_3074_cov_2.996303	2561	2629	280	2	68	0.0294118
NODE_611_length_3074_cov_2.996303	2561	2629	284	1	68	0.0147059
NODE_611_length_3074_cov_2.996303	2561	2629	291	1	68	0.0147059
NODE_611_length_3074_cov_2.996303	2561	2629	295	1	68	0.0147059
NODE_611_length_3074_cov_2.996303	2561	2629	297	1	68	0.0147059
NODE_611_length_3074_cov_2.996303	2561	2629	298	1	68	0.0147059
NODE_611_length_3074_cov_2.996303	2561	2629	299	1	68	0.0147059
NODE_611_length_3074_cov_2.996303	2561	2629	306	1	68	0.0147059
NODE_611_length_3074_cov_2.996303	2561	2629	312	1	68	0.0147059
NODE_611_length_3074_cov_2.996303	2561	2629	318	1	68	0.0147059
NODE_611_length_3074_cov_2.996303	2561	2629	338	1	68	0.0147059
NODE_611_length_3074_cov_2.996303	2561	2629	353	1	68	0.0147059
NODE_611_length_3074_cov_2.996303	2561	2629	357	1	68	0.0147059
NODE_611_length_3074_cov_2.996303	2561	2629	359	1	68	0.0147059
NODE_611_length_3074_cov_2.996303	2561	2629	388	1	68	0.0147059
NODE_611_length_3074_cov_2.996303	2561	2629	396	1	68	0.0147059
NODE_611_length_3074_cov_2.996303	2561	2629	406	1	68	0.0147059
NODE_611_length_3074_cov_2.996303	2561	2629	408	1	68	0.0147059
NODE_611_length_3074_cov_2.996303	2561	2629	411	1	68	0.0147059
NODE_615_length_3069_cov_2.448822	2948	2991	0	6	43	0.1395349
NODE_615_length_3069_cov_2.448822	2948	2991	2	12	43	0.2790698
NODE_615_length_3069_cov_2.448822	2948	2991	6	25	43	0.5813953
NODE_616_length_3059_cov_20.037500	346	426	39	11	80	0.1375000
NODE_616_length_3059_cov_20.037500	346	426	41	4	80	0.0500000
NODE_616_length_3059_cov_20.037500	346	426	44	1	80	0.0125000
NODE_616_length_3059_cov_20.037500	346	426	45	5	80	0.0625000
NODE_616_length_3059_cov_20.037500	346	426	55	12	80	0.1500000
NODE_616_length_3059_cov_20.037500	346	426	60	1	80	0.0125000
NODE_616_length_3059_cov_20.037500	346	426	61	1	80	0.0125000
NODE_616_length_3059_cov_20.037500	346	426	65	5	80	0.0625000
NODE_616_length_3059_cov_20.037500	346	426	66	3	80	0.0375000
NODE_616_length_3059_cov_20.037500	346	426	68	1	80	0.0125000
NODE_616_length_3059_cov_20.037500	346	426	75	1	80	0.0125000
NODE_616_length_3059_cov_20.037500	346	426	77	4	80	0.0500000
NODE_616_length_3059_cov_20.037500	346	426	83	4	80	0.0500000
NODE_616_length_3059_cov_20.037500	346	426	87	3	80	0.0375000
NODE_616_length_3059_cov_20.037500	346	426	90	4	80	0.0500000
NODE_616_length_3059_cov_20.037500	346	426	91	20	80	0.2500000
NODE_616_length_3059_cov_20.037500	399	479	54	4	80	0.0500000
NODE_616_length_3059_cov_20.037500	399	479	58	3	80	0.0375000
NODE_616_length_3059_cov_20.037500	399	479	59	1	80	0.0125000
NODE_616_length_3059_cov_20.037500	399	479	60	2	80	0.0250000
NODE_616_length_3059_cov_20.037500	399	479	62	5	80	0.0625000
NODE_616_length_3059_cov_20.037500	399	479	63	10	80	0.1250000
NODE_616_length_3059_cov_20.037500	399	479	65	3	80	0.0375000
NODE_616_length_3059_cov_20.037500	399	479	71	8	80	0.1000000
NODE_616_length_3059_cov_20.037500	399	479	72	3	80	0.0375000
NODE_616_length_3059_cov_20.037500	399	479	73	1	80	0.0125000
NODE_616_length_3059_cov_20.037500	399	479	79	4	80	0.0500000
NODE_616_length_3059_cov_20.037500	399	479	81	2	80	0.0250000
NODE_616_length_3059_cov_20.037500	399	479	85	3	80	0.0375000
NODE_616_length_3059_cov_20.037500	399	479	87	3	80	0.0375000
NODE_616_length_3059_cov_20.037500	399	479	90	4	80	0.0500000
NODE_616_length_3059_cov_20.037500	399	479	91	24	80	0.3000000
NODE_616_length_3059_cov_20.037500	1317	1397	8	9	80	0.1125000
NODE_616_length_3059_cov_20.037500	1317	1397	11	12	80	0.1500000
NODE_616_length_3059_cov_20.037500	1317	1397	12	8	80	0.1000000
NODE_616_length_3059_cov_20.037500	1317	1397	13	13	80	0.1625000
NODE_616_length_3059_cov_20.037500	1317	1397	14	12	80	0.1500000
NODE_616_length_3059_cov_20.037500	1317	1397	16	26	80	0.3250000
NODE_616_length_3059_cov_20.037500	1370	1447	4	33	77	0.4285714
NODE_616_length_3059_cov_20.037500	1370	1447	6	16	77	0.2077922
NODE_616_length_3059_cov_20.037500	1370	1447	8	2	77	0.0259740
NODE_616_length_3059_cov_20.037500	1370	1447	11	12	77	0.1558442
NODE_616_length_3059_cov_20.037500	1370	1447	12	9	77	0.1168831
NODE_616_length_3059_cov_20.037500	1370	1447	13	5	77	0.0649351
NODE_616_length_3059_cov_20.037500	2514	2594	0	57	80	0.7125000
NODE_616_length_3059_cov_20.037500	2514	2594	2	23	80	0.2875000
NODE_616_length_3059_cov_20.037500	2567	2647	0	80	80	1.0000000
NODE_617_length_3058_cov_21.767489	2802	2882	2	72	80	0.9000000
NODE_617_length_3058_cov_21.767489	2802	2882	3	1	80	0.0125000
NODE_617_length_3058_cov_21.767489	2802	2882	4	5	80	0.0625000
NODE_617_length_3058_cov_21.767489	2802	2882	16	1	80	0.0125000
NODE_617_length_3058_cov_21.767489	2802	2882	18	1	80	0.0125000
NODE_617_length_3058_cov_21.767489	2855	2930	2	22	75	0.2933333
NODE_617_length_3058_cov_21.767489	2855	2930	3	15	75	0.2000000
NODE_617_length_3058_cov_21.767489	2855	2930	4	38	75	0.5066667
NODE_621_length_3047_cov_47.232361	418	489	0	11	71	0.1549296
NODE_621_length_3047_cov_47.232361	418	489	2	23	71	0.3239437
NODE_621_length_3047_cov_47.232361	418	489	4	37	71	0.5211267
NODE_621_length_3047_cov_47.232361	758	801	7	1	43	0.0232558
NODE_621_length_3047_cov_47.232361	758	801	9	5	43	0.1162791
NODE_621_length_3047_cov_47.232361	758	801	11	1	43	0.0232558
NODE_621_length_3047_cov_47.232361	758	801	14	2	43	0.0465116
NODE_621_length_3047_cov_47.232361	758	801	18	1	43	0.0232558
NODE_621_length_3047_cov_47.232361	758	801	22	2	43	0.0465116
NODE_621_length_3047_cov_47.232361	758	801	24	2	43	0.0465116
NODE_621_length_3047_cov_47.232361	758	801	26	7	43	0.1627907
NODE_621_length_3047_cov_47.232361	758	801	27	10	43	0.2325581
NODE_621_length_3047_cov_47.232361	758	801	28	2	43	0.0465116
NODE_621_length_3047_cov_47.232361	758	801	31	4	43	0.0930233
NODE_621_length_3047_cov_47.232361	758	801	33	1	43	0.0232558
NODE_621_length_3047_cov_47.232361	758	801	35	1	43	0.0232558
NODE_621_length_3047_cov_47.232361	758	801	37	4	43	0.0930233
NODE_623_length_3044_cov_38.951783	1702	1782	0	13	80	0.1625000
NODE_623_length_3044_cov_38.951783	1702	1782	2	67	80	0.8375000
NODE_623_length_3044_cov_38.951783	1755	1835	0	66	80	0.8250000
NODE_623_length_3044_cov_38.951783	1755	1835	2	14	80	0.1750000
NODE_623_length_3044_cov_38.951783	1831	1911	0	29	80	0.3625000
NODE_623_length_3044_cov_38.951783	1831	1911	6	15	80	0.1875000
NODE_623_length_3044_cov_38.951783	1831	1911	10	36	80	0.4500000
NODE_623_length_3044_cov_38.951783	1884	1964	2	12	80	0.1500000
NODE_623_length_3044_cov_38.951783	1884	1964	10	46	80	0.5750000
NODE_623_length_3044_cov_38.951783	1884	1964	12	22	80	0.2750000
NODE_623_length_3044_cov_38.951783	2556	2636	0	23	80	0.2875000
NODE_623_length_3044_cov_38.951783	2556	2636	1	30	80	0.3750000
NODE_623_length_3044_cov_38.951783	2556	2636	2	1	80	0.0125000
NODE_623_length_3044_cov_38.951783	2556	2636	3	26	80	0.3250000
NODE_623_length_3044_cov_38.951783	2609	2689	1	1	80	0.0125000
NODE_623_length_3044_cov_38.951783	2609	2689	2	4	80	0.0500000
NODE_623_length_3044_cov_38.951783	2609	2689	3	69	80	0.8625000
NODE_623_length_3044_cov_38.951783	2609	2689	4	6	80	0.0750000
NODE_625_length_3039_cov_3.258163	261	337	4	22	76	0.2894737
NODE_625_length_3039_cov_3.258163	261	337	6	54	76	0.7105263
NODE_625_length_3039_cov_3.258163	261	336	4	21	75	0.2800000
NODE_625_length_3039_cov_3.258163	261	336	6	54	75	0.7200000
NODE_625_length_3039_cov_3.258163	261	337	4	22	76	0.2894737
NODE_625_length_3039_cov_3.258163	261	337	6	54	76	0.7105263
NODE_625_length_3039_cov_3.258163	270	337	4	22	67	0.3283582
NODE_625_length_3039_cov_3.258163	270	337	6	45	67	0.6716418
NODE_627_length_3036_cov_8.968676	2303	2367	0	8	64	0.1250000
NODE_627_length_3036_cov_8.968676	2303	2367	2	56	64	0.8750000
NODE_627_length_3036_cov_8.968676	2340	2420	0	46	80	0.5750000
NODE_627_length_3036_cov_8.968676	2340	2420	2	19	80	0.2375000
NODE_627_length_3036_cov_8.968676	2340	2420	4	10	80	0.1250000
NODE_627_length_3036_cov_8.968676	2340	2420	6	5	80	0.0625000
NODE_627_length_3036_cov_8.968676	2416	2496	6	5	80	0.0625000
NODE_627_length_3036_cov_8.968676	2416	2496	10	4	80	0.0500000
NODE_627_length_3036_cov_8.968676	2416	2496	12	10	80	0.1250000
NODE_627_length_3036_cov_8.968676	2416	2496	14	8	80	0.1000000
NODE_627_length_3036_cov_8.968676	2416	2496	18	53	80	0.6625000
NODE_627_length_3036_cov_8.968676	2469	2549	6	10	80	0.1250000
NODE_627_length_3036_cov_8.968676	2469	2549	7	4	80	0.0500000
NODE_627_length_3036_cov_8.968676	2469	2549	10	22	80	0.2750000
NODE_627_length_3036_cov_8.968676	2469	2549	12	12	80	0.1500000
NODE_627_length_3036_cov_8.968676	2469	2549	14	2	80	0.0250000
NODE_627_length_3036_cov_8.968676	2469	2549	16	3	80	0.0375000
NODE_627_length_3036_cov_8.968676	2469	2549	18	27	80	0.3375000
NODE_629_length_3032_cov_7.470849	1026	1068	24	1	42	0.0238095
NODE_629_length_3032_cov_7.470849	1026	1068	28	3	42	0.0714286
NODE_629_length_3032_cov_7.470849	1026	1068	30	7	42	0.1666667
NODE_629_length_3032_cov_7.470849	1026	1068	32	3	42	0.0714286
NODE_629_length_3032_cov_7.470849	1026	1068	33	2	42	0.0476190
NODE_629_length_3032_cov_7.470849	1026	1068	34	19	42	0.4523810
NODE_629_length_3032_cov_7.470849	1026	1068	35	2	42	0.0476190
NODE_629_length_3032_cov_7.470849	1026	1068	37	5	42	0.1190476
NODE_630_length_3025_cov_11.862611	2371	2451	0	80	80	1.0000000
NODE_630_length_3025_cov_11.862611	2424	2504	0	80	80	1.0000000
NODE_630_length_3025_cov_11.862611	2500	2580	0	80	80	1.0000000
NODE_630_length_3025_cov_11.862611	2553	2633	0	60	80	0.7500000
NODE_630_length_3025_cov_11.862611	2553	2633	2	20	80	0.2500000
NODE_635_length_3012_cov_33.100240	2379	2459	1	53	80	0.6625000
NODE_635_length_3012_cov_33.100240	2379	2459	5	27	80	0.3375000
NODE_635_length_3012_cov_33.100240	2432	2512	1	1	80	0.0125000
NODE_635_length_3012_cov_33.100240	2432	2512	5	75	80	0.9375000
NODE_635_length_3012_cov_33.100240	2432	2512	6	4	80	0.0500000
NODE_637_length_3007_cov_11.843535	2641	2721	0	79	80	0.9875000
NODE_637_length_3007_cov_11.843535	2641	2721	1	1	80	0.0125000
NODE_643_length_2992_cov_2.636709	2032	2112	0	58	80	0.7250000
NODE_643_length_2992_cov_2.636709	2032	2112	2	3	80	0.0375000
NODE_643_length_2992_cov_2.636709	2032	2112	4	19	80	0.2375000
NODE_643_length_2992_cov_2.636709	2085	2165	0	5	80	0.0625000
NODE_643_length_2992_cov_2.636709	2085	2165	2	3	80	0.0375000
NODE_643_length_2992_cov_2.636709	2085	2165	4	40	80	0.5000000
NODE_643_length_2992_cov_2.636709	2085	2165	6	4	80	0.0500000
NODE_643_length_2992_cov_2.636709	2085	2165	8	28	80	0.3500000
NODE_646_length_2978_cov_4.883293	382	452	0	70	70	1.0000000
NODE_646_length_2978_cov_4.883293	1858	1938	0	80	80	1.0000000
NODE_646_length_2978_cov_4.883293	1926	1991	0	25	65	0.3846154
NODE_646_length_2978_cov_4.883293	1926	1991	2	40	65	0.6153846
NODE_646_length_2978_cov_4.883293	1987	2066	0	23	79	0.2911392
NODE_646_length_2978_cov_4.883293	1987	2066	2	56	79	0.7088608
NODE_646_length_2978_cov_4.883293	2040	2079	0	36	39	0.9230769
NODE_646_length_2978_cov_4.883293	2040	2079	2	3	39	0.0769231
NODE_647_length_2976_cov_24.683003	1764	1844	0	80	80	1.0000000
NODE_647_length_2976_cov_24.683003	1817	1897	0	80	80	1.0000000
NODE_647_length_2976_cov_24.683003	1893	1973	0	56	80	0.7000000
NODE_647_length_2976_cov_24.683003	1893	1973	2	24	80	0.3000000
NODE_647_length_2976_cov_24.683003	1946	2026	0	3	80	0.0375000
NODE_647_length_2976_cov_24.683003	1946	2026	2	31	80	0.3875000
NODE_647_length_2976_cov_24.683003	1946	2026	4	46	80	0.5750000
NODE_651_length_2967_cov_16.146095	238	318	18	2	80	0.0250000
NODE_651_length_2967_cov_16.146095	238	318	20	18	80	0.2250000
NODE_651_length_2967_cov_16.146095	238	318	22	24	80	0.3000000
NODE_651_length_2967_cov_16.146095	238	318	24	18	80	0.2250000
NODE_651_length_2967_cov_16.146095	238	318	26	18	80	0.2250000
NODE_651_length_2967_cov_16.146095	291	371	12	14	80	0.1750000
NODE_651_length_2967_cov_16.146095	291	371	14	4	80	0.0500000
NODE_651_length_2967_cov_16.146095	291	371	16	28	80	0.3500000
NODE_651_length_2967_cov_16.146095	291	371	18	9	80	0.1125000
NODE_651_length_2967_cov_16.146095	291	371	20	11	80	0.1375000
NODE_651_length_2967_cov_16.146095	291	371	22	6	80	0.0750000
NODE_651_length_2967_cov_16.146095	291	371	24	1	80	0.0125000
NODE_651_length_2967_cov_16.146095	291	371	26	7	80	0.0875000
NODE_651_length_2967_cov_16.146095	367	447	0	1	80	0.0125000
NODE_651_length_2967_cov_16.146095	367	447	4	18	80	0.2250000
NODE_651_length_2967_cov_16.146095	367	447	6	3	80	0.0375000
NODE_651_length_2967_cov_16.146095	367	447	8	48	80	0.6000000
NODE_651_length_2967_cov_16.146095	367	447	12	3	80	0.0375000
NODE_651_length_2967_cov_16.146095	367	447	14	7	80	0.0875000
NODE_651_length_2967_cov_16.146095	420	500	0	54	80	0.6750000
NODE_651_length_2967_cov_16.146095	420	500	4	18	80	0.2250000
NODE_651_length_2967_cov_16.146095	420	500	6	3	80	0.0375000
NODE_651_length_2967_cov_16.146095	420	500	8	5	80	0.0625000
NODE_653_length_2965_cov_19.913468	92	134	0	5	42	0.1190476
NODE_653_length_2965_cov_19.913468	92	134	2	7	42	0.1666667
NODE_653_length_2965_cov_19.913468	92	134	4	3	42	0.0714286
NODE_653_length_2965_cov_19.913468	92	134	6	3	42	0.0714286
NODE_653_length_2965_cov_19.913468	92	134	12	1	42	0.0238095
NODE_653_length_2965_cov_19.913468	92	134	19	1	42	0.0238095
NODE_653_length_2965_cov_19.913468	92	134	23	1	42	0.0238095
NODE_653_length_2965_cov_19.913468	92	134	25	1	42	0.0238095
NODE_653_length_2965_cov_19.913468	92	134	27	20	42	0.4761905
NODE_653_length_2965_cov_19.913468	109	178	0	23	69	0.3333333
NODE_653_length_2965_cov_19.913468	109	178	1	24	69	0.3478261
NODE_653_length_2965_cov_19.913468	109	178	2	7	69	0.1014493
NODE_653_length_2965_cov_19.913468	109	178	3	1	69	0.0144928
NODE_653_length_2965_cov_19.913468	109	178	4	3	69	0.0434783
NODE_653_length_2965_cov_19.913468	109	178	6	3	69	0.0434783
NODE_653_length_2965_cov_19.913468	109	178	7	1	69	0.0144928
NODE_653_length_2965_cov_19.913468	109	178	12	1	69	0.0144928
NODE_653_length_2965_cov_19.913468	109	178	19	1	69	0.0144928
NODE_653_length_2965_cov_19.913468	109	178	23	1	69	0.0144928
NODE_653_length_2965_cov_19.913468	109	178	25	1	69	0.0144928
NODE_653_length_2965_cov_19.913468	109	178	27	3	69	0.0434783
NODE_653_length_2965_cov_19.913468	109	178	0	23	69	0.3333333
NODE_653_length_2965_cov_19.913468	109	178	1	24	69	0.3478261
NODE_653_length_2965_cov_19.913468	109	178	2	7	69	0.1014493
NODE_653_length_2965_cov_19.913468	109	178	3	1	69	0.0144928
NODE_653_length_2965_cov_19.913468	109	178	4	3	69	0.0434783
NODE_653_length_2965_cov_19.913468	109	178	6	3	69	0.0434783
NODE_653_length_2965_cov_19.913468	109	178	7	1	69	0.0144928
NODE_653_length_2965_cov_19.913468	109	178	12	1	69	0.0144928
NODE_653_length_2965_cov_19.913468	109	178	19	1	69	0.0144928
NODE_653_length_2965_cov_19.913468	109	178	23	1	69	0.0144928
NODE_653_length_2965_cov_19.913468	109	178	25	1	69	0.0144928
NODE_653_length_2965_cov_19.913468	109	178	27	3	69	0.0434783
NODE_653_length_2965_cov_19.913468	2298	2378	0	80	80	1.0000000
NODE_653_length_2965_cov_19.913468	2351	2431	0	80	80	1.0000000
NODE_653_length_2965_cov_19.913468	2427	2507	0	80	80	1.0000000
NODE_653_length_2965_cov_19.913468	2480	2560	0	80	80	1.0000000
NODE_656_length_2960_cov_35.741699	459	539	0	80	80	1.0000000
NODE_656_length_2960_cov_35.741699	512	592	0	80	80	1.0000000
NODE_659_length_2951_cov_7.195652	1100	1141	194	2	41	0.0487805
NODE_659_length_2951_cov_7.195652	1100	1141	198	1	41	0.0243902
NODE_659_length_2951_cov_7.195652	1100	1141	210	1	41	0.0243902
NODE_659_length_2951_cov_7.195652	1100	1141	216	1	41	0.0243902
NODE_659_length_2951_cov_7.195652	1100	1141	220	1	41	0.0243902
NODE_659_length_2951_cov_7.195652	1100	1141	222	1	41	0.0243902
NODE_659_length_2951_cov_7.195652	1100	1141	228	1	41	0.0243902
NODE_659_length_2951_cov_7.195652	1100	1141	234	1	41	0.0243902
NODE_659_length_2951_cov_7.195652	1100	1141	238	1	41	0.0243902
NODE_659_length_2951_cov_7.195652	1100	1141	239	2	41	0.0487805
NODE_659_length_2951_cov_7.195652	1100	1141	241	1	41	0.0243902
NODE_659_length_2951_cov_7.195652	1100	1141	247	1	41	0.0243902
NODE_659_length_2951_cov_7.195652	1100	1141	249	2	41	0.0487805
NODE_659_length_2951_cov_7.195652	1100	1141	250	1	41	0.0243902
NODE_659_length_2951_cov_7.195652	1100	1141	251	1	41	0.0243902
NODE_659_length_2951_cov_7.195652	1100	1141	254	1	41	0.0243902
NODE_659_length_2951_cov_7.195652	1100	1141	255	1	41	0.0243902
NODE_659_length_2951_cov_7.195652	1100	1141	257	1	41	0.0243902
NODE_659_length_2951_cov_7.195652	1100	1141	267	1	41	0.0243902
NODE_659_length_2951_cov_7.195652	1100	1141	269	1	41	0.0243902
NODE_659_length_2951_cov_7.195652	1100	1141	273	2	41	0.0487805
NODE_659_length_2951_cov_7.195652	1100	1141	281	1	41	0.0243902
NODE_659_length_2951_cov_7.195652	1100	1141	283	1	41	0.0243902
NODE_659_length_2951_cov_7.195652	1100	1141	291	3	41	0.0731707
NODE_659_length_2951_cov_7.195652	1100	1141	293	1	41	0.0243902
NODE_659_length_2951_cov_7.195652	1100	1141	299	2	41	0.0487805
NODE_659_length_2951_cov_7.195652	1100	1141	301	1	41	0.0243902
NODE_659_length_2951_cov_7.195652	1100	1141	302	1	41	0.0243902
NODE_659_length_2951_cov_7.195652	1100	1141	303	1	41	0.0243902
NODE_659_length_2951_cov_7.195652	1100	1141	306	5	41	0.1219512
NODE_665_length_2935_cov_37.693230	1492	1572	48	1	80	0.0125000
NODE_665_length_2935_cov_37.693230	1492	1572	49	2	80	0.0250000
NODE_665_length_2935_cov_37.693230	1492	1572	54	1	80	0.0125000
NODE_665_length_2935_cov_37.693230	1492	1572	64	1	80	0.0125000
NODE_665_length_2935_cov_37.693230	1492	1572	68	4	80	0.0500000
NODE_665_length_2935_cov_37.693230	1492	1572	72	4	80	0.0500000
NODE_665_length_2935_cov_37.693230	1492	1572	74	7	80	0.0875000
NODE_665_length_2935_cov_37.693230	1492	1572	76	27	80	0.3375000
NODE_665_length_2935_cov_37.693230	1492	1572	78	17	80	0.2125000
NODE_665_length_2935_cov_37.693230	1492	1572	80	16	80	0.2000000
NODE_665_length_2935_cov_37.693230	1534	1589	62	8	55	0.1454545
NODE_665_length_2935_cov_37.693230	1534	1589	65	4	55	0.0727273
NODE_665_length_2935_cov_37.693230	1534	1589	67	1	55	0.0181818
NODE_665_length_2935_cov_37.693230	1534	1589	68	2	55	0.0363636
NODE_665_length_2935_cov_37.693230	1534	1589	74	1	55	0.0181818
NODE_665_length_2935_cov_37.693230	1534	1589	76	27	55	0.4909091
NODE_665_length_2935_cov_37.693230	1534	1589	78	12	55	0.2181818
NODE_665_length_2935_cov_37.693230	1545	1619	6	2	74	0.0270270
NODE_665_length_2935_cov_37.693230	1545	1619	8	1	74	0.0135135
NODE_665_length_2935_cov_37.693230	1545	1619	10	2	74	0.0270270
NODE_665_length_2935_cov_37.693230	1545	1619	12	1	74	0.0135135
NODE_665_length_2935_cov_37.693230	1545	1619	18	3	74	0.0405405
NODE_665_length_2935_cov_37.693230	1545	1619	22	1	74	0.0135135
NODE_665_length_2935_cov_37.693230	1545	1619	24	3	74	0.0405405
NODE_665_length_2935_cov_37.693230	1545	1619	26	2	74	0.0270270
NODE_665_length_2935_cov_37.693230	1545	1619	30	1	74	0.0135135
NODE_665_length_2935_cov_37.693230	1545	1619	32	1	74	0.0135135
NODE_665_length_2935_cov_37.693230	1545	1619	33	1	74	0.0135135
NODE_665_length_2935_cov_37.693230	1545	1619	34	4	74	0.0540541
NODE_665_length_2935_cov_37.693230	1545	1619	36	4	74	0.0540541
NODE_665_length_2935_cov_37.693230	1545	1619	38	1	74	0.0135135
NODE_665_length_2935_cov_37.693230	1545	1619	42	1	74	0.0135135
NODE_665_length_2935_cov_37.693230	1545	1619	48	1	74	0.0135135
NODE_665_length_2935_cov_37.693230	1545	1619	54	1	74	0.0135135
NODE_665_length_2935_cov_37.693230	1545	1619	62	8	74	0.1081081
NODE_665_length_2935_cov_37.693230	1545	1619	65	4	74	0.0540541
NODE_665_length_2935_cov_37.693230	1545	1619	67	1	74	0.0135135
NODE_665_length_2935_cov_37.693230	1545	1619	68	2	74	0.0270270
NODE_665_length_2935_cov_37.693230	1545	1619	74	1	74	0.0135135
NODE_665_length_2935_cov_37.693230	1545	1619	76	27	74	0.3648649
NODE_665_length_2935_cov_37.693230	1545	1619	78	1	74	0.0135135
NODE_665_length_2935_cov_37.693230	1625	1701	0	27	76	0.3552631
NODE_665_length_2935_cov_37.693230	1625	1701	2	49	76	0.6447368
NODE_665_length_2935_cov_37.693230	2863	2906	2	3	43	0.0697674
NODE_665_length_2935_cov_37.693230	2863	2906	4	1	43	0.0232558
NODE_665_length_2935_cov_37.693230	2863	2906	5	30	43	0.6976744
NODE_665_length_2935_cov_37.693230	2863	2906	6	9	43	0.2093023
NODE_675_length_2913_cov_4.376688	2664	2739	0	3	75	0.0400000
NODE_675_length_2913_cov_4.376688	2664	2739	4	3	75	0.0400000
NODE_675_length_2913_cov_4.376688	2664	2739	6	23	75	0.3066667
NODE_675_length_2913_cov_4.376688	2664	2739	8	46	75	0.6133333
NODE_675_length_2913_cov_4.376688	2664	2723	6	13	59	0.2203390
NODE_675_length_2913_cov_4.376688	2664	2723	8	46	59	0.7796610
NODE_675_length_2913_cov_4.376688	2664	2739	0	3	75	0.0400000
NODE_675_length_2913_cov_4.376688	2664	2739	4	3	75	0.0400000
NODE_675_length_2913_cov_4.376688	2664	2739	6	23	75	0.3066667
NODE_675_length_2913_cov_4.376688	2664	2739	8	46	75	0.6133333
NODE_675_length_2913_cov_4.376688	2664	2739	0	3	75	0.0400000
NODE_675_length_2913_cov_4.376688	2664	2739	4	3	75	0.0400000
NODE_675_length_2913_cov_4.376688	2664	2739	6	23	75	0.3066667
NODE_675_length_2913_cov_4.376688	2664	2739	8	46	75	0.6133333
NODE_675_length_2913_cov_4.376688	2673	2739	0	3	66	0.0454545
NODE_675_length_2913_cov_4.376688	2673	2739	4	3	66	0.0454545
NODE_675_length_2913_cov_4.376688	2673	2739	6	23	66	0.3484848
NODE_675_length_2913_cov_4.376688	2673	2739	8	37	66	0.5606061
NODE_675_length_2913_cov_4.376688	2717	2780	0	44	63	0.6984127
NODE_675_length_2913_cov_4.376688	2717	2780	4	3	63	0.0476190
NODE_675_length_2913_cov_4.376688	2717	2780	6	16	63	0.2539683
NODE_675_length_2913_cov_4.376688	2745	2778	0	33	33	1.0000000
NODE_677_length_2909_cov_71.975089	2090	2174	403	1	84	0.0119048
NODE_677_length_2909_cov_71.975089	2090	2174	404	2	84	0.0238095
NODE_677_length_2909_cov_71.975089	2090	2174	408	1	84	0.0119048
NODE_677_length_2909_cov_71.975089	2090	2174	409	3	84	0.0357143
NODE_677_length_2909_cov_71.975089	2090	2174	410	1	84	0.0119048
NODE_677_length_2909_cov_71.975089	2090	2174	412	3	84	0.0357143
NODE_677_length_2909_cov_71.975089	2090	2174	413	1	84	0.0119048
NODE_677_length_2909_cov_71.975089	2090	2174	414	1	84	0.0119048
NODE_677_length_2909_cov_71.975089	2090	2174	415	2	84	0.0238095
NODE_677_length_2909_cov_71.975089	2090	2174	419	1	84	0.0119048
NODE_677_length_2909_cov_71.975089	2090	2174	420	1	84	0.0119048
NODE_677_length_2909_cov_71.975089	2090	2174	421	1	84	0.0119048
NODE_677_length_2909_cov_71.975089	2090	2174	422	1	84	0.0119048
NODE_677_length_2909_cov_71.975089	2090	2174	425	1	84	0.0119048
NODE_677_length_2909_cov_71.975089	2090	2174	427	1	84	0.0119048
NODE_677_length_2909_cov_71.975089	2090	2174	432	2	84	0.0238095
NODE_677_length_2909_cov_71.975089	2090	2174	435	1	84	0.0119048
NODE_677_length_2909_cov_71.975089	2090	2174	437	1	84	0.0119048
NODE_677_length_2909_cov_71.975089	2090	2174	443	1	84	0.0119048
NODE_677_length_2909_cov_71.975089	2090	2174	454	1	84	0.0119048
NODE_677_length_2909_cov_71.975089	2090	2174	459	2	84	0.0238095
NODE_677_length_2909_cov_71.975089	2090	2174	460	2	84	0.0238095
NODE_677_length_2909_cov_71.975089	2090	2174	461	1	84	0.0119048
NODE_677_length_2909_cov_71.975089	2090	2174	463	3	84	0.0357143
NODE_677_length_2909_cov_71.975089	2090	2174	464	3	84	0.0357143
NODE_677_length_2909_cov_71.975089	2090	2174	466	1	84	0.0119048
NODE_677_length_2909_cov_71.975089	2090	2174	467	1	84	0.0119048
NODE_677_length_2909_cov_71.975089	2090	2174	469	1	84	0.0119048
NODE_677_length_2909_cov_71.975089	2090	2174	472	2	84	0.0238095
NODE_677_length_2909_cov_71.975089	2090	2174	476	1	84	0.0119048
NODE_677_length_2909_cov_71.975089	2090	2174	478	2	84	0.0238095
NODE_677_length_2909_cov_71.975089	2090	2174	480	1	84	0.0119048
NODE_677_length_2909_cov_71.975089	2090	2174	488	1	84	0.0119048
NODE_677_length_2909_cov_71.975089	2090	2174	491	1	84	0.0119048
NODE_677_length_2909_cov_71.975089	2090	2174	496	1	84	0.0119048
NODE_677_length_2909_cov_71.975089	2090	2174	501	1	84	0.0119048
NODE_677_length_2909_cov_71.975089	2090	2174	503	1	84	0.0119048
NODE_677_length_2909_cov_71.975089	2090	2174	511	1	84	0.0119048
NODE_677_length_2909_cov_71.975089	2090	2174	517	1	84	0.0119048
NODE_677_length_2909_cov_71.975089	2090	2174	520	1	84	0.0119048
NODE_677_length_2909_cov_71.975089	2090	2174	526	1	84	0.0119048
NODE_677_length_2909_cov_71.975089	2090	2174	530	2	84	0.0238095
NODE_677_length_2909_cov_71.975089	2090	2174	535	1	84	0.0119048
NODE_677_length_2909_cov_71.975089	2090	2174	550	1	84	0.0119048
NODE_677_length_2909_cov_71.975089	2090	2174	563	1	84	0.0119048
NODE_677_length_2909_cov_71.975089	2090	2174	580	1	84	0.0119048
NODE_677_length_2909_cov_71.975089	2090	2174	592	1	84	0.0119048
NODE_677_length_2909_cov_71.975089	2090	2174	608	2	84	0.0238095
NODE_677_length_2909_cov_71.975089	2090	2174	610	2	84	0.0238095
NODE_677_length_2909_cov_71.975089	2090	2174	613	1	84	0.0119048
NODE_677_length_2909_cov_71.975089	2090	2174	619	1	84	0.0119048
NODE_677_length_2909_cov_71.975089	2090	2174	628	1	84	0.0119048
NODE_677_length_2909_cov_71.975089	2090	2174	644	1	84	0.0119048
NODE_677_length_2909_cov_71.975089	2090	2174	646	1	84	0.0119048
NODE_677_length_2909_cov_71.975089	2090	2174	653	1	84	0.0119048
NODE_677_length_2909_cov_71.975089	2090	2174	671	1	84	0.0119048
NODE_677_length_2909_cov_71.975089	2090	2174	680	1	84	0.0119048
NODE_677_length_2909_cov_71.975089	2090	2174	684	1	84	0.0119048
NODE_677_length_2909_cov_71.975089	2090	2174	685	1	84	0.0119048
NODE_677_length_2909_cov_71.975089	2090	2174	690	1	84	0.0119048
NODE_677_length_2909_cov_71.975089	2090	2174	695	1	84	0.0119048
NODE_677_length_2909_cov_71.975089	2090	2174	696	1	84	0.0119048
NODE_677_length_2909_cov_71.975089	2090	2174	698	1	84	0.0119048
NODE_677_length_2909_cov_71.975089	2090	2174	700	1	84	0.0119048
NODE_677_length_2909_cov_71.975089	2090	2174	701	1	84	0.0119048
NODE_677_length_2909_cov_71.975089	2090	2174	707	1	84	0.0119048
NODE_678_length_2908_cov_5.937344	2495	2575	2	40	80	0.5000000
NODE_678_length_2908_cov_5.937344	2495	2575	4	40	80	0.5000000
NODE_678_length_2908_cov_5.937344	2548	2628	0	45	80	0.5625000
NODE_678_length_2908_cov_5.937344	2548	2628	2	35	80	0.4375000
NODE_678_length_2908_cov_5.937344	2624	2704	0	80	80	1.0000000
NODE_678_length_2908_cov_5.937344	2677	2757	0	80	80	1.0000000
NODE_679_length_2905_cov_12.777619	2358	2419	0	57	61	0.9344262
NODE_679_length_2905_cov_12.777619	2358	2419	2	1	61	0.0163934
NODE_679_length_2905_cov_12.777619	2358	2419	9	1	61	0.0163934
NODE_679_length_2905_cov_12.777619	2358	2419	13	1	61	0.0163934
NODE_679_length_2905_cov_12.777619	2358	2419	15	1	61	0.0163934
NODE_679_length_2905_cov_12.777619	2358	2419	0	57	61	0.9344262
NODE_679_length_2905_cov_12.777619	2358	2419	2	1	61	0.0163934
NODE_679_length_2905_cov_12.777619	2358	2419	9	1	61	0.0163934
NODE_679_length_2905_cov_12.777619	2358	2419	13	1	61	0.0163934
NODE_679_length_2905_cov_12.777619	2358	2419	15	1	61	0.0163934
NODE_679_length_2905_cov_12.777619	2358	2419	0	57	61	0.9344262
NODE_679_length_2905_cov_12.777619	2358	2419	2	1	61	0.0163934
NODE_679_length_2905_cov_12.777619	2358	2419	9	1	61	0.0163934
NODE_679_length_2905_cov_12.777619	2358	2419	13	1	61	0.0163934
NODE_679_length_2905_cov_12.777619	2358	2419	15	1	61	0.0163934
NODE_679_length_2905_cov_12.777619	2392	2472	0	80	80	1.0000000
NODE_680_length_2903_cov_5.474322	2423	2464	12	7	41	0.1707317
NODE_680_length_2903_cov_5.474322	2423	2464	14	4	41	0.0975610
NODE_680_length_2903_cov_5.474322	2423	2464	16	11	41	0.2682927
NODE_680_length_2903_cov_5.474322	2423	2464	17	19	41	0.4634146
NODE_684_length_2898_cov_5.786352	0	74	0	44	74	0.5945946
NODE_684_length_2898_cov_5.786352	0	74	4	30	74	0.4054054
NODE_684_length_2898_cov_5.786352	47	124	0	8	77	0.1038961
NODE_684_length_2898_cov_5.786352	47	124	4	69	77	0.8961039
NODE_686_length_2895_cov_8.519313	869	949	2	12	80	0.1500000
NODE_686_length_2895_cov_8.519313	869	949	8	52	80	0.6500000
NODE_686_length_2895_cov_8.519313	869	949	10	16	80	0.2000000
NODE_686_length_2895_cov_8.519313	922	1002	0	16	80	0.2000000
NODE_686_length_2895_cov_8.519313	922	1002	2	15	80	0.1875000
NODE_686_length_2895_cov_8.519313	922	1002	8	38	80	0.4750000
NODE_686_length_2895_cov_8.519313	922	1002	10	11	80	0.1375000
NODE_688_length_2894_cov_2.036136	2677	2757	34	1	80	0.0125000
NODE_688_length_2894_cov_2.036136	2677	2757	36	3	80	0.0375000
NODE_688_length_2894_cov_2.036136	2677	2757	40	1	80	0.0125000
NODE_688_length_2894_cov_2.036136	2677	2757	42	1	80	0.0125000
NODE_688_length_2894_cov_2.036136	2677	2757	46	14	80	0.1750000
NODE_688_length_2894_cov_2.036136	2677	2757	47	1	80	0.0125000
NODE_688_length_2894_cov_2.036136	2677	2757	48	31	80	0.3875000
NODE_688_length_2894_cov_2.036136	2677	2757	50	28	80	0.3500000
NODE_689_length_2891_cov_7.938037	193	275	2	2	82	0.0243902
NODE_689_length_2891_cov_7.938037	193	275	4	9	82	0.1097561
NODE_689_length_2891_cov_7.938037	193	275	6	5	82	0.0609756
NODE_689_length_2891_cov_7.938037	193	275	8	25	82	0.3048781
NODE_689_length_2891_cov_7.938037	193	275	10	4	82	0.0487805
NODE_689_length_2891_cov_7.938037	193	275	12	6	82	0.0731707
NODE_689_length_2891_cov_7.938037	193	275	14	8	82	0.0975610
NODE_689_length_2891_cov_7.938037	193	275	20	2	82	0.0243902
NODE_689_length_2891_cov_7.938037	193	275	22	3	82	0.0365854
NODE_689_length_2891_cov_7.938037	193	275	25	14	82	0.1707317
NODE_689_length_2891_cov_7.938037	193	275	31	4	82	0.0487805
NODE_691_length_2889_cov_11.426882	407	487	0	78	80	0.9750000
NODE_691_length_2889_cov_11.426882	407	487	1	2	80	0.0250000
NODE_691_length_2889_cov_11.426882	460	540	0	80	80	1.0000000
NODE_691_length_2889_cov_11.426882	1006	1086	6	4	80	0.0500000
NODE_691_length_2889_cov_11.426882	1006	1086	8	1	80	0.0125000
NODE_691_length_2889_cov_11.426882	1006	1086	13	4	80	0.0500000
NODE_691_length_2889_cov_11.426882	1006	1086	17	1	80	0.0125000
NODE_691_length_2889_cov_11.426882	1006	1086	20	1	80	0.0125000
NODE_691_length_2889_cov_11.426882	1006	1086	21	1	80	0.0125000
NODE_691_length_2889_cov_11.426882	1006	1086	22	1	80	0.0125000
NODE_691_length_2889_cov_11.426882	1006	1086	26	2	80	0.0250000
NODE_691_length_2889_cov_11.426882	1006	1086	28	1	80	0.0125000
NODE_691_length_2889_cov_11.426882	1006	1086	30	2	80	0.0250000
NODE_691_length_2889_cov_11.426882	1006	1086	34	47	80	0.5875000
NODE_691_length_2889_cov_11.426882	1006	1086	36	1	80	0.0125000
NODE_691_length_2889_cov_11.426882	1006	1086	40	14	80	0.1750000
NODE_691_length_2889_cov_11.426882	1007	1086	6	4	79	0.0506329
NODE_691_length_2889_cov_11.426882	1007	1086	8	1	79	0.0126582
NODE_691_length_2889_cov_11.426882	1007	1086	13	4	79	0.0506329
NODE_691_length_2889_cov_11.426882	1007	1086	17	1	79	0.0126582
NODE_691_length_2889_cov_11.426882	1007	1086	20	1	79	0.0126582
NODE_691_length_2889_cov_11.426882	1007	1086	21	1	79	0.0126582
NODE_691_length_2889_cov_11.426882	1007	1086	22	1	79	0.0126582
NODE_691_length_2889_cov_11.426882	1007	1086	26	2	79	0.0253165
NODE_691_length_2889_cov_11.426882	1007	1086	28	1	79	0.0126582
NODE_691_length_2889_cov_11.426882	1007	1086	30	2	79	0.0253165
NODE_691_length_2889_cov_11.426882	1007	1086	34	47	79	0.5949367
NODE_691_length_2889_cov_11.426882	1007	1086	36	1	79	0.0126582
NODE_691_length_2889_cov_11.426882	1007	1086	40	13	79	0.1645570
NODE_691_length_2889_cov_11.426882	1059	1138	0	50	79	0.6329114
NODE_691_length_2889_cov_11.426882	1059	1138	4	1	79	0.0126582
NODE_691_length_2889_cov_11.426882	1059	1138	6	5	79	0.0632911
NODE_691_length_2889_cov_11.426882	1059	1138	8	1	79	0.0126582
NODE_691_length_2889_cov_11.426882	1059	1138	13	4	79	0.0506329
NODE_691_length_2889_cov_11.426882	1059	1138	17	1	79	0.0126582
NODE_691_length_2889_cov_11.426882	1059	1138	20	1	79	0.0126582
NODE_691_length_2889_cov_11.426882	1059	1138	21	1	79	0.0126582
NODE_691_length_2889_cov_11.426882	1059	1138	22	1	79	0.0126582
NODE_691_length_2889_cov_11.426882	1059	1138	26	2	79	0.0253165
NODE_691_length_2889_cov_11.426882	1059	1138	28	1	79	0.0126582
NODE_691_length_2889_cov_11.426882	1059	1138	30	2	79	0.0253165
NODE_691_length_2889_cov_11.426882	1059	1138	34	9	79	0.1139240
NODE_691_length_2889_cov_11.426882	1059	1138	0	50	79	0.6329114
NODE_691_length_2889_cov_11.426882	1059	1138	4	1	79	0.0126582
NODE_691_length_2889_cov_11.426882	1059	1138	6	5	79	0.0632911
NODE_691_length_2889_cov_11.426882	1059	1138	8	1	79	0.0126582
NODE_691_length_2889_cov_11.426882	1059	1138	13	4	79	0.0506329
NODE_691_length_2889_cov_11.426882	1059	1138	17	1	79	0.0126582
NODE_691_length_2889_cov_11.426882	1059	1138	20	1	79	0.0126582
NODE_691_length_2889_cov_11.426882	1059	1138	21	1	79	0.0126582
NODE_691_length_2889_cov_11.426882	1059	1138	22	1	79	0.0126582
NODE_691_length_2889_cov_11.426882	1059	1138	26	2	79	0.0253165
NODE_691_length_2889_cov_11.426882	1059	1138	28	1	79	0.0126582
NODE_691_length_2889_cov_11.426882	1059	1138	30	2	79	0.0253165
NODE_691_length_2889_cov_11.426882	1059	1138	34	9	79	0.1139240
NODE_693_length_2888_cov_3.789172	992	1072	6	6	80	0.0750000
NODE_693_length_2888_cov_3.789172	992	1072	8	44	80	0.5500000
NODE_693_length_2888_cov_3.789172	992	1072	10	30	80	0.3750000
NODE_693_length_2888_cov_3.789172	1045	1087	4	2	42	0.0476190
NODE_693_length_2888_cov_3.789172	1045	1087	6	19	42	0.4523810
NODE_693_length_2888_cov_3.789172	1045	1087	10	21	42	0.5000000
NODE_697_length_2878_cov_6.277798	2712	2781	4	27	69	0.3913043
NODE_697_length_2878_cov_6.277798	2712	2781	7	3	69	0.0434783
NODE_697_length_2878_cov_6.277798	2712	2781	9	15	69	0.2173913
NODE_697_length_2878_cov_6.277798	2712	2781	11	10	69	0.1449275
NODE_697_length_2878_cov_6.277798	2712	2781	13	1	69	0.0144928
NODE_697_length_2878_cov_6.277798	2712	2781	15	1	69	0.0144928
NODE_697_length_2878_cov_6.277798	2712	2781	17	3	69	0.0434783
NODE_697_length_2878_cov_6.277798	2712	2781	19	9	69	0.1304348
NODE_703_length_2862_cov_9.060803	2409	2489	8	5	80	0.0625000
NODE_703_length_2862_cov_9.060803	2409	2489	11	24	80	0.3000000
NODE_703_length_2862_cov_9.060803	2409	2489	13	10	80	0.1250000
NODE_703_length_2862_cov_9.060803	2409	2489	16	41	80	0.5125000
NODE_703_length_2862_cov_9.060803	2462	2542	8	54	80	0.6750000
NODE_703_length_2862_cov_9.060803	2462	2542	11	24	80	0.3000000
NODE_703_length_2862_cov_9.060803	2462	2542	13	2	80	0.0250000
NODE_712_length_2840_cov_2.079533	1660	1740	0	22	80	0.2750000
NODE_712_length_2840_cov_2.079533	1660	1740	4	58	80	0.7250000
NODE_713_length_2839_cov_16.762044	327	402	0	7	75	0.0933333
NODE_713_length_2839_cov_16.762044	327	402	3	15	75	0.2000000
NODE_713_length_2839_cov_16.762044	327	402	5	1	75	0.0133333
NODE_713_length_2839_cov_16.762044	327	402	6	52	75	0.6933333
NODE_713_length_2839_cov_16.762044	380	468	0	73	88	0.8295454
NODE_713_length_2839_cov_16.762044	380	468	3	15	88	0.1704545
NODE_713_length_2839_cov_16.762044	1021	1101	0	80	80	1.0000000
NODE_713_length_2839_cov_16.762044	1074	1154	0	32	80	0.4000000
NODE_713_length_2839_cov_16.762044	1074	1154	2	7	80	0.0875000
NODE_713_length_2839_cov_16.762044	1074	1154	4	41	80	0.5125000
NODE_714_length_2835_cov_29.691520	1552	1581	300	1	29	0.0344828
NODE_714_length_2835_cov_29.691520	1552	1581	303	3	29	0.1034483
NODE_714_length_2835_cov_29.691520	1552	1581	306	1	29	0.0344828
NODE_714_length_2835_cov_29.691520	1552	1581	308	2	29	0.0689655
NODE_714_length_2835_cov_29.691520	1552	1581	310	1	29	0.0344828
NODE_714_length_2835_cov_29.691520	1552	1581	311	1	29	0.0344828
NODE_714_length_2835_cov_29.691520	1552	1581	314	1	29	0.0344828
NODE_714_length_2835_cov_29.691520	1552	1581	318	1	29	0.0344828
NODE_714_length_2835_cov_29.691520	1552	1581	320	2	29	0.0689655
NODE_714_length_2835_cov_29.691520	1552	1581	322	1	29	0.0344828
NODE_714_length_2835_cov_29.691520	1552	1581	324	5	29	0.1724138
NODE_714_length_2835_cov_29.691520	1552	1581	330	1	29	0.0344828
NODE_714_length_2835_cov_29.691520	1552	1581	332	1	29	0.0344828
NODE_714_length_2835_cov_29.691520	1552	1581	336	1	29	0.0344828
NODE_714_length_2835_cov_29.691520	1552	1581	348	2	29	0.0689655
NODE_714_length_2835_cov_29.691520	1552	1581	350	1	29	0.0344828
NODE_714_length_2835_cov_29.691520	1552	1581	354	4	29	0.1379310
NODE_714_length_2835_cov_29.691520	1554	1629	71	1	75	0.0133333
NODE_714_length_2835_cov_29.691520	1554	1629	74	1	75	0.0133333
NODE_714_length_2835_cov_29.691520	1554	1629	80	1	75	0.0133333
NODE_714_length_2835_cov_29.691520	1554	1629	85	1	75	0.0133333
NODE_714_length_2835_cov_29.691520	1554	1629	94	1	75	0.0133333
NODE_714_length_2835_cov_29.691520	1554	1629	98	1	75	0.0133333
NODE_714_length_2835_cov_29.691520	1554	1629	102	1	75	0.0133333
NODE_714_length_2835_cov_29.691520	1554	1629	114	1	75	0.0133333
NODE_714_length_2835_cov_29.691520	1554	1629	119	2	75	0.0266667
NODE_714_length_2835_cov_29.691520	1554	1629	123	1	75	0.0133333
NODE_714_length_2835_cov_29.691520	1554	1629	132	1	75	0.0133333
NODE_714_length_2835_cov_29.691520	1554	1629	136	1	75	0.0133333
NODE_714_length_2835_cov_29.691520	1554	1629	143	1	75	0.0133333
NODE_714_length_2835_cov_29.691520	1554	1629	145	1	75	0.0133333
NODE_714_length_2835_cov_29.691520	1554	1629	147	1	75	0.0133333
NODE_714_length_2835_cov_29.691520	1554	1629	165	1	75	0.0133333
NODE_714_length_2835_cov_29.691520	1554	1629	171	1	75	0.0133333
NODE_714_length_2835_cov_29.691520	1554	1629	177	1	75	0.0133333
NODE_714_length_2835_cov_29.691520	1554	1629	191	1	75	0.0133333
NODE_714_length_2835_cov_29.691520	1554	1629	195	2	75	0.0266667
NODE_714_length_2835_cov_29.691520	1554	1629	206	1	75	0.0133333
NODE_714_length_2835_cov_29.691520	1554	1629	210	1	75	0.0133333
NODE_714_length_2835_cov_29.691520	1554	1629	214	1	75	0.0133333
NODE_714_length_2835_cov_29.691520	1554	1629	216	1	75	0.0133333
NODE_714_length_2835_cov_29.691520	1554	1629	225	1	75	0.0133333
NODE_714_length_2835_cov_29.691520	1554	1629	227	1	75	0.0133333
NODE_714_length_2835_cov_29.691520	1554	1629	229	1	75	0.0133333
NODE_714_length_2835_cov_29.691520	1554	1629	236	1	75	0.0133333
NODE_714_length_2835_cov_29.691520	1554	1629	248	1	75	0.0133333
NODE_714_length_2835_cov_29.691520	1554	1629	251	1	75	0.0133333
NODE_714_length_2835_cov_29.691520	1554	1629	255	3	75	0.0400000
NODE_714_length_2835_cov_29.691520	1554	1629	259	1	75	0.0133333
NODE_714_length_2835_cov_29.691520	1554	1629	263	1	75	0.0133333
NODE_714_length_2835_cov_29.691520	1554	1629	266	1	75	0.0133333
NODE_714_length_2835_cov_29.691520	1554	1629	269	1	75	0.0133333
NODE_714_length_2835_cov_29.691520	1554	1629	271	1	75	0.0133333
NODE_714_length_2835_cov_29.691520	1554	1629	273	1	75	0.0133333
NODE_714_length_2835_cov_29.691520	1554	1629	291	1	75	0.0133333
NODE_714_length_2835_cov_29.691520	1554	1629	295	1	75	0.0133333
NODE_714_length_2835_cov_29.691520	1554	1629	299	2	75	0.0266667
NODE_714_length_2835_cov_29.691520	1554	1629	300	4	75	0.0533333
NODE_714_length_2835_cov_29.691520	1554	1629	303	3	75	0.0400000
NODE_714_length_2835_cov_29.691520	1554	1629	306	1	75	0.0133333
NODE_714_length_2835_cov_29.691520	1554	1629	308	2	75	0.0266667
NODE_714_length_2835_cov_29.691520	1554	1629	310	1	75	0.0133333
NODE_714_length_2835_cov_29.691520	1554	1629	311	1	75	0.0133333
NODE_714_length_2835_cov_29.691520	1554	1629	314	1	75	0.0133333
NODE_714_length_2835_cov_29.691520	1554	1629	318	1	75	0.0133333
NODE_714_length_2835_cov_29.691520	1554	1629	320	2	75	0.0266667
NODE_714_length_2835_cov_29.691520	1554	1629	322	1	75	0.0133333
NODE_714_length_2835_cov_29.691520	1554	1629	324	5	75	0.0666667
NODE_714_length_2835_cov_29.691520	1554	1629	330	1	75	0.0133333
NODE_714_length_2835_cov_29.691520	1554	1629	332	1	75	0.0133333
NODE_714_length_2835_cov_29.691520	1554	1629	336	1	75	0.0133333
NODE_714_length_2835_cov_29.691520	1554	1629	348	2	75	0.0266667
NODE_714_length_2835_cov_29.691520	1554	1629	350	1	75	0.0133333
NODE_714_length_2835_cov_29.691520	1554	1629	354	2	75	0.0266667
NODE_720_length_2825_cov_9.731108	487	567	0	18	80	0.2250000
NODE_720_length_2825_cov_9.731108	487	567	5	36	80	0.4500000
NODE_720_length_2825_cov_9.731108	487	567	7	8	80	0.1000000
NODE_720_length_2825_cov_9.731108	487	567	8	18	80	0.2250000
NODE_720_length_2825_cov_9.731108	540	620	0	71	80	0.8875000
NODE_720_length_2825_cov_9.731108	540	620	5	9	80	0.1125000
NODE_726_length_2810_cov_2.844338	206	289	26	6	83	0.0722892
NODE_726_length_2810_cov_2.844338	206	289	32	3	83	0.0361446
NODE_726_length_2810_cov_2.844338	206	289	34	3	83	0.0361446
NODE_726_length_2810_cov_2.844338	206	289	36	4	83	0.0481928
NODE_726_length_2810_cov_2.844338	206	289	40	2	83	0.0240964
NODE_726_length_2810_cov_2.844338	206	289	42	4	83	0.0481928
NODE_726_length_2810_cov_2.844338	206	289	44	4	83	0.0481928
NODE_726_length_2810_cov_2.844338	206	289	46	7	83	0.0843373
NODE_726_length_2810_cov_2.844338	206	289	48	14	83	0.1686747
NODE_726_length_2810_cov_2.844338	206	289	51	2	83	0.0240964
NODE_726_length_2810_cov_2.844338	206	289	53	5	83	0.0602410
NODE_726_length_2810_cov_2.844338	206	289	57	2	83	0.0240964
NODE_726_length_2810_cov_2.844338	206	289	59	4	83	0.0481928
NODE_726_length_2810_cov_2.844338	206	289	62	5	83	0.0602410
NODE_726_length_2810_cov_2.844338	206	289	63	1	83	0.0120482
NODE_726_length_2810_cov_2.844338	206	289	66	1	83	0.0120482
NODE_726_length_2810_cov_2.844338	206	289	67	3	83	0.0361446
NODE_726_length_2810_cov_2.844338	206	289	71	1	83	0.0120482
NODE_726_length_2810_cov_2.844338	206	289	73	4	83	0.0481928
NODE_726_length_2810_cov_2.844338	206	289	75	2	83	0.0240964
NODE_726_length_2810_cov_2.844338	206	289	83	3	83	0.0361446
NODE_726_length_2810_cov_2.844338	206	289	85	2	83	0.0240964
NODE_726_length_2810_cov_2.844338	206	289	86	1	83	0.0120482
NODE_728_length_2808_cov_2.867110	140	163	30	1	23	0.0434783
NODE_728_length_2808_cov_2.867110	140	163	32	1	23	0.0434783
NODE_728_length_2808_cov_2.867110	140	163	34	20	23	0.8695652
NODE_728_length_2808_cov_2.867110	140	163	36	1	23	0.0434783
NODE_729_length_2807_cov_8.423191	125	205	4	10	80	0.1250000
NODE_729_length_2807_cov_8.423191	125	205	6	13	80	0.1625000
NODE_729_length_2807_cov_8.423191	125	205	10	32	80	0.4000000
NODE_729_length_2807_cov_8.423191	125	205	11	25	80	0.3125000
NODE_729_length_2807_cov_8.423191	178	258	7	4	80	0.0500000
NODE_729_length_2807_cov_8.423191	178	258	10	2	80	0.0250000
NODE_729_length_2807_cov_8.423191	178	258	11	54	80	0.6750000
NODE_729_length_2807_cov_8.423191	178	258	15	20	80	0.2500000
NODE_729_length_2807_cov_8.423191	2451	2515	2	50	64	0.7812500
NODE_729_length_2807_cov_8.423191	2451	2515	4	14	64	0.2187500
NODE_735_length_2801_cov_26.131384	461	521	1	31	60	0.5166667
NODE_735_length_2801_cov_26.131384	461	521	3	13	60	0.2166667
NODE_735_length_2801_cov_26.131384	461	521	4	16	60	0.2666667
NODE_735_length_2801_cov_26.131384	494	574	0	18	80	0.2250000
NODE_735_length_2801_cov_26.131384	494	574	1	62	80	0.7750000
NODE_735_length_2801_cov_26.131384	1536	1596	33	1	60	0.0166667
NODE_735_length_2801_cov_26.131384	1536	1596	39	1	60	0.0166667
NODE_735_length_2801_cov_26.131384	1536	1596	47	1	60	0.0166667
NODE_735_length_2801_cov_26.131384	1536	1596	59	1	60	0.0166667
NODE_735_length_2801_cov_26.131384	1536	1596	61	1	60	0.0166667
NODE_735_length_2801_cov_26.131384	1536	1596	63	5	60	0.0833333
NODE_735_length_2801_cov_26.131384	1536	1596	65	1	60	0.0166667
NODE_735_length_2801_cov_26.131384	1536	1596	69	1	60	0.0166667
NODE_735_length_2801_cov_26.131384	1536	1596	74	2	60	0.0333333
NODE_735_length_2801_cov_26.131384	1536	1596	76	1	60	0.0166667
NODE_735_length_2801_cov_26.131384	1536	1596	77	1	60	0.0166667
NODE_735_length_2801_cov_26.131384	1536	1596	83	1	60	0.0166667
NODE_735_length_2801_cov_26.131384	1536	1596	85	2	60	0.0333333
NODE_735_length_2801_cov_26.131384	1536	1596	89	1	60	0.0166667
NODE_735_length_2801_cov_26.131384	1536	1596	92	1	60	0.0166667
NODE_735_length_2801_cov_26.131384	1536	1596	103	2	60	0.0333333
NODE_735_length_2801_cov_26.131384	1536	1596	116	1	60	0.0166667
NODE_735_length_2801_cov_26.131384	1536	1596	119	1	60	0.0166667
NODE_735_length_2801_cov_26.131384	1536	1596	122	1	60	0.0166667
NODE_735_length_2801_cov_26.131384	1536	1596	124	1	60	0.0166667
NODE_735_length_2801_cov_26.131384	1536	1596	126	2	60	0.0333333
NODE_735_length_2801_cov_26.131384	1536	1596	130	3	60	0.0500000
NODE_735_length_2801_cov_26.131384	1536	1596	134	2	60	0.0333333
NODE_735_length_2801_cov_26.131384	1536	1596	135	3	60	0.0500000
NODE_735_length_2801_cov_26.131384	1536	1596	137	1	60	0.0166667
NODE_735_length_2801_cov_26.131384	1536	1596	155	5	60	0.0833333
NODE_735_length_2801_cov_26.131384	1536	1596	156	1	60	0.0166667
NODE_735_length_2801_cov_26.131384	1536	1596	158	2	60	0.0333333
NODE_735_length_2801_cov_26.131384	1536	1596	159	1	60	0.0166667
NODE_735_length_2801_cov_26.131384	1536	1596	162	1	60	0.0166667
NODE_735_length_2801_cov_26.131384	1536	1596	166	1	60	0.0166667
NODE_735_length_2801_cov_26.131384	1536	1596	168	1	60	0.0166667
NODE_735_length_2801_cov_26.131384	1536	1596	169	1	60	0.0166667
NODE_735_length_2801_cov_26.131384	1536	1596	171	1	60	0.0166667
NODE_735_length_2801_cov_26.131384	1536	1596	180	1	60	0.0166667
NODE_735_length_2801_cov_26.131384	1536	1596	182	1	60	0.0166667
NODE_735_length_2801_cov_26.131384	1536	1596	198	1	60	0.0166667
NODE_735_length_2801_cov_26.131384	1536	1596	201	1	60	0.0166667
NODE_735_length_2801_cov_26.131384	1536	1596	209	1	60	0.0166667
NODE_735_length_2801_cov_26.131384	1536	1596	212	1	60	0.0166667
NODE_735_length_2801_cov_26.131384	1536	1596	214	1	60	0.0166667
NODE_735_length_2801_cov_26.131384	1536	1596	216	1	60	0.0166667
NODE_735_length_2801_cov_26.131384	1815	1881	4	22	66	0.3333333
NODE_735_length_2801_cov_26.131384	1815	1881	7	44	66	0.6666667
NODE_735_length_2801_cov_26.131384	1854	1934	3	33	80	0.4125000
NODE_735_length_2801_cov_26.131384	1854	1934	5	3	80	0.0375000
NODE_735_length_2801_cov_26.131384	1854	1934	7	44	80	0.5500000
NODE_736_length_2801_cov_3.594375	2589	2645	0	56	56	1.0000000
NODE_738_length_2796_cov_94.511680	1090	1137	15	4	47	0.0851064
NODE_738_length_2796_cov_94.511680	1090	1137	17	1	47	0.0212766
NODE_738_length_2796_cov_94.511680	1090	1137	19	1	47	0.0212766
NODE_738_length_2796_cov_94.511680	1090	1137	21	1	47	0.0212766
NODE_738_length_2796_cov_94.511680	1090	1137	28	1	47	0.0212766
NODE_738_length_2796_cov_94.511680	1090	1137	34	1	47	0.0212766
NODE_738_length_2796_cov_94.511680	1090	1137	35	1	47	0.0212766
NODE_738_length_2796_cov_94.511680	1090	1137	37	1	47	0.0212766
NODE_738_length_2796_cov_94.511680	1090	1137	38	1	47	0.0212766
NODE_738_length_2796_cov_94.511680	1090	1137	45	1	47	0.0212766
NODE_738_length_2796_cov_94.511680	1090	1137	46	1	47	0.0212766
NODE_738_length_2796_cov_94.511680	1090	1137	56	2	47	0.0425532
NODE_738_length_2796_cov_94.511680	1090	1137	57	1	47	0.0212766
NODE_738_length_2796_cov_94.511680	1090	1137	60	1	47	0.0212766
NODE_738_length_2796_cov_94.511680	1090	1137	62	1	47	0.0212766
NODE_738_length_2796_cov_94.511680	1090	1137	64	2	47	0.0425532
NODE_738_length_2796_cov_94.511680	1090	1137	70	1	47	0.0212766
NODE_738_length_2796_cov_94.511680	1090	1137	79	1	47	0.0212766
NODE_738_length_2796_cov_94.511680	1090	1137	83	1	47	0.0212766
NODE_738_length_2796_cov_94.511680	1090	1137	85	1	47	0.0212766
NODE_738_length_2796_cov_94.511680	1090	1137	99	1	47	0.0212766
NODE_738_length_2796_cov_94.511680	1090	1137	103	1	47	0.0212766
NODE_738_length_2796_cov_94.511680	1090	1137	105	1	47	0.0212766
NODE_738_length_2796_cov_94.511680	1090	1137	110	1	47	0.0212766
NODE_738_length_2796_cov_94.511680	1090	1137	118	1	47	0.0212766
NODE_738_length_2796_cov_94.511680	1090	1137	120	1	47	0.0212766
NODE_738_length_2796_cov_94.511680	1090	1137	124	1	47	0.0212766
NODE_738_length_2796_cov_94.511680	1090	1137	126	2	47	0.0425532
NODE_738_length_2796_cov_94.511680	1090	1137	128	1	47	0.0212766
NODE_738_length_2796_cov_94.511680	1090	1137	129	3	47	0.0638298
NODE_738_length_2796_cov_94.511680	1090	1137	132	1	47	0.0212766
NODE_738_length_2796_cov_94.511680	1090	1137	139	1	47	0.0212766
NODE_738_length_2796_cov_94.511680	1090	1137	147	1	47	0.0212766
NODE_738_length_2796_cov_94.511680	1090	1137	149	1	47	0.0212766
NODE_738_length_2796_cov_94.511680	1090	1137	159	1	47	0.0212766
NODE_738_length_2796_cov_94.511680	1090	1137	164	1	47	0.0212766
NODE_738_length_2796_cov_94.511680	1090	1137	171	1	47	0.0212766
NODE_738_length_2796_cov_94.511680	1090	1137	174	1	47	0.0212766
NODE_738_length_2796_cov_94.511680	1090	1137	179	1	47	0.0212766
NODE_738_length_2796_cov_94.511680	2717	2796	0	79	79	1.0000000
NODE_744_length_2791_cov_9.997028	310	390	0	80	80	1.0000000
NODE_744_length_2791_cov_9.997028	363	443	0	80	80	1.0000000
NODE_752_length_2778_cov_31.340799	2241	2321	0	26	80	0.3250000
NODE_752_length_2778_cov_31.340799	2241	2321	4	16	80	0.2000000
NODE_752_length_2778_cov_31.340799	2241	2321	6	38	80	0.4750000
NODE_752_length_2778_cov_31.340799	2294	2374	0	13	80	0.1625000
NODE_752_length_2778_cov_31.340799	2294	2374	2	14	80	0.1750000
NODE_752_length_2778_cov_31.340799	2294	2374	6	53	80	0.6625000
NODE_752_length_2778_cov_31.340799	2370	2450	2	38	80	0.4750000
NODE_752_length_2778_cov_31.340799	2370	2450	4	42	80	0.5250000
NODE_752_length_2778_cov_31.340799	2423	2503	0	26	80	0.3250000
NODE_752_length_2778_cov_31.340799	2423	2503	2	33	80	0.4125000
NODE_752_length_2778_cov_31.340799	2423	2503	4	21	80	0.2625000
NODE_752_length_2778_cov_31.340799	2564	2620	0	56	56	1.0000000
NODE_758_length_2767_cov_12.450150	1941	2021	4	80	80	1.0000000
NODE_758_length_2767_cov_12.450150	1994	2074	0	37	80	0.4625000
NODE_758_length_2767_cov_12.450150	1994	2074	2	1	80	0.0125000
NODE_758_length_2767_cov_12.450150	1994	2074	4	42	80	0.5250000
NODE_767_length_2745_cov_5.322751	511	583	0	72	72	1.0000000
NODE_777_length_2720_cov_25.561618	2213	2293	0	5	80	0.0625000
NODE_777_length_2720_cov_25.561618	2213	2293	2	75	80	0.9375000
NODE_777_length_2720_cov_25.561618	2266	2346	0	1	80	0.0125000
NODE_777_length_2720_cov_25.561618	2266	2346	2	79	80	0.9875000
NODE_782_length_2716_cov_39.885747	715	795	4	1	80	0.0125000
NODE_782_length_2716_cov_39.885747	715	795	6	9	80	0.1125000
NODE_782_length_2716_cov_39.885747	715	795	8	26	80	0.3250000
NODE_782_length_2716_cov_39.885747	715	795	10	38	80	0.4750000
NODE_782_length_2716_cov_39.885747	715	795	12	6	80	0.0750000
NODE_782_length_2716_cov_39.885747	768	848	0	4	80	0.0500000
NODE_782_length_2716_cov_39.885747	768	848	2	46	80	0.5750000
NODE_782_length_2716_cov_39.885747	768	848	4	4	80	0.0500000
NODE_782_length_2716_cov_39.885747	768	848	6	9	80	0.1125000
NODE_782_length_2716_cov_39.885747	768	848	8	17	80	0.2125000
NODE_782_length_2716_cov_39.885747	844	924	0	29	80	0.3625000
NODE_782_length_2716_cov_39.885747	844	924	2	51	80	0.6375000
NODE_782_length_2716_cov_39.885747	897	977	2	44	80	0.5500000
NODE_782_length_2716_cov_39.885747	897	977	4	36	80	0.4500000
NODE_785_length_2710_cov_10.896974	2410	2446	18	1	36	0.0277778
NODE_785_length_2710_cov_10.896974	2410	2446	19	4	36	0.1111111
NODE_785_length_2710_cov_10.896974	2410	2446	20	24	36	0.6666667
NODE_785_length_2710_cov_10.896974	2410	2446	21	4	36	0.1111111
NODE_785_length_2710_cov_10.896974	2410	2446	22	3	36	0.0833333
NODE_785_length_2710_cov_10.896974	2419	2499	16	4	80	0.0500000
NODE_785_length_2710_cov_10.896974	2419	2499	18	6	80	0.0750000
NODE_785_length_2710_cov_10.896974	2419	2499	20	43	80	0.5375000
NODE_785_length_2710_cov_10.896974	2419	2499	21	4	80	0.0500000
NODE_785_length_2710_cov_10.896974	2419	2499	22	12	80	0.1500000
NODE_785_length_2710_cov_10.896974	2419	2499	24	9	80	0.1125000
NODE_785_length_2710_cov_10.896974	2419	2499	28	2	80	0.0250000
NODE_788_length_2708_cov_25.097355	2289	2369	0	62	80	0.7750000
NODE_788_length_2708_cov_25.097355	2289	2369	2	18	80	0.2250000
NODE_788_length_2708_cov_25.097355	2342	2422	0	80	80	1.0000000
NODE_789_length_2708_cov_14.569950	18	98	100	2	80	0.0250000
NODE_789_length_2708_cov_14.569950	18	98	102	1	80	0.0125000
NODE_789_length_2708_cov_14.569950	18	98	104	1	80	0.0125000
NODE_789_length_2708_cov_14.569950	18	98	105	1	80	0.0125000
NODE_789_length_2708_cov_14.569950	18	98	110	1	80	0.0125000
NODE_789_length_2708_cov_14.569950	18	98	111	3	80	0.0375000
NODE_789_length_2708_cov_14.569950	18	98	113	5	80	0.0625000
NODE_789_length_2708_cov_14.569950	18	98	115	1	80	0.0125000
NODE_789_length_2708_cov_14.569950	18	98	117	24	80	0.3000000
NODE_789_length_2708_cov_14.569950	18	98	121	41	80	0.5125000
NODE_789_length_2708_cov_14.569950	71	134	11	1	63	0.0158730
NODE_789_length_2708_cov_14.569950	71	134	34	1	63	0.0158730
NODE_789_length_2708_cov_14.569950	71	134	38	1	63	0.0158730
NODE_789_length_2708_cov_14.569950	71	134	42	1	63	0.0158730
NODE_789_length_2708_cov_14.569950	71	134	49	1	63	0.0158730
NODE_789_length_2708_cov_14.569950	71	134	53	1	63	0.0158730
NODE_789_length_2708_cov_14.569950	71	134	61	2	63	0.0317460
NODE_789_length_2708_cov_14.569950	71	134	69	2	63	0.0317460
NODE_789_length_2708_cov_14.569950	71	134	79	1	63	0.0158730
NODE_789_length_2708_cov_14.569950	71	134	81	2	63	0.0317460
NODE_789_length_2708_cov_14.569950	71	134	83	2	63	0.0317460
NODE_789_length_2708_cov_14.569950	71	134	85	1	63	0.0158730
NODE_789_length_2708_cov_14.569950	71	134	87	2	63	0.0317460
NODE_789_length_2708_cov_14.569950	71	134	89	1	63	0.0158730
NODE_789_length_2708_cov_14.569950	71	134	93	1	63	0.0158730
NODE_789_length_2708_cov_14.569950	71	134	99	2	63	0.0317460
NODE_789_length_2708_cov_14.569950	71	134	101	1	63	0.0158730
NODE_789_length_2708_cov_14.569950	71	134	103	1	63	0.0158730
NODE_789_length_2708_cov_14.569950	71	134	107	1	63	0.0158730
NODE_789_length_2708_cov_14.569950	71	134	113	1	63	0.0158730
NODE_789_length_2708_cov_14.569950	71	134	119	2	63	0.0317460
NODE_789_length_2708_cov_14.569950	71	134	121	35	63	0.5555556
NODE_797_length_2691_cov_35.457948	401	481	0	80	80	1.0000000
NODE_797_length_2691_cov_35.457948	454	534	0	80	80	1.0000000
NODE_803_length_2684_cov_17.345068	146	194	4	5	48	0.1041667
NODE_803_length_2684_cov_17.345068	146	194	6	11	48	0.2291667
NODE_803_length_2684_cov_17.345068	146	194	7	1	48	0.0208333
NODE_803_length_2684_cov_17.345068	146	194	8	4	48	0.0833333
NODE_803_length_2684_cov_17.345068	146	194	10	27	48	0.5625000
NODE_803_length_2684_cov_17.345068	146	194	4	5	48	0.1041667
NODE_803_length_2684_cov_17.345068	146	194	6	11	48	0.2291667
NODE_803_length_2684_cov_17.345068	146	194	7	1	48	0.0208333
NODE_803_length_2684_cov_17.345068	146	194	8	4	48	0.0833333
NODE_803_length_2684_cov_17.345068	146	194	10	27	48	0.5625000
NODE_803_length_2684_cov_17.345068	146	194	4	5	48	0.1041667
NODE_803_length_2684_cov_17.345068	146	194	6	11	48	0.2291667
NODE_803_length_2684_cov_17.345068	146	194	7	1	48	0.0208333
NODE_803_length_2684_cov_17.345068	146	194	8	4	48	0.0833333
NODE_803_length_2684_cov_17.345068	146	194	10	27	48	0.5625000
NODE_803_length_2684_cov_17.345068	146	194	4	5	48	0.1041667
NODE_803_length_2684_cov_17.345068	146	194	6	11	48	0.2291667
NODE_803_length_2684_cov_17.345068	146	194	7	1	48	0.0208333
NODE_803_length_2684_cov_17.345068	146	194	8	4	48	0.0833333
NODE_803_length_2684_cov_17.345068	146	194	10	27	48	0.5625000
NODE_803_length_2684_cov_17.345068	146	194	4	5	48	0.1041667
NODE_803_length_2684_cov_17.345068	146	194	6	11	48	0.2291667
NODE_803_length_2684_cov_17.345068	146	194	7	1	48	0.0208333
NODE_803_length_2684_cov_17.345068	146	194	8	4	48	0.0833333
NODE_803_length_2684_cov_17.345068	146	194	10	27	48	0.5625000
NODE_805_length_2682_cov_43.500581	913	992	286	1	79	0.0126582
NODE_805_length_2682_cov_43.500581	913	992	288	2	79	0.0253165
NODE_805_length_2682_cov_43.500581	913	992	290	2	79	0.0253165
NODE_805_length_2682_cov_43.500581	913	992	298	1	79	0.0126582
NODE_805_length_2682_cov_43.500581	913	992	301	1	79	0.0126582
NODE_805_length_2682_cov_43.500581	913	992	304	1	79	0.0126582
NODE_805_length_2682_cov_43.500581	913	992	310	1	79	0.0126582
NODE_805_length_2682_cov_43.500581	913	992	312	1	79	0.0126582
NODE_805_length_2682_cov_43.500581	913	992	316	1	79	0.0126582
NODE_805_length_2682_cov_43.500581	913	992	318	1	79	0.0126582
NODE_805_length_2682_cov_43.500581	913	992	321	1	79	0.0126582
NODE_805_length_2682_cov_43.500581	913	992	329	1	79	0.0126582
NODE_805_length_2682_cov_43.500581	913	992	340	1	79	0.0126582
NODE_805_length_2682_cov_43.500581	913	992	341	1	79	0.0126582
NODE_805_length_2682_cov_43.500581	913	992	344	2	79	0.0253165
NODE_805_length_2682_cov_43.500581	913	992	350	1	79	0.0126582
NODE_805_length_2682_cov_43.500581	913	992	351	1	79	0.0126582
NODE_805_length_2682_cov_43.500581	913	992	353	1	79	0.0126582
NODE_805_length_2682_cov_43.500581	913	992	359	1	79	0.0126582
NODE_805_length_2682_cov_43.500581	913	992	361	1	79	0.0126582
NODE_805_length_2682_cov_43.500581	913	992	363	1	79	0.0126582
NODE_805_length_2682_cov_43.500581	913	992	364	1	79	0.0126582
NODE_805_length_2682_cov_43.500581	913	992	366	1	79	0.0126582
NODE_805_length_2682_cov_43.500581	913	992	367	1	79	0.0126582
NODE_805_length_2682_cov_43.500581	913	992	368	2	79	0.0253165
NODE_805_length_2682_cov_43.500581	913	992	375	1	79	0.0126582
NODE_805_length_2682_cov_43.500581	913	992	382	1	79	0.0126582
NODE_805_length_2682_cov_43.500581	913	992	384	1	79	0.0126582
NODE_805_length_2682_cov_43.500581	913	992	386	1	79	0.0126582
NODE_805_length_2682_cov_43.500581	913	992	387	1	79	0.0126582
NODE_805_length_2682_cov_43.500581	913	992	398	1	79	0.0126582
NODE_805_length_2682_cov_43.500581	913	992	408	1	79	0.0126582
NODE_805_length_2682_cov_43.500581	913	992	410	1	79	0.0126582
NODE_805_length_2682_cov_43.500581	913	992	411	1	79	0.0126582
NODE_805_length_2682_cov_43.500581	913	992	412	1	79	0.0126582
NODE_805_length_2682_cov_43.500581	913	992	413	2	79	0.0253165
NODE_805_length_2682_cov_43.500581	913	992	424	1	79	0.0126582
NODE_805_length_2682_cov_43.500581	913	992	427	1	79	0.0126582
NODE_805_length_2682_cov_43.500581	913	992	429	1	79	0.0126582
NODE_805_length_2682_cov_43.500581	913	992	432	1	79	0.0126582
NODE_805_length_2682_cov_43.500581	913	992	441	1	79	0.0126582
NODE_805_length_2682_cov_43.500581	913	992	442	1	79	0.0126582
NODE_805_length_2682_cov_43.500581	913	992	443	2	79	0.0253165
NODE_805_length_2682_cov_43.500581	913	992	445	1	79	0.0126582
NODE_805_length_2682_cov_43.500581	913	992	447	1	79	0.0126582
NODE_805_length_2682_cov_43.500581	913	992	448	1	79	0.0126582
NODE_805_length_2682_cov_43.500581	913	992	450	1	79	0.0126582
NODE_805_length_2682_cov_43.500581	913	992	451	1	79	0.0126582
NODE_805_length_2682_cov_43.500581	913	992	452	1	79	0.0126582
NODE_805_length_2682_cov_43.500581	913	992	455	2	79	0.0253165
NODE_805_length_2682_cov_43.500581	913	992	459	1	79	0.0126582
NODE_805_length_2682_cov_43.500581	913	992	460	1	79	0.0126582
NODE_805_length_2682_cov_43.500581	913	992	461	2	79	0.0253165
NODE_805_length_2682_cov_43.500581	913	992	462	1	79	0.0126582
NODE_805_length_2682_cov_43.500581	913	992	464	2	79	0.0253165
NODE_805_length_2682_cov_43.500581	913	992	467	1	79	0.0126582
NODE_805_length_2682_cov_43.500581	913	992	468	2	79	0.0253165
NODE_805_length_2682_cov_43.500581	913	992	472	1	79	0.0126582
NODE_805_length_2682_cov_43.500581	913	992	476	1	79	0.0126582
NODE_805_length_2682_cov_43.500581	913	992	490	1	79	0.0126582
NODE_805_length_2682_cov_43.500581	913	992	510	1	79	0.0126582
NODE_805_length_2682_cov_43.500581	913	992	513	2	79	0.0253165
NODE_805_length_2682_cov_43.500581	913	992	515	1	79	0.0126582
NODE_805_length_2682_cov_43.500581	913	992	525	1	79	0.0126582
NODE_805_length_2682_cov_43.500581	913	992	543	1	79	0.0126582
NODE_805_length_2682_cov_43.500581	913	992	548	1	79	0.0126582
NODE_805_length_2682_cov_43.500581	913	992	551	1	79	0.0126582
NODE_805_length_2682_cov_43.500581	913	992	554	1	79	0.0126582
NODE_805_length_2682_cov_43.500581	965	1002	265	1	37	0.0270270
NODE_805_length_2682_cov_43.500581	965	1002	274	1	37	0.0270270
NODE_805_length_2682_cov_43.500581	965	1002	277	1	37	0.0270270
NODE_805_length_2682_cov_43.500581	965	1002	279	1	37	0.0270270
NODE_805_length_2682_cov_43.500581	965	1002	284	5	37	0.1351351
NODE_805_length_2682_cov_43.500581	965	1002	286	2	37	0.0540541
NODE_805_length_2682_cov_43.500581	965	1002	288	2	37	0.0540541
NODE_805_length_2682_cov_43.500581	965	1002	290	2	37	0.0540541
NODE_805_length_2682_cov_43.500581	965	1002	298	1	37	0.0270270
NODE_805_length_2682_cov_43.500581	965	1002	301	1	37	0.0270270
NODE_805_length_2682_cov_43.500581	965	1002	304	1	37	0.0270270
NODE_805_length_2682_cov_43.500581	965	1002	310	1	37	0.0270270
NODE_805_length_2682_cov_43.500581	965	1002	312	1	37	0.0270270
NODE_805_length_2682_cov_43.500581	965	1002	316	1	37	0.0270270
NODE_805_length_2682_cov_43.500581	965	1002	318	1	37	0.0270270
NODE_805_length_2682_cov_43.500581	965	1002	321	1	37	0.0270270
NODE_805_length_2682_cov_43.500581	965	1002	329	1	37	0.0270270
NODE_805_length_2682_cov_43.500581	965	1002	340	1	37	0.0270270
NODE_805_length_2682_cov_43.500581	965	1002	341	1	37	0.0270270
NODE_805_length_2682_cov_43.500581	965	1002	344	2	37	0.0540541
NODE_805_length_2682_cov_43.500581	965	1002	350	1	37	0.0270270
NODE_805_length_2682_cov_43.500581	965	1002	351	1	37	0.0270270
NODE_805_length_2682_cov_43.500581	965	1002	353	1	37	0.0270270
NODE_805_length_2682_cov_43.500581	965	1002	359	1	37	0.0270270
NODE_805_length_2682_cov_43.500581	965	1002	361	1	37	0.0270270
NODE_805_length_2682_cov_43.500581	965	1002	363	1	37	0.0270270
NODE_805_length_2682_cov_43.500581	965	1002	364	1	37	0.0270270
NODE_805_length_2682_cov_43.500581	965	1002	366	1	37	0.0270270
NODE_805_length_2682_cov_43.500581	965	1002	367	1	37	0.0270270
NODE_808_length_2675_cov_10.369565	209	289	8	2	80	0.0250000
NODE_808_length_2675_cov_10.369565	209	289	10	31	80	0.3875000
NODE_808_length_2675_cov_10.369565	209	289	14	4	80	0.0500000
NODE_808_length_2675_cov_10.369565	209	289	16	2	80	0.0250000
NODE_808_length_2675_cov_10.369565	209	289	18	9	80	0.1125000
NODE_808_length_2675_cov_10.369565	209	289	20	6	80	0.0750000
NODE_808_length_2675_cov_10.369565	209	289	22	13	80	0.1625000
NODE_808_length_2675_cov_10.369565	209	289	24	13	80	0.1625000
NODE_813_length_2670_cov_17.489304	1995	2075	0	80	80	1.0000000
NODE_813_length_2670_cov_17.489304	2048	2128	0	55	80	0.6875000
NODE_813_length_2670_cov_17.489304	2048	2128	6	5	80	0.0625000
NODE_813_length_2670_cov_17.489304	2048	2128	10	20	80	0.2500000
NODE_813_length_2670_cov_17.489304	2124	2204	10	26	80	0.3250000
NODE_813_length_2670_cov_17.489304	2124	2204	11	43	80	0.5375000
NODE_813_length_2670_cov_17.489304	2124	2204	12	11	80	0.1375000
NODE_813_length_2670_cov_17.489304	2177	2257	6	2	80	0.0250000
NODE_813_length_2670_cov_17.489304	2177	2257	7	1	80	0.0125000
NODE_813_length_2670_cov_17.489304	2177	2257	11	16	80	0.2000000
NODE_813_length_2670_cov_17.489304	2177	2257	12	61	80	0.7625000
NODE_815_length_2665_cov_19.145752	548	628	0	80	80	1.0000000
NODE_815_length_2665_cov_19.145752	601	681	0	80	80	1.0000000
NODE_815_length_2665_cov_19.145752	2099	2176	0	73	77	0.9480519
NODE_815_length_2665_cov_19.145752	2099	2176	2	4	77	0.0519481
NODE_815_length_2665_cov_19.145752	2172	2252	2	80	80	1.0000000
NODE_815_length_2665_cov_19.145752	2172	2252	2	80	80	1.0000000
NODE_815_length_2665_cov_19.145752	2225	2267	0	11	42	0.2619048
NODE_815_length_2665_cov_19.145752	2225	2267	2	31	42	0.7380952
NODE_816_length_2664_cov_4.175049	2005	2085	0	5	80	0.0625000
NODE_816_length_2664_cov_4.175049	2005	2085	2	12	80	0.1500000
NODE_816_length_2664_cov_4.175049	2005	2085	3	1	80	0.0125000
NODE_816_length_2664_cov_4.175049	2005	2085	4	62	80	0.7750000
NODE_816_length_2664_cov_4.175049	2058	2138	0	5	80	0.0625000
NODE_816_length_2664_cov_4.175049	2058	2138	2	65	80	0.8125000
NODE_816_length_2664_cov_4.175049	2058	2138	3	1	80	0.0125000
NODE_816_length_2664_cov_4.175049	2058	2138	4	9	80	0.1125000
NODE_822_length_2650_cov_19.800862	800	880	32	2	80	0.0250000
NODE_822_length_2650_cov_19.800862	800	880	34	4	80	0.0500000
NODE_822_length_2650_cov_19.800862	800	880	36	4	80	0.0500000
NODE_822_length_2650_cov_19.800862	800	880	37	6	80	0.0750000
NODE_822_length_2650_cov_19.800862	800	880	38	4	80	0.0500000
NODE_822_length_2650_cov_19.800862	800	880	39	1	80	0.0125000
NODE_822_length_2650_cov_19.800862	800	880	40	4	80	0.0500000
NODE_822_length_2650_cov_19.800862	800	880	42	27	80	0.3375000
NODE_822_length_2650_cov_19.800862	800	880	43	12	80	0.1500000
NODE_822_length_2650_cov_19.800862	800	880	44	10	80	0.1250000
NODE_822_length_2650_cov_19.800862	800	880	45	1	80	0.0125000
NODE_822_length_2650_cov_19.800862	800	880	46	5	80	0.0625000
NODE_824_length_2645_cov_8.618225	931	1011	0	2	80	0.0250000
NODE_824_length_2645_cov_8.618225	931	1011	2	35	80	0.4375000
NODE_824_length_2645_cov_8.618225	931	1011	4	5	80	0.0625000
NODE_824_length_2645_cov_8.618225	931	1011	6	31	80	0.3875000
NODE_824_length_2645_cov_8.618225	931	1011	8	7	80	0.0875000
NODE_824_length_2645_cov_8.618225	984	1064	0	2	80	0.0250000
NODE_824_length_2645_cov_8.618225	984	1064	2	78	80	0.9750000
NODE_827_length_2640_cov_16.462810	94	164	206	1	70	0.0142857
NODE_827_length_2640_cov_16.462810	94	164	215	1	70	0.0142857
NODE_827_length_2640_cov_16.462810	94	164	223	1	70	0.0142857
NODE_827_length_2640_cov_16.462810	94	164	235	1	70	0.0142857
NODE_827_length_2640_cov_16.462810	94	164	237	1	70	0.0142857
NODE_827_length_2640_cov_16.462810	94	164	239	1	70	0.0142857
NODE_827_length_2640_cov_16.462810	94	164	246	1	70	0.0142857
NODE_827_length_2640_cov_16.462810	94	164	248	1	70	0.0142857
NODE_827_length_2640_cov_16.462810	94	164	253	3	70	0.0428571
NODE_827_length_2640_cov_16.462810	94	164	254	1	70	0.0142857
NODE_827_length_2640_cov_16.462810	94	164	255	2	70	0.0285714
NODE_827_length_2640_cov_16.462810	94	164	269	1	70	0.0142857
NODE_827_length_2640_cov_16.462810	94	164	271	1	70	0.0142857
NODE_827_length_2640_cov_16.462810	94	164	274	1	70	0.0142857
NODE_827_length_2640_cov_16.462810	94	164	288	1	70	0.0142857
NODE_827_length_2640_cov_16.462810	94	164	293	1	70	0.0142857
NODE_827_length_2640_cov_16.462810	94	164	295	1	70	0.0142857
NODE_827_length_2640_cov_16.462810	94	164	302	1	70	0.0142857
NODE_827_length_2640_cov_16.462810	94	164	317	1	70	0.0142857
NODE_827_length_2640_cov_16.462810	94	164	323	1	70	0.0142857
NODE_827_length_2640_cov_16.462810	94	164	356	2	70	0.0285714
NODE_827_length_2640_cov_16.462810	94	164	358	2	70	0.0285714
NODE_827_length_2640_cov_16.462810	94	164	362	1	70	0.0142857
NODE_827_length_2640_cov_16.462810	94	164	380	1	70	0.0142857
NODE_827_length_2640_cov_16.462810	94	164	391	3	70	0.0428571
NODE_827_length_2640_cov_16.462810	94	164	393	1	70	0.0142857
NODE_827_length_2640_cov_16.462810	94	164	394	1	70	0.0142857
NODE_827_length_2640_cov_16.462810	94	164	395	1	70	0.0142857
NODE_827_length_2640_cov_16.462810	94	164	397	1	70	0.0142857
NODE_827_length_2640_cov_16.462810	94	164	402	1	70	0.0142857
NODE_827_length_2640_cov_16.462810	94	164	406	1	70	0.0142857
NODE_827_length_2640_cov_16.462810	94	164	415	1	70	0.0142857
NODE_827_length_2640_cov_16.462810	94	164	417	2	70	0.0285714
NODE_827_length_2640_cov_16.462810	94	164	419	2	70	0.0285714
NODE_827_length_2640_cov_16.462810	94	164	421	1	70	0.0142857
NODE_827_length_2640_cov_16.462810	94	164	436	1	70	0.0142857
NODE_827_length_2640_cov_16.462810	94	164	446	1	70	0.0142857
NODE_827_length_2640_cov_16.462810	94	164	467	2	70	0.0285714
NODE_827_length_2640_cov_16.462810	94	164	471	1	70	0.0142857
NODE_827_length_2640_cov_16.462810	94	164	477	3	70	0.0428571
NODE_827_length_2640_cov_16.462810	94	164	479	1	70	0.0142857
NODE_827_length_2640_cov_16.462810	94	164	481	4	70	0.0571429
NODE_827_length_2640_cov_16.462810	94	164	484	1	70	0.0142857
NODE_827_length_2640_cov_16.462810	94	164	485	3	70	0.0428571
NODE_827_length_2640_cov_16.462810	94	164	487	8	70	0.1142857
NODE_827_length_2640_cov_16.462810	94	164	489	1	70	0.0142857
NODE_827_length_2640_cov_16.462810	147	209	158	2	62	0.0322581
NODE_827_length_2640_cov_16.462810	147	209	166	1	62	0.0161290
NODE_827_length_2640_cov_16.462810	147	209	169	4	62	0.0645161
NODE_827_length_2640_cov_16.462810	147	209	170	3	62	0.0483871
NODE_827_length_2640_cov_16.462810	147	209	172	3	62	0.0483871
NODE_827_length_2640_cov_16.462810	147	209	173	6	62	0.0967742
NODE_827_length_2640_cov_16.462810	147	209	175	1	62	0.0161290
NODE_827_length_2640_cov_16.462810	147	209	176	1	62	0.0161290
NODE_827_length_2640_cov_16.462810	147	209	178	3	62	0.0483871
NODE_827_length_2640_cov_16.462810	147	209	180	1	62	0.0161290
NODE_827_length_2640_cov_16.462810	147	209	182	2	62	0.0322581
NODE_827_length_2640_cov_16.462810	147	209	185	2	62	0.0322581
NODE_827_length_2640_cov_16.462810	147	209	186	3	62	0.0483871
NODE_827_length_2640_cov_16.462810	147	209	187	4	62	0.0645161
NODE_827_length_2640_cov_16.462810	147	209	188	1	62	0.0161290
NODE_827_length_2640_cov_16.462810	147	209	189	2	62	0.0322581
NODE_827_length_2640_cov_16.462810	147	209	193	1	62	0.0161290
NODE_827_length_2640_cov_16.462810	147	209	195	1	62	0.0161290
NODE_827_length_2640_cov_16.462810	147	209	196	2	62	0.0322581
NODE_827_length_2640_cov_16.462810	147	209	197	1	62	0.0161290
NODE_827_length_2640_cov_16.462810	147	209	200	1	62	0.0161290
NODE_827_length_2640_cov_16.462810	147	209	206	1	62	0.0161290
NODE_827_length_2640_cov_16.462810	147	209	215	1	62	0.0161290
NODE_827_length_2640_cov_16.462810	147	209	223	1	62	0.0161290
NODE_827_length_2640_cov_16.462810	147	209	235	1	62	0.0161290
NODE_827_length_2640_cov_16.462810	147	209	237	1	62	0.0161290
NODE_827_length_2640_cov_16.462810	147	209	239	1	62	0.0161290
NODE_827_length_2640_cov_16.462810	147	209	246	1	62	0.0161290
NODE_827_length_2640_cov_16.462810	147	209	248	1	62	0.0161290
NODE_827_length_2640_cov_16.462810	147	209	253	3	62	0.0483871
NODE_827_length_2640_cov_16.462810	147	209	254	1	62	0.0161290
NODE_827_length_2640_cov_16.462810	147	209	255	2	62	0.0322581
NODE_827_length_2640_cov_16.462810	147	209	269	1	62	0.0161290
NODE_827_length_2640_cov_16.462810	147	209	271	1	62	0.0161290
NODE_827_length_2640_cov_16.462810	147	209	274	1	62	0.0161290
NODE_828_length_2636_cov_200.191171	561	641	1454	1	80	0.0125000
NODE_828_length_2636_cov_200.191171	561	641	1455	1	80	0.0125000
NODE_828_length_2636_cov_200.191171	561	641	1457	1	80	0.0125000
NODE_828_length_2636_cov_200.191171	561	641	1475	1	80	0.0125000
NODE_828_length_2636_cov_200.191171	561	641	1478	1	80	0.0125000
NODE_828_length_2636_cov_200.191171	561	641	1488	1	80	0.0125000
NODE_828_length_2636_cov_200.191171	561	641	1502	1	80	0.0125000
NODE_828_length_2636_cov_200.191171	561	641	1507	1	80	0.0125000
NODE_828_length_2636_cov_200.191171	561	641	1511	1	80	0.0125000
NODE_828_length_2636_cov_200.191171	561	641	1517	1	80	0.0125000
NODE_828_length_2636_cov_200.191171	561	641	1523	1	80	0.0125000
NODE_828_length_2636_cov_200.191171	561	641	1559	1	80	0.0125000
NODE_828_length_2636_cov_200.191171	561	641	1566	1	80	0.0125000
NODE_828_length_2636_cov_200.191171	561	641	1571	1	80	0.0125000
NODE_828_length_2636_cov_200.191171	561	641	1584	1	80	0.0125000
NODE_828_length_2636_cov_200.191171	561	641	1610	1	80	0.0125000
NODE_828_length_2636_cov_200.191171	561	641	1611	1	80	0.0125000
NODE_828_length_2636_cov_200.191171	561	641	1614	1	80	0.0125000
NODE_828_length_2636_cov_200.191171	561	641	1615	1	80	0.0125000
NODE_828_length_2636_cov_200.191171	561	641	1619	1	80	0.0125000
NODE_828_length_2636_cov_200.191171	561	641	1630	1	80	0.0125000
NODE_828_length_2636_cov_200.191171	561	641	1631	1	80	0.0125000
NODE_828_length_2636_cov_200.191171	561	641	1633	2	80	0.0250000
NODE_828_length_2636_cov_200.191171	561	641	1641	3	80	0.0375000
NODE_828_length_2636_cov_200.191171	561	641	1643	1	80	0.0125000
NODE_828_length_2636_cov_200.191171	561	641	1647	1	80	0.0125000
NODE_828_length_2636_cov_200.191171	561	641	1652	1	80	0.0125000
NODE_828_length_2636_cov_200.191171	561	641	1653	2	80	0.0250000
NODE_828_length_2636_cov_200.191171	561	641	1660	1	80	0.0125000
NODE_828_length_2636_cov_200.191171	561	641	1677	1	80	0.0125000
NODE_828_length_2636_cov_200.191171	561	641	1686	1	80	0.0125000
NODE_828_length_2636_cov_200.191171	561	641	1690	1	80	0.0125000
NODE_828_length_2636_cov_200.191171	561	641	1694	1	80	0.0125000
NODE_828_length_2636_cov_200.191171	561	641	1697	1	80	0.0125000
NODE_828_length_2636_cov_200.191171	561	641	1702	1	80	0.0125000
NODE_828_length_2636_cov_200.191171	561	641	1707	1	80	0.0125000
NODE_828_length_2636_cov_200.191171	561	641	1712	1	80	0.0125000
NODE_828_length_2636_cov_200.191171	561	641	1718	1	80	0.0125000
NODE_828_length_2636_cov_200.191171	561	641	1724	1	80	0.0125000
NODE_828_length_2636_cov_200.191171	561	641	1730	1	80	0.0125000
NODE_828_length_2636_cov_200.191171	561	641	1737	1	80	0.0125000
NODE_828_length_2636_cov_200.191171	561	641	1738	1	80	0.0125000
NODE_828_length_2636_cov_200.191171	561	641	1739	1	80	0.0125000
NODE_828_length_2636_cov_200.191171	561	641	1742	1	80	0.0125000
NODE_828_length_2636_cov_200.191171	561	641	1746	1	80	0.0125000
NODE_828_length_2636_cov_200.191171	561	641	1756	1	80	0.0125000
NODE_828_length_2636_cov_200.191171	561	641	1757	1	80	0.0125000
NODE_828_length_2636_cov_200.191171	561	641	1765	1	80	0.0125000
NODE_828_length_2636_cov_200.191171	561	641	1770	1	80	0.0125000
NODE_828_length_2636_cov_200.191171	561	641	1779	1	80	0.0125000
NODE_828_length_2636_cov_200.191171	561	641	1789	1	80	0.0125000
NODE_828_length_2636_cov_200.191171	561	641	1790	1	80	0.0125000
NODE_828_length_2636_cov_200.191171	561	641	1792	1	80	0.0125000
NODE_828_length_2636_cov_200.191171	561	641	1799	1	80	0.0125000
NODE_828_length_2636_cov_200.191171	561	641	1803	1	80	0.0125000
NODE_828_length_2636_cov_200.191171	561	641	1808	1	80	0.0125000
NODE_828_length_2636_cov_200.191171	561	641	1810	1	80	0.0125000
NODE_828_length_2636_cov_200.191171	561	641	1813	1	80	0.0125000
NODE_828_length_2636_cov_200.191171	561	641	1815	1	80	0.0125000
NODE_828_length_2636_cov_200.191171	561	641	1816	1	80	0.0125000
NODE_828_length_2636_cov_200.191171	561	641	1817	1	80	0.0125000
NODE_828_length_2636_cov_200.191171	561	641	1818	1	80	0.0125000
NODE_828_length_2636_cov_200.191171	561	641	1819	2	80	0.0250000
NODE_828_length_2636_cov_200.191171	561	641	1822	1	80	0.0125000
NODE_828_length_2636_cov_200.191171	561	641	1823	1	80	0.0125000
NODE_828_length_2636_cov_200.191171	561	641	1825	1	80	0.0125000
NODE_828_length_2636_cov_200.191171	561	641	1832	1	80	0.0125000
NODE_828_length_2636_cov_200.191171	561	641	1841	2	80	0.0250000
NODE_828_length_2636_cov_200.191171	561	641	1842	2	80	0.0250000
NODE_828_length_2636_cov_200.191171	561	641	1844	1	80	0.0125000
NODE_828_length_2636_cov_200.191171	561	641	1845	1	80	0.0125000
NODE_828_length_2636_cov_200.191171	561	641	1850	1	80	0.0125000
NODE_828_length_2636_cov_200.191171	561	641	1853	1	80	0.0125000
NODE_828_length_2636_cov_200.191171	614	695	332	1	81	0.0123457
NODE_828_length_2636_cov_200.191171	614	695	358	1	81	0.0123457
NODE_828_length_2636_cov_200.191171	614	695	378	2	81	0.0246914
NODE_828_length_2636_cov_200.191171	614	695	382	1	81	0.0123457
NODE_828_length_2636_cov_200.191171	614	695	385	1	81	0.0123457
NODE_828_length_2636_cov_200.191171	614	695	403	1	81	0.0123457
NODE_828_length_2636_cov_200.191171	614	695	409	1	81	0.0123457
NODE_828_length_2636_cov_200.191171	614	695	433	1	81	0.0123457
NODE_828_length_2636_cov_200.191171	614	695	436	1	81	0.0123457
NODE_828_length_2636_cov_200.191171	614	695	454	1	81	0.0123457
NODE_828_length_2636_cov_200.191171	614	695	482	1	81	0.0123457
NODE_828_length_2636_cov_200.191171	614	695	507	1	81	0.0123457
NODE_828_length_2636_cov_200.191171	614	695	509	1	81	0.0123457
NODE_828_length_2636_cov_200.191171	614	695	531	1	81	0.0123457
NODE_828_length_2636_cov_200.191171	614	695	536	1	81	0.0123457
NODE_828_length_2636_cov_200.191171	614	695	553	1	81	0.0123457
NODE_828_length_2636_cov_200.191171	614	695	574	1	81	0.0123457
NODE_828_length_2636_cov_200.191171	614	695	586	1	81	0.0123457
NODE_828_length_2636_cov_200.191171	614	695	612	1	81	0.0123457
NODE_828_length_2636_cov_200.191171	614	695	620	1	81	0.0123457
NODE_828_length_2636_cov_200.191171	614	695	621	1	81	0.0123457
NODE_828_length_2636_cov_200.191171	614	695	650	1	81	0.0123457
NODE_828_length_2636_cov_200.191171	614	695	670	1	81	0.0123457
NODE_828_length_2636_cov_200.191171	614	695	692	1	81	0.0123457
NODE_828_length_2636_cov_200.191171	614	695	730	1	81	0.0123457
NODE_828_length_2636_cov_200.191171	614	695	749	1	81	0.0123457
NODE_828_length_2636_cov_200.191171	614	695	763	1	81	0.0123457
NODE_828_length_2636_cov_200.191171	614	695	846	1	81	0.0123457
NODE_828_length_2636_cov_200.191171	614	695	893	1	81	0.0123457
NODE_828_length_2636_cov_200.191171	614	695	1018	1	81	0.0123457
NODE_828_length_2636_cov_200.191171	614	695	1035	1	81	0.0123457
NODE_828_length_2636_cov_200.191171	614	695	1041	1	81	0.0123457
NODE_828_length_2636_cov_200.191171	614	695	1050	1	81	0.0123457
NODE_828_length_2636_cov_200.191171	614	695	1062	1	81	0.0123457
NODE_828_length_2636_cov_200.191171	614	695	1066	1	81	0.0123457
NODE_828_length_2636_cov_200.191171	614	695	1090	1	81	0.0123457
NODE_828_length_2636_cov_200.191171	614	695	1105	1	81	0.0123457
NODE_828_length_2636_cov_200.191171	614	695	1116	1	81	0.0123457
NODE_828_length_2636_cov_200.191171	614	695	1171	1	81	0.0123457
NODE_828_length_2636_cov_200.191171	614	695	1184	1	81	0.0123457
NODE_828_length_2636_cov_200.191171	614	695	1195	1	81	0.0123457
NODE_828_length_2636_cov_200.191171	614	695	1246	1	81	0.0123457
NODE_828_length_2636_cov_200.191171	614	695	1248	1	81	0.0123457
NODE_828_length_2636_cov_200.191171	614	695	1271	1	81	0.0123457
NODE_828_length_2636_cov_200.191171	614	695	1309	1	81	0.0123457
NODE_828_length_2636_cov_200.191171	614	695	1345	1	81	0.0123457
NODE_828_length_2636_cov_200.191171	614	695	1361	1	81	0.0123457
NODE_828_length_2636_cov_200.191171	614	695	1377	1	81	0.0123457
NODE_828_length_2636_cov_200.191171	614	695	1382	1	81	0.0123457
NODE_828_length_2636_cov_200.191171	614	695	1402	1	81	0.0123457
NODE_828_length_2636_cov_200.191171	614	695	1409	1	81	0.0123457
NODE_828_length_2636_cov_200.191171	614	695	1429	1	81	0.0123457
NODE_828_length_2636_cov_200.191171	614	695	1467	1	81	0.0123457
NODE_828_length_2636_cov_200.191171	614	695	1475	1	81	0.0123457
NODE_828_length_2636_cov_200.191171	614	695	1478	1	81	0.0123457
NODE_828_length_2636_cov_200.191171	614	695	1488	1	81	0.0123457
NODE_828_length_2636_cov_200.191171	614	695	1502	1	81	0.0123457
NODE_828_length_2636_cov_200.191171	614	695	1507	1	81	0.0123457
NODE_828_length_2636_cov_200.191171	614	695	1511	1	81	0.0123457
NODE_828_length_2636_cov_200.191171	614	695	1523	1	81	0.0123457
NODE_828_length_2636_cov_200.191171	614	695	1566	1	81	0.0123457
NODE_828_length_2636_cov_200.191171	614	695	1571	1	81	0.0123457
NODE_828_length_2636_cov_200.191171	614	695	1610	1	81	0.0123457
NODE_828_length_2636_cov_200.191171	614	695	1611	1	81	0.0123457
NODE_828_length_2636_cov_200.191171	614	695	1615	1	81	0.0123457
NODE_828_length_2636_cov_200.191171	614	695	1619	1	81	0.0123457
NODE_828_length_2636_cov_200.191171	614	695	1630	1	81	0.0123457
NODE_828_length_2636_cov_200.191171	614	695	1633	1	81	0.0123457
NODE_828_length_2636_cov_200.191171	614	695	1641	3	81	0.0370370
NODE_828_length_2636_cov_200.191171	614	695	1643	1	81	0.0123457
NODE_828_length_2636_cov_200.191171	614	695	1652	1	81	0.0123457
NODE_828_length_2636_cov_200.191171	614	695	1653	1	81	0.0123457
NODE_828_length_2636_cov_200.191171	614	695	1677	1	81	0.0123457
NODE_828_length_2636_cov_200.191171	614	695	1686	1	81	0.0123457
NODE_828_length_2636_cov_200.191171	614	695	1690	1	81	0.0123457
NODE_828_length_2636_cov_200.191171	614	695	1694	1	81	0.0123457
NODE_828_length_2636_cov_200.191171	614	695	1697	1	81	0.0123457
NODE_828_length_2636_cov_200.191171	614	695	1702	1	81	0.0123457
NODE_830_length_2631_cov_10.831754	446	526	0	36	80	0.4500000
NODE_830_length_2631_cov_10.831754	446	526	2	27	80	0.3375000
NODE_830_length_2631_cov_10.831754	446	526	4	17	80	0.2125000
NODE_830_length_2631_cov_10.831754	499	572	2	10	73	0.1369863
NODE_830_length_2631_cov_10.831754	499	572	4	63	73	0.8630137
NODE_833_length_2622_cov_63.057471	1877	1953	169	1	76	0.0131579
NODE_833_length_2622_cov_63.057471	1877	1953	174	1	76	0.0131579
NODE_833_length_2622_cov_63.057471	1877	1953	181	1	76	0.0131579
NODE_833_length_2622_cov_63.057471	1877	1953	187	1	76	0.0131579
NODE_833_length_2622_cov_63.057471	1877	1953	188	1	76	0.0131579
NODE_833_length_2622_cov_63.057471	1877	1953	189	1	76	0.0131579
NODE_833_length_2622_cov_63.057471	1877	1953	191	2	76	0.0263158
NODE_833_length_2622_cov_63.057471	1877	1953	193	3	76	0.0394737
NODE_833_length_2622_cov_63.057471	1877	1953	198	1	76	0.0131579
NODE_833_length_2622_cov_63.057471	1877	1953	202	1	76	0.0131579
NODE_833_length_2622_cov_63.057471	1877	1953	205	1	76	0.0131579
NODE_833_length_2622_cov_63.057471	1877	1953	207	1	76	0.0131579
NODE_833_length_2622_cov_63.057471	1877	1953	208	3	76	0.0394737
NODE_833_length_2622_cov_63.057471	1877	1953	213	1	76	0.0131579
NODE_833_length_2622_cov_63.057471	1877	1953	221	1	76	0.0131579
NODE_833_length_2622_cov_63.057471	1877	1953	223	9	76	0.1184211
NODE_833_length_2622_cov_63.057471	1877	1953	224	1	76	0.0131579
NODE_833_length_2622_cov_63.057471	1877	1953	225	2	76	0.0263158
NODE_833_length_2622_cov_63.057471	1877	1953	229	1	76	0.0131579
NODE_833_length_2622_cov_63.057471	1877	1953	231	1	76	0.0131579
NODE_833_length_2622_cov_63.057471	1877	1953	237	4	76	0.0526316
NODE_833_length_2622_cov_63.057471	1877	1953	239	2	76	0.0263158
NODE_833_length_2622_cov_63.057471	1877	1953	243	3	76	0.0394737
NODE_833_length_2622_cov_63.057471	1877	1953	245	1	76	0.0131579
NODE_833_length_2622_cov_63.057471	1877	1953	247	1	76	0.0131579
NODE_833_length_2622_cov_63.057471	1877	1953	251	1	76	0.0131579
NODE_833_length_2622_cov_63.057471	1877	1953	252	1	76	0.0131579
NODE_833_length_2622_cov_63.057471	1877	1953	253	4	76	0.0526316
NODE_833_length_2622_cov_63.057471	1877	1953	254	5	76	0.0657895
NODE_833_length_2622_cov_63.057471	1877	1953	255	3	76	0.0394737
NODE_833_length_2622_cov_63.057471	1877	1953	256	3	76	0.0394737
NODE_833_length_2622_cov_63.057471	1877	1953	257	3	76	0.0394737
NODE_833_length_2622_cov_63.057471	1877	1953	258	1	76	0.0131579
NODE_833_length_2622_cov_63.057471	1877	1953	259	3	76	0.0394737
NODE_833_length_2622_cov_63.057471	1877	1953	260	7	76	0.0921053
NODE_833_length_2622_cov_63.057471	2426	2506	6	8	80	0.1000000
NODE_833_length_2622_cov_63.057471	2426	2506	9	1	80	0.0125000
NODE_833_length_2622_cov_63.057471	2426	2506	10	1	80	0.0125000
NODE_833_length_2622_cov_63.057471	2426	2506	11	4	80	0.0500000
NODE_833_length_2622_cov_63.057471	2426	2506	15	6	80	0.0750000
NODE_833_length_2622_cov_63.057471	2426	2506	17	1	80	0.0125000
NODE_833_length_2622_cov_63.057471	2426	2506	18	3	80	0.0375000
NODE_833_length_2622_cov_63.057471	2426	2506	19	11	80	0.1375000
NODE_833_length_2622_cov_63.057471	2426	2506	20	2	80	0.0250000
NODE_833_length_2622_cov_63.057471	2426	2506	26	1	80	0.0125000
NODE_833_length_2622_cov_63.057471	2426	2506	32	3	80	0.0375000
NODE_833_length_2622_cov_63.057471	2426	2506	33	5	80	0.0625000
NODE_833_length_2622_cov_63.057471	2426	2506	34	3	80	0.0375000
NODE_833_length_2622_cov_63.057471	2426	2506	37	3	80	0.0375000
NODE_833_length_2622_cov_63.057471	2426	2506	38	1	80	0.0125000
NODE_833_length_2622_cov_63.057471	2426	2506	40	2	80	0.0250000
NODE_833_length_2622_cov_63.057471	2426	2506	42	1	80	0.0125000
NODE_833_length_2622_cov_63.057471	2426	2506	45	3	80	0.0375000
NODE_833_length_2622_cov_63.057471	2426	2506	46	1	80	0.0125000
NODE_833_length_2622_cov_63.057471	2426	2506	47	7	80	0.0875000
NODE_833_length_2622_cov_63.057471	2426	2506	48	2	80	0.0250000
NODE_833_length_2622_cov_63.057471	2426	2506	50	3	80	0.0375000
NODE_833_length_2622_cov_63.057471	2426	2506	52	5	80	0.0625000
NODE_833_length_2622_cov_63.057471	2426	2506	56	2	80	0.0250000
NODE_833_length_2622_cov_63.057471	2426	2506	58	1	80	0.0125000
NODE_833_length_2622_cov_63.057471	2479	2559	40	2	80	0.0250000
NODE_833_length_2622_cov_63.057471	2479	2559	42	1	80	0.0125000
NODE_833_length_2622_cov_63.057471	2479	2559	45	3	80	0.0375000
NODE_833_length_2622_cov_63.057471	2479	2559	46	1	80	0.0125000
NODE_833_length_2622_cov_63.057471	2479	2559	47	7	80	0.0875000
NODE_833_length_2622_cov_63.057471	2479	2559	48	2	80	0.0250000
NODE_833_length_2622_cov_63.057471	2479	2559	50	3	80	0.0375000
NODE_833_length_2622_cov_63.057471	2479	2559	52	5	80	0.0625000
NODE_833_length_2622_cov_63.057471	2479	2559	56	2	80	0.0250000
NODE_833_length_2622_cov_63.057471	2479	2559	58	3	80	0.0375000
NODE_833_length_2622_cov_63.057471	2479	2559	59	3	80	0.0375000
NODE_833_length_2622_cov_63.057471	2479	2559	60	3	80	0.0375000
NODE_833_length_2622_cov_63.057471	2479	2559	62	1	80	0.0125000
NODE_833_length_2622_cov_63.057471	2479	2559	63	11	80	0.1375000
NODE_833_length_2622_cov_63.057471	2479	2559	64	8	80	0.1000000
NODE_833_length_2622_cov_63.057471	2479	2559	66	25	80	0.3125000
NODE_836_length_2617_cov_16.817315	1404	1448	14	25	44	0.5681818
NODE_836_length_2617_cov_16.817315	1404	1448	16	19	44	0.4318182
NODE_836_length_2617_cov_16.817315	1467	1521	4	9	54	0.1666667
NODE_836_length_2617_cov_16.817315	1467	1521	6	34	54	0.6296296
NODE_836_length_2617_cov_16.817315	1467	1521	8	11	54	0.2037037
NODE_839_length_2610_cov_2.232577	2127	2163	0	14	36	0.3888889
NODE_839_length_2610_cov_2.232577	2127	2163	2	22	36	0.6111111
NODE_840_length_2609_cov_13.245418	2066	2146	1	8	80	0.1000000
NODE_840_length_2609_cov_13.245418	2066	2146	2	14	80	0.1750000
NODE_840_length_2609_cov_13.245418	2066	2146	18	8	80	0.1000000
NODE_840_length_2609_cov_13.245418	2066	2146	20	50	80	0.6250000
NODE_840_length_2609_cov_13.245418	2119	2199	1	61	80	0.7625000
NODE_840_length_2609_cov_13.245418	2119	2199	2	14	80	0.1750000
NODE_840_length_2609_cov_13.245418	2119	2199	18	5	80	0.0625000
NODE_840_length_2609_cov_13.245418	2195	2275	0	64	80	0.8000000
NODE_840_length_2609_cov_13.245418	2195	2275	1	16	80	0.2000000
NODE_840_length_2609_cov_13.245418	2248	2328	0	80	80	1.0000000
NODE_845_length_2595_cov_5.638622	2157	2237	0	80	80	1.0000000
NODE_847_length_2594_cov_109.880160	386	450	56	1	64	0.0156250
NODE_847_length_2594_cov_109.880160	386	450	60	1	64	0.0156250
NODE_847_length_2594_cov_109.880160	386	450	65	1	64	0.0156250
NODE_847_length_2594_cov_109.880160	386	450	66	1	64	0.0156250
NODE_847_length_2594_cov_109.880160	386	450	80	1	64	0.0156250
NODE_847_length_2594_cov_109.880160	386	450	82	1	64	0.0156250
NODE_847_length_2594_cov_109.880160	386	450	86	6	64	0.0937500
NODE_847_length_2594_cov_109.880160	386	450	92	1	64	0.0156250
NODE_847_length_2594_cov_109.880160	386	450	95	3	64	0.0468750
NODE_847_length_2594_cov_109.880160	386	450	97	1	64	0.0156250
NODE_847_length_2594_cov_109.880160	386	450	121	1	64	0.0156250
NODE_847_length_2594_cov_109.880160	386	450	146	1	64	0.0156250
NODE_847_length_2594_cov_109.880160	386	450	154	1	64	0.0156250
NODE_847_length_2594_cov_109.880160	386	450	157	2	64	0.0312500
NODE_847_length_2594_cov_109.880160	386	450	164	1	64	0.0156250
NODE_847_length_2594_cov_109.880160	386	450	166	1	64	0.0156250
NODE_847_length_2594_cov_109.880160	386	450	168	1	64	0.0156250
NODE_847_length_2594_cov_109.880160	386	450	183	1	64	0.0156250
NODE_847_length_2594_cov_109.880160	386	450	187	1	64	0.0156250
NODE_847_length_2594_cov_109.880160	386	450	193	1	64	0.0156250
NODE_847_length_2594_cov_109.880160	386	450	199	1	64	0.0156250
NODE_847_length_2594_cov_109.880160	386	450	211	4	64	0.0625000
NODE_847_length_2594_cov_109.880160	386	450	219	1	64	0.0156250
NODE_847_length_2594_cov_109.880160	386	450	225	2	64	0.0312500
NODE_847_length_2594_cov_109.880160	386	450	227	1	64	0.0156250
NODE_847_length_2594_cov_109.880160	386	450	229	1	64	0.0156250
NODE_847_length_2594_cov_109.880160	386	450	233	1	64	0.0156250
NODE_847_length_2594_cov_109.880160	386	450	255	1	64	0.0156250
NODE_847_length_2594_cov_109.880160	386	450	264	1	64	0.0156250
NODE_847_length_2594_cov_109.880160	386	450	268	1	64	0.0156250
NODE_847_length_2594_cov_109.880160	386	450	285	1	64	0.0156250
NODE_847_length_2594_cov_109.880160	386	450	295	1	64	0.0156250
NODE_847_length_2594_cov_109.880160	386	450	297	1	64	0.0156250
NODE_847_length_2594_cov_109.880160	386	450	299	2	64	0.0312500
NODE_847_length_2594_cov_109.880160	386	450	303	1	64	0.0156250
NODE_847_length_2594_cov_109.880160	386	450	307	4	64	0.0625000
NODE_847_length_2594_cov_109.880160	386	450	310	3	64	0.0468750
NODE_847_length_2594_cov_109.880160	386	450	315	3	64	0.0468750
NODE_847_length_2594_cov_109.880160	386	450	319	2	64	0.0312500
NODE_847_length_2594_cov_109.880160	386	450	328	3	64	0.0468750
NODE_847_length_2594_cov_109.880160	386	450	332	1	64	0.0156250
NODE_856_length_2575_cov_4.890549	1860	1912	4	12	52	0.2307692
NODE_856_length_2575_cov_4.890549	1860	1912	6	1	52	0.0192308
NODE_856_length_2575_cov_4.890549	1860	1912	8	37	52	0.7115384
NODE_856_length_2575_cov_4.890549	1860	1912	10	2	52	0.0384615
NODE_857_length_2572_cov_46.828548	302	382	0	4	80	0.0500000
NODE_857_length_2572_cov_46.828548	302	382	2	76	80	0.9500000
NODE_857_length_2572_cov_46.828548	355	435	0	57	80	0.7125000
NODE_857_length_2572_cov_46.828548	355	435	2	23	80	0.2875000
NODE_868_length_2551_cov_40.721860	1104	1150	4	42	46	0.9130435
NODE_868_length_2551_cov_40.721860	1104	1150	6	4	46	0.0869565
NODE_868_length_2551_cov_40.721860	1199	1259	4	45	60	0.7500000
NODE_868_length_2551_cov_40.721860	1199	1259	6	15	60	0.2500000
NODE_870_length_2547_cov_218.062908	436	486	0	24	50	0.4800000
NODE_870_length_2547_cov_218.062908	436	486	2	6	50	0.1200000
NODE_870_length_2547_cov_218.062908	436	486	6	5	50	0.1000000
NODE_870_length_2547_cov_218.062908	436	486	10	2	50	0.0400000
NODE_870_length_2547_cov_218.062908	436	486	12	2	50	0.0400000
NODE_870_length_2547_cov_218.062908	436	486	14	1	50	0.0200000
NODE_870_length_2547_cov_218.062908	436	486	15	1	50	0.0200000
NODE_870_length_2547_cov_218.062908	436	486	17	3	50	0.0600000
NODE_870_length_2547_cov_218.062908	436	486	21	1	50	0.0200000
NODE_870_length_2547_cov_218.062908	436	486	23	5	50	0.1000000
NODE_879_length_2527_cov_27.275947	503	548	38	3	45	0.0666667
NODE_879_length_2527_cov_27.275947	503	548	40	5	45	0.1111111
NODE_879_length_2527_cov_27.275947	503	548	42	1	45	0.0222222
NODE_879_length_2527_cov_27.275947	503	548	44	7	45	0.1555556
NODE_879_length_2527_cov_27.275947	503	548	46	1	45	0.0222222
NODE_879_length_2527_cov_27.275947	503	548	48	7	45	0.1555556
NODE_879_length_2527_cov_27.275947	503	548	50	2	45	0.0444444
NODE_879_length_2527_cov_27.275947	503	548	52	2	45	0.0444444
NODE_879_length_2527_cov_27.275947	503	548	54	2	45	0.0444444
NODE_879_length_2527_cov_27.275947	503	548	60	2	45	0.0444444
NODE_879_length_2527_cov_27.275947	503	548	62	13	45	0.2888889
NODE_884_length_2519_cov_15.991322	2122	2202	0	22	80	0.2750000
NODE_884_length_2519_cov_15.991322	2122	2202	4	58	80	0.7250000
NODE_884_length_2519_cov_15.991322	2175	2255	0	22	80	0.2750000
NODE_884_length_2519_cov_15.991322	2175	2255	1	1	80	0.0125000
NODE_884_length_2519_cov_15.991322	2175	2255	2	7	80	0.0875000
NODE_884_length_2519_cov_15.991322	2175	2255	4	50	80	0.6250000
NODE_885_length_2518_cov_7.035965	62	142	163	1	80	0.0125000
NODE_885_length_2518_cov_7.035965	62	142	166	2	80	0.0250000
NODE_885_length_2518_cov_7.035965	62	142	168	1	80	0.0125000
NODE_885_length_2518_cov_7.035965	62	142	169	1	80	0.0125000
NODE_885_length_2518_cov_7.035965	62	142	171	1	80	0.0125000
NODE_885_length_2518_cov_7.035965	62	142	172	3	80	0.0375000
NODE_885_length_2518_cov_7.035965	62	142	176	1	80	0.0125000
NODE_885_length_2518_cov_7.035965	62	142	179	1	80	0.0125000
NODE_885_length_2518_cov_7.035965	62	142	184	3	80	0.0375000
NODE_885_length_2518_cov_7.035965	62	142	185	4	80	0.0500000
NODE_885_length_2518_cov_7.035965	62	142	186	2	80	0.0250000
NODE_885_length_2518_cov_7.035965	62	142	187	4	80	0.0500000
NODE_885_length_2518_cov_7.035965	62	142	189	1	80	0.0125000
NODE_885_length_2518_cov_7.035965	62	142	190	1	80	0.0125000
NODE_885_length_2518_cov_7.035965	62	142	192	2	80	0.0250000
NODE_885_length_2518_cov_7.035965	62	142	194	1	80	0.0125000
NODE_885_length_2518_cov_7.035965	62	142	197	6	80	0.0750000
NODE_885_length_2518_cov_7.035965	62	142	198	1	80	0.0125000
NODE_885_length_2518_cov_7.035965	62	142	199	7	80	0.0875000
NODE_885_length_2518_cov_7.035965	62	142	200	3	80	0.0375000
NODE_885_length_2518_cov_7.035965	62	142	202	5	80	0.0625000
NODE_885_length_2518_cov_7.035965	62	142	203	11	80	0.1375000
NODE_885_length_2518_cov_7.035965	62	142	205	8	80	0.1000000
NODE_885_length_2518_cov_7.035965	62	142	207	3	80	0.0375000
NODE_885_length_2518_cov_7.035965	62	142	209	4	80	0.0500000
NODE_885_length_2518_cov_7.035965	62	142	210	3	80	0.0375000
NODE_885_length_2518_cov_7.035965	2005	2085	0	80	80	1.0000000
NODE_885_length_2518_cov_7.035965	2058	2138	0	80	80	1.0000000
NODE_887_length_2515_cov_37.984272	393	473	0	31	80	0.3875000
NODE_887_length_2515_cov_37.984272	393	473	2	49	80	0.6125000
NODE_887_length_2515_cov_37.984272	446	526	0	24	80	0.3000000
NODE_887_length_2515_cov_37.984272	446	526	2	56	80	0.7000000
NODE_887_length_2515_cov_37.984272	1896	1976	0	80	80	1.0000000
NODE_887_length_2515_cov_37.984272	1949	2029	0	80	80	1.0000000
NODE_887_length_2515_cov_37.984272	2025	2105	0	80	80	1.0000000
NODE_887_length_2515_cov_37.984272	2025	2104	0	79	79	1.0000000
NODE_887_length_2515_cov_37.984272	2078	2158	0	80	80	1.0000000
NODE_888_length_2512_cov_48.259428	1299	1379	24	7	80	0.0875000
NODE_888_length_2512_cov_48.259428	1299	1379	25	4	80	0.0500000
NODE_888_length_2512_cov_48.259428	1299	1379	26	22	80	0.2750000
NODE_888_length_2512_cov_48.259428	1299	1379	27	1	80	0.0125000
NODE_888_length_2512_cov_48.259428	1299	1379	28	10	80	0.1250000
NODE_888_length_2512_cov_48.259428	1299	1379	30	2	80	0.0250000
NODE_888_length_2512_cov_48.259428	1299	1379	32	11	80	0.1375000
NODE_888_length_2512_cov_48.259428	1299	1379	36	10	80	0.1250000
NODE_888_length_2512_cov_48.259428	1299	1379	37	4	80	0.0500000
NODE_888_length_2512_cov_48.259428	1299	1379	38	9	80	0.1125000
NODE_888_length_2512_cov_48.259428	1352	1432	18	3	80	0.0375000
NODE_888_length_2512_cov_48.259428	1352	1432	20	2	80	0.0250000
NODE_888_length_2512_cov_48.259428	1352	1432	22	15	80	0.1875000
NODE_888_length_2512_cov_48.259428	1352	1432	24	13	80	0.1625000
NODE_888_length_2512_cov_48.259428	1352	1432	28	8	80	0.1000000
NODE_888_length_2512_cov_48.259428	1352	1432	31	1	80	0.0125000
NODE_888_length_2512_cov_48.259428	1352	1432	32	8	80	0.1000000
NODE_888_length_2512_cov_48.259428	1352	1432	34	2	80	0.0250000
NODE_888_length_2512_cov_48.259428	1352	1432	36	10	80	0.1250000
NODE_888_length_2512_cov_48.259428	1352	1432	37	9	80	0.1125000
NODE_888_length_2512_cov_48.259428	1352	1432	38	9	80	0.1125000
NODE_888_length_2512_cov_48.259428	1428	1512	28	7	84	0.0833333
NODE_888_length_2512_cov_48.259428	1428	1512	32	9	84	0.1071429
NODE_888_length_2512_cov_48.259428	1428	1512	34	9	84	0.1071429
NODE_888_length_2512_cov_48.259428	1428	1512	35	1	84	0.0119048
NODE_888_length_2512_cov_48.259428	1428	1512	36	3	84	0.0357143
NODE_888_length_2512_cov_48.259428	1428	1512	38	1	84	0.0119048
NODE_888_length_2512_cov_48.259428	1428	1512	40	1	84	0.0119048
NODE_888_length_2512_cov_48.259428	1428	1512	41	1	84	0.0119048
NODE_888_length_2512_cov_48.259428	1428	1512	42	5	84	0.0595238
NODE_888_length_2512_cov_48.259428	1428	1512	44	4	84	0.0476190
NODE_888_length_2512_cov_48.259428	1428	1512	46	3	84	0.0357143
NODE_888_length_2512_cov_48.259428	1428	1512	48	1	84	0.0119048
NODE_888_length_2512_cov_48.259428	1428	1512	50	1	84	0.0119048
NODE_888_length_2512_cov_48.259428	1428	1512	52	1	84	0.0119048
NODE_888_length_2512_cov_48.259428	1428	1512	54	5	84	0.0595238
NODE_888_length_2512_cov_48.259428	1428	1512	56	1	84	0.0119048
NODE_888_length_2512_cov_48.259428	1428	1512	58	1	84	0.0119048
NODE_888_length_2512_cov_48.259428	1428	1512	60	1	84	0.0119048
NODE_888_length_2512_cov_48.259428	1428	1512	76	1	84	0.0119048
NODE_888_length_2512_cov_48.259428	1428	1512	80	4	84	0.0476190
NODE_888_length_2512_cov_48.259428	1428	1512	84	2	84	0.0238095
NODE_888_length_2512_cov_48.259428	1428	1512	88	1	84	0.0119048
NODE_888_length_2512_cov_48.259428	1428	1512	90	9	84	0.1071429
NODE_888_length_2512_cov_48.259428	1428	1512	92	1	84	0.0119048
NODE_888_length_2512_cov_48.259428	1428	1512	94	2	84	0.0238095
NODE_888_length_2512_cov_48.259428	1428	1512	99	1	84	0.0119048
NODE_888_length_2512_cov_48.259428	1428	1512	103	1	84	0.0119048
NODE_888_length_2512_cov_48.259428	1428	1512	111	1	84	0.0119048
NODE_888_length_2512_cov_48.259428	1428	1512	113	1	84	0.0119048
NODE_888_length_2512_cov_48.259428	1428	1512	118	1	84	0.0119048
NODE_888_length_2512_cov_48.259428	1428	1512	119	1	84	0.0119048
NODE_888_length_2512_cov_48.259428	1428	1512	120	2	84	0.0238095
NODE_888_length_2512_cov_48.259428	1428	1512	122	1	84	0.0119048
NODE_888_length_2512_cov_48.259428	1485	1565	80	3	80	0.0375000
NODE_888_length_2512_cov_48.259428	1485	1565	84	2	80	0.0250000
NODE_888_length_2512_cov_48.259428	1485	1565	88	1	80	0.0125000
NODE_888_length_2512_cov_48.259428	1485	1565	90	9	80	0.1125000
NODE_888_length_2512_cov_48.259428	1485	1565	92	1	80	0.0125000
NODE_888_length_2512_cov_48.259428	1485	1565	94	2	80	0.0250000
NODE_888_length_2512_cov_48.259428	1485	1565	99	1	80	0.0125000
NODE_888_length_2512_cov_48.259428	1485	1565	103	1	80	0.0125000
NODE_888_length_2512_cov_48.259428	1485	1565	111	1	80	0.0125000
NODE_888_length_2512_cov_48.259428	1485	1565	113	1	80	0.0125000
NODE_888_length_2512_cov_48.259428	1485	1565	118	1	80	0.0125000
NODE_888_length_2512_cov_48.259428	1485	1565	119	1	80	0.0125000
NODE_888_length_2512_cov_48.259428	1485	1565	120	2	80	0.0250000
NODE_888_length_2512_cov_48.259428	1485	1565	122	1	80	0.0125000
NODE_888_length_2512_cov_48.259428	1485	1565	124	8	80	0.1000000
NODE_888_length_2512_cov_48.259428	1485	1565	125	4	80	0.0500000
NODE_888_length_2512_cov_48.259428	1485	1565	126	7	80	0.0875000
NODE_888_length_2512_cov_48.259428	1485	1565	127	5	80	0.0625000
NODE_888_length_2512_cov_48.259428	1485	1565	128	9	80	0.1125000
NODE_888_length_2512_cov_48.259428	1485	1565	129	2	80	0.0250000
NODE_888_length_2512_cov_48.259428	1485	1565	130	4	80	0.0500000
NODE_888_length_2512_cov_48.259428	1485	1565	131	1	80	0.0125000
NODE_888_length_2512_cov_48.259428	1485	1565	132	11	80	0.1375000
NODE_888_length_2512_cov_48.259428	1485	1565	134	2	80	0.0250000
NODE_891_length_2505_cov_102.009975	390	470	0	1	80	0.0125000
NODE_891_length_2505_cov_102.009975	390	470	2	48	80	0.6000000
NODE_891_length_2505_cov_102.009975	390	470	4	31	80	0.3875000
NODE_891_length_2505_cov_102.009975	443	510	4	67	67	1.0000000
NODE_894_length_2499_cov_2.655417	2325	2375	0	20	50	0.4000000
NODE_894_length_2499_cov_2.655417	2325	2375	2	30	50	0.6000000
NODE_895_length_2498_cov_9.614840	239	281	0	42	42	1.0000000
NODE_895_length_2498_cov_9.614840	254	335	0	81	81	1.0000000
NODE_895_length_2498_cov_9.614840	254	335	0	81	81	1.0000000
NODE_895_length_2498_cov_9.614840	331	411	0	7	80	0.0875000
NODE_895_length_2498_cov_9.614840	331	411	2	73	80	0.9125000
NODE_895_length_2498_cov_9.614840	384	464	0	48	80	0.6000000
NODE_895_length_2498_cov_9.614840	384	464	2	32	80	0.4000000
NODE_898_length_2495_cov_5.151085	2395	2444	0	4	49	0.0816327
NODE_898_length_2495_cov_5.151085	2395	2444	2	39	49	0.7959183
NODE_898_length_2495_cov_5.151085	2395	2444	4	6	49	0.1224490
NODE_898_length_2495_cov_5.151085	2395	2444	0	4	49	0.0816327
NODE_898_length_2495_cov_5.151085	2395	2444	2	39	49	0.7959183
NODE_898_length_2495_cov_5.151085	2395	2444	4	6	49	0.1224490
NODE_898_length_2495_cov_5.151085	2396	2444	0	4	48	0.0833333
NODE_898_length_2495_cov_5.151085	2396	2444	2	39	48	0.8125000
NODE_898_length_2495_cov_5.151085	2396	2444	4	5	48	0.1041667
NODE_898_length_2495_cov_5.151085	2396	2444	0	4	48	0.0833333
NODE_898_length_2495_cov_5.151085	2396	2444	2	39	48	0.8125000
NODE_898_length_2495_cov_5.151085	2396	2444	4	5	48	0.1041667
NODE_898_length_2495_cov_5.151085	2396	2444	0	4	48	0.0833333
NODE_898_length_2495_cov_5.151085	2396	2444	2	39	48	0.8125000
NODE_898_length_2495_cov_5.151085	2396	2444	4	5	48	0.1041667
NODE_900_length_2492_cov_43.645215	408	488	0	53	80	0.6625000
NODE_900_length_2492_cov_43.645215	408	488	1	27	80	0.3375000
NODE_903_length_2489_cov_15.105021	204	234	0	30	30	1.0000000
NODE_905_length_2488_cov_2.434910	2141	2200	33	3	59	0.0508475
NODE_905_length_2488_cov_2.434910	2141	2200	35	14	59	0.2372881
NODE_905_length_2488_cov_2.434910	2141	2200	37	13	59	0.2203390
NODE_905_length_2488_cov_2.434910	2141	2200	38	23	59	0.3898305
NODE_905_length_2488_cov_2.434910	2141	2200	39	3	59	0.0508475
NODE_905_length_2488_cov_2.434910	2141	2200	40	3	59	0.0508475
NODE_906_length_2484_cov_335.301887	224	279	1155	1	55	0.0181818
NODE_906_length_2484_cov_335.301887	224	279	1165	1	55	0.0181818
NODE_906_length_2484_cov_335.301887	224	279	1170	1	55	0.0181818
NODE_906_length_2484_cov_335.301887	224	279	1175	1	55	0.0181818
NODE_906_length_2484_cov_335.301887	224	279	1177	1	55	0.0181818
NODE_906_length_2484_cov_335.301887	224	279	1182	1	55	0.0181818
NODE_906_length_2484_cov_335.301887	224	279	1204	1	55	0.0181818
NODE_906_length_2484_cov_335.301887	224	279	1224	1	55	0.0181818
NODE_906_length_2484_cov_335.301887	224	279	1227	1	55	0.0181818
NODE_906_length_2484_cov_335.301887	224	279	1236	1	55	0.0181818
NODE_906_length_2484_cov_335.301887	224	279	1237	1	55	0.0181818
NODE_906_length_2484_cov_335.301887	224	279	1238	2	55	0.0363636
NODE_906_length_2484_cov_335.301887	224	279	1239	1	55	0.0181818
NODE_906_length_2484_cov_335.301887	224	279	1240	1	55	0.0181818
NODE_906_length_2484_cov_335.301887	224	279	1242	3	55	0.0545455
NODE_906_length_2484_cov_335.301887	224	279	1244	1	55	0.0181818
NODE_906_length_2484_cov_335.301887	224	279	1245	1	55	0.0181818
NODE_906_length_2484_cov_335.301887	224	279	1246	3	55	0.0545455
NODE_906_length_2484_cov_335.301887	224	279	1248	1	55	0.0181818
NODE_906_length_2484_cov_335.301887	224	279	1249	2	55	0.0363636
NODE_906_length_2484_cov_335.301887	224	279	1250	1	55	0.0181818
NODE_906_length_2484_cov_335.301887	224	279	1251	2	55	0.0363636
NODE_906_length_2484_cov_335.301887	224	279	1252	3	55	0.0545455
NODE_906_length_2484_cov_335.301887	224	279	1253	1	55	0.0181818
NODE_906_length_2484_cov_335.301887	224	279	1254	4	55	0.0727273
NODE_906_length_2484_cov_335.301887	224	279	1255	1	55	0.0181818
NODE_906_length_2484_cov_335.301887	224	279	1256	1	55	0.0181818
NODE_906_length_2484_cov_335.301887	224	279	1257	3	55	0.0545455
NODE_906_length_2484_cov_335.301887	224	279	1258	3	55	0.0545455
NODE_906_length_2484_cov_335.301887	224	279	1259	1	55	0.0181818
NODE_906_length_2484_cov_335.301887	224	279	1260	1	55	0.0181818
NODE_906_length_2484_cov_335.301887	224	279	1261	2	55	0.0363636
NODE_906_length_2484_cov_335.301887	224	279	1262	1	55	0.0181818
NODE_906_length_2484_cov_335.301887	224	279	1263	1	55	0.0181818
NODE_906_length_2484_cov_335.301887	224	279	1265	2	55	0.0363636
NODE_906_length_2484_cov_335.301887	224	279	1270	1	55	0.0181818
NODE_906_length_2484_cov_335.301887	224	279	1272	1	55	0.0181818
NODE_906_length_2484_cov_335.301887	252	332	902	1	80	0.0125000
NODE_906_length_2484_cov_335.301887	252	332	912	1	80	0.0125000
NODE_906_length_2484_cov_335.301887	252	332	925	1	80	0.0125000
NODE_906_length_2484_cov_335.301887	252	332	936	1	80	0.0125000
NODE_906_length_2484_cov_335.301887	252	332	950	1	80	0.0125000
NODE_906_length_2484_cov_335.301887	252	332	954	1	80	0.0125000
NODE_906_length_2484_cov_335.301887	252	332	959	1	80	0.0125000
NODE_906_length_2484_cov_335.301887	252	332	974	1	80	0.0125000
NODE_906_length_2484_cov_335.301887	252	332	996	1	80	0.0125000
NODE_906_length_2484_cov_335.301887	252	332	1006	1	80	0.0125000
NODE_906_length_2484_cov_335.301887	252	332	1015	1	80	0.0125000
NODE_906_length_2484_cov_335.301887	252	332	1039	1	80	0.0125000
NODE_906_length_2484_cov_335.301887	252	332	1048	1	80	0.0125000
NODE_906_length_2484_cov_335.301887	252	332	1068	1	80	0.0125000
NODE_906_length_2484_cov_335.301887	252	332	1096	1	80	0.0125000
NODE_906_length_2484_cov_335.301887	252	332	1114	1	80	0.0125000
NODE_906_length_2484_cov_335.301887	252	332	1149	1	80	0.0125000
NODE_906_length_2484_cov_335.301887	252	332	1165	1	80	0.0125000
NODE_906_length_2484_cov_335.301887	252	332	1166	1	80	0.0125000
NODE_906_length_2484_cov_335.301887	252	332	1168	1	80	0.0125000
NODE_906_length_2484_cov_335.301887	252	332	1170	1	80	0.0125000
NODE_906_length_2484_cov_335.301887	252	332	1171	2	80	0.0250000
NODE_906_length_2484_cov_335.301887	252	332	1172	1	80	0.0125000
NODE_906_length_2484_cov_335.301887	252	332	1174	1	80	0.0125000
NODE_906_length_2484_cov_335.301887	252	332	1186	1	80	0.0125000
NODE_906_length_2484_cov_335.301887	252	332	1204	1	80	0.0125000
NODE_906_length_2484_cov_335.301887	252	332	1205	1	80	0.0125000
NODE_906_length_2484_cov_335.301887	252	332	1208	2	80	0.0250000
NODE_906_length_2484_cov_335.301887	252	332	1209	1	80	0.0125000
NODE_906_length_2484_cov_335.301887	252	332	1217	1	80	0.0125000
NODE_906_length_2484_cov_335.301887	252	332	1218	1	80	0.0125000
NODE_906_length_2484_cov_335.301887	252	332	1220	1	80	0.0125000
NODE_906_length_2484_cov_335.301887	252	332	1221	2	80	0.0250000
NODE_906_length_2484_cov_335.301887	252	332	1224	1	80	0.0125000
NODE_906_length_2484_cov_335.301887	252	332	1225	4	80	0.0500000
NODE_906_length_2484_cov_335.301887	252	332	1226	1	80	0.0125000
NODE_906_length_2484_cov_335.301887	252	332	1229	1	80	0.0125000
NODE_906_length_2484_cov_335.301887	252	332	1230	2	80	0.0250000
NODE_906_length_2484_cov_335.301887	252	332	1231	1	80	0.0125000
NODE_906_length_2484_cov_335.301887	252	332	1232	2	80	0.0250000
NODE_906_length_2484_cov_335.301887	252	332	1236	2	80	0.0250000
NODE_906_length_2484_cov_335.301887	252	332	1237	2	80	0.0250000
NODE_906_length_2484_cov_335.301887	252	332	1238	3	80	0.0375000
NODE_906_length_2484_cov_335.301887	252	332	1242	2	80	0.0250000
NODE_906_length_2484_cov_335.301887	252	332	1246	1	80	0.0125000
NODE_906_length_2484_cov_335.301887	252	332	1249	2	80	0.0250000
NODE_906_length_2484_cov_335.301887	252	332	1251	2	80	0.0250000
NODE_906_length_2484_cov_335.301887	252	332	1252	1	80	0.0125000
NODE_906_length_2484_cov_335.301887	252	332	1253	1	80	0.0125000
NODE_906_length_2484_cov_335.301887	252	332	1254	2	80	0.0250000
NODE_906_length_2484_cov_335.301887	252	332	1255	1	80	0.0125000
NODE_906_length_2484_cov_335.301887	252	332	1257	3	80	0.0375000
NODE_906_length_2484_cov_335.301887	252	332	1258	2	80	0.0250000
NODE_906_length_2484_cov_335.301887	252	332	1259	1	80	0.0125000
NODE_906_length_2484_cov_335.301887	252	332	1261	2	80	0.0250000
NODE_906_length_2484_cov_335.301887	252	332	1262	1	80	0.0125000
NODE_906_length_2484_cov_335.301887	252	332	1263	1	80	0.0125000
NODE_906_length_2484_cov_335.301887	252	332	1265	2	80	0.0250000
NODE_906_length_2484_cov_335.301887	252	332	1270	1	80	0.0125000
NODE_912_length_2479_cov_90.381092	369	449	0	80	80	1.0000000
NODE_912_length_2479_cov_90.381092	422	499	0	77	77	1.0000000
NODE_912_length_2479_cov_90.381092	1610	1685	174	1	75	0.0133333
NODE_912_length_2479_cov_90.381092	1610	1685	212	1	75	0.0133333
NODE_912_length_2479_cov_90.381092	1610	1685	229	1	75	0.0133333
NODE_912_length_2479_cov_90.381092	1610	1685	231	1	75	0.0133333
NODE_912_length_2479_cov_90.381092	1610	1685	233	1	75	0.0133333
NODE_912_length_2479_cov_90.381092	1610	1685	241	1	75	0.0133333
NODE_912_length_2479_cov_90.381092	1610	1685	251	2	75	0.0266667
NODE_912_length_2479_cov_90.381092	1610	1685	253	2	75	0.0266667
NODE_912_length_2479_cov_90.381092	1610	1685	263	1	75	0.0133333
NODE_912_length_2479_cov_90.381092	1610	1685	265	1	75	0.0133333
NODE_912_length_2479_cov_90.381092	1610	1685	271	2	75	0.0266667
NODE_912_length_2479_cov_90.381092	1610	1685	286	1	75	0.0133333
NODE_912_length_2479_cov_90.381092	1610	1685	302	1	75	0.0133333
NODE_912_length_2479_cov_90.381092	1610	1685	305	1	75	0.0133333
NODE_912_length_2479_cov_90.381092	1610	1685	318	1	75	0.0133333
NODE_912_length_2479_cov_90.381092	1610	1685	330	1	75	0.0133333
NODE_912_length_2479_cov_90.381092	1610	1685	340	1	75	0.0133333
NODE_912_length_2479_cov_90.381092	1610	1685	342	1	75	0.0133333
NODE_912_length_2479_cov_90.381092	1610	1685	352	1	75	0.0133333
NODE_912_length_2479_cov_90.381092	1610	1685	363	1	75	0.0133333
NODE_912_length_2479_cov_90.381092	1610	1685	389	1	75	0.0133333
NODE_912_length_2479_cov_90.381092	1610	1685	395	1	75	0.0133333
NODE_912_length_2479_cov_90.381092	1610	1685	401	1	75	0.0133333
NODE_912_length_2479_cov_90.381092	1610	1685	406	1	75	0.0133333
NODE_912_length_2479_cov_90.381092	1610	1685	409	1	75	0.0133333
NODE_912_length_2479_cov_90.381092	1610	1685	411	1	75	0.0133333
NODE_912_length_2479_cov_90.381092	1610	1685	419	1	75	0.0133333
NODE_912_length_2479_cov_90.381092	1610	1685	421	2	75	0.0266667
NODE_912_length_2479_cov_90.381092	1610	1685	424	1	75	0.0133333
NODE_912_length_2479_cov_90.381092	1610	1685	432	2	75	0.0266667
NODE_912_length_2479_cov_90.381092	1610	1685	436	1	75	0.0133333
NODE_912_length_2479_cov_90.381092	1610	1685	439	1	75	0.0133333
NODE_912_length_2479_cov_90.381092	1610	1685	447	1	75	0.0133333
NODE_912_length_2479_cov_90.381092	1610	1685	461	1	75	0.0133333
NODE_912_length_2479_cov_90.381092	1610	1685	478	2	75	0.0266667
NODE_912_length_2479_cov_90.381092	1610	1685	484	1	75	0.0133333
NODE_912_length_2479_cov_90.381092	1610	1685	493	1	75	0.0133333
NODE_912_length_2479_cov_90.381092	1610	1685	496	1	75	0.0133333
NODE_912_length_2479_cov_90.381092	1610	1685	501	1	75	0.0133333
NODE_912_length_2479_cov_90.381092	1610	1685	503	1	75	0.0133333
NODE_912_length_2479_cov_90.381092	1610	1685	507	1	75	0.0133333
NODE_912_length_2479_cov_90.381092	1610	1685	529	1	75	0.0133333
NODE_912_length_2479_cov_90.381092	1610	1685	536	1	75	0.0133333
NODE_912_length_2479_cov_90.381092	1610	1685	538	1	75	0.0133333
NODE_912_length_2479_cov_90.381092	1610	1685	542	1	75	0.0133333
NODE_912_length_2479_cov_90.381092	1610	1685	549	1	75	0.0133333
NODE_912_length_2479_cov_90.381092	1610	1685	551	1	75	0.0133333
NODE_912_length_2479_cov_90.381092	1610	1685	552	2	75	0.0266667
NODE_912_length_2479_cov_90.381092	1610	1685	567	1	75	0.0133333
NODE_912_length_2479_cov_90.381092	1610	1685	577	1	75	0.0133333
NODE_912_length_2479_cov_90.381092	1610	1685	590	1	75	0.0133333
NODE_912_length_2479_cov_90.381092	1610	1685	591	2	75	0.0266667
NODE_912_length_2479_cov_90.381092	1610	1685	592	1	75	0.0133333
NODE_912_length_2479_cov_90.381092	1610	1685	599	1	75	0.0133333
NODE_912_length_2479_cov_90.381092	1610	1685	600	1	75	0.0133333
NODE_912_length_2479_cov_90.381092	1610	1685	603	2	75	0.0266667
NODE_912_length_2479_cov_90.381092	1610	1685	605	3	75	0.0400000
NODE_912_length_2479_cov_90.381092	1610	1685	606	1	75	0.0133333
NODE_912_length_2479_cov_90.381092	1610	1685	609	1	75	0.0133333
NODE_912_length_2479_cov_90.381092	1610	1685	611	2	75	0.0266667
NODE_912_length_2479_cov_90.381092	1610	1685	615	2	75	0.0266667
NODE_912_length_2479_cov_90.381092	1610	1685	617	1	75	0.0133333
NODE_912_length_2479_cov_90.381092	1658	1730	536	1	72	0.0138889
NODE_912_length_2479_cov_90.381092	1658	1730	538	1	72	0.0138889
NODE_912_length_2479_cov_90.381092	1658	1730	542	1	72	0.0138889
NODE_912_length_2479_cov_90.381092	1658	1730	549	1	72	0.0138889
NODE_912_length_2479_cov_90.381092	1658	1730	551	1	72	0.0138889
NODE_912_length_2479_cov_90.381092	1658	1730	552	2	72	0.0277778
NODE_912_length_2479_cov_90.381092	1658	1730	567	1	72	0.0138889
NODE_912_length_2479_cov_90.381092	1658	1730	577	1	72	0.0138889
NODE_912_length_2479_cov_90.381092	1658	1730	590	1	72	0.0138889
NODE_912_length_2479_cov_90.381092	1658	1730	591	2	72	0.0277778
NODE_912_length_2479_cov_90.381092	1658	1730	592	1	72	0.0138889
NODE_912_length_2479_cov_90.381092	1658	1730	599	1	72	0.0138889
NODE_912_length_2479_cov_90.381092	1658	1730	600	1	72	0.0138889
NODE_912_length_2479_cov_90.381092	1658	1730	603	2	72	0.0277778
NODE_912_length_2479_cov_90.381092	1658	1730	605	3	72	0.0416667
NODE_912_length_2479_cov_90.381092	1658	1730	606	1	72	0.0138889
NODE_912_length_2479_cov_90.381092	1658	1730	609	1	72	0.0138889
NODE_912_length_2479_cov_90.381092	1658	1730	610	1	72	0.0138889
NODE_912_length_2479_cov_90.381092	1658	1730	611	3	72	0.0416667
NODE_912_length_2479_cov_90.381092	1658	1730	612	2	72	0.0277778
NODE_912_length_2479_cov_90.381092	1658	1730	613	1	72	0.0138889
NODE_912_length_2479_cov_90.381092	1658	1730	615	4	72	0.0555556
NODE_912_length_2479_cov_90.381092	1658	1730	617	4	72	0.0555556
NODE_912_length_2479_cov_90.381092	1658	1730	619	3	72	0.0416667
NODE_912_length_2479_cov_90.381092	1658	1730	621	2	72	0.0277778
NODE_912_length_2479_cov_90.381092	1658	1730	622	1	72	0.0138889
NODE_912_length_2479_cov_90.381092	1658	1730	623	2	72	0.0277778
NODE_912_length_2479_cov_90.381092	1658	1730	624	3	72	0.0416667
NODE_912_length_2479_cov_90.381092	1658	1730	625	1	72	0.0138889
NODE_912_length_2479_cov_90.381092	1658	1730	627	1	72	0.0138889
NODE_912_length_2479_cov_90.381092	1658	1730	629	2	72	0.0277778
NODE_912_length_2479_cov_90.381092	1658	1730	630	1	72	0.0138889
NODE_912_length_2479_cov_90.381092	1658	1730	631	3	72	0.0416667
NODE_912_length_2479_cov_90.381092	1658	1730	632	1	72	0.0138889
NODE_912_length_2479_cov_90.381092	1658	1730	635	2	72	0.0277778
NODE_912_length_2479_cov_90.381092	1658	1730	636	2	72	0.0277778
NODE_912_length_2479_cov_90.381092	1658	1730	637	1	72	0.0138889
NODE_912_length_2479_cov_90.381092	1658	1730	639	1	72	0.0138889
NODE_912_length_2479_cov_90.381092	1658	1730	641	1	72	0.0138889
NODE_912_length_2479_cov_90.381092	1658	1730	644	1	72	0.0138889
NODE_912_length_2479_cov_90.381092	1658	1730	645	1	72	0.0138889
NODE_912_length_2479_cov_90.381092	1658	1730	647	3	72	0.0416667
NODE_912_length_2479_cov_90.381092	1658	1730	649	1	72	0.0138889
NODE_912_length_2479_cov_90.381092	1658	1730	651	1	72	0.0138889
NODE_912_length_2479_cov_90.381092	1658	1730	653	1	72	0.0138889
NODE_913_length_2479_cov_3.433193	2379	2426	0	46	47	0.9787234
NODE_913_length_2479_cov_3.433193	2379	2426	2	1	47	0.0212766
NODE_913_length_2479_cov_3.433193	2399	2479	0	80	80	1.0000000
NODE_915_length_2474_cov_7.237895	399	479	0	80	80	1.0000000
NODE_915_length_2474_cov_7.237895	452	532	0	80	80	1.0000000
NODE_922_length_2465_cov_3.098056	2133	2213	8	42	80	0.5250000
NODE_922_length_2465_cov_3.098056	2133	2213	10	38	80	0.4750000
NODE_922_length_2465_cov_3.098056	2191	2253	10	62	62	1.0000000
NODE_923_length_2464_cov_24.562791	331	409	0	78	78	1.0000000
NODE_923_length_2464_cov_24.562791	382	462	0	80	80	1.0000000
NODE_924_length_2461_cov_2.696444	292	372	0	80	80	1.0000000
NODE_924_length_2461_cov_2.696444	345	425	0	80	80	1.0000000
NODE_938_length_2447_cov_16.079216	2344	2424	39	1	80	0.0125000
NODE_938_length_2447_cov_16.079216	2344	2424	43	1	80	0.0125000
NODE_938_length_2447_cov_16.079216	2344	2424	47	5	80	0.0625000
NODE_938_length_2447_cov_16.079216	2344	2424	51	3	80	0.0375000
NODE_938_length_2447_cov_16.079216	2344	2424	53	1	80	0.0125000
NODE_938_length_2447_cov_16.079216	2344	2424	55	1	80	0.0125000
NODE_938_length_2447_cov_16.079216	2344	2424	59	1	80	0.0125000
NODE_938_length_2447_cov_16.079216	2344	2424	61	1	80	0.0125000
NODE_938_length_2447_cov_16.079216	2344	2424	63	2	80	0.0250000
NODE_938_length_2447_cov_16.079216	2344	2424	67	3	80	0.0375000
NODE_938_length_2447_cov_16.079216	2344	2424	69	3	80	0.0375000
NODE_938_length_2447_cov_16.079216	2344	2424	71	5	80	0.0625000
NODE_938_length_2447_cov_16.079216	2344	2424	77	2	80	0.0250000
NODE_938_length_2447_cov_16.079216	2344	2424	78	1	80	0.0125000
NODE_938_length_2447_cov_16.079216	2344	2424	79	2	80	0.0250000
NODE_938_length_2447_cov_16.079216	2344	2424	81	2	80	0.0250000
NODE_938_length_2447_cov_16.079216	2344	2424	83	12	80	0.1500000
NODE_938_length_2447_cov_16.079216	2344	2424	93	12	80	0.1500000
NODE_938_length_2447_cov_16.079216	2344	2424	97	3	80	0.0375000
NODE_938_length_2447_cov_16.079216	2344	2424	99	4	80	0.0500000
NODE_938_length_2447_cov_16.079216	2344	2424	101	1	80	0.0125000
NODE_938_length_2447_cov_16.079216	2344	2424	105	2	80	0.0250000
NODE_938_length_2447_cov_16.079216	2344	2424	109	3	80	0.0375000
NODE_938_length_2447_cov_16.079216	2344	2424	111	1	80	0.0125000
NODE_938_length_2447_cov_16.079216	2344	2424	117	5	80	0.0625000
NODE_938_length_2447_cov_16.079216	2344	2424	119	3	80	0.0375000
NODE_938_length_2447_cov_16.079216	2397	2447	28	4	50	0.0800000
NODE_938_length_2447_cov_16.079216	2397	2447	32	1	50	0.0200000
NODE_938_length_2447_cov_16.079216	2397	2447	34	1	50	0.0200000
NODE_938_length_2447_cov_16.079216	2397	2447	36	4	50	0.0800000
NODE_938_length_2447_cov_16.079216	2397	2447	38	7	50	0.1400000
NODE_938_length_2447_cov_16.079216	2397	2447	39	7	50	0.1400000
NODE_938_length_2447_cov_16.079216	2397	2447	43	1	50	0.0200000
NODE_938_length_2447_cov_16.079216	2397	2447	47	5	50	0.1000000
NODE_938_length_2447_cov_16.079216	2397	2447	51	3	50	0.0600000
NODE_938_length_2447_cov_16.079216	2397	2447	53	1	50	0.0200000
NODE_938_length_2447_cov_16.079216	2397	2447	55	1	50	0.0200000
NODE_938_length_2447_cov_16.079216	2397	2447	59	1	50	0.0200000
NODE_938_length_2447_cov_16.079216	2397	2447	61	1	50	0.0200000
NODE_938_length_2447_cov_16.079216	2397	2447	63	2	50	0.0400000
NODE_938_length_2447_cov_16.079216	2397	2447	67	3	50	0.0600000
NODE_938_length_2447_cov_16.079216	2397	2447	69	3	50	0.0600000
NODE_938_length_2447_cov_16.079216	2397	2447	71	5	50	0.1000000
NODE_940_length_2446_cov_2.341287	1521	1578	2	10	57	0.1754386
NODE_940_length_2446_cov_2.341287	1521	1578	4	47	57	0.8245614
NODE_940_length_2446_cov_2.341287	1551	1593	2	19	42	0.4523810
NODE_940_length_2446_cov_2.341287	1551	1593	4	23	42	0.5476190
NODE_949_length_2437_cov_13.341745	418	498	4	80	80	1.0000000
NODE_949_length_2437_cov_13.341745	471	551	0	32	80	0.4000000
NODE_949_length_2437_cov_13.341745	471	551	1	1	80	0.0125000
NODE_949_length_2437_cov_13.341745	471	551	2	3	80	0.0375000
NODE_949_length_2437_cov_13.341745	471	551	3	1	80	0.0125000
NODE_949_length_2437_cov_13.341745	471	551	4	38	80	0.4750000
NODE_949_length_2437_cov_13.341745	471	551	6	1	80	0.0125000
NODE_949_length_2437_cov_13.341745	471	551	11	2	80	0.0250000
NODE_949_length_2437_cov_13.341745	471	551	14	1	80	0.0125000
NODE_949_length_2437_cov_13.341745	471	551	18	1	80	0.0125000
NODE_951_length_2432_cov_70.360909	1875	1955	0	80	80	1.0000000
NODE_951_length_2432_cov_70.360909	1928	2008	0	80	80	1.0000000
NODE_955_length_2430_cov_19.835264	0	68	34	1	68	0.0147059
NODE_955_length_2430_cov_19.835264	0	68	38	2	68	0.0294118
NODE_955_length_2430_cov_19.835264	0	68	44	1	68	0.0147059
NODE_955_length_2430_cov_19.835264	0	68	47	1	68	0.0147059
NODE_955_length_2430_cov_19.835264	0	68	49	2	68	0.0294118
NODE_955_length_2430_cov_19.835264	0	68	50	3	68	0.0441176
NODE_955_length_2430_cov_19.835264	0	68	56	1	68	0.0147059
NODE_955_length_2430_cov_19.835264	0	68	58	1	68	0.0147059
NODE_955_length_2430_cov_19.835264	0	68	60	1	68	0.0147059
NODE_955_length_2430_cov_19.835264	0	68	62	1	68	0.0147059
NODE_955_length_2430_cov_19.835264	0	68	64	1	68	0.0147059
NODE_955_length_2430_cov_19.835264	0	68	68	2	68	0.0294118
NODE_955_length_2430_cov_19.835264	0	68	70	1	68	0.0147059
NODE_955_length_2430_cov_19.835264	0	68	76	2	68	0.0294118
NODE_955_length_2430_cov_19.835264	0	68	77	3	68	0.0441176
NODE_955_length_2430_cov_19.835264	0	68	86	1	68	0.0147059
NODE_955_length_2430_cov_19.835264	0	68	92	1	68	0.0147059
NODE_955_length_2430_cov_19.835264	0	68	99	1	68	0.0147059
NODE_955_length_2430_cov_19.835264	0	68	101	2	68	0.0294118
NODE_955_length_2430_cov_19.835264	0	68	102	1	68	0.0147059
NODE_955_length_2430_cov_19.835264	0	68	104	3	68	0.0441176
NODE_955_length_2430_cov_19.835264	0	68	106	2	68	0.0294118
NODE_955_length_2430_cov_19.835264	0	68	108	1	68	0.0147059
NODE_955_length_2430_cov_19.835264	0	68	109	1	68	0.0147059
NODE_955_length_2430_cov_19.835264	0	68	112	4	68	0.0588235
NODE_955_length_2430_cov_19.835264	0	68	113	3	68	0.0441176
NODE_955_length_2430_cov_19.835264	0	68	114	4	68	0.0588235
NODE_955_length_2430_cov_19.835264	0	68	120	2	68	0.0294118
NODE_955_length_2430_cov_19.835264	0	68	123	2	68	0.0294118
NODE_955_length_2430_cov_19.835264	0	68	125	4	68	0.0588235
NODE_955_length_2430_cov_19.835264	0	68	129	1	68	0.0147059
NODE_955_length_2430_cov_19.835264	0	68	131	1	68	0.0147059
NODE_955_length_2430_cov_19.835264	0	68	136	2	68	0.0294118
NODE_955_length_2430_cov_19.835264	0	68	142	1	68	0.0147059
NODE_955_length_2430_cov_19.835264	0	68	143	1	68	0.0147059
NODE_955_length_2430_cov_19.835264	0	68	151	3	68	0.0441176
NODE_955_length_2430_cov_19.835264	0	68	153	3	68	0.0441176
NODE_955_length_2430_cov_19.835264	0	68	159	1	68	0.0147059
NODE_955_length_2430_cov_19.835264	0	24	34	1	24	0.0416667
NODE_955_length_2430_cov_19.835264	0	24	38	2	24	0.0833333
NODE_955_length_2430_cov_19.835264	0	24	44	1	24	0.0416667
NODE_955_length_2430_cov_19.835264	0	24	47	1	24	0.0416667
NODE_955_length_2430_cov_19.835264	0	24	49	2	24	0.0833333
NODE_955_length_2430_cov_19.835264	0	24	50	3	24	0.1250000
NODE_955_length_2430_cov_19.835264	0	24	56	1	24	0.0416667
NODE_955_length_2430_cov_19.835264	0	24	58	1	24	0.0416667
NODE_955_length_2430_cov_19.835264	0	24	60	1	24	0.0416667
NODE_955_length_2430_cov_19.835264	0	24	62	1	24	0.0416667
NODE_955_length_2430_cov_19.835264	0	24	64	1	24	0.0416667
NODE_955_length_2430_cov_19.835264	0	24	68	2	24	0.0833333
NODE_955_length_2430_cov_19.835264	0	24	70	1	24	0.0416667
NODE_955_length_2430_cov_19.835264	0	24	76	2	24	0.0833333
NODE_955_length_2430_cov_19.835264	0	24	77	3	24	0.1250000
NODE_955_length_2430_cov_19.835264	0	24	86	1	24	0.0416667
NODE_956_length_2428_cov_179.842422	538	618	2	59	80	0.7375000
NODE_956_length_2428_cov_179.842422	538	618	4	21	80	0.2625000
NODE_956_length_2428_cov_179.842422	591	671	0	14	80	0.1750000
NODE_956_length_2428_cov_179.842422	591	671	2	66	80	0.8250000
NODE_956_length_2428_cov_179.842422	667	747	0	32	80	0.4000000
NODE_956_length_2428_cov_179.842422	667	747	5	8	80	0.1000000
NODE_956_length_2428_cov_179.842422	667	747	6	40	80	0.5000000
NODE_956_length_2428_cov_179.842422	720	800	0	23	80	0.2875000
NODE_956_length_2428_cov_179.842422	720	800	5	38	80	0.4750000
NODE_956_length_2428_cov_179.842422	720	800	6	19	80	0.2375000
NODE_956_length_2428_cov_179.842422	1308	1388	0	15	80	0.1875000
NODE_956_length_2428_cov_179.842422	1308	1388	4	6	80	0.0750000
NODE_956_length_2428_cov_179.842422	1308	1388	6	59	80	0.7375000
NODE_956_length_2428_cov_179.842422	1361	1441	0	68	80	0.8500000
NODE_956_length_2428_cov_179.842422	1361	1441	4	6	80	0.0750000
NODE_956_length_2428_cov_179.842422	1361	1441	6	6	80	0.0750000
NODE_956_length_2428_cov_179.842422	1437	1517	0	80	80	1.0000000
NODE_956_length_2428_cov_179.842422	1490	1570	0	80	80	1.0000000
NODE_956_length_2428_cov_179.842422	1986	2026	1049	1	40	0.0250000
NODE_956_length_2428_cov_179.842422	1986	2026	1050	1	40	0.0250000
NODE_956_length_2428_cov_179.842422	1986	2026	1056	1	40	0.0250000
NODE_956_length_2428_cov_179.842422	1986	2026	1058	2	40	0.0500000
NODE_956_length_2428_cov_179.842422	1986	2026	1059	2	40	0.0500000
NODE_956_length_2428_cov_179.842422	1986	2026	1060	2	40	0.0500000
NODE_956_length_2428_cov_179.842422	1986	2026	1061	2	40	0.0500000
NODE_956_length_2428_cov_179.842422	1986	2026	1063	1	40	0.0250000
NODE_956_length_2428_cov_179.842422	1986	2026	1064	1	40	0.0250000
NODE_956_length_2428_cov_179.842422	1986	2026	1066	3	40	0.0750000
NODE_956_length_2428_cov_179.842422	1986	2026	1067	2	40	0.0500000
NODE_956_length_2428_cov_179.842422	1986	2026	1070	1	40	0.0250000
NODE_956_length_2428_cov_179.842422	1986	2026	1073	1	40	0.0250000
NODE_956_length_2428_cov_179.842422	1986	2026	1074	1	40	0.0250000
NODE_956_length_2428_cov_179.842422	1986	2026	1095	1	40	0.0250000
NODE_956_length_2428_cov_179.842422	1986	2026	1097	1	40	0.0250000
NODE_956_length_2428_cov_179.842422	1986	2026	1098	1	40	0.0250000
NODE_956_length_2428_cov_179.842422	1986	2026	1101	1	40	0.0250000
NODE_956_length_2428_cov_179.842422	1986	2026	1103	1	40	0.0250000
NODE_956_length_2428_cov_179.842422	1986	2026	1108	1	40	0.0250000
NODE_956_length_2428_cov_179.842422	1986	2026	1109	1	40	0.0250000
NODE_956_length_2428_cov_179.842422	1986	2026	1112	1	40	0.0250000
NODE_956_length_2428_cov_179.842422	1986	2026	1113	1	40	0.0250000
NODE_956_length_2428_cov_179.842422	1986	2026	1129	1	40	0.0250000
NODE_956_length_2428_cov_179.842422	1986	2026	1130	1	40	0.0250000
NODE_956_length_2428_cov_179.842422	1986	2026	1140	1	40	0.0250000
NODE_956_length_2428_cov_179.842422	1986	2026	1141	1	40	0.0250000
NODE_956_length_2428_cov_179.842422	1986	2026	1142	1	40	0.0250000
NODE_956_length_2428_cov_179.842422	1986	2026	1157	1	40	0.0250000
NODE_956_length_2428_cov_179.842422	1986	2026	1159	1	40	0.0250000
NODE_956_length_2428_cov_179.842422	1986	2026	1166	1	40	0.0250000
NODE_956_length_2428_cov_179.842422	1986	2026	1171	1	40	0.0250000
NODE_956_length_2428_cov_179.842422	1986	2026	1176	1	40	0.0250000
NODE_959_length_2422_cov_6.665088	197	255	0	56	58	0.9655172
NODE_959_length_2422_cov_6.665088	197	255	3	2	58	0.0344828
NODE_963_length_2414_cov_32.871706	411	491	0	80	80	1.0000000
NODE_963_length_2414_cov_32.871706	464	544	0	80	80	1.0000000
NODE_964_length_2414_cov_2.105832	2349	2390	0	41	41	1.0000000
NODE_968_length_2410_cov_9.107313	1874	1954	0	80	80	1.0000000
NODE_968_length_2410_cov_9.107313	1927	2007	0	27	80	0.3375000
NODE_968_length_2410_cov_9.107313	1927	2007	4	53	80	0.6625000
NODE_977_length_2390_cov_20.371454	1753	1833	0	80	80	1.0000000
NODE_977_length_2390_cov_20.371454	1806	1886	0	80	80	1.0000000
NODE_979_length_2389_cov_17.904803	1601	1681	0	15	80	0.1875000
NODE_979_length_2389_cov_17.904803	1601	1681	6	65	80	0.8125000
NODE_979_length_2389_cov_17.904803	1654	1734	4	6	80	0.0750000
NODE_979_length_2389_cov_17.904803	1654	1734	6	33	80	0.4125000
NODE_979_length_2389_cov_17.904803	1654	1734	10	41	80	0.5125000
NODE_979_length_2389_cov_17.904803	1730	1810	0	21	80	0.2625000
NODE_979_length_2389_cov_17.904803	1730	1810	4	59	80	0.7375000
NODE_979_length_2389_cov_17.904803	1783	1863	0	74	80	0.9250000
NODE_979_length_2389_cov_17.904803	1783	1863	4	6	80	0.0750000
NODE_988_length_2381_cov_32.280894	398	478	0	80	80	1.0000000
NODE_988_length_2381_cov_32.280894	451	531	0	59	80	0.7375000
NODE_988_length_2381_cov_32.280894	451	531	2	21	80	0.2625000
NODE_988_length_2381_cov_32.280894	527	607	2	42	80	0.5250000
NODE_988_length_2381_cov_32.280894	527	607	4	38	80	0.4750000
NODE_988_length_2381_cov_32.280894	580	660	0	17	80	0.2125000
NODE_988_length_2381_cov_32.280894	580	660	2	48	80	0.6000000
NODE_988_length_2381_cov_32.280894	580	660	4	15	80	0.1875000
NODE_988_length_2381_cov_32.280894	2288	2368	0	5	80	0.0625000
NODE_988_length_2381_cov_32.280894	2288	2368	1	14	80	0.1750000
NODE_988_length_2381_cov_32.280894	2288	2368	2	61	80	0.7625000
NODE_997_length_2369_cov_4.896916	241	321	0	80	80	1.0000000
NODE_997_length_2369_cov_4.896916	294	374	0	80	80	1.0000000
NODE_1002_length_2364_cov_2.482561	0	79	0	79	79	1.0000000
NODE_1004_length_2360_cov_8.620080	587	651	53	5	64	0.0781250
NODE_1004_length_2360_cov_8.620080	587	651	55	1	64	0.0156250
NODE_1004_length_2360_cov_8.620080	587	651	57	2	64	0.0312500
NODE_1004_length_2360_cov_8.620080	587	651	61	4	64	0.0625000
NODE_1004_length_2360_cov_8.620080	587	651	63	3	64	0.0468750
NODE_1004_length_2360_cov_8.620080	587	651	68	8	64	0.1250000
NODE_1004_length_2360_cov_8.620080	587	651	70	21	64	0.3281250
NODE_1004_length_2360_cov_8.620080	587	651	72	20	64	0.3125000
NODE_1004_length_2360_cov_8.620080	587	651	53	5	64	0.0781250
NODE_1004_length_2360_cov_8.620080	587	651	55	1	64	0.0156250
NODE_1004_length_2360_cov_8.620080	587	651	57	2	64	0.0312500
NODE_1004_length_2360_cov_8.620080	587	651	61	4	64	0.0625000
NODE_1004_length_2360_cov_8.620080	587	651	63	3	64	0.0468750
NODE_1004_length_2360_cov_8.620080	587	651	68	8	64	0.1250000
NODE_1004_length_2360_cov_8.620080	587	651	70	21	64	0.3281250
NODE_1004_length_2360_cov_8.620080	587	651	72	20	64	0.3125000
NODE_1004_length_2360_cov_8.620080	624	684	16	12	60	0.2000000
NODE_1004_length_2360_cov_8.620080	624	684	20	3	60	0.0500000
NODE_1004_length_2360_cov_8.620080	624	684	22	3	60	0.0500000
NODE_1004_length_2360_cov_8.620080	624	684	24	1	60	0.0166667
NODE_1004_length_2360_cov_8.620080	624	684	28	1	60	0.0166667
NODE_1004_length_2360_cov_8.620080	624	684	29	2	60	0.0333333
NODE_1004_length_2360_cov_8.620080	624	684	41	1	60	0.0166667
NODE_1004_length_2360_cov_8.620080	624	684	43	1	60	0.0166667
NODE_1004_length_2360_cov_8.620080	624	684	45	3	60	0.0500000
NODE_1004_length_2360_cov_8.620080	624	684	47	3	60	0.0500000
NODE_1004_length_2360_cov_8.620080	624	684	51	2	60	0.0333333
NODE_1004_length_2360_cov_8.620080	624	684	53	6	60	0.1000000
NODE_1004_length_2360_cov_8.620080	624	684	55	1	60	0.0166667
NODE_1004_length_2360_cov_8.620080	624	684	57	2	60	0.0333333
NODE_1004_length_2360_cov_8.620080	624	684	61	4	60	0.0666667
NODE_1004_length_2360_cov_8.620080	624	684	63	3	60	0.0500000
NODE_1004_length_2360_cov_8.620080	624	684	68	7	60	0.1166667
NODE_1004_length_2360_cov_8.620080	624	684	72	5	60	0.0833333
NODE_1004_length_2360_cov_8.620080	1827	1907	0	80	80	1.0000000
NODE_1004_length_2360_cov_8.620080	1880	1960	0	80	80	1.0000000
NODE_1005_length_2359_cov_22.317257	958	1038	0	5	80	0.0625000
NODE_1005_length_2359_cov_22.317257	958	1038	2	75	80	0.9375000
NODE_1005_length_2359_cov_22.317257	1011	1091	0	44	80	0.5500000
NODE_1005_length_2359_cov_22.317257	1011	1091	2	36	80	0.4500000
NODE_1008_length_2357_cov_25.711249	716	796	4	52	80	0.6500000
NODE_1008_length_2357_cov_25.711249	716	796	8	24	80	0.3000000
NODE_1008_length_2357_cov_25.711249	716	796	11	1	80	0.0125000
NODE_1008_length_2357_cov_25.711249	716	796	12	3	80	0.0375000
NODE_1008_length_2357_cov_25.711249	769	849	4	12	80	0.1500000
NODE_1008_length_2357_cov_25.711249	769	849	8	48	80	0.6000000
NODE_1008_length_2357_cov_25.711249	769	849	11	1	80	0.0125000
NODE_1008_length_2357_cov_25.711249	769	849	12	19	80	0.2375000
NODE_1015_length_2345_cov_5.386465	1845	1925	0	53	80	0.6625000
NODE_1015_length_2345_cov_5.386465	1845	1925	4	27	80	0.3375000
NODE_1015_length_2345_cov_5.386465	1898	1978	4	80	80	1.0000000
NODE_1016_length_2344_cov_6.236526	1208	1269	4	14	61	0.2295082
NODE_1016_length_2344_cov_6.236526	1208	1269	8	7	61	0.1147541
NODE_1016_length_2344_cov_6.236526	1208	1269	10	40	61	0.6557377
NODE_1016_length_2344_cov_6.236526	1208	1269	4	14	61	0.2295082
NODE_1016_length_2344_cov_6.236526	1208	1269	8	7	61	0.1147541
NODE_1016_length_2344_cov_6.236526	1208	1269	10	40	61	0.6557377
NODE_1016_length_2344_cov_6.236526	1208	1269	4	14	61	0.2295082
NODE_1016_length_2344_cov_6.236526	1208	1269	8	7	61	0.1147541
NODE_1016_length_2344_cov_6.236526	1208	1269	10	40	61	0.6557377
NODE_1016_length_2344_cov_6.236526	1208	1267	4	12	59	0.2033898
NODE_1016_length_2344_cov_6.236526	1208	1267	8	7	59	0.1186441
NODE_1016_length_2344_cov_6.236526	1208	1267	10	40	59	0.6779661
NODE_1023_length_2332_cov_4.725929	34	101	0	65	67	0.9701493
NODE_1023_length_2332_cov_4.725929	34	101	10	2	67	0.0298507
NODE_1027_length_2327_cov_18.210952	2213	2293	0	16	80	0.2000000
NODE_1027_length_2327_cov_18.210952	2213	2293	2	30	80	0.3750000
NODE_1027_length_2327_cov_18.210952	2213	2293	4	17	80	0.2125000
NODE_1027_length_2327_cov_18.210952	2213	2293	6	5	80	0.0625000
NODE_1027_length_2327_cov_18.210952	2213	2293	8	12	80	0.1500000
NODE_1027_length_2327_cov_18.210952	2266	2327	4	10	61	0.1639344
NODE_1027_length_2327_cov_18.210952	2266	2327	6	39	61	0.6393443
NODE_1027_length_2327_cov_18.210952	2266	2327	8	12	61	0.1967213
NODE_1028_length_2326_cov_15.583745	1709	1789	0	55	80	0.6875000
NODE_1028_length_2326_cov_15.583745	1709	1789	1	14	80	0.1750000
NODE_1028_length_2326_cov_15.583745	1709	1789	2	11	80	0.1375000
NODE_1028_length_2326_cov_15.583745	1762	1842	0	2	80	0.0250000
NODE_1028_length_2326_cov_15.583745	1762	1842	1	14	80	0.1750000
NODE_1028_length_2326_cov_15.583745	1762	1842	2	14	80	0.1750000
NODE_1028_length_2326_cov_15.583745	1762	1842	3	49	80	0.6125000
NODE_1028_length_2326_cov_15.583745	1762	1842	4	1	80	0.0125000
NODE_1030_length_2325_cov_14.998652	553	633	0	80	80	1.0000000
NODE_1030_length_2325_cov_14.998652	606	686	0	80	80	1.0000000
NODE_1034_length_2317_cov_11.956718	920	1000	4	80	80	1.0000000
NODE_1034_length_2317_cov_11.956718	973	1053	0	30	80	0.3750000
NODE_1034_length_2317_cov_11.956718	973	1053	2	4	80	0.0500000
NODE_1034_length_2317_cov_11.956718	973	1053	4	46	80	0.5750000
NODE_1034_length_2317_cov_11.956718	1049	1129	2	45	80	0.5625000
NODE_1034_length_2317_cov_11.956718	1049	1129	4	25	80	0.3125000
NODE_1034_length_2317_cov_11.956718	1049	1129	6	10	80	0.1250000
NODE_1034_length_2317_cov_11.956718	1102	1184	2	18	82	0.2195122
NODE_1034_length_2317_cov_11.956718	1102	1184	4	28	82	0.3414634
NODE_1034_length_2317_cov_11.956718	1102	1184	6	36	82	0.4390244
NODE_1037_length_2316_cov_8.556608	168	247	100	1	79	0.0126582
NODE_1037_length_2316_cov_8.556608	168	247	101	1	79	0.0126582
NODE_1037_length_2316_cov_8.556608	168	247	104	2	79	0.0253165
NODE_1037_length_2316_cov_8.556608	168	247	106	3	79	0.0379747
NODE_1037_length_2316_cov_8.556608	168	247	107	2	79	0.0253165
NODE_1037_length_2316_cov_8.556608	168	247	109	2	79	0.0253165
NODE_1037_length_2316_cov_8.556608	168	247	115	2	79	0.0253165
NODE_1037_length_2316_cov_8.556608	168	247	117	2	79	0.0253165
NODE_1037_length_2316_cov_8.556608	168	247	121	1	79	0.0126582
NODE_1037_length_2316_cov_8.556608	168	247	127	4	79	0.0506329
NODE_1037_length_2316_cov_8.556608	168	247	129	4	79	0.0506329
NODE_1037_length_2316_cov_8.556608	168	247	130	1	79	0.0126582
NODE_1037_length_2316_cov_8.556608	168	247	131	2	79	0.0253165
NODE_1037_length_2316_cov_8.556608	168	247	132	1	79	0.0126582
NODE_1037_length_2316_cov_8.556608	168	247	133	1	79	0.0126582
NODE_1037_length_2316_cov_8.556608	168	247	134	1	79	0.0126582
NODE_1037_length_2316_cov_8.556608	168	247	135	3	79	0.0379747
NODE_1037_length_2316_cov_8.556608	168	247	143	2	79	0.0253165
NODE_1037_length_2316_cov_8.556608	168	247	146	1	79	0.0126582
NODE_1037_length_2316_cov_8.556608	168	247	147	2	79	0.0253165
NODE_1037_length_2316_cov_8.556608	168	247	151	1	79	0.0126582
NODE_1037_length_2316_cov_8.556608	168	247	153	2	79	0.0253165
NODE_1037_length_2316_cov_8.556608	168	247	155	3	79	0.0379747
NODE_1037_length_2316_cov_8.556608	168	247	157	4	79	0.0506329
NODE_1037_length_2316_cov_8.556608	168	247	158	1	79	0.0126582
NODE_1037_length_2316_cov_8.556608	168	247	159	11	79	0.1392405
NODE_1037_length_2316_cov_8.556608	168	247	160	5	79	0.0632911
NODE_1037_length_2316_cov_8.556608	168	247	161	4	79	0.0506329
NODE_1037_length_2316_cov_8.556608	168	247	162	7	79	0.0886076
NODE_1037_length_2316_cov_8.556608	168	247	164	3	79	0.0379747
NODE_1037_length_2316_cov_8.556608	1117	1198	21	1	81	0.0123457
NODE_1037_length_2316_cov_8.556608	1117	1198	22	4	81	0.0493827
NODE_1037_length_2316_cov_8.556608	1117	1198	24	3	81	0.0370370
NODE_1037_length_2316_cov_8.556608	1117	1198	26	3	81	0.0370370
NODE_1037_length_2316_cov_8.556608	1117	1198	28	5	81	0.0617284
NODE_1037_length_2316_cov_8.556608	1117	1198	34	1	81	0.0123457
NODE_1037_length_2316_cov_8.556608	1117	1198	36	1	81	0.0123457
NODE_1037_length_2316_cov_8.556608	1117	1198	38	2	81	0.0246914
NODE_1037_length_2316_cov_8.556608	1117	1198	40	3	81	0.0370370
NODE_1037_length_2316_cov_8.556608	1117	1198	42	10	81	0.1234568
NODE_1037_length_2316_cov_8.556608	1117	1198	46	2	81	0.0246914
NODE_1037_length_2316_cov_8.556608	1117	1198	48	1	81	0.0123457
NODE_1037_length_2316_cov_8.556608	1117	1198	51	1	81	0.0123457
NODE_1037_length_2316_cov_8.556608	1117	1198	52	1	81	0.0123457
NODE_1037_length_2316_cov_8.556608	1117	1198	54	4	81	0.0493827
NODE_1037_length_2316_cov_8.556608	1117	1198	57	2	81	0.0246914
NODE_1037_length_2316_cov_8.556608	1117	1198	61	1	81	0.0123457
NODE_1037_length_2316_cov_8.556608	1117	1198	63	1	81	0.0123457
NODE_1037_length_2316_cov_8.556608	1117	1198	69	3	81	0.0370370
NODE_1037_length_2316_cov_8.556608	1117	1198	71	5	81	0.0617284
NODE_1037_length_2316_cov_8.556608	1117	1198	73	2	81	0.0246914
NODE_1037_length_2316_cov_8.556608	1117	1198	76	2	81	0.0246914
NODE_1037_length_2316_cov_8.556608	1117	1198	77	2	81	0.0246914
NODE_1037_length_2316_cov_8.556608	1117	1198	78	8	81	0.0987654
NODE_1037_length_2316_cov_8.556608	1117	1198	79	5	81	0.0617284
NODE_1037_length_2316_cov_8.556608	1117	1198	80	3	81	0.0370370
NODE_1037_length_2316_cov_8.556608	1117	1198	81	5	81	0.0617284
NODE_1037_length_2316_cov_8.556608	1369	1412	174	3	43	0.0697674
NODE_1037_length_2316_cov_8.556608	1369	1412	176	9	43	0.2093023
NODE_1037_length_2316_cov_8.556608	1369	1412	177	1	43	0.0232558
NODE_1037_length_2316_cov_8.556608	1369	1412	178	1	43	0.0232558
NODE_1037_length_2316_cov_8.556608	1369	1412	188	2	43	0.0465116
NODE_1037_length_2316_cov_8.556608	1369	1412	201	2	43	0.0465116
NODE_1037_length_2316_cov_8.556608	1369	1412	212	1	43	0.0232558
NODE_1037_length_2316_cov_8.556608	1369	1412	213	1	43	0.0232558
NODE_1037_length_2316_cov_8.556608	1369	1412	217	1	43	0.0232558
NODE_1037_length_2316_cov_8.556608	1369	1412	220	4	43	0.0930233
NODE_1037_length_2316_cov_8.556608	1369	1412	222	6	43	0.1395349
NODE_1037_length_2316_cov_8.556608	1369	1412	223	2	43	0.0465116
NODE_1037_length_2316_cov_8.556608	1369	1412	224	2	43	0.0465116
NODE_1037_length_2316_cov_8.556608	1369	1412	225	1	43	0.0232558
NODE_1037_length_2316_cov_8.556608	1369	1412	228	2	43	0.0465116
NODE_1037_length_2316_cov_8.556608	1369	1412	236	2	43	0.0465116
NODE_1037_length_2316_cov_8.556608	1369	1412	241	1	43	0.0232558
NODE_1037_length_2316_cov_8.556608	1369	1412	245	2	43	0.0465116
NODE_1040_length_2311_cov_2.821881	2121	2201	6	3	80	0.0375000
NODE_1040_length_2311_cov_2.821881	2121	2201	7	2	80	0.0250000
NODE_1040_length_2311_cov_2.821881	2121	2201	8	17	80	0.2125000
NODE_1040_length_2311_cov_2.821881	2121	2201	9	6	80	0.0750000
NODE_1040_length_2311_cov_2.821881	2121	2201	10	52	80	0.6500000
NODE_1040_length_2311_cov_2.821881	2174	2225	4	2	51	0.0392157
NODE_1040_length_2311_cov_2.821881	2174	2225	6	25	51	0.4901961
NODE_1040_length_2311_cov_2.821881	2174	2225	9	2	51	0.0392157
NODE_1040_length_2311_cov_2.821881	2174	2225	10	22	51	0.4313726
NODE_1044_length_2306_cov_17.347984	995	1075	0	42	80	0.5250000
NODE_1044_length_2306_cov_17.347984	995	1075	4	38	80	0.4750000
NODE_1044_length_2306_cov_17.347984	1048	1128	0	12	80	0.1500000
NODE_1044_length_2306_cov_17.347984	1048	1128	4	68	80	0.8500000
NODE_1052_length_2300_cov_9.803271	934	1014	0	27	80	0.3375000
NODE_1052_length_2300_cov_9.803271	934	1014	2	53	80	0.6625000
NODE_1052_length_2300_cov_9.803271	1892	1965	0	69	73	0.9452055
NODE_1052_length_2300_cov_9.803271	1892	1965	2	4	73	0.0547945
NODE_1059_length_2289_cov_17.807306	968	1026	305	2	58	0.0344828
NODE_1059_length_2289_cov_17.807306	968	1026	308	3	58	0.0517241
NODE_1059_length_2289_cov_17.807306	968	1026	309	3	58	0.0517241
NODE_1059_length_2289_cov_17.807306	968	1026	310	3	58	0.0517241
NODE_1059_length_2289_cov_17.807306	968	1026	312	1	58	0.0172414
NODE_1059_length_2289_cov_17.807306	968	1026	320	1	58	0.0172414
NODE_1059_length_2289_cov_17.807306	968	1026	321	1	58	0.0172414
NODE_1059_length_2289_cov_17.807306	968	1026	322	1	58	0.0172414
NODE_1059_length_2289_cov_17.807306	968	1026	323	3	58	0.0517241
NODE_1059_length_2289_cov_17.807306	968	1026	327	4	58	0.0689655
NODE_1059_length_2289_cov_17.807306	968	1026	328	2	58	0.0344828
NODE_1059_length_2289_cov_17.807306	968	1026	329	2	58	0.0344828
NODE_1059_length_2289_cov_17.807306	968	1026	330	3	58	0.0517241
NODE_1059_length_2289_cov_17.807306	968	1026	331	1	58	0.0172414
NODE_1059_length_2289_cov_17.807306	968	1026	332	4	58	0.0689655
NODE_1059_length_2289_cov_17.807306	968	1026	334	1	58	0.0172414
NODE_1059_length_2289_cov_17.807306	968	1026	335	1	58	0.0172414
NODE_1059_length_2289_cov_17.807306	968	1026	336	1	58	0.0172414
NODE_1059_length_2289_cov_17.807306	968	1026	340	1	58	0.0172414
NODE_1059_length_2289_cov_17.807306	968	1026	342	2	58	0.0344828
NODE_1059_length_2289_cov_17.807306	968	1026	346	1	58	0.0172414
NODE_1059_length_2289_cov_17.807306	968	1026	350	1	58	0.0172414
NODE_1059_length_2289_cov_17.807306	968	1026	355	1	58	0.0172414
NODE_1059_length_2289_cov_17.807306	968	1026	359	2	58	0.0344828
NODE_1059_length_2289_cov_17.807306	968	1026	361	3	58	0.0517241
NODE_1059_length_2289_cov_17.807306	968	1026	363	1	58	0.0172414
NODE_1059_length_2289_cov_17.807306	968	1026	365	4	58	0.0689655
NODE_1059_length_2289_cov_17.807306	968	1026	367	2	58	0.0344828
NODE_1059_length_2289_cov_17.807306	968	1026	369	3	58	0.0517241
NODE_1059_length_2289_cov_17.807306	1021	1079	186	1	58	0.0172414
NODE_1059_length_2289_cov_17.807306	1021	1079	187	1	58	0.0172414
NODE_1059_length_2289_cov_17.807306	1021	1079	198	1	58	0.0172414
NODE_1059_length_2289_cov_17.807306	1021	1079	199	1	58	0.0172414
NODE_1059_length_2289_cov_17.807306	1021	1079	204	1	58	0.0172414
NODE_1059_length_2289_cov_17.807306	1021	1079	206	1	58	0.0172414
NODE_1059_length_2289_cov_17.807306	1021	1079	207	1	58	0.0172414
NODE_1059_length_2289_cov_17.807306	1021	1079	211	1	58	0.0172414
NODE_1059_length_2289_cov_17.807306	1021	1079	215	2	58	0.0344828
NODE_1059_length_2289_cov_17.807306	1021	1079	216	1	58	0.0172414
NODE_1059_length_2289_cov_17.807306	1021	1079	222	1	58	0.0172414
NODE_1059_length_2289_cov_17.807306	1021	1079	228	2	58	0.0344828
NODE_1059_length_2289_cov_17.807306	1021	1079	231	1	58	0.0172414
NODE_1059_length_2289_cov_17.807306	1021	1079	235	1	58	0.0172414
NODE_1059_length_2289_cov_17.807306	1021	1079	237	3	58	0.0517241
NODE_1059_length_2289_cov_17.807306	1021	1079	241	1	58	0.0172414
NODE_1059_length_2289_cov_17.807306	1021	1079	243	3	58	0.0517241
NODE_1059_length_2289_cov_17.807306	1021	1079	246	1	58	0.0172414
NODE_1059_length_2289_cov_17.807306	1021	1079	248	1	58	0.0172414
NODE_1059_length_2289_cov_17.807306	1021	1079	249	1	58	0.0172414
NODE_1059_length_2289_cov_17.807306	1021	1079	250	1	58	0.0172414
NODE_1059_length_2289_cov_17.807306	1021	1079	252	1	58	0.0172414
NODE_1059_length_2289_cov_17.807306	1021	1079	254	2	58	0.0344828
NODE_1059_length_2289_cov_17.807306	1021	1079	258	3	58	0.0517241
NODE_1059_length_2289_cov_17.807306	1021	1079	261	2	58	0.0344828
NODE_1059_length_2289_cov_17.807306	1021	1079	267	1	58	0.0172414
NODE_1059_length_2289_cov_17.807306	1021	1079	269	1	58	0.0172414
NODE_1059_length_2289_cov_17.807306	1021	1079	275	1	58	0.0172414
NODE_1059_length_2289_cov_17.807306	1021	1079	277	1	58	0.0172414
NODE_1059_length_2289_cov_17.807306	1021	1079	282	1	58	0.0172414
NODE_1059_length_2289_cov_17.807306	1021	1079	285	1	58	0.0172414
NODE_1059_length_2289_cov_17.807306	1021	1079	286	1	58	0.0172414
NODE_1059_length_2289_cov_17.807306	1021	1079	289	2	58	0.0344828
NODE_1059_length_2289_cov_17.807306	1021	1079	292	2	58	0.0344828
NODE_1059_length_2289_cov_17.807306	1021	1079	293	2	58	0.0344828
NODE_1059_length_2289_cov_17.807306	1021	1079	295	1	58	0.0172414
NODE_1059_length_2289_cov_17.807306	1021	1079	299	1	58	0.0172414
NODE_1059_length_2289_cov_17.807306	1021	1079	302	2	58	0.0344828
NODE_1059_length_2289_cov_17.807306	1021	1079	305	3	58	0.0517241
NODE_1059_length_2289_cov_17.807306	1021	1079	308	1	58	0.0172414
NODE_1059_length_2289_cov_17.807306	1021	1079	309	1	58	0.0172414
NODE_1059_length_2289_cov_17.807306	1021	1079	310	1	58	0.0172414
NODE_1060_length_2289_cov_7.736986	2161	2218	155	1	57	0.0175439
NODE_1060_length_2289_cov_7.736986	2161	2218	176	1	57	0.0175439
NODE_1060_length_2289_cov_7.736986	2161	2218	208	1	57	0.0175439
NODE_1060_length_2289_cov_7.736986	2161	2218	210	1	57	0.0175439
NODE_1060_length_2289_cov_7.736986	2161	2218	223	1	57	0.0175439
NODE_1060_length_2289_cov_7.736986	2161	2218	235	1	57	0.0175439
NODE_1060_length_2289_cov_7.736986	2161	2218	240	1	57	0.0175439
NODE_1060_length_2289_cov_7.736986	2161	2218	252	1	57	0.0175439
NODE_1060_length_2289_cov_7.736986	2161	2218	256	1	57	0.0175439
NODE_1060_length_2289_cov_7.736986	2161	2218	260	1	57	0.0175439
NODE_1060_length_2289_cov_7.736986	2161	2218	262	1	57	0.0175439
NODE_1060_length_2289_cov_7.736986	2161	2218	266	2	57	0.0350877
NODE_1060_length_2289_cov_7.736986	2161	2218	268	1	57	0.0175439
NODE_1060_length_2289_cov_7.736986	2161	2218	274	1	57	0.0175439
NODE_1060_length_2289_cov_7.736986	2161	2218	276	4	57	0.0701754
NODE_1060_length_2289_cov_7.736986	2161	2218	292	1	57	0.0175439
NODE_1060_length_2289_cov_7.736986	2161	2218	294	1	57	0.0175439
NODE_1060_length_2289_cov_7.736986	2161	2218	296	1	57	0.0175439
NODE_1060_length_2289_cov_7.736986	2161	2218	300	1	57	0.0175439
NODE_1060_length_2289_cov_7.736986	2161	2218	304	2	57	0.0350877
NODE_1060_length_2289_cov_7.736986	2161	2218	318	2	57	0.0350877
NODE_1060_length_2289_cov_7.736986	2161	2218	320	25	57	0.4385965
NODE_1060_length_2289_cov_7.736986	2161	2218	322	5	57	0.0877193
NODE_1060_length_2289_cov_7.736986	2191	2271	170	1	80	0.0125000
NODE_1060_length_2289_cov_7.736986	2191	2271	190	2	80	0.0250000
NODE_1060_length_2289_cov_7.736986	2191	2271	194	1	80	0.0125000
NODE_1060_length_2289_cov_7.736986	2191	2271	202	1	80	0.0125000
NODE_1060_length_2289_cov_7.736986	2191	2271	237	2	80	0.0250000
NODE_1060_length_2289_cov_7.736986	2191	2271	240	2	80	0.0250000
NODE_1060_length_2289_cov_7.736986	2191	2271	261	1	80	0.0125000
NODE_1060_length_2289_cov_7.736986	2191	2271	278	1	80	0.0125000
NODE_1060_length_2289_cov_7.736986	2191	2271	281	1	80	0.0125000
NODE_1060_length_2289_cov_7.736986	2191	2271	283	1	80	0.0125000
NODE_1060_length_2289_cov_7.736986	2191	2271	286	1	80	0.0125000
NODE_1060_length_2289_cov_7.736986	2191	2271	294	1	80	0.0125000
NODE_1060_length_2289_cov_7.736986	2191	2271	301	1	80	0.0125000
NODE_1060_length_2289_cov_7.736986	2191	2271	304	1	80	0.0125000
NODE_1060_length_2289_cov_7.736986	2191	2271	306	2	80	0.0250000
NODE_1060_length_2289_cov_7.736986	2191	2271	308	1	80	0.0125000
NODE_1060_length_2289_cov_7.736986	2191	2271	310	2	80	0.0250000
NODE_1060_length_2289_cov_7.736986	2191	2271	312	4	80	0.0500000
NODE_1060_length_2289_cov_7.736986	2191	2271	314	10	80	0.1250000
NODE_1060_length_2289_cov_7.736986	2191	2271	316	7	80	0.0875000
NODE_1060_length_2289_cov_7.736986	2191	2271	318	12	80	0.1500000
NODE_1060_length_2289_cov_7.736986	2191	2271	320	25	80	0.3125000
NODE_1061_length_2288_cov_8.539973	340	420	0	6	80	0.0750000
NODE_1061_length_2288_cov_8.539973	340	420	2	3	80	0.0375000
NODE_1061_length_2288_cov_8.539973	340	420	4	6	80	0.0750000
NODE_1061_length_2288_cov_8.539973	340	420	6	26	80	0.3250000
NODE_1061_length_2288_cov_8.539973	340	420	8	12	80	0.1500000
NODE_1061_length_2288_cov_8.539973	340	420	29	3	80	0.0375000
NODE_1061_length_2288_cov_8.539973	340	420	33	1	80	0.0125000
NODE_1061_length_2288_cov_8.539973	340	420	35	7	80	0.0875000
NODE_1061_length_2288_cov_8.539973	340	420	39	10	80	0.1250000
NODE_1061_length_2288_cov_8.539973	340	420	43	1	80	0.0125000
NODE_1061_length_2288_cov_8.539973	340	420	50	2	80	0.0250000
NODE_1061_length_2288_cov_8.539973	340	420	54	3	80	0.0375000
NODE_1061_length_2288_cov_8.539973	393	473	0	2	80	0.0250000
NODE_1061_length_2288_cov_8.539973	393	473	4	4	80	0.0500000
NODE_1061_length_2288_cov_8.539973	393	473	6	18	80	0.2250000
NODE_1061_length_2288_cov_8.539973	393	473	8	56	80	0.7000000
NODE_1065_length_2278_cov_19.655805	450	530	2	59	80	0.7375000
NODE_1065_length_2278_cov_19.655805	450	530	4	21	80	0.2625000
NODE_1065_length_2278_cov_19.655805	503	583	2	6	80	0.0750000
NODE_1065_length_2278_cov_19.655805	503	583	3	5	80	0.0625000
NODE_1065_length_2278_cov_19.655805	503	583	4	52	80	0.6500000
NODE_1065_length_2278_cov_19.655805	503	583	5	17	80	0.2125000
NODE_1065_length_2278_cov_19.655805	579	659	0	7	80	0.0875000
NODE_1065_length_2278_cov_19.655805	579	659	2	36	80	0.4500000
NODE_1065_length_2278_cov_19.655805	579	659	4	37	80	0.4625000
NODE_1065_length_2278_cov_19.655805	632	712	0	22	80	0.2750000
NODE_1065_length_2278_cov_19.655805	632	712	2	3	80	0.0375000
NODE_1065_length_2278_cov_19.655805	632	712	4	55	80	0.6875000
NODE_1071_length_2272_cov_26.123792	226	306	0	80	80	1.0000000
NODE_1071_length_2272_cov_26.123792	279	359	0	80	80	1.0000000
NODE_1071_length_2272_cov_26.123792	1684	1731	35	2	47	0.0425532
NODE_1071_length_2272_cov_26.123792	1684	1731	43	1	47	0.0212766
NODE_1071_length_2272_cov_26.123792	1684	1731	55	1	47	0.0212766
NODE_1071_length_2272_cov_26.123792	1684	1731	70	1	47	0.0212766
NODE_1071_length_2272_cov_26.123792	1684	1731	75	1	47	0.0212766
NODE_1071_length_2272_cov_26.123792	1684	1731	87	1	47	0.0212766
NODE_1071_length_2272_cov_26.123792	1684	1731	94	2	47	0.0425532
NODE_1071_length_2272_cov_26.123792	1684	1731	97	4	47	0.0851064
NODE_1071_length_2272_cov_26.123792	1684	1731	99	2	47	0.0425532
NODE_1071_length_2272_cov_26.123792	1684	1731	101	2	47	0.0425532
NODE_1071_length_2272_cov_26.123792	1684	1731	103	1	47	0.0212766
NODE_1071_length_2272_cov_26.123792	1684	1731	105	2	47	0.0425532
NODE_1071_length_2272_cov_26.123792	1684	1731	107	1	47	0.0212766
NODE_1071_length_2272_cov_26.123792	1684	1731	109	2	47	0.0425532
NODE_1071_length_2272_cov_26.123792	1684	1731	111	1	47	0.0212766
NODE_1071_length_2272_cov_26.123792	1684	1731	112	2	47	0.0425532
NODE_1071_length_2272_cov_26.123792	1684	1731	125	1	47	0.0212766
NODE_1071_length_2272_cov_26.123792	1684	1731	127	1	47	0.0212766
NODE_1071_length_2272_cov_26.123792	1684	1731	135	1	47	0.0212766
NODE_1071_length_2272_cov_26.123792	1684	1731	140	1	47	0.0212766
NODE_1071_length_2272_cov_26.123792	1684	1731	146	2	47	0.0425532
NODE_1071_length_2272_cov_26.123792	1684	1731	150	1	47	0.0212766
NODE_1071_length_2272_cov_26.123792	1684	1731	152	1	47	0.0212766
NODE_1071_length_2272_cov_26.123792	1684	1731	156	1	47	0.0212766
NODE_1071_length_2272_cov_26.123792	1684	1731	157	1	47	0.0212766
NODE_1071_length_2272_cov_26.123792	1684	1731	160	1	47	0.0212766
NODE_1071_length_2272_cov_26.123792	1684	1731	161	1	47	0.0212766
NODE_1071_length_2272_cov_26.123792	1684	1731	166	1	47	0.0212766
NODE_1071_length_2272_cov_26.123792	1684	1731	173	1	47	0.0212766
NODE_1071_length_2272_cov_26.123792	1684	1731	175	1	47	0.0212766
NODE_1071_length_2272_cov_26.123792	1684	1731	177	1	47	0.0212766
NODE_1071_length_2272_cov_26.123792	1684	1731	178	1	47	0.0212766
NODE_1071_length_2272_cov_26.123792	1684	1731	180	2	47	0.0425532
NODE_1071_length_2272_cov_26.123792	1684	1731	184	1	47	0.0212766
NODE_1071_length_2272_cov_26.123792	1684	1731	189	1	47	0.0212766
NODE_1071_length_2272_cov_26.123792	1694	1725	87	1	31	0.0322581
NODE_1071_length_2272_cov_26.123792	1694	1725	94	2	31	0.0645161
NODE_1071_length_2272_cov_26.123792	1694	1725	97	4	31	0.1290323
NODE_1071_length_2272_cov_26.123792	1694	1725	99	2	31	0.0645161
NODE_1071_length_2272_cov_26.123792	1694	1725	101	2	31	0.0645161
NODE_1071_length_2272_cov_26.123792	1694	1725	103	1	31	0.0322581
NODE_1071_length_2272_cov_26.123792	1694	1725	105	2	31	0.0645161
NODE_1071_length_2272_cov_26.123792	1694	1725	107	1	31	0.0322581
NODE_1071_length_2272_cov_26.123792	1694	1725	109	2	31	0.0645161
NODE_1071_length_2272_cov_26.123792	1694	1725	111	1	31	0.0322581
NODE_1071_length_2272_cov_26.123792	1694	1725	112	2	31	0.0645161
NODE_1071_length_2272_cov_26.123792	1694	1725	125	1	31	0.0322581
NODE_1071_length_2272_cov_26.123792	1694	1725	127	1	31	0.0322581
NODE_1071_length_2272_cov_26.123792	1694	1725	135	1	31	0.0322581
NODE_1071_length_2272_cov_26.123792	1694	1725	140	1	31	0.0322581
NODE_1071_length_2272_cov_26.123792	1694	1725	146	2	31	0.0645161
NODE_1071_length_2272_cov_26.123792	1694	1725	150	1	31	0.0322581
NODE_1071_length_2272_cov_26.123792	1694	1725	152	1	31	0.0322581
NODE_1071_length_2272_cov_26.123792	1694	1725	156	1	31	0.0322581
NODE_1071_length_2272_cov_26.123792	1694	1725	157	1	31	0.0322581
NODE_1071_length_2272_cov_26.123792	1694	1725	160	1	31	0.0322581
NODE_1071_length_2272_cov_26.123792	1759	1833	4	70	74	0.9459459
NODE_1071_length_2272_cov_26.123792	1759	1833	13	4	74	0.0540541
NODE_1071_length_2272_cov_26.123792	1812	1892	4	17	80	0.2125000
NODE_1071_length_2272_cov_26.123792	1812	1892	9	23	80	0.2875000
NODE_1071_length_2272_cov_26.123792	1812	1892	11	5	80	0.0625000
NODE_1071_length_2272_cov_26.123792	1812	1892	13	35	80	0.4375000
NODE_1072_length_2272_cov_8.175334	213	293	160	1	80	0.0125000
NODE_1072_length_2272_cov_8.175334	213	293	162	2	80	0.0250000
NODE_1072_length_2272_cov_8.175334	213	293	170	4	80	0.0500000
NODE_1072_length_2272_cov_8.175334	213	293	172	1	80	0.0125000
NODE_1072_length_2272_cov_8.175334	213	293	174	1	80	0.0125000
NODE_1072_length_2272_cov_8.175334	213	293	176	2	80	0.0250000
NODE_1072_length_2272_cov_8.175334	213	293	184	1	80	0.0125000
NODE_1072_length_2272_cov_8.175334	213	293	186	2	80	0.0250000
NODE_1072_length_2272_cov_8.175334	213	293	192	1	80	0.0125000
NODE_1072_length_2272_cov_8.175334	213	293	195	4	80	0.0500000
NODE_1072_length_2272_cov_8.175334	213	293	196	1	80	0.0125000
NODE_1072_length_2272_cov_8.175334	213	293	203	1	80	0.0125000
NODE_1072_length_2272_cov_8.175334	213	293	204	1	80	0.0125000
NODE_1072_length_2272_cov_8.175334	213	293	205	2	80	0.0250000
NODE_1072_length_2272_cov_8.175334	213	293	209	2	80	0.0250000
NODE_1072_length_2272_cov_8.175334	213	293	211	1	80	0.0125000
NODE_1072_length_2272_cov_8.175334	213	293	212	1	80	0.0125000
NODE_1072_length_2272_cov_8.175334	213	293	215	2	80	0.0250000
NODE_1072_length_2272_cov_8.175334	213	293	216	1	80	0.0125000
NODE_1072_length_2272_cov_8.175334	213	293	222	1	80	0.0125000
NODE_1072_length_2272_cov_8.175334	213	293	223	1	80	0.0125000
NODE_1072_length_2272_cov_8.175334	213	293	225	1	80	0.0125000
NODE_1072_length_2272_cov_8.175334	213	293	226	2	80	0.0250000
NODE_1072_length_2272_cov_8.175334	213	293	228	1	80	0.0125000
NODE_1072_length_2272_cov_8.175334	213	293	229	3	80	0.0375000
NODE_1072_length_2272_cov_8.175334	213	293	230	1	80	0.0125000
NODE_1072_length_2272_cov_8.175334	213	293	234	2	80	0.0250000
NODE_1072_length_2272_cov_8.175334	213	293	238	1	80	0.0125000
NODE_1072_length_2272_cov_8.175334	213	293	239	4	80	0.0500000
NODE_1072_length_2272_cov_8.175334	213	293	242	1	80	0.0125000
NODE_1072_length_2272_cov_8.175334	213	293	245	1	80	0.0125000
NODE_1072_length_2272_cov_8.175334	213	293	247	1	80	0.0125000
NODE_1072_length_2272_cov_8.175334	213	293	249	1	80	0.0125000
NODE_1072_length_2272_cov_8.175334	213	293	252	6	80	0.0750000
NODE_1072_length_2272_cov_8.175334	213	293	253	1	80	0.0125000
NODE_1072_length_2272_cov_8.175334	213	293	254	1	80	0.0125000
NODE_1072_length_2272_cov_8.175334	213	293	256	2	80	0.0250000
NODE_1072_length_2272_cov_8.175334	213	293	257	2	80	0.0250000
NODE_1072_length_2272_cov_8.175334	213	293	258	3	80	0.0375000
NODE_1072_length_2272_cov_8.175334	213	293	259	2	80	0.0250000
NODE_1072_length_2272_cov_8.175334	213	293	261	6	80	0.0750000
NODE_1072_length_2272_cov_8.175334	213	293	262	2	80	0.0250000
NODE_1072_length_2272_cov_8.175334	213	293	263	1	80	0.0125000
NODE_1072_length_2272_cov_8.175334	213	293	266	1	80	0.0125000
NODE_1072_length_2272_cov_8.175334	213	293	268	1	80	0.0125000
NODE_1072_length_2272_cov_8.175334	266	346	7	1	80	0.0125000
NODE_1072_length_2272_cov_8.175334	266	346	15	1	80	0.0125000
NODE_1072_length_2272_cov_8.175334	266	346	43	1	80	0.0125000
NODE_1072_length_2272_cov_8.175334	266	346	45	1	80	0.0125000
NODE_1072_length_2272_cov_8.175334	266	346	51	1	80	0.0125000
NODE_1072_length_2272_cov_8.175334	266	346	55	1	80	0.0125000
NODE_1072_length_2272_cov_8.175334	266	346	57	1	80	0.0125000
NODE_1072_length_2272_cov_8.175334	266	346	71	2	80	0.0250000
NODE_1072_length_2272_cov_8.175334	266	346	73	1	80	0.0125000
NODE_1072_length_2272_cov_8.175334	266	346	75	1	80	0.0125000
NODE_1072_length_2272_cov_8.175334	266	346	77	2	80	0.0250000
NODE_1072_length_2272_cov_8.175334	266	346	80	2	80	0.0250000
NODE_1072_length_2272_cov_8.175334	266	346	86	1	80	0.0125000
NODE_1072_length_2272_cov_8.175334	266	346	88	1	80	0.0125000
NODE_1072_length_2272_cov_8.175334	266	346	90	1	80	0.0125000
NODE_1072_length_2272_cov_8.175334	266	346	92	1	80	0.0125000
NODE_1072_length_2272_cov_8.175334	266	346	94	1	80	0.0125000
NODE_1072_length_2272_cov_8.175334	266	346	102	3	80	0.0375000
NODE_1072_length_2272_cov_8.175334	266	346	104	1	80	0.0125000
NODE_1072_length_2272_cov_8.175334	266	346	106	2	80	0.0250000
NODE_1072_length_2272_cov_8.175334	266	346	114	2	80	0.0250000
NODE_1072_length_2272_cov_8.175334	266	346	116	1	80	0.0125000
NODE_1072_length_2272_cov_8.175334	266	346	119	3	80	0.0375000
NODE_1072_length_2272_cov_8.175334	266	346	121	2	80	0.0250000
NODE_1072_length_2272_cov_8.175334	266	346	123	2	80	0.0250000
NODE_1072_length_2272_cov_8.175334	266	346	131	1	80	0.0125000
NODE_1072_length_2272_cov_8.175334	266	346	132	1	80	0.0125000
NODE_1072_length_2272_cov_8.175334	266	346	142	6	80	0.0750000
NODE_1072_length_2272_cov_8.175334	266	346	144	2	80	0.0250000
NODE_1072_length_2272_cov_8.175334	266	346	150	2	80	0.0250000
NODE_1072_length_2272_cov_8.175334	266	346	151	4	80	0.0500000
NODE_1072_length_2272_cov_8.175334	266	346	156	1	80	0.0125000
NODE_1072_length_2272_cov_8.175334	266	346	160	1	80	0.0125000
NODE_1072_length_2272_cov_8.175334	266	346	162	2	80	0.0250000
NODE_1072_length_2272_cov_8.175334	266	346	170	4	80	0.0500000
NODE_1072_length_2272_cov_8.175334	266	346	172	1	80	0.0125000
NODE_1072_length_2272_cov_8.175334	266	346	174	1	80	0.0125000
NODE_1072_length_2272_cov_8.175334	266	346	176	2	80	0.0250000
NODE_1072_length_2272_cov_8.175334	266	346	184	1	80	0.0125000
NODE_1072_length_2272_cov_8.175334	266	346	186	2	80	0.0250000
NODE_1072_length_2272_cov_8.175334	266	346	192	1	80	0.0125000
NODE_1072_length_2272_cov_8.175334	266	346	196	1	80	0.0125000
NODE_1072_length_2272_cov_8.175334	266	346	204	1	80	0.0125000
NODE_1072_length_2272_cov_8.175334	266	346	205	1	80	0.0125000
NODE_1072_length_2272_cov_8.175334	266	346	209	1	80	0.0125000
NODE_1072_length_2272_cov_8.175334	266	346	211	1	80	0.0125000
NODE_1072_length_2272_cov_8.175334	266	346	215	1	80	0.0125000
NODE_1072_length_2272_cov_8.175334	266	346	216	1	80	0.0125000
NODE_1072_length_2272_cov_8.175334	266	346	226	2	80	0.0250000
NODE_1072_length_2272_cov_8.175334	266	346	228	1	80	0.0125000
NODE_1072_length_2272_cov_8.175334	266	346	230	1	80	0.0125000
NODE_1072_length_2272_cov_8.175334	266	346	234	1	80	0.0125000
NODE_1077_length_2266_cov_13.206276	359	439	2	13	80	0.1625000
NODE_1077_length_2266_cov_13.206276	359	439	4	14	80	0.1750000
NODE_1077_length_2266_cov_13.206276	359	439	10	31	80	0.3875000
NODE_1077_length_2266_cov_13.206276	359	439	12	14	80	0.1750000
NODE_1077_length_2266_cov_13.206276	359	439	15	8	80	0.1000000
NODE_1077_length_2266_cov_13.206276	412	492	10	5	80	0.0625000
NODE_1077_length_2266_cov_13.206276	412	492	12	14	80	0.1750000
NODE_1077_length_2266_cov_13.206276	412	492	15	16	80	0.2000000
NODE_1077_length_2266_cov_13.206276	412	492	17	13	80	0.1625000
NODE_1077_length_2266_cov_13.206276	412	492	18	3	80	0.0375000
NODE_1077_length_2266_cov_13.206276	412	492	19	6	80	0.0750000
NODE_1077_length_2266_cov_13.206276	412	492	20	23	80	0.2875000
NODE_1077_length_2266_cov_13.206276	488	568	16	4	80	0.0500000
NODE_1077_length_2266_cov_13.206276	488	568	18	24	80	0.3000000
NODE_1077_length_2266_cov_13.206276	488	568	20	10	80	0.1250000
NODE_1077_length_2266_cov_13.206276	488	568	22	8	80	0.1000000
NODE_1077_length_2266_cov_13.206276	488	568	23	1	80	0.0125000
NODE_1077_length_2266_cov_13.206276	488	568	24	33	80	0.4125000
NODE_1077_length_2266_cov_13.206276	541	627	4	3	86	0.0348837
NODE_1077_length_2266_cov_13.206276	541	627	10	8	86	0.0930233
NODE_1077_length_2266_cov_13.206276	541	627	11	7	86	0.0813954
NODE_1077_length_2266_cov_13.206276	541	627	13	23	86	0.2674419
NODE_1077_length_2266_cov_13.206276	541	627	15	5	86	0.0581395
NODE_1077_length_2266_cov_13.206276	541	627	18	28	86	0.3255814
NODE_1077_length_2266_cov_13.206276	541	627	22	8	86	0.0930233
NODE_1077_length_2266_cov_13.206276	541	627	24	4	86	0.0465116
NODE_1078_length_2262_cov_11.759131	413	493	0	80	80	1.0000000
NODE_1078_length_2262_cov_11.759131	466	546	0	80	80	1.0000000
NODE_1079_length_2260_cov_37.814901	219	299	0	5	80	0.0625000
NODE_1079_length_2260_cov_37.814901	219	299	2	75	80	0.9375000
NODE_1079_length_2260_cov_37.814901	742	822	1	10	80	0.1250000
NODE_1079_length_2260_cov_37.814901	742	822	2	14	80	0.1750000
NODE_1079_length_2260_cov_37.814901	742	822	3	56	80	0.7000000
NODE_1079_length_2260_cov_37.814901	795	875	0	51	80	0.6375000
NODE_1079_length_2260_cov_37.814901	795	875	2	16	80	0.2000000
NODE_1079_length_2260_cov_37.814901	795	875	3	13	80	0.1625000
NODE_1079_length_2260_cov_37.814901	1533	1613	40	1	80	0.0125000
NODE_1079_length_2260_cov_37.814901	1533	1613	41	4	80	0.0500000
NODE_1079_length_2260_cov_37.814901	1533	1613	42	10	80	0.1250000
NODE_1079_length_2260_cov_37.814901	1533	1613	44	2	80	0.0250000
NODE_1079_length_2260_cov_37.814901	1533	1613	46	24	80	0.3000000
NODE_1079_length_2260_cov_37.814901	1533	1613	48	2	80	0.0250000
NODE_1079_length_2260_cov_37.814901	1533	1613	49	23	80	0.2875000
NODE_1079_length_2260_cov_37.814901	1533	1613	50	14	80	0.1750000
NODE_1079_length_2260_cov_37.814901	1586	1666	2	18	80	0.2250000
NODE_1079_length_2260_cov_37.814901	1586	1666	4	21	80	0.2625000
NODE_1079_length_2260_cov_37.814901	1586	1666	14	11	80	0.1375000
NODE_1079_length_2260_cov_37.814901	1586	1666	16	2	80	0.0250000
NODE_1079_length_2260_cov_37.814901	1586	1666	46	21	80	0.2625000
NODE_1079_length_2260_cov_37.814901	1586	1666	48	1	80	0.0125000
NODE_1079_length_2260_cov_37.814901	1586	1666	49	6	80	0.0750000
NODE_1079_length_2260_cov_37.814901	1662	1742	4	50	80	0.6250000
NODE_1079_length_2260_cov_37.814901	1662	1742	6	12	80	0.1500000
NODE_1079_length_2260_cov_37.814901	1662	1742	8	18	80	0.2250000
NODE_1079_length_2260_cov_37.814901	1715	1795	4	9	80	0.1125000
NODE_1079_length_2260_cov_37.814901	1715	1795	6	34	80	0.4250000
NODE_1079_length_2260_cov_37.814901	1715	1795	8	37	80	0.4625000
NODE_1082_length_2253_cov_8.904828	472	552	2	13	80	0.1625000
NODE_1082_length_2253_cov_8.904828	472	552	3	2	80	0.0250000
NODE_1082_length_2253_cov_8.904828	472	552	7	2	80	0.0250000
NODE_1082_length_2253_cov_8.904828	472	552	8	1	80	0.0125000
NODE_1082_length_2253_cov_8.904828	472	552	9	1	80	0.0125000
NODE_1082_length_2253_cov_8.904828	472	552	10	1	80	0.0125000
NODE_1082_length_2253_cov_8.904828	472	552	11	3	80	0.0375000
NODE_1082_length_2253_cov_8.904828	472	552	13	5	80	0.0625000
NODE_1082_length_2253_cov_8.904828	472	552	14	6	80	0.0750000
NODE_1082_length_2253_cov_8.904828	472	552	15	1	80	0.0125000
NODE_1082_length_2253_cov_8.904828	472	552	16	5	80	0.0625000
NODE_1082_length_2253_cov_8.904828	472	552	17	1	80	0.0125000
NODE_1082_length_2253_cov_8.904828	472	552	26	1	80	0.0125000
NODE_1082_length_2253_cov_8.904828	472	552	27	4	80	0.0500000
NODE_1082_length_2253_cov_8.904828	472	552	29	1	80	0.0125000
NODE_1082_length_2253_cov_8.904828	472	552	31	4	80	0.0500000
NODE_1082_length_2253_cov_8.904828	472	552	35	1	80	0.0125000
NODE_1082_length_2253_cov_8.904828	472	552	37	3	80	0.0375000
NODE_1082_length_2253_cov_8.904828	472	552	39	2	80	0.0250000
NODE_1082_length_2253_cov_8.904828	472	552	40	2	80	0.0250000
NODE_1082_length_2253_cov_8.904828	472	552	47	1	80	0.0125000
NODE_1082_length_2253_cov_8.904828	472	552	50	2	80	0.0250000
NODE_1082_length_2253_cov_8.904828	472	552	52	3	80	0.0375000
NODE_1082_length_2253_cov_8.904828	472	552	56	3	80	0.0375000
NODE_1082_length_2253_cov_8.904828	472	552	58	3	80	0.0375000
NODE_1082_length_2253_cov_8.904828	472	552	60	2	80	0.0250000
NODE_1082_length_2253_cov_8.904828	472	552	66	1	80	0.0125000
NODE_1082_length_2253_cov_8.904828	472	552	70	2	80	0.0250000
NODE_1082_length_2253_cov_8.904828	472	552	74	2	80	0.0250000
NODE_1082_length_2253_cov_8.904828	472	552	82	1	80	0.0125000
NODE_1082_length_2253_cov_8.904828	472	552	84	1	80	0.0125000
NODE_1085_length_2252_cov_2.801208	1128	1170	2	22	42	0.5238096
NODE_1085_length_2252_cov_2.801208	1128	1170	6	20	42	0.4761905
NODE_1085_length_2252_cov_2.801208	1137	1172	2	13	35	0.3714286
NODE_1085_length_2252_cov_2.801208	1137	1172	6	22	35	0.6285715
NODE_1086_length_2252_cov_2.078031	13	62	0	49	49	1.0000000
NODE_1086_length_2252_cov_2.078031	13	61	0	48	48	1.0000000
NODE_1086_length_2252_cov_2.078031	13	62	0	49	49	1.0000000
NODE_1086_length_2252_cov_2.078031	13	62	0	49	49	1.0000000
NODE_1086_length_2252_cov_2.078031	13	61	0	48	48	1.0000000
NODE_1087_length_2251_cov_15.458178	1443	1506	0	2	63	0.0317460
NODE_1087_length_2251_cov_15.458178	1443	1506	2	59	63	0.9365079
NODE_1087_length_2251_cov_15.458178	1443	1506	4	1	63	0.0158730
NODE_1087_length_2251_cov_15.458178	1443	1506	20	1	63	0.0158730
NODE_1087_length_2251_cov_15.458178	1496	1550	2	20	54	0.3703704
NODE_1087_length_2251_cov_15.458178	1496	1550	3	5	54	0.0925926
NODE_1087_length_2251_cov_15.458178	1496	1550	4	1	54	0.0185185
NODE_1087_length_2251_cov_15.458178	1496	1550	6	1	54	0.0185185
NODE_1087_length_2251_cov_15.458178	1496	1550	10	3	54	0.0555556
NODE_1087_length_2251_cov_15.458178	1496	1550	12	1	54	0.0185185
NODE_1087_length_2251_cov_15.458178	1496	1550	14	1	54	0.0185185
NODE_1087_length_2251_cov_15.458178	1496	1550	15	1	54	0.0185185
NODE_1087_length_2251_cov_15.458178	1496	1550	17	1	54	0.0185185
NODE_1087_length_2251_cov_15.458178	1496	1550	18	3	54	0.0555556
NODE_1087_length_2251_cov_15.458178	1496	1550	20	1	54	0.0185185
NODE_1087_length_2251_cov_15.458178	1496	1550	21	4	54	0.0740741
NODE_1087_length_2251_cov_15.458178	1496	1550	23	3	54	0.0555556
NODE_1087_length_2251_cov_15.458178	1496	1550	25	2	54	0.0370370
NODE_1087_length_2251_cov_15.458178	1496	1550	27	1	54	0.0185185
NODE_1087_length_2251_cov_15.458178	1496	1550	29	1	54	0.0185185
NODE_1087_length_2251_cov_15.458178	1496	1550	31	1	54	0.0185185
NODE_1087_length_2251_cov_15.458178	1496	1550	33	2	54	0.0370370
NODE_1087_length_2251_cov_15.458178	1496	1550	42	1	54	0.0185185
NODE_1087_length_2251_cov_15.458178	1496	1550	47	1	54	0.0185185
NODE_1089_length_2250_cov_18.370990	1658	1738	0	80	80	1.0000000
NODE_1089_length_2250_cov_18.370990	1711	1791	0	80	80	1.0000000
NODE_1090_length_2250_cov_5.331474	1844	1924	0	80	80	1.0000000
NODE_1093_length_2247_cov_7.906890	364	436	16	19	72	0.2638889
NODE_1093_length_2247_cov_7.906890	364	436	18	22	72	0.3055556
NODE_1093_length_2247_cov_7.906890	364	436	20	31	72	0.4305556
NODE_1095_length_2246_cov_7.612948	1992	2055	2	23	63	0.3650794
NODE_1095_length_2246_cov_7.612948	1992	2055	3	1	63	0.0158730
NODE_1095_length_2246_cov_7.612948	1992	2055	4	35	63	0.5555556
NODE_1095_length_2246_cov_7.612948	1992	2055	5	4	63	0.0634921
NODE_1095_length_2246_cov_7.612948	2045	2108	2	26	63	0.4126984
NODE_1095_length_2246_cov_7.612948	2045	2108	4	37	63	0.5873016
NODE_1104_length_2233_cov_35.127460	1517	1597	0	80	80	1.0000000
NODE_1104_length_2233_cov_35.127460	1570	1650	0	80	80	1.0000000
NODE_1105_length_2231_cov_45.701689	315	396	16	5	81	0.0617284
NODE_1105_length_2231_cov_45.701689	315	396	18	3	81	0.0370370
NODE_1105_length_2231_cov_45.701689	315	396	20	2	81	0.0246914
NODE_1105_length_2231_cov_45.701689	315	396	24	6	81	0.0740741
NODE_1105_length_2231_cov_45.701689	315	396	26	7	81	0.0864198
NODE_1105_length_2231_cov_45.701689	315	396	28	47	81	0.5802469
NODE_1105_length_2231_cov_45.701689	315	396	30	5	81	0.0617284
NODE_1105_length_2231_cov_45.701689	315	396	34	4	81	0.0493827
NODE_1105_length_2231_cov_45.701689	315	396	36	2	81	0.0246914
NODE_1105_length_2231_cov_45.701689	369	449	0	7	80	0.0875000
NODE_1105_length_2231_cov_45.701689	369	449	2	17	80	0.2125000
NODE_1105_length_2231_cov_45.701689	369	449	4	2	80	0.0250000
NODE_1105_length_2231_cov_45.701689	369	449	6	11	80	0.1375000
NODE_1105_length_2231_cov_45.701689	369	449	8	13	80	0.1625000
NODE_1105_length_2231_cov_45.701689	369	449	12	1	80	0.0125000
NODE_1105_length_2231_cov_45.701689	369	449	14	2	80	0.0250000
NODE_1105_length_2231_cov_45.701689	369	449	16	5	80	0.0625000
NODE_1105_length_2231_cov_45.701689	369	449	18	3	80	0.0375000
NODE_1105_length_2231_cov_45.701689	369	449	20	2	80	0.0250000
NODE_1105_length_2231_cov_45.701689	369	449	24	6	80	0.0750000
NODE_1105_length_2231_cov_45.701689	369	449	26	7	80	0.0875000
NODE_1105_length_2231_cov_45.701689	369	449	28	4	80	0.0500000
NODE_1105_length_2231_cov_45.701689	496	576	0	80	80	1.0000000
NODE_1105_length_2231_cov_45.701689	582	662	0	80	80	1.0000000
NODE_1105_length_2231_cov_45.701689	625	705	0	80	80	1.0000000
NODE_1105_length_2231_cov_45.701689	711	791	0	80	80	1.0000000
NODE_1105_length_2231_cov_45.701689	1141	1186	0	3	45	0.0666667
NODE_1105_length_2231_cov_45.701689	1141	1186	2	20	45	0.4444444
NODE_1105_length_2231_cov_45.701689	1141	1186	6	11	45	0.2444444
NODE_1105_length_2231_cov_45.701689	1141	1186	8	11	45	0.2444444
NODE_1105_length_2231_cov_45.701689	1787	1867	0	80	80	1.0000000
NODE_1105_length_2231_cov_45.701689	1840	1920	0	80	80	1.0000000
NODE_1106_length_2230_cov_12.608634	1520	1600	0	54	80	0.6750000
NODE_1106_length_2230_cov_12.608634	1520	1600	2	26	80	0.3250000
NODE_1106_length_2230_cov_12.608634	1573	1653	0	8	80	0.1000000
NODE_1106_length_2230_cov_12.608634	1573	1653	2	72	80	0.9000000
NODE_1112_length_2218_cov_5.292591	1427	1497	2	27	70	0.3857143
NODE_1112_length_2218_cov_5.292591	1427	1497	4	6	70	0.0857143
NODE_1112_length_2218_cov_5.292591	1427	1497	6	10	70	0.1428571
NODE_1112_length_2218_cov_5.292591	1427	1497	8	27	70	0.3857143
NODE_1112_length_2218_cov_5.292591	1470	1536	2	12	66	0.1818182
NODE_1112_length_2218_cov_5.292591	1470	1536	4	6	66	0.0909091
NODE_1112_length_2218_cov_5.292591	1470	1536	6	25	66	0.3787879
NODE_1112_length_2218_cov_5.292591	1470	1536	8	23	66	0.3484848
NODE_1115_length_2215_cov_51.865784	108	188	0	80	80	1.0000000
NODE_1115_length_2215_cov_51.865784	161	241	0	80	80	1.0000000
NODE_1115_length_2215_cov_51.865784	237	317	0	80	80	1.0000000
NODE_1115_length_2215_cov_51.865784	290	370	0	80	80	1.0000000
NODE_1115_length_2215_cov_51.865784	1030	1102	13	1	72	0.0138889
NODE_1115_length_2215_cov_51.865784	1030	1102	20	3	72	0.0416667
NODE_1115_length_2215_cov_51.865784	1030	1102	21	2	72	0.0277778
NODE_1115_length_2215_cov_51.865784	1030	1102	23	2	72	0.0277778
NODE_1115_length_2215_cov_51.865784	1030	1102	25	8	72	0.1111111
NODE_1115_length_2215_cov_51.865784	1030	1102	26	6	72	0.0833333
NODE_1115_length_2215_cov_51.865784	1030	1102	28	2	72	0.0277778
NODE_1115_length_2215_cov_51.865784	1030	1102	30	6	72	0.0833333
NODE_1115_length_2215_cov_51.865784	1030	1102	33	2	72	0.0277778
NODE_1115_length_2215_cov_51.865784	1030	1102	35	3	72	0.0416667
NODE_1115_length_2215_cov_51.865784	1030	1102	39	3	72	0.0416667
NODE_1115_length_2215_cov_51.865784	1030	1102	43	4	72	0.0555556
NODE_1115_length_2215_cov_51.865784	1030	1102	47	1	72	0.0138889
NODE_1115_length_2215_cov_51.865784	1030	1102	48	2	72	0.0277778
NODE_1115_length_2215_cov_51.865784	1030	1102	50	1	72	0.0138889
NODE_1115_length_2215_cov_51.865784	1030	1102	51	3	72	0.0416667
NODE_1115_length_2215_cov_51.865784	1030	1102	55	1	72	0.0138889
NODE_1115_length_2215_cov_51.865784	1030	1102	57	3	72	0.0416667
NODE_1115_length_2215_cov_51.865784	1030	1102	68	2	72	0.0277778
NODE_1115_length_2215_cov_51.865784	1030	1102	71	1	72	0.0138889
NODE_1115_length_2215_cov_51.865784	1030	1102	77	5	72	0.0694444
NODE_1115_length_2215_cov_51.865784	1030	1102	79	1	72	0.0138889
NODE_1115_length_2215_cov_51.865784	1030	1102	80	1	72	0.0138889
NODE_1115_length_2215_cov_51.865784	1030	1102	83	4	72	0.0555556
NODE_1115_length_2215_cov_51.865784	1030	1102	85	4	72	0.0555556
NODE_1115_length_2215_cov_51.865784	1030	1102	86	1	72	0.0138889
NODE_1115_length_2215_cov_51.865784	1571	1651	0	10	80	0.1250000
NODE_1115_length_2215_cov_51.865784	1571	1651	2	70	80	0.8750000
NODE_1115_length_2215_cov_51.865784	1624	1704	0	42	80	0.5250000
NODE_1115_length_2215_cov_51.865784	1624	1704	2	38	80	0.4750000
NODE_1117_length_2212_cov_63.988168	459	539	0	80	80	1.0000000
NODE_1117_length_2212_cov_63.988168	512	592	0	77	80	0.9625000
NODE_1117_length_2212_cov_63.988168	512	592	2	3	80	0.0375000
NODE_1117_length_2212_cov_63.988168	588	668	0	1	80	0.0125000
NODE_1117_length_2212_cov_63.988168	588	668	2	45	80	0.5625000
NODE_1117_length_2212_cov_63.988168	588	668	4	34	80	0.4250000
NODE_1117_length_2212_cov_63.988168	641	721	0	6	80	0.0750000
NODE_1117_length_2212_cov_63.988168	641	721	2	59	80	0.7375000
NODE_1117_length_2212_cov_63.988168	641	721	4	15	80	0.1875000
NODE_1119_length_2212_cov_4.632750	1479	1559	2	60	80	0.7500000
NODE_1119_length_2212_cov_4.632750	1479	1559	4	20	80	0.2500000
NODE_1119_length_2212_cov_4.632750	1532	1612	2	7	80	0.0875000
NODE_1119_length_2212_cov_4.632750	1532	1612	4	35	80	0.4375000
NODE_1119_length_2212_cov_4.632750	1532	1612	5	15	80	0.1875000
NODE_1119_length_2212_cov_4.632750	1532	1612	6	23	80	0.2875000
NODE_1122_length_2211_cov_16.247159	1808	1888	13	8	80	0.1000000
NODE_1122_length_2211_cov_16.247159	1808	1888	15	11	80	0.1375000
NODE_1122_length_2211_cov_16.247159	1808	1888	19	3	80	0.0375000
NODE_1122_length_2211_cov_16.247159	1808	1888	25	14	80	0.1750000
NODE_1122_length_2211_cov_16.247159	1808	1888	27	24	80	0.3000000
NODE_1122_length_2211_cov_16.247159	1808	1888	29	20	80	0.2500000
NODE_1124_length_2207_cov_46.766129	1273	1348	95	2	75	0.0266667
NODE_1124_length_2207_cov_46.766129	1273	1348	98	1	75	0.0133333
NODE_1124_length_2207_cov_46.766129	1273	1348	99	1	75	0.0133333
NODE_1124_length_2207_cov_46.766129	1273	1348	100	2	75	0.0266667
NODE_1124_length_2207_cov_46.766129	1273	1348	101	4	75	0.0533333
NODE_1124_length_2207_cov_46.766129	1273	1348	102	2	75	0.0266667
NODE_1124_length_2207_cov_46.766129	1273	1348	103	9	75	0.1200000
NODE_1124_length_2207_cov_46.766129	1273	1348	104	6	75	0.0800000
NODE_1124_length_2207_cov_46.766129	1273	1348	105	4	75	0.0533333
NODE_1124_length_2207_cov_46.766129	1273	1348	106	1	75	0.0133333
NODE_1124_length_2207_cov_46.766129	1273	1348	108	2	75	0.0266667
NODE_1124_length_2207_cov_46.766129	1273	1348	114	1	75	0.0133333
NODE_1124_length_2207_cov_46.766129	1273	1348	116	4	75	0.0533333
NODE_1124_length_2207_cov_46.766129	1273	1348	117	2	75	0.0266667
NODE_1124_length_2207_cov_46.766129	1273	1348	118	2	75	0.0266667
NODE_1124_length_2207_cov_46.766129	1273	1348	119	3	75	0.0400000
NODE_1124_length_2207_cov_46.766129	1273	1348	120	3	75	0.0400000
NODE_1124_length_2207_cov_46.766129	1273	1348	121	1	75	0.0133333
NODE_1124_length_2207_cov_46.766129	1273	1348	122	2	75	0.0266667
NODE_1124_length_2207_cov_46.766129	1273	1348	123	3	75	0.0400000
NODE_1124_length_2207_cov_46.766129	1273	1348	126	2	75	0.0266667
NODE_1124_length_2207_cov_46.766129	1273	1348	127	3	75	0.0400000
NODE_1124_length_2207_cov_46.766129	1273	1348	128	5	75	0.0666667
NODE_1124_length_2207_cov_46.766129	1273	1348	129	5	75	0.0666667
NODE_1124_length_2207_cov_46.766129	1273	1348	130	3	75	0.0400000
NODE_1124_length_2207_cov_46.766129	1273	1348	131	1	75	0.0133333
NODE_1124_length_2207_cov_46.766129	1273	1348	132	1	75	0.0133333
NODE_1124_length_2207_cov_46.766129	1324	1401	86	2	77	0.0259740
NODE_1124_length_2207_cov_46.766129	1324	1401	87	1	77	0.0129870
NODE_1124_length_2207_cov_46.766129	1324	1401	88	2	77	0.0259740
NODE_1124_length_2207_cov_46.766129	1324	1401	89	1	77	0.0129870
NODE_1124_length_2207_cov_46.766129	1324	1401	90	13	77	0.1688312
NODE_1124_length_2207_cov_46.766129	1324	1401	91	1	77	0.0129870
NODE_1124_length_2207_cov_46.766129	1324	1401	94	3	77	0.0389610
NODE_1124_length_2207_cov_46.766129	1324	1401	100	3	77	0.0389610
NODE_1124_length_2207_cov_46.766129	1324	1401	101	3	77	0.0389610
NODE_1124_length_2207_cov_46.766129	1324	1401	104	1	77	0.0129870
NODE_1124_length_2207_cov_46.766129	1324	1401	112	1	77	0.0129870
NODE_1124_length_2207_cov_46.766129	1324	1401	114	1	77	0.0129870
NODE_1124_length_2207_cov_46.766129	1324	1401	116	8	77	0.1038961
NODE_1124_length_2207_cov_46.766129	1324	1401	117	1	77	0.0129870
NODE_1124_length_2207_cov_46.766129	1324	1401	118	1	77	0.0129870
NODE_1124_length_2207_cov_46.766129	1324	1401	119	1	77	0.0129870
NODE_1124_length_2207_cov_46.766129	1324	1401	120	3	77	0.0389610
NODE_1124_length_2207_cov_46.766129	1324	1401	122	2	77	0.0259740
NODE_1124_length_2207_cov_46.766129	1324	1401	123	2	77	0.0259740
NODE_1124_length_2207_cov_46.766129	1324	1401	124	5	77	0.0649351
NODE_1124_length_2207_cov_46.766129	1324	1401	126	2	77	0.0259740
NODE_1124_length_2207_cov_46.766129	1324	1401	127	3	77	0.0389610
NODE_1124_length_2207_cov_46.766129	1324	1401	128	6	77	0.0779221
NODE_1124_length_2207_cov_46.766129	1324	1401	129	5	77	0.0649351
NODE_1124_length_2207_cov_46.766129	1324	1401	130	4	77	0.0519481
NODE_1124_length_2207_cov_46.766129	1324	1401	131	1	77	0.0129870
NODE_1124_length_2207_cov_46.766129	1324	1401	132	1	77	0.0129870
NODE_1127_length_2205_cov_12.762108	1818	1898	0	7	80	0.0875000
NODE_1127_length_2205_cov_12.762108	1818	1898	2	73	80	0.9125000
NODE_1127_length_2205_cov_12.762108	1871	1951	0	46	80	0.5750000
NODE_1127_length_2205_cov_12.762108	1871	1951	2	34	80	0.4250000
NODE_1127_length_2205_cov_12.762108	1872	1951	0	46	79	0.5822785
NODE_1127_length_2205_cov_12.762108	1872	1951	2	33	79	0.4177215
NODE_1127_length_2205_cov_12.762108	1947	2020	0	73	73	1.0000000
NODE_1128_length_2202_cov_8.687114	1848	1912	0	64	64	1.0000000
NODE_1130_length_2200_cov_10.639695	1461	1541	2	10	80	0.1250000
NODE_1130_length_2200_cov_10.639695	1461	1541	3	31	80	0.3875000
NODE_1130_length_2200_cov_10.639695	1461	1541	4	27	80	0.3375000
NODE_1130_length_2200_cov_10.639695	1461	1541	6	12	80	0.1500000
NODE_1130_length_2200_cov_10.639695	1514	1594	4	15	80	0.1875000
NODE_1130_length_2200_cov_10.639695	1514	1594	6	44	80	0.5500000
NODE_1130_length_2200_cov_10.639695	1514	1594	8	21	80	0.2625000
NODE_1131_length_2199_cov_10.839524	1709	1789	0	80	80	1.0000000
NODE_1131_length_2199_cov_10.839524	1762	1842	0	80	80	1.0000000
NODE_1135_length_2196_cov_64.718646	885	965	16	20	80	0.2500000
NODE_1135_length_2196_cov_64.718646	885	965	23	1	80	0.0125000
NODE_1135_length_2196_cov_64.718646	885	965	24	27	80	0.3375000
NODE_1135_length_2196_cov_64.718646	885	965	28	32	80	0.4000000
NODE_1135_length_2196_cov_64.718646	938	1018	4	3	80	0.0375000
NODE_1135_length_2196_cov_64.718646	938	1018	11	1	80	0.0125000
NODE_1135_length_2196_cov_64.718646	938	1018	12	33	80	0.4125000
NODE_1135_length_2196_cov_64.718646	938	1018	18	2	80	0.0250000
NODE_1135_length_2196_cov_64.718646	938	1018	20	10	80	0.1250000
NODE_1135_length_2196_cov_64.718646	938	1018	22	4	80	0.0500000
NODE_1135_length_2196_cov_64.718646	938	1018	28	27	80	0.3375000
NODE_1138_length_2195_cov_8.443225	114	136	0	22	22	1.0000000
NODE_1139_length_2195_cov_6.113550	1245	1330	0	56	85	0.6588235
NODE_1139_length_2195_cov_6.113550	1245	1330	2	29	85	0.3411765
NODE_1139_length_2195_cov_6.113550	1306	1352	2	46	46	1.0000000
NODE_1141_length_2194_cov_1.366587	15	77	0	7	62	0.1129032
NODE_1141_length_2194_cov_1.366587	15	77	2	52	62	0.8387097
NODE_1141_length_2194_cov_1.366587	15	77	4	3	62	0.0483871
NODE_1142_length_2193_cov_8.320917	374	454	0	25	80	0.3125000
NODE_1142_length_2193_cov_8.320917	374	454	2	55	80	0.6875000
NODE_1142_length_2193_cov_8.320917	427	502	0	12	75	0.1600000
NODE_1142_length_2193_cov_8.320917	427	502	2	63	75	0.8400000
NODE_1146_length_2189_cov_36.884689	383	463	0	12	80	0.1500000
NODE_1146_length_2189_cov_36.884689	383	463	2	1	80	0.0125000
NODE_1146_length_2189_cov_36.884689	383	463	8	67	80	0.8375000
NODE_1146_length_2189_cov_36.884689	436	516	0	34	80	0.4250000
NODE_1146_length_2189_cov_36.884689	436	516	6	7	80	0.0875000
NODE_1146_length_2189_cov_36.884689	436	516	8	39	80	0.4875000
NODE_1146_length_2189_cov_36.884689	1257	1337	0	12	80	0.1500000
NODE_1146_length_2189_cov_36.884689	1257	1337	2	68	80	0.8500000
NODE_1146_length_2189_cov_36.884689	1310	1390	0	65	80	0.8125000
NODE_1146_length_2189_cov_36.884689	1310	1390	2	15	80	0.1875000
NODE_1146_length_2189_cov_36.884689	1427	1507	0	8	80	0.1000000
NODE_1146_length_2189_cov_36.884689	1427	1507	2	72	80	0.9000000
NODE_1146_length_2189_cov_36.884689	1480	1560	0	44	80	0.5500000
NODE_1146_length_2189_cov_36.884689	1480	1560	2	36	80	0.4500000
NODE_1152_length_2184_cov_9.464748	1536	1616	0	80	80	1.0000000
NODE_1152_length_2184_cov_9.464748	1589	1669	0	80	80	1.0000000
NODE_1154_length_2183_cov_45.471209	1632	1712	0	80	80	1.0000000
NODE_1154_length_2183_cov_45.471209	1685	1765	0	80	80	1.0000000
NODE_1159_length_2176_cov_47.338950	0	52	4	52	52	1.0000000
NODE_1162_length_2174_cov_40.560964	1638	1718	0	39	80	0.4875000
NODE_1162_length_2174_cov_40.560964	1638	1718	3	12	80	0.1500000
NODE_1162_length_2174_cov_40.560964	1638	1718	6	29	80	0.3625000
NODE_1162_length_2174_cov_40.560964	1691	1771	6	43	80	0.5375000
NODE_1162_length_2174_cov_40.560964	1691	1771	8	37	80	0.4625000
NODE_1163_length_2174_cov_35.399518	284	364	0	26	80	0.3250000
NODE_1163_length_2174_cov_35.399518	284	364	2	54	80	0.6750000
NODE_1163_length_2174_cov_35.399518	337	414	2	77	77	1.0000000
NODE_1163_length_2174_cov_35.399518	1542	1620	270	2	78	0.0256410
NODE_1163_length_2174_cov_35.399518	1542	1620	271	3	78	0.0384615
NODE_1163_length_2174_cov_35.399518	1542	1620	272	2	78	0.0256410
NODE_1163_length_2174_cov_35.399518	1542	1620	275	1	78	0.0128205
NODE_1163_length_2174_cov_35.399518	1542	1620	277	2	78	0.0256410
NODE_1163_length_2174_cov_35.399518	1542	1620	279	1	78	0.0128205
NODE_1163_length_2174_cov_35.399518	1542	1620	280	1	78	0.0128205
NODE_1163_length_2174_cov_35.399518	1542	1620	281	6	78	0.0769231
NODE_1163_length_2174_cov_35.399518	1542	1620	282	4	78	0.0512821
NODE_1163_length_2174_cov_35.399518	1542	1620	283	1	78	0.0128205
NODE_1163_length_2174_cov_35.399518	1542	1620	284	1	78	0.0128205
NODE_1163_length_2174_cov_35.399518	1542	1620	285	1	78	0.0128205
NODE_1163_length_2174_cov_35.399518	1542	1620	287	2	78	0.0256410
NODE_1163_length_2174_cov_35.399518	1542	1620	292	1	78	0.0128205
NODE_1163_length_2174_cov_35.399518	1542	1620	293	2	78	0.0256410
NODE_1163_length_2174_cov_35.399518	1542	1620	294	1	78	0.0128205
NODE_1163_length_2174_cov_35.399518	1542	1620	297	1	78	0.0128205
NODE_1163_length_2174_cov_35.399518	1542	1620	299	1	78	0.0128205
NODE_1163_length_2174_cov_35.399518	1542	1620	300	1	78	0.0128205
NODE_1163_length_2174_cov_35.399518	1542	1620	301	1	78	0.0128205
NODE_1163_length_2174_cov_35.399518	1542	1620	310	1	78	0.0128205
NODE_1163_length_2174_cov_35.399518	1542	1620	317	1	78	0.0128205
NODE_1163_length_2174_cov_35.399518	1542	1620	323	1	78	0.0128205
NODE_1163_length_2174_cov_35.399518	1542	1620	331	1	78	0.0128205
NODE_1163_length_2174_cov_35.399518	1542	1620	332	1	78	0.0128205
NODE_1163_length_2174_cov_35.399518	1542	1620	334	2	78	0.0256410
NODE_1163_length_2174_cov_35.399518	1542	1620	335	1	78	0.0128205
NODE_1163_length_2174_cov_35.399518	1542	1620	336	1	78	0.0128205
NODE_1163_length_2174_cov_35.399518	1542	1620	345	3	78	0.0384615
NODE_1163_length_2174_cov_35.399518	1542	1620	347	3	78	0.0384615
NODE_1163_length_2174_cov_35.399518	1542	1620	350	3	78	0.0384615
NODE_1163_length_2174_cov_35.399518	1542	1620	351	1	78	0.0128205
NODE_1163_length_2174_cov_35.399518	1542	1620	352	2	78	0.0256410
NODE_1163_length_2174_cov_35.399518	1542	1620	353	4	78	0.0512821
NODE_1163_length_2174_cov_35.399518	1542	1620	354	4	78	0.0512821
NODE_1163_length_2174_cov_35.399518	1542	1620	357	2	78	0.0256410
NODE_1163_length_2174_cov_35.399518	1542	1620	358	4	78	0.0512821
NODE_1163_length_2174_cov_35.399518	1542	1620	361	2	78	0.0256410
NODE_1163_length_2174_cov_35.399518	1542	1620	362	1	78	0.0128205
NODE_1163_length_2174_cov_35.399518	1542	1620	363	2	78	0.0256410
NODE_1163_length_2174_cov_35.399518	1542	1620	364	1	78	0.0128205
NODE_1163_length_2174_cov_35.399518	1542	1620	367	1	78	0.0128205
NODE_1163_length_2174_cov_35.399518	1542	1620	368	1	78	0.0128205
NODE_1163_length_2174_cov_35.399518	1593	1673	249	1	80	0.0125000
NODE_1163_length_2174_cov_35.399518	1593	1673	250	1	80	0.0125000
NODE_1163_length_2174_cov_35.399518	1593	1673	251	1	80	0.0125000
NODE_1163_length_2174_cov_35.399518	1593	1673	252	1	80	0.0125000
NODE_1163_length_2174_cov_35.399518	1593	1673	253	2	80	0.0250000
NODE_1163_length_2174_cov_35.399518	1593	1673	254	5	80	0.0625000
NODE_1163_length_2174_cov_35.399518	1593	1673	256	5	80	0.0625000
NODE_1163_length_2174_cov_35.399518	1593	1673	258	5	80	0.0625000
NODE_1163_length_2174_cov_35.399518	1593	1673	261	3	80	0.0375000
NODE_1163_length_2174_cov_35.399518	1593	1673	262	1	80	0.0125000
NODE_1163_length_2174_cov_35.399518	1593	1673	263	4	80	0.0500000
NODE_1163_length_2174_cov_35.399518	1593	1673	264	1	80	0.0125000
NODE_1163_length_2174_cov_35.399518	1593	1673	265	5	80	0.0625000
NODE_1163_length_2174_cov_35.399518	1593	1673	268	1	80	0.0125000
NODE_1163_length_2174_cov_35.399518	1593	1673	269	1	80	0.0125000
NODE_1163_length_2174_cov_35.399518	1593	1673	270	4	80	0.0500000
NODE_1163_length_2174_cov_35.399518	1593	1673	271	6	80	0.0750000
NODE_1163_length_2174_cov_35.399518	1593	1673	272	6	80	0.0750000
NODE_1163_length_2174_cov_35.399518	1593	1673	274	3	80	0.0375000
NODE_1163_length_2174_cov_35.399518	1593	1673	275	3	80	0.0375000
NODE_1163_length_2174_cov_35.399518	1593	1673	277	2	80	0.0250000
NODE_1163_length_2174_cov_35.399518	1593	1673	279	3	80	0.0375000
NODE_1163_length_2174_cov_35.399518	1593	1673	280	1	80	0.0125000
NODE_1163_length_2174_cov_35.399518	1593	1673	281	6	80	0.0750000
NODE_1163_length_2174_cov_35.399518	1593	1673	282	4	80	0.0500000
NODE_1163_length_2174_cov_35.399518	1593	1673	283	1	80	0.0125000
NODE_1163_length_2174_cov_35.399518	1593	1673	284	1	80	0.0125000
NODE_1163_length_2174_cov_35.399518	1593	1673	285	1	80	0.0125000
NODE_1163_length_2174_cov_35.399518	1593	1673	287	2	80	0.0250000
NODE_1163_length_2174_cov_35.399518	2075	2152	63	10	77	0.1298701
NODE_1163_length_2174_cov_35.399518	2075	2152	64	67	77	0.8701299
NODE_1163_length_2174_cov_35.399518	2075	2152	63	10	77	0.1298701
NODE_1163_length_2174_cov_35.399518	2075	2152	64	67	77	0.8701299
NODE_1163_length_2174_cov_35.399518	2075	2152	63	10	77	0.1298701
NODE_1163_length_2174_cov_35.399518	2075	2152	64	67	77	0.8701299
NODE_1163_length_2174_cov_35.399518	2125	2174	2	3	49	0.0612245
NODE_1163_length_2174_cov_35.399518	2125	2174	6	6	49	0.1224490
NODE_1163_length_2174_cov_35.399518	2125	2174	8	3	49	0.0612245
NODE_1163_length_2174_cov_35.399518	2125	2174	31	1	49	0.0204082
NODE_1163_length_2174_cov_35.399518	2125	2174	34	2	49	0.0408163
NODE_1163_length_2174_cov_35.399518	2125	2174	36	1	49	0.0204082
NODE_1163_length_2174_cov_35.399518	2125	2174	43	1	49	0.0204082
NODE_1163_length_2174_cov_35.399518	2125	2174	64	32	49	0.6530612
NODE_1163_length_2174_cov_35.399518	2128	2174	2	3	46	0.0652174
NODE_1163_length_2174_cov_35.399518	2128	2174	6	6	46	0.1304348
NODE_1163_length_2174_cov_35.399518	2128	2174	8	3	46	0.0652174
NODE_1163_length_2174_cov_35.399518	2128	2174	31	1	46	0.0217391
NODE_1163_length_2174_cov_35.399518	2128	2174	34	2	46	0.0434783
NODE_1163_length_2174_cov_35.399518	2128	2174	36	1	46	0.0217391
NODE_1163_length_2174_cov_35.399518	2128	2174	43	1	46	0.0217391
NODE_1163_length_2174_cov_35.399518	2128	2174	64	29	46	0.6304348
NODE_1163_length_2174_cov_35.399518	2130	2174	2	3	44	0.0681818
NODE_1163_length_2174_cov_35.399518	2130	2174	6	6	44	0.1363636
NODE_1163_length_2174_cov_35.399518	2130	2174	8	3	44	0.0681818
NODE_1163_length_2174_cov_35.399518	2130	2174	31	1	44	0.0227273
NODE_1163_length_2174_cov_35.399518	2130	2174	34	2	44	0.0454545
NODE_1163_length_2174_cov_35.399518	2130	2174	36	1	44	0.0227273
NODE_1163_length_2174_cov_35.399518	2130	2174	43	1	44	0.0227273
NODE_1163_length_2174_cov_35.399518	2130	2174	64	27	44	0.6136364
NODE_1164_length_2172_cov_44.861553	1110	1190	11	6	80	0.0750000
NODE_1164_length_2172_cov_44.861553	1110	1190	13	74	80	0.9250000
NODE_1164_length_2172_cov_44.861553	1163	1243	6	3	80	0.0375000
NODE_1164_length_2172_cov_44.861553	1163	1243	8	15	80	0.1875000
NODE_1164_length_2172_cov_44.861553	1163	1243	9	17	80	0.2125000
NODE_1164_length_2172_cov_44.861553	1163	1243	10	16	80	0.2000000
NODE_1164_length_2172_cov_44.861553	1163	1243	11	4	80	0.0500000
NODE_1164_length_2172_cov_44.861553	1163	1243	13	25	80	0.3125000
NODE_1164_length_2172_cov_44.861553	1239	1319	2	11	80	0.1375000
NODE_1164_length_2172_cov_44.861553	1239	1319	4	17	80	0.2125000
NODE_1164_length_2172_cov_44.861553	1239	1319	6	4	80	0.0500000
NODE_1164_length_2172_cov_44.861553	1239	1319	8	8	80	0.1000000
NODE_1164_length_2172_cov_44.861553	1239	1319	12	40	80	0.5000000
NODE_1164_length_2172_cov_44.861553	1292	1372	6	18	80	0.2250000
NODE_1164_length_2172_cov_44.861553	1292	1372	10	1	80	0.0125000
NODE_1164_length_2172_cov_44.861553	1292	1372	12	61	80	0.7625000
NODE_1166_length_2167_cov_33.133946	414	494	0	80	80	1.0000000
NODE_1166_length_2167_cov_33.133946	467	547	0	80	80	1.0000000
NODE_1166_length_2167_cov_33.133946	543	623	0	80	80	1.0000000
NODE_1166_length_2167_cov_33.133946	596	676	0	80	80	1.0000000
NODE_1169_length_2165_cov_21.460794	980	1060	2	2	80	0.0250000
NODE_1169_length_2165_cov_21.460794	980	1060	6	7	80	0.0875000
NODE_1169_length_2165_cov_21.460794	980	1060	10	69	80	0.8625000
NODE_1169_length_2165_cov_21.460794	980	1060	11	1	80	0.0125000
NODE_1169_length_2165_cov_21.460794	980	1060	12	1	80	0.0125000
NODE_1169_length_2165_cov_21.460794	1033	1113	0	27	80	0.3375000
NODE_1169_length_2165_cov_21.460794	1033	1113	6	10	80	0.1250000
NODE_1169_length_2165_cov_21.460794	1033	1113	10	43	80	0.5375000
NODE_1176_length_2157_cov_22.284257	989	1069	2	80	80	1.0000000
NODE_1176_length_2157_cov_22.284257	1042	1122	0	12	80	0.1500000
NODE_1176_length_2157_cov_22.284257	1042	1122	1	14	80	0.1750000
NODE_1176_length_2157_cov_22.284257	1042	1122	2	54	80	0.6750000
NODE_1176_length_2157_cov_22.284257	1118	1198	0	80	80	1.0000000
NODE_1176_length_2157_cov_22.284257	1171	1251	0	37	80	0.4625000
NODE_1176_length_2157_cov_22.284257	1171	1251	2	21	80	0.2625000
NODE_1176_length_2157_cov_22.284257	1171	1251	6	22	80	0.2750000
NODE_1177_length_2157_cov_8.830418	867	947	0	74	80	0.9250000
NODE_1177_length_2157_cov_8.830418	867	947	1	6	80	0.0750000
NODE_1177_length_2157_cov_8.830418	920	1000	0	21	80	0.2625000
NODE_1177_length_2157_cov_8.830418	920	1000	1	59	80	0.7375000
NODE_1177_length_2157_cov_8.830418	996	1076	1	19	80	0.2375000
NODE_1177_length_2157_cov_8.830418	996	1076	3	12	80	0.1500000
NODE_1177_length_2157_cov_8.830418	996	1076	5	47	80	0.5875000
NODE_1177_length_2157_cov_8.830418	996	1076	6	2	80	0.0250000
NODE_1177_length_2157_cov_8.830418	1049	1129	1	29	80	0.3625000
NODE_1177_length_2157_cov_8.830418	1049	1129	3	7	80	0.0875000
NODE_1177_length_2157_cov_8.830418	1049	1129	5	27	80	0.3375000
NODE_1177_length_2157_cov_8.830418	1049	1129	6	17	80	0.2125000
NODE_1178_length_2156_cov_25.065630	0	41	11	1	41	0.0243902
NODE_1178_length_2156_cov_25.065630	0	41	13	4	41	0.0975610
NODE_1178_length_2156_cov_25.065630	0	41	21	1	41	0.0243902
NODE_1178_length_2156_cov_25.065630	0	41	23	1	41	0.0243902
NODE_1178_length_2156_cov_25.065630	0	41	27	2	41	0.0487805
NODE_1178_length_2156_cov_25.065630	0	41	29	1	41	0.0243902
NODE_1178_length_2156_cov_25.065630	0	41	33	1	41	0.0243902
NODE_1178_length_2156_cov_25.065630	0	41	37	1	41	0.0243902
NODE_1178_length_2156_cov_25.065630	0	41	45	1	41	0.0243902
NODE_1178_length_2156_cov_25.065630	0	41	51	2	41	0.0487805
NODE_1178_length_2156_cov_25.065630	0	41	56	1	41	0.0243902
NODE_1178_length_2156_cov_25.065630	0	41	58	1	41	0.0243902
NODE_1178_length_2156_cov_25.065630	0	41	63	1	41	0.0243902
NODE_1178_length_2156_cov_25.065630	0	41	64	1	41	0.0243902
NODE_1178_length_2156_cov_25.065630	0	41	68	1	41	0.0243902
NODE_1178_length_2156_cov_25.065630	0	41	72	4	41	0.0975610
NODE_1178_length_2156_cov_25.065630	0	41	74	1	41	0.0243902
NODE_1178_length_2156_cov_25.065630	0	41	75	3	41	0.0731707
NODE_1178_length_2156_cov_25.065630	0	41	77	1	41	0.0243902
NODE_1178_length_2156_cov_25.065630	0	41	79	1	41	0.0243902
NODE_1178_length_2156_cov_25.065630	0	41	81	3	41	0.0731707
NODE_1178_length_2156_cov_25.065630	0	41	83	1	41	0.0243902
NODE_1178_length_2156_cov_25.065630	0	41	85	6	41	0.1463415
NODE_1178_length_2156_cov_25.065630	0	41	89	1	41	0.0243902
NODE_1178_length_2156_cov_25.065630	14	94	51	1	80	0.0125000
NODE_1178_length_2156_cov_25.065630	14	94	56	1	80	0.0125000
NODE_1178_length_2156_cov_25.065630	14	94	58	1	80	0.0125000
NODE_1178_length_2156_cov_25.065630	14	94	63	1	80	0.0125000
NODE_1178_length_2156_cov_25.065630	14	94	64	1	80	0.0125000
NODE_1178_length_2156_cov_25.065630	14	94	68	1	80	0.0125000
NODE_1178_length_2156_cov_25.065630	14	94	72	4	80	0.0500000
NODE_1178_length_2156_cov_25.065630	14	94	74	1	80	0.0125000
NODE_1178_length_2156_cov_25.065630	14	94	75	3	80	0.0375000
NODE_1178_length_2156_cov_25.065630	14	94	77	1	80	0.0125000
NODE_1178_length_2156_cov_25.065630	14	94	79	1	80	0.0125000
NODE_1178_length_2156_cov_25.065630	14	94	81	3	80	0.0375000
NODE_1178_length_2156_cov_25.065630	14	94	83	1	80	0.0125000
NODE_1178_length_2156_cov_25.065630	14	94	85	6	80	0.0750000
NODE_1178_length_2156_cov_25.065630	14	94	89	3	80	0.0375000
NODE_1178_length_2156_cov_25.065630	14	94	93	3	80	0.0375000
NODE_1178_length_2156_cov_25.065630	14	94	95	1	80	0.0125000
NODE_1178_length_2156_cov_25.065630	14	94	97	11	80	0.1375000
NODE_1178_length_2156_cov_25.065630	14	94	101	3	80	0.0375000
NODE_1178_length_2156_cov_25.065630	14	94	103	3	80	0.0375000
NODE_1178_length_2156_cov_25.065630	14	94	105	5	80	0.0625000
NODE_1178_length_2156_cov_25.065630	14	94	107	9	80	0.1125000
NODE_1178_length_2156_cov_25.065630	14	94	109	2	80	0.0250000
NODE_1178_length_2156_cov_25.065630	14	94	115	8	80	0.1000000
NODE_1178_length_2156_cov_25.065630	14	94	117	1	80	0.0125000
NODE_1178_length_2156_cov_25.065630	14	94	121	5	80	0.0625000
NODE_1181_length_2156_cov_3.216334	1890	1970	0	80	80	1.0000000
NODE_1181_length_2156_cov_3.216334	1943	2023	0	80	80	1.0000000
NODE_1184_length_2153_cov_11.610029	1968	2048	0	9	80	0.1125000
NODE_1184_length_2153_cov_11.610029	1968	2048	2	58	80	0.7250000
NODE_1184_length_2153_cov_11.610029	1968	2048	4	1	80	0.0125000
NODE_1184_length_2153_cov_11.610029	1968	2048	6	3	80	0.0375000
NODE_1184_length_2153_cov_11.610029	1968	2048	10	2	80	0.0250000
NODE_1184_length_2153_cov_11.610029	1968	2048	12	1	80	0.0125000
NODE_1184_length_2153_cov_11.610029	1968	2048	16	1	80	0.0125000
NODE_1184_length_2153_cov_11.610029	1968	2048	20	1	80	0.0125000
NODE_1184_length_2153_cov_11.610029	1968	2048	22	2	80	0.0250000
NODE_1184_length_2153_cov_11.610029	1968	2048	26	2	80	0.0250000
NODE_1184_length_2153_cov_11.610029	1977	2048	0	9	71	0.1267606
NODE_1184_length_2153_cov_11.610029	1977	2048	2	49	71	0.6901408
NODE_1184_length_2153_cov_11.610029	1977	2048	4	1	71	0.0140845
NODE_1184_length_2153_cov_11.610029	1977	2048	6	3	71	0.0422535
NODE_1184_length_2153_cov_11.610029	1977	2048	10	2	71	0.0281690
NODE_1184_length_2153_cov_11.610029	1977	2048	12	1	71	0.0140845
NODE_1184_length_2153_cov_11.610029	1977	2048	16	1	71	0.0140845
NODE_1184_length_2153_cov_11.610029	1977	2048	20	1	71	0.0140845
NODE_1184_length_2153_cov_11.610029	1977	2048	22	2	71	0.0281690
NODE_1184_length_2153_cov_11.610029	1977	2048	26	2	71	0.0281690
NODE_1190_length_2147_cov_25.116211	814	894	12	14	80	0.1750000
NODE_1190_length_2147_cov_25.116211	814	894	14	7	80	0.0875000
NODE_1190_length_2147_cov_25.116211	814	894	15	4	80	0.0500000
NODE_1190_length_2147_cov_25.116211	814	894	16	16	80	0.2000000
NODE_1190_length_2147_cov_25.116211	814	894	17	7	80	0.0875000
NODE_1190_length_2147_cov_25.116211	814	894	18	32	80	0.4000000
NODE_1190_length_2147_cov_25.116211	867	947	4	12	80	0.1500000
NODE_1190_length_2147_cov_25.116211	867	947	5	3	80	0.0375000
NODE_1190_length_2147_cov_25.116211	867	947	6	16	80	0.2000000
NODE_1190_length_2147_cov_25.116211	867	947	8	1	80	0.0125000
NODE_1190_length_2147_cov_25.116211	867	947	12	11	80	0.1375000
NODE_1190_length_2147_cov_25.116211	867	947	14	10	80	0.1250000
NODE_1190_length_2147_cov_25.116211	867	947	15	4	80	0.0500000
NODE_1190_length_2147_cov_25.116211	867	947	16	14	80	0.1750000
NODE_1190_length_2147_cov_25.116211	867	947	17	7	80	0.0875000
NODE_1190_length_2147_cov_25.116211	867	947	18	2	80	0.0250000
NODE_1197_length_2136_cov_16.947472	279	359	0	24	80	0.3000000
NODE_1197_length_2136_cov_16.947472	279	359	2	56	80	0.7000000
NODE_1197_length_2136_cov_16.947472	332	412	2	78	80	0.9750000
NODE_1197_length_2136_cov_16.947472	332	412	4	2	80	0.0250000
NODE_1197_length_2136_cov_16.947472	408	488	2	13	80	0.1625000
NODE_1197_length_2136_cov_16.947472	408	488	4	67	80	0.8375000
NODE_1197_length_2136_cov_16.947472	461	541	0	39	80	0.4875000
NODE_1197_length_2136_cov_16.947472	461	541	2	16	80	0.2000000
NODE_1197_length_2136_cov_16.947472	461	541	4	25	80	0.3125000
NODE_1199_length_2133_cov_15.038840	498	578	4	15	80	0.1875000
NODE_1199_length_2133_cov_15.038840	498	578	6	1	80	0.0125000
NODE_1199_length_2133_cov_15.038840	498	578	10	2	80	0.0250000
NODE_1199_length_2133_cov_15.038840	498	578	11	25	80	0.3125000
NODE_1199_length_2133_cov_15.038840	498	578	12	37	80	0.4625000
NODE_1199_length_2133_cov_15.038840	551	631	0	32	80	0.4000000
NODE_1199_length_2133_cov_15.038840	551	631	2	12	80	0.1500000
NODE_1199_length_2133_cov_15.038840	551	631	4	24	80	0.3000000
NODE_1199_length_2133_cov_15.038840	551	631	6	1	80	0.0125000
NODE_1199_length_2133_cov_15.038840	551	631	11	11	80	0.1375000
NODE_1199_length_2133_cov_15.038840	627	707	0	80	80	1.0000000
NODE_1199_length_2133_cov_15.038840	680	722	0	42	42	1.0000000
NODE_1204_length_2128_cov_11.799409	1698	1778	0	80	80	1.0000000
NODE_1204_length_2128_cov_11.799409	1751	1831	0	80	80	1.0000000
NODE_1206_length_2126_cov_6.854465	1614	1694	0	80	80	1.0000000
NODE_1206_length_2126_cov_6.854465	1667	1747	0	80	80	1.0000000
NODE_1209_length_2123_cov_12.668478	102	143	2	41	41	1.0000000
NODE_1209_length_2123_cov_12.668478	1474	1500	4	26	26	1.0000000
NODE_1209_length_2123_cov_12.668478	1552	1601	7	10	49	0.2040816
NODE_1209_length_2123_cov_12.668478	1552	1601	8	30	49	0.6122449
NODE_1209_length_2123_cov_12.668478	1552	1601	9	9	49	0.1836735
NODE_1209_length_2123_cov_12.668478	1574	1654	8	47	80	0.5875000
NODE_1209_length_2123_cov_12.668478	1574	1654	10	33	80	0.4125000
NODE_1211_length_2121_cov_10.101879	497	577	0	80	80	1.0000000
NODE_1211_length_2121_cov_10.101879	550	630	0	80	80	1.0000000
NODE_1211_length_2121_cov_10.101879	1935	2008	2	1	73	0.0136986
NODE_1211_length_2121_cov_10.101879	1935	2008	4	5	73	0.0684932
NODE_1211_length_2121_cov_10.101879	1935	2008	6	13	73	0.1780822
NODE_1211_length_2121_cov_10.101879	1935	2008	10	19	73	0.2602740
NODE_1211_length_2121_cov_10.101879	1935	2008	14	31	73	0.4246575
NODE_1211_length_2121_cov_10.101879	1935	2008	16	4	73	0.0547945
NODE_1212_length_2121_cov_9.964886	1523	1603	0	19	80	0.2375000
NODE_1212_length_2121_cov_9.964886	1523	1603	7	28	80	0.3500000
NODE_1212_length_2121_cov_9.964886	1523	1603	8	33	80	0.4125000
NODE_1212_length_2121_cov_9.964886	1576	1656	0	72	80	0.9000000
NODE_1212_length_2121_cov_9.964886	1576	1656	7	8	80	0.1000000
NODE_1213_length_2120_cov_24.609599	25	92	0	67	67	1.0000000
NODE_1215_length_2119_cov_18.446040	366	446	0	80	80	1.0000000
NODE_1215_length_2119_cov_18.446040	419	499	0	80	80	1.0000000
NODE_1215_length_2119_cov_18.446040	1239	1319	0	80	80	1.0000000
NODE_1215_length_2119_cov_18.446040	1292	1372	0	80	80	1.0000000
NODE_1225_length_2110_cov_8.668324	1755	1835	0	80	80	1.0000000
NODE_1225_length_2110_cov_8.668324	1808	1888	0	80	80	1.0000000
NODE_1227_length_2106_cov_14.643747	1579	1659	0	37	80	0.4625000
NODE_1227_length_2106_cov_14.643747	1579	1659	3	19	80	0.2375000
NODE_1227_length_2106_cov_14.643747	1579	1659	5	9	80	0.1125000
NODE_1227_length_2106_cov_14.643747	1579	1659	6	15	80	0.1875000
NODE_1227_length_2106_cov_14.643747	1632	1712	0	80	80	1.0000000
NODE_1227_length_2106_cov_14.643747	1708	1786	0	78	78	1.0000000
NODE_1227_length_2106_cov_14.643747	1759	1839	0	73	80	0.9125000
NODE_1227_length_2106_cov_14.643747	1759	1839	2	6	80	0.0750000
NODE_1227_length_2106_cov_14.643747	1759	1839	6	1	80	0.0125000
NODE_1228_length_2106_cov_3.173393	48	96	0	48	48	1.0000000
NODE_1228_length_2106_cov_3.173393	48	96	0	48	48	1.0000000
NODE_1228_length_2106_cov_3.173393	48	96	0	48	48	1.0000000
NODE_1228_length_2106_cov_3.173393	48	96	0	48	48	1.0000000
NODE_1228_length_2106_cov_3.173393	48	96	0	48	48	1.0000000
NODE_1229_length_2102_cov_23.872192	390	470	0	76	80	0.9500000
NODE_1229_length_2102_cov_23.872192	390	470	2	4	80	0.0500000
NODE_1229_length_2102_cov_23.872192	443	523	0	23	80	0.2875000
NODE_1229_length_2102_cov_23.872192	443	523	2	57	80	0.7125000
NODE_1229_length_2102_cov_23.872192	519	599	0	7	80	0.0875000
NODE_1229_length_2102_cov_23.872192	519	599	2	73	80	0.9125000
NODE_1229_length_2102_cov_23.872192	572	652	2	33	80	0.4125000
NODE_1229_length_2102_cov_23.872192	572	652	4	18	80	0.2250000
NODE_1229_length_2102_cov_23.872192	572	652	6	29	80	0.3625000
NODE_1229_length_2102_cov_23.872192	1049	1101	419	1	52	0.0192308
NODE_1229_length_2102_cov_23.872192	1049	1101	421	1	52	0.0192308
NODE_1229_length_2102_cov_23.872192	1049	1101	422	3	52	0.0576923
NODE_1229_length_2102_cov_23.872192	1049	1101	423	1	52	0.0192308
NODE_1229_length_2102_cov_23.872192	1049	1101	424	1	52	0.0192308
NODE_1229_length_2102_cov_23.872192	1049	1101	426	1	52	0.0192308
NODE_1229_length_2102_cov_23.872192	1049	1101	430	1	52	0.0192308
NODE_1229_length_2102_cov_23.872192	1049	1101	433	1	52	0.0192308
NODE_1229_length_2102_cov_23.872192	1049	1101	442	1	52	0.0192308
NODE_1229_length_2102_cov_23.872192	1049	1101	450	1	52	0.0192308
NODE_1229_length_2102_cov_23.872192	1049	1101	454	1	52	0.0192308
NODE_1229_length_2102_cov_23.872192	1049	1101	456	3	52	0.0576923
NODE_1229_length_2102_cov_23.872192	1049	1101	458	1	52	0.0192308
NODE_1229_length_2102_cov_23.872192	1049	1101	461	1	52	0.0192308
NODE_1229_length_2102_cov_23.872192	1049	1101	463	1	52	0.0192308
NODE_1229_length_2102_cov_23.872192	1049	1101	464	2	52	0.0384615
NODE_1229_length_2102_cov_23.872192	1049	1101	468	1	52	0.0192308
NODE_1229_length_2102_cov_23.872192	1049	1101	479	1	52	0.0192308
NODE_1229_length_2102_cov_23.872192	1049	1101	482	1	52	0.0192308
NODE_1229_length_2102_cov_23.872192	1049	1101	490	1	52	0.0192308
NODE_1229_length_2102_cov_23.872192	1049	1101	496	1	52	0.0192308
NODE_1229_length_2102_cov_23.872192	1049	1101	506	1	52	0.0192308
NODE_1229_length_2102_cov_23.872192	1049	1101	518	1	52	0.0192308
NODE_1229_length_2102_cov_23.872192	1049	1101	520	1	52	0.0192308
NODE_1229_length_2102_cov_23.872192	1049	1101	525	1	52	0.0192308
NODE_1229_length_2102_cov_23.872192	1049	1101	540	2	52	0.0384615
NODE_1229_length_2102_cov_23.872192	1049	1101	541	1	52	0.0192308
NODE_1229_length_2102_cov_23.872192	1049	1101	542	1	52	0.0192308
NODE_1229_length_2102_cov_23.872192	1049	1101	545	1	52	0.0192308
NODE_1229_length_2102_cov_23.872192	1049	1101	546	7	52	0.1346154
NODE_1229_length_2102_cov_23.872192	1049	1101	547	2	52	0.0384615
NODE_1229_length_2102_cov_23.872192	1049	1101	548	3	52	0.0576923
NODE_1229_length_2102_cov_23.872192	1049	1101	549	2	52	0.0384615
NODE_1229_length_2102_cov_23.872192	1049	1101	550	2	52	0.0384615
NODE_1229_length_2102_cov_23.872192	1049	1101	553	1	52	0.0192308
NODE_1231_length_2100_cov_21.504248	450	530	0	80	80	1.0000000
NODE_1231_length_2100_cov_21.504248	503	578	0	75	75	1.0000000
NODE_1231_length_2100_cov_21.504248	579	659	0	80	80	1.0000000
NODE_1231_length_2100_cov_21.504248	632	712	0	80	80	1.0000000
NODE_1231_length_2100_cov_21.504248	1420	1500	0	80	80	1.0000000
NODE_1231_length_2100_cov_21.504248	1473	1553	0	80	80	1.0000000
NODE_1232_length_2100_cov_6.399300	1510	1590	0	6	80	0.0750000
NODE_1232_length_2100_cov_6.399300	1510	1590	2	55	80	0.6875000
NODE_1232_length_2100_cov_6.399300	1510	1590	4	19	80	0.2375000
NODE_1232_length_2100_cov_6.399300	1559	1590	0	6	31	0.1935484
NODE_1232_length_2100_cov_6.399300	1559	1590	2	25	31	0.8064516
NODE_1232_length_2100_cov_6.399300	1563	1644	0	60	81	0.7407407
NODE_1232_length_2100_cov_6.399300	1563	1644	2	21	81	0.2592593
NODE_1232_length_2100_cov_6.399300	1563	1644	0	60	81	0.7407407
NODE_1232_length_2100_cov_6.399300	1563	1644	2	21	81	0.2592593
NODE_1234_length_2099_cov_40.603500	960	1040	2	75	80	0.9375000
NODE_1234_length_2099_cov_40.603500	960	1040	4	5	80	0.0625000
NODE_1234_length_2099_cov_40.603500	1013	1093	0	16	80	0.2000000
NODE_1234_length_2099_cov_40.603500	1013	1093	2	64	80	0.8000000
NODE_1234_length_2099_cov_40.603500	1089	1169	0	47	80	0.5875000
NODE_1234_length_2099_cov_40.603500	1089	1169	2	9	80	0.1125000
NODE_1234_length_2099_cov_40.603500	1089	1169	4	2	80	0.0250000
NODE_1234_length_2099_cov_40.603500	1089	1169	6	3	80	0.0375000
NODE_1234_length_2099_cov_40.603500	1089	1169	8	1	80	0.0125000
NODE_1234_length_2099_cov_40.603500	1089	1169	14	12	80	0.1500000
NODE_1234_length_2099_cov_40.603500	1089	1169	18	6	80	0.0750000
NODE_1234_length_2099_cov_40.603500	1142	1222	2	3	80	0.0375000
NODE_1234_length_2099_cov_40.603500	1142	1222	4	2	80	0.0250000
NODE_1234_length_2099_cov_40.603500	1142	1222	6	3	80	0.0375000
NODE_1234_length_2099_cov_40.603500	1142	1222	8	1	80	0.0125000
NODE_1234_length_2099_cov_40.603500	1142	1222	14	12	80	0.1500000
NODE_1234_length_2099_cov_40.603500	1142	1222	18	22	80	0.2750000
NODE_1234_length_2099_cov_40.603500	1142	1222	19	13	80	0.1625000
NODE_1234_length_2099_cov_40.603500	1142	1222	20	24	80	0.3000000
NODE_1235_length_2098_cov_62.733867	1042	1122	0	31	80	0.3875000
NODE_1235_length_2098_cov_62.733867	1042	1122	10	49	80	0.6125000
NODE_1235_length_2098_cov_62.733867	1095	1175	0	47	80	0.5875000
NODE_1235_length_2098_cov_62.733867	1095	1175	3	1	80	0.0125000
NODE_1235_length_2098_cov_62.733867	1095	1175	6	32	80	0.4000000
NODE_1235_length_2098_cov_62.733867	1171	1251	6	80	80	1.0000000
NODE_1235_length_2098_cov_62.733867	1224	1304	0	9	80	0.1125000
NODE_1235_length_2098_cov_62.733867	1224	1304	3	1	80	0.0125000
NODE_1235_length_2098_cov_62.733867	1224	1304	5	2	80	0.0250000
NODE_1235_length_2098_cov_62.733867	1224	1304	6	68	80	0.8500000
NODE_1236_length_2098_cov_20.220110	550	630	0	80	80	1.0000000
NODE_1236_length_2098_cov_20.220110	603	683	0	80	80	1.0000000
NODE_1236_length_2098_cov_20.220110	1571	1651	0	40	80	0.5000000
NODE_1236_length_2098_cov_20.220110	1571	1651	2	40	80	0.5000000
NODE_1236_length_2098_cov_20.220110	1624	1704	0	11	80	0.1375000
NODE_1236_length_2098_cov_20.220110	1624	1704	2	69	80	0.8625000
NODE_1237_length_2098_cov_8.261631	324	404	0	78	80	0.9750000
NODE_1237_length_2098_cov_8.261631	324	404	1	1	80	0.0125000
NODE_1237_length_2098_cov_8.261631	324	404	2	1	80	0.0125000
NODE_1239_length_2095_cov_29.930862	1128	1209	124	1	81	0.0123457
NODE_1239_length_2095_cov_29.930862	1128	1209	135	1	81	0.0123457
NODE_1239_length_2095_cov_29.930862	1128	1209	152	1	81	0.0123457
NODE_1239_length_2095_cov_29.930862	1128	1209	164	1	81	0.0123457
NODE_1239_length_2095_cov_29.930862	1128	1209	170	1	81	0.0123457
NODE_1239_length_2095_cov_29.930862	1128	1209	174	1	81	0.0123457
NODE_1239_length_2095_cov_29.930862	1128	1209	184	1	81	0.0123457
NODE_1239_length_2095_cov_29.930862	1128	1209	191	1	81	0.0123457
NODE_1239_length_2095_cov_29.930862	1128	1209	201	1	81	0.0123457
NODE_1239_length_2095_cov_29.930862	1128	1209	209	1	81	0.0123457
NODE_1239_length_2095_cov_29.930862	1128	1209	223	1	81	0.0123457
NODE_1239_length_2095_cov_29.930862	1128	1209	235	1	81	0.0123457
NODE_1239_length_2095_cov_29.930862	1128	1209	243	1	81	0.0123457
NODE_1239_length_2095_cov_29.930862	1128	1209	245	1	81	0.0123457
NODE_1239_length_2095_cov_29.930862	1128	1209	258	1	81	0.0123457
NODE_1239_length_2095_cov_29.930862	1128	1209	261	2	81	0.0246914
NODE_1239_length_2095_cov_29.930862	1128	1209	265	2	81	0.0246914
NODE_1239_length_2095_cov_29.930862	1128	1209	269	2	81	0.0246914
NODE_1239_length_2095_cov_29.930862	1128	1209	277	1	81	0.0123457
NODE_1239_length_2095_cov_29.930862	1128	1209	281	1	81	0.0123457
NODE_1239_length_2095_cov_29.930862	1128	1209	287	1	81	0.0123457
NODE_1239_length_2095_cov_29.930862	1128	1209	291	1	81	0.0123457
NODE_1239_length_2095_cov_29.930862	1128	1209	293	1	81	0.0123457
NODE_1239_length_2095_cov_29.930862	1128	1209	314	1	81	0.0123457
NODE_1239_length_2095_cov_29.930862	1128	1209	331	1	81	0.0123457
NODE_1239_length_2095_cov_29.930862	1128	1209	337	1	81	0.0123457
NODE_1239_length_2095_cov_29.930862	1128	1209	355	1	81	0.0123457
NODE_1239_length_2095_cov_29.930862	1128	1209	358	1	81	0.0123457
NODE_1239_length_2095_cov_29.930862	1128	1209	367	2	81	0.0246914
NODE_1239_length_2095_cov_29.930862	1128	1209	372	1	81	0.0123457
NODE_1239_length_2095_cov_29.930862	1128	1209	373	1	81	0.0123457
NODE_1239_length_2095_cov_29.930862	1128	1209	380	1	81	0.0123457
NODE_1239_length_2095_cov_29.930862	1128	1209	388	1	81	0.0123457
NODE_1239_length_2095_cov_29.930862	1128	1209	391	1	81	0.0123457
NODE_1239_length_2095_cov_29.930862	1128	1209	398	2	81	0.0246914
NODE_1239_length_2095_cov_29.930862	1128	1209	405	1	81	0.0123457
NODE_1239_length_2095_cov_29.930862	1128	1209	407	1	81	0.0123457
NODE_1239_length_2095_cov_29.930862	1128	1209	423	1	81	0.0123457
NODE_1239_length_2095_cov_29.930862	1128	1209	427	1	81	0.0123457
NODE_1239_length_2095_cov_29.930862	1128	1209	434	1	81	0.0123457
NODE_1239_length_2095_cov_29.930862	1128	1209	449	1	81	0.0123457
NODE_1239_length_2095_cov_29.930862	1128	1209	451	1	81	0.0123457
NODE_1239_length_2095_cov_29.930862	1128	1209	463	1	81	0.0123457
NODE_1239_length_2095_cov_29.930862	1128	1209	464	1	81	0.0123457
NODE_1239_length_2095_cov_29.930862	1128	1209	467	1	81	0.0123457
NODE_1239_length_2095_cov_29.930862	1128	1209	469	1	81	0.0123457
NODE_1239_length_2095_cov_29.930862	1128	1209	470	1	81	0.0123457
NODE_1239_length_2095_cov_29.930862	1128	1209	476	1	81	0.0123457
NODE_1239_length_2095_cov_29.930862	1128	1209	479	4	81	0.0493827
NODE_1239_length_2095_cov_29.930862	1128	1209	485	1	81	0.0123457
NODE_1239_length_2095_cov_29.930862	1128	1209	491	1	81	0.0123457
NODE_1239_length_2095_cov_29.930862	1128	1209	509	2	81	0.0246914
NODE_1239_length_2095_cov_29.930862	1128	1209	513	1	81	0.0123457
NODE_1239_length_2095_cov_29.930862	1128	1209	519	1	81	0.0123457
NODE_1239_length_2095_cov_29.930862	1128	1209	530	2	81	0.0246914
NODE_1239_length_2095_cov_29.930862	1128	1209	552	1	81	0.0123457
NODE_1239_length_2095_cov_29.930862	1128	1209	554	2	81	0.0246914
NODE_1239_length_2095_cov_29.930862	1128	1209	558	1	81	0.0123457
NODE_1239_length_2095_cov_29.930862	1128	1209	566	1	81	0.0123457
NODE_1239_length_2095_cov_29.930862	1128	1209	568	1	81	0.0123457
NODE_1239_length_2095_cov_29.930862	1128	1209	572	1	81	0.0123457
NODE_1239_length_2095_cov_29.930862	1128	1209	576	1	81	0.0123457
NODE_1239_length_2095_cov_29.930862	1128	1209	586	1	81	0.0123457
NODE_1239_length_2095_cov_29.930862	1128	1209	588	1	81	0.0123457
NODE_1239_length_2095_cov_29.930862	1128	1209	592	1	81	0.0123457
NODE_1239_length_2095_cov_29.930862	1128	1209	600	1	81	0.0123457
NODE_1239_length_2095_cov_29.930862	1128	1209	606	2	81	0.0246914
NODE_1239_length_2095_cov_29.930862	1128	1209	623	1	81	0.0123457
NODE_1239_length_2095_cov_29.930862	1128	1209	630	1	81	0.0123457
NODE_1239_length_2095_cov_29.930862	1204	1258	600	1	54	0.0185185
NODE_1239_length_2095_cov_29.930862	1204	1258	606	2	54	0.0370370
NODE_1239_length_2095_cov_29.930862	1204	1258	623	1	54	0.0185185
NODE_1239_length_2095_cov_29.930862	1204	1258	630	1	54	0.0185185
NODE_1239_length_2095_cov_29.930862	1204	1258	655	1	54	0.0185185
NODE_1239_length_2095_cov_29.930862	1204	1258	656	1	54	0.0185185
NODE_1239_length_2095_cov_29.930862	1204	1258	661	1	54	0.0185185
NODE_1239_length_2095_cov_29.930862	1204	1258	670	1	54	0.0185185
NODE_1239_length_2095_cov_29.930862	1204	1258	672	2	54	0.0370370
NODE_1239_length_2095_cov_29.930862	1204	1258	686	1	54	0.0185185
NODE_1239_length_2095_cov_29.930862	1204	1258	688	3	54	0.0555556
NODE_1239_length_2095_cov_29.930862	1204	1258	690	2	54	0.0370370
NODE_1239_length_2095_cov_29.930862	1204	1258	691	1	54	0.0185185
NODE_1239_length_2095_cov_29.930862	1204	1258	692	1	54	0.0185185
NODE_1239_length_2095_cov_29.930862	1204	1258	693	2	54	0.0370370
NODE_1239_length_2095_cov_29.930862	1204	1258	697	1	54	0.0185185
NODE_1239_length_2095_cov_29.930862	1204	1258	700	2	54	0.0370370
NODE_1239_length_2095_cov_29.930862	1204	1258	701	4	54	0.0740741
NODE_1239_length_2095_cov_29.930862	1204	1258	702	1	54	0.0185185
NODE_1239_length_2095_cov_29.930862	1204	1258	706	1	54	0.0185185
NODE_1239_length_2095_cov_29.930862	1204	1258	707	1	54	0.0185185
NODE_1239_length_2095_cov_29.930862	1204	1258	709	3	54	0.0555556
NODE_1239_length_2095_cov_29.930862	1204	1258	710	1	54	0.0185185
NODE_1239_length_2095_cov_29.930862	1204	1258	711	1	54	0.0185185
NODE_1239_length_2095_cov_29.930862	1204	1258	712	3	54	0.0555556
NODE_1239_length_2095_cov_29.930862	1204	1258	713	2	54	0.0370370
NODE_1239_length_2095_cov_29.930862	1204	1258	714	1	54	0.0185185
NODE_1239_length_2095_cov_29.930862	1204	1258	715	2	54	0.0370370
NODE_1239_length_2095_cov_29.930862	1204	1258	716	1	54	0.0185185
NODE_1239_length_2095_cov_29.930862	1204	1258	718	2	54	0.0370370
NODE_1239_length_2095_cov_29.930862	1204	1258	719	1	54	0.0185185
NODE_1239_length_2095_cov_29.930862	1204	1258	720	1	54	0.0185185
NODE_1239_length_2095_cov_29.930862	1204	1258	721	1	54	0.0185185
NODE_1239_length_2095_cov_29.930862	1204	1258	723	2	54	0.0370370
NODE_1239_length_2095_cov_29.930862	1204	1258	729	2	54	0.0370370
NODE_1251_length_2084_cov_1.720403	959	1039	2	10	80	0.1250000
NODE_1251_length_2084_cov_1.720403	959	1039	4	32	80	0.4000000
NODE_1251_length_2084_cov_1.720403	959	1039	6	38	80	0.4750000
NODE_1251_length_2084_cov_1.720403	1012	1092	0	4	80	0.0500000
NODE_1251_length_2084_cov_1.720403	1012	1092	2	59	80	0.7375000
NODE_1251_length_2084_cov_1.720403	1012	1092	6	17	80	0.2125000
NODE_1252_length_2083_cov_5.864415	419	499	0	50	80	0.6250000
NODE_1252_length_2083_cov_5.864415	419	499	2	30	80	0.3750000
NODE_1252_length_2083_cov_5.864415	472	552	0	80	80	1.0000000
NODE_1252_length_2083_cov_5.864415	548	628	0	80	80	1.0000000
NODE_1252_length_2083_cov_5.864415	601	681	0	80	80	1.0000000
NODE_1256_length_2078_cov_47.394644	311	391	0	3	80	0.0375000
NODE_1256_length_2078_cov_47.394644	311	391	2	77	80	0.9625000
NODE_1256_length_2078_cov_47.394644	364	444	0	44	80	0.5500000
NODE_1256_length_2078_cov_47.394644	364	444	2	36	80	0.4500000
NODE_1256_length_2078_cov_47.394644	440	520	0	30	80	0.3750000
NODE_1256_length_2078_cov_47.394644	440	520	2	50	80	0.6250000
NODE_1256_length_2078_cov_47.394644	493	573	0	1	80	0.0125000
NODE_1256_length_2078_cov_47.394644	493	573	2	79	80	0.9875000
NODE_1267_length_2067_cov_13.647866	1349	1429	0	80	80	1.0000000
NODE_1267_length_2067_cov_13.647866	1402	1482	0	80	80	1.0000000
NODE_1269_length_2066_cov_19.127605	1497	1577	9	6	80	0.0750000
NODE_1269_length_2066_cov_19.127605	1497	1577	11	15	80	0.1875000
NODE_1269_length_2066_cov_19.127605	1497	1577	15	41	80	0.5125000
NODE_1269_length_2066_cov_19.127605	1497	1577	17	15	80	0.1875000
NODE_1269_length_2066_cov_19.127605	1497	1577	21	3	80	0.0375000
NODE_1269_length_2066_cov_19.127605	1550	1630	0	5	80	0.0625000
NODE_1269_length_2066_cov_19.127605	1550	1630	2	12	80	0.1500000
NODE_1269_length_2066_cov_19.127605	1550	1630	6	10	80	0.1250000
NODE_1269_length_2066_cov_19.127605	1550	1630	8	13	80	0.1625000
NODE_1269_length_2066_cov_19.127605	1550	1630	9	19	80	0.2375000
NODE_1269_length_2066_cov_19.127605	1550	1630	11	15	80	0.1875000
NODE_1269_length_2066_cov_19.127605	1550	1630	17	6	80	0.0750000
NODE_1274_length_2061_cov_43.187054	364	444	4	26	80	0.3250000
NODE_1274_length_2061_cov_43.187054	364	444	10	23	80	0.2875000
NODE_1274_length_2061_cov_43.187054	364	444	12	15	80	0.1875000
NODE_1274_length_2061_cov_43.187054	364	444	14	16	80	0.2000000
NODE_1274_length_2061_cov_43.187054	417	497	2	1	80	0.0125000
NODE_1274_length_2061_cov_43.187054	417	497	10	75	80	0.9375000
NODE_1274_length_2061_cov_43.187054	417	497	14	4	80	0.0500000
NODE_1275_length_2061_cov_3.251784	981	1033	0	52	52	1.0000000
NODE_1275_length_2061_cov_3.251784	1006	1086	0	80	80	1.0000000
NODE_1277_length_2058_cov_4.531394	1844	1875	2	28	31	0.9032258
NODE_1277_length_2058_cov_4.531394	1844	1875	4	3	31	0.0967742
NODE_1277_length_2058_cov_4.531394	1848	1928	2	45	80	0.5625000
NODE_1277_length_2058_cov_4.531394	1848	1928	3	1	80	0.0125000
NODE_1277_length_2058_cov_4.531394	1848	1928	4	21	80	0.2625000
NODE_1277_length_2058_cov_4.531394	1848	1928	6	13	80	0.1625000
NODE_1279_length_2056_cov_20.525805	749	829	0	80	80	1.0000000
NODE_1279_length_2056_cov_20.525805	802	882	0	80	80	1.0000000
NODE_1279_length_2056_cov_20.525805	878	958	0	80	80	1.0000000
NODE_1279_length_2056_cov_20.525805	931	1011	0	80	80	1.0000000
NODE_1281_length_2055_cov_10.047546	1468	1548	0	3	80	0.0375000
NODE_1281_length_2055_cov_10.047546	1468	1548	2	77	80	0.9625000
NODE_1281_length_2055_cov_10.047546	1521	1601	0	11	80	0.1375000
NODE_1281_length_2055_cov_10.047546	1521	1601	2	69	80	0.8625000
NODE_1286_length_2049_cov_6.846154	270	350	0	80	80	1.0000000
NODE_1286_length_2049_cov_6.846154	323	403	0	80	80	1.0000000
NODE_1286_length_2049_cov_6.846154	1595	1674	0	79	79	1.0000000
NODE_1286_length_2049_cov_6.846154	1648	1712	0	64	64	1.0000000
NODE_1293_length_2045_cov_46.790339	876	956	2	7	80	0.0875000
NODE_1293_length_2045_cov_46.790339	876	956	4	12	80	0.1500000
NODE_1293_length_2045_cov_46.790339	876	956	10	61	80	0.7625000
NODE_1293_length_2045_cov_46.790339	929	1009	0	17	80	0.2125000
NODE_1293_length_2045_cov_46.790339	929	1009	2	43	80	0.5375000
NODE_1293_length_2045_cov_46.790339	929	1009	4	12	80	0.1500000
NODE_1293_length_2045_cov_46.790339	929	1009	10	8	80	0.1000000
NODE_1293_length_2045_cov_46.790339	1005	1085	0	5	80	0.0625000
NODE_1293_length_2045_cov_46.790339	1005	1085	2	10	80	0.1250000
NODE_1293_length_2045_cov_46.790339	1005	1085	4	65	80	0.8125000
NODE_1293_length_2045_cov_46.790339	1058	1138	0	58	80	0.7250000
NODE_1293_length_2045_cov_46.790339	1058	1138	2	6	80	0.0750000
NODE_1293_length_2045_cov_46.790339	1058	1138	4	16	80	0.2000000
NODE_1298_length_2042_cov_4.447761	241	315	0	54	74	0.7297297
NODE_1298_length_2042_cov_4.447761	241	315	2	20	74	0.2702703
NODE_1301_length_2040_cov_30.109737	1760	1844	528	3	84	0.0357143
NODE_1301_length_2040_cov_30.109737	1760	1844	530	1	84	0.0119048
NODE_1301_length_2040_cov_30.109737	1760	1844	534	1	84	0.0119048
NODE_1301_length_2040_cov_30.109737	1760	1844	541	2	84	0.0238095
NODE_1301_length_2040_cov_30.109737	1760	1844	542	1	84	0.0119048
NODE_1301_length_2040_cov_30.109737	1760	1844	543	1	84	0.0119048
NODE_1301_length_2040_cov_30.109737	1760	1844	544	1	84	0.0119048
NODE_1301_length_2040_cov_30.109737	1760	1844	546	1	84	0.0119048
NODE_1301_length_2040_cov_30.109737	1760	1844	548	2	84	0.0238095
NODE_1301_length_2040_cov_30.109737	1760	1844	550	1	84	0.0119048
NODE_1301_length_2040_cov_30.109737	1760	1844	558	2	84	0.0238095
NODE_1301_length_2040_cov_30.109737	1760	1844	569	1	84	0.0119048
NODE_1301_length_2040_cov_30.109737	1760	1844	572	1	84	0.0119048
NODE_1301_length_2040_cov_30.109737	1760	1844	574	2	84	0.0238095
NODE_1301_length_2040_cov_30.109737	1760	1844	576	1	84	0.0119048
NODE_1301_length_2040_cov_30.109737	1760	1844	577	1	84	0.0119048
NODE_1301_length_2040_cov_30.109737	1760	1844	578	1	84	0.0119048
NODE_1301_length_2040_cov_30.109737	1760	1844	584	1	84	0.0119048
NODE_1301_length_2040_cov_30.109737	1760	1844	590	1	84	0.0119048
NODE_1301_length_2040_cov_30.109737	1760	1844	591	1	84	0.0119048
NODE_1301_length_2040_cov_30.109737	1760	1844	592	1	84	0.0119048
NODE_1301_length_2040_cov_30.109737	1760	1844	595	2	84	0.0238095
NODE_1301_length_2040_cov_30.109737	1760	1844	596	2	84	0.0238095
NODE_1301_length_2040_cov_30.109737	1760	1844	598	1	84	0.0119048
NODE_1301_length_2040_cov_30.109737	1760	1844	601	1	84	0.0119048
NODE_1301_length_2040_cov_30.109737	1760	1844	608	1	84	0.0119048
NODE_1301_length_2040_cov_30.109737	1760	1844	611	1	84	0.0119048
NODE_1301_length_2040_cov_30.109737	1760	1844	613	1	84	0.0119048
NODE_1301_length_2040_cov_30.109737	1760	1844	614	2	84	0.0238095
NODE_1301_length_2040_cov_30.109737	1760	1844	615	1	84	0.0119048
NODE_1301_length_2040_cov_30.109737	1760	1844	619	1	84	0.0119048
NODE_1301_length_2040_cov_30.109737	1760	1844	620	2	84	0.0238095
NODE_1301_length_2040_cov_30.109737	1760	1844	623	1	84	0.0119048
NODE_1301_length_2040_cov_30.109737	1760	1844	624	1	84	0.0119048
NODE_1301_length_2040_cov_30.109737	1760	1844	626	1	84	0.0119048
NODE_1301_length_2040_cov_30.109737	1760	1844	627	1	84	0.0119048
NODE_1301_length_2040_cov_30.109737	1760	1844	628	4	84	0.0476190
NODE_1301_length_2040_cov_30.109737	1760	1844	631	1	84	0.0119048
NODE_1301_length_2040_cov_30.109737	1760	1844	632	2	84	0.0238095
NODE_1301_length_2040_cov_30.109737	1760	1844	634	7	84	0.0833333
NODE_1301_length_2040_cov_30.109737	1760	1844	635	2	84	0.0238095
NODE_1301_length_2040_cov_30.109737	1760	1844	637	1	84	0.0119048
NODE_1301_length_2040_cov_30.109737	1760	1844	638	2	84	0.0238095
NODE_1301_length_2040_cov_30.109737	1760	1844	639	1	84	0.0119048
NODE_1301_length_2040_cov_30.109737	1760	1844	640	2	84	0.0238095
NODE_1301_length_2040_cov_30.109737	1760	1844	643	2	84	0.0238095
NODE_1301_length_2040_cov_30.109737	1760	1844	646	2	84	0.0238095
NODE_1301_length_2040_cov_30.109737	1760	1844	650	2	84	0.0238095
NODE_1301_length_2040_cov_30.109737	1760	1844	651	2	84	0.0238095
NODE_1301_length_2040_cov_30.109737	1760	1844	652	2	84	0.0238095
NODE_1301_length_2040_cov_30.109737	1760	1844	653	1	84	0.0119048
NODE_1301_length_2040_cov_30.109737	1760	1844	654	1	84	0.0119048
NODE_1301_length_2040_cov_30.109737	1760	1844	657	1	84	0.0119048
NODE_1301_length_2040_cov_30.109737	1760	1844	658	2	84	0.0238095
NODE_1301_length_2040_cov_30.109737	1760	1844	660	1	84	0.0119048
NODE_1306_length_2036_cov_11.672173	369	449	0	43	80	0.5375000
NODE_1306_length_2036_cov_11.672173	369	449	2	37	80	0.4625000
NODE_1306_length_2036_cov_11.672173	422	502	0	1	80	0.0125000
NODE_1306_length_2036_cov_11.672173	422	502	2	79	80	0.9875000
NODE_1312_length_2032_cov_11.188308	416	496	1	3	80	0.0375000
NODE_1312_length_2032_cov_11.188308	416	496	7	77	80	0.9625000
NODE_1312_length_2032_cov_11.188308	469	549	0	16	80	0.2000000
NODE_1312_length_2032_cov_11.188308	469	549	6	20	80	0.2500000
NODE_1312_length_2032_cov_11.188308	469	549	7	44	80	0.5500000
NODE_1318_length_2027_cov_43.702282	1129	1209	0	77	80	0.9625000
NODE_1318_length_2027_cov_43.702282	1129	1209	2	3	80	0.0375000
NODE_1318_length_2027_cov_43.702282	1182	1262	0	24	80	0.3000000
NODE_1318_length_2027_cov_43.702282	1182	1262	2	56	80	0.7000000
NODE_1318_length_2027_cov_43.702282	1258	1338	0	71	80	0.8875000
NODE_1318_length_2027_cov_43.702282	1258	1338	2	9	80	0.1125000
NODE_1318_length_2027_cov_43.702282	1311	1391	0	80	80	1.0000000
NODE_1319_length_2027_cov_6.558610	229	303	0	74	74	1.0000000
NODE_1319_length_2027_cov_6.558610	229	303	0	74	74	1.0000000
NODE_1319_length_2027_cov_6.558610	276	356	0	80	80	1.0000000
NODE_1320_length_2026_cov_18.457706	688	768	0	80	80	1.0000000
NODE_1320_length_2026_cov_18.457706	741	821	0	80	80	1.0000000
NODE_1324_length_2025_cov_10.711319	617	697	6	31	80	0.3875000
NODE_1324_length_2025_cov_10.711319	617	697	8	25	80	0.3125000
NODE_1324_length_2025_cov_10.711319	617	697	9	23	80	0.2875000
NODE_1324_length_2025_cov_10.711319	617	697	10	1	80	0.0125000
NODE_1324_length_2025_cov_10.711319	712	783	9	3	71	0.0422535
NODE_1324_length_2025_cov_10.711319	712	783	11	19	71	0.2676056
NODE_1324_length_2025_cov_10.711319	712	783	12	11	71	0.1549296
NODE_1324_length_2025_cov_10.711319	712	783	13	11	71	0.1549296
NODE_1324_length_2025_cov_10.711319	712	783	14	8	71	0.1126761
NODE_1324_length_2025_cov_10.711319	712	783	16	19	71	0.2676056
NODE_1324_length_2025_cov_10.711319	756	829	6	1	73	0.0136986
NODE_1324_length_2025_cov_10.711319	756	829	8	3	73	0.0410959
NODE_1324_length_2025_cov_10.711319	756	829	9	2	73	0.0273973
NODE_1324_length_2025_cov_10.711319	756	829	10	2	73	0.0273973
NODE_1324_length_2025_cov_10.711319	756	829	11	4	73	0.0547945
NODE_1324_length_2025_cov_10.711319	756	829	12	16	73	0.2191781
NODE_1324_length_2025_cov_10.711319	756	829	13	29	73	0.3972603
NODE_1324_length_2025_cov_10.711319	756	829	14	8	73	0.1095890
NODE_1324_length_2025_cov_10.711319	756	829	16	8	73	0.1095890
NODE_1325_length_2024_cov_33.891948	1045	1125	0	1	80	0.0125000
NODE_1325_length_2024_cov_33.891948	1045	1125	2	79	80	0.9875000
NODE_1325_length_2024_cov_33.891948	1098	1178	0	28	80	0.3500000
NODE_1325_length_2024_cov_33.891948	1098	1178	2	52	80	0.6500000
NODE_1331_length_2018_cov_33.742053	1215	1295	261	1	80	0.0125000
NODE_1331_length_2018_cov_33.742053	1215	1295	265	1	80	0.0125000
NODE_1331_length_2018_cov_33.742053	1215	1295	267	1	80	0.0125000
NODE_1331_length_2018_cov_33.742053	1215	1295	271	1	80	0.0125000
NODE_1331_length_2018_cov_33.742053	1215	1295	273	1	80	0.0125000
NODE_1331_length_2018_cov_33.742053	1215	1295	277	2	80	0.0250000
NODE_1331_length_2018_cov_33.742053	1215	1295	281	1	80	0.0125000
NODE_1331_length_2018_cov_33.742053	1215	1295	286	1	80	0.0125000
NODE_1331_length_2018_cov_33.742053	1215	1295	291	1	80	0.0125000
NODE_1331_length_2018_cov_33.742053	1215	1295	295	2	80	0.0250000
NODE_1331_length_2018_cov_33.742053	1215	1295	300	1	80	0.0125000
NODE_1331_length_2018_cov_33.742053	1215	1295	304	1	80	0.0125000
NODE_1331_length_2018_cov_33.742053	1215	1295	314	1	80	0.0125000
NODE_1331_length_2018_cov_33.742053	1215	1295	315	1	80	0.0125000
NODE_1331_length_2018_cov_33.742053	1215	1295	318	1	80	0.0125000
NODE_1331_length_2018_cov_33.742053	1215	1295	330	1	80	0.0125000
NODE_1331_length_2018_cov_33.742053	1215	1295	340	1	80	0.0125000
NODE_1331_length_2018_cov_33.742053	1215	1295	345	1	80	0.0125000
NODE_1331_length_2018_cov_33.742053	1215	1295	347	1	80	0.0125000
NODE_1331_length_2018_cov_33.742053	1215	1295	349	1	80	0.0125000
NODE_1331_length_2018_cov_33.742053	1215	1295	353	3	80	0.0375000
NODE_1331_length_2018_cov_33.742053	1215	1295	354	2	80	0.0250000
NODE_1331_length_2018_cov_33.742053	1215	1295	357	1	80	0.0125000
NODE_1331_length_2018_cov_33.742053	1215	1295	376	4	80	0.0500000
NODE_1331_length_2018_cov_33.742053	1215	1295	379	2	80	0.0250000
NODE_1331_length_2018_cov_33.742053	1215	1295	380	2	80	0.0250000
NODE_1331_length_2018_cov_33.742053	1215	1295	382	1	80	0.0125000
NODE_1331_length_2018_cov_33.742053	1215	1295	383	6	80	0.0750000
NODE_1331_length_2018_cov_33.742053	1215	1295	384	2	80	0.0250000
NODE_1331_length_2018_cov_33.742053	1215	1295	385	1	80	0.0125000
NODE_1331_length_2018_cov_33.742053	1215	1295	386	3	80	0.0375000
NODE_1331_length_2018_cov_33.742053	1215	1295	387	1	80	0.0125000
NODE_1331_length_2018_cov_33.742053	1215	1295	388	7	80	0.0875000
NODE_1331_length_2018_cov_33.742053	1215	1295	389	2	80	0.0250000
NODE_1331_length_2018_cov_33.742053	1215	1295	390	6	80	0.0750000
NODE_1331_length_2018_cov_33.742053	1215	1295	392	5	80	0.0625000
NODE_1331_length_2018_cov_33.742053	1215	1295	394	2	80	0.0250000
NODE_1331_length_2018_cov_33.742053	1215	1295	395	3	80	0.0375000
NODE_1331_length_2018_cov_33.742053	1215	1295	396	3	80	0.0375000
NODE_1331_length_2018_cov_33.742053	1215	1295	397	1	80	0.0125000
NODE_1331_length_2018_cov_33.742053	1215	1295	398	1	80	0.0125000
NODE_1331_length_2018_cov_33.742053	1268	1298	374	1	30	0.0333333
NODE_1331_length_2018_cov_33.742053	1268	1298	375	1	30	0.0333333
NODE_1331_length_2018_cov_33.742053	1268	1298	380	3	30	0.1000000
NODE_1331_length_2018_cov_33.742053	1268	1298	382	1	30	0.0333333
NODE_1331_length_2018_cov_33.742053	1268	1298	383	4	30	0.1333333
NODE_1331_length_2018_cov_33.742053	1268	1298	384	2	30	0.0666667
NODE_1331_length_2018_cov_33.742053	1268	1298	385	1	30	0.0333333
NODE_1331_length_2018_cov_33.742053	1268	1298	386	3	30	0.1000000
NODE_1331_length_2018_cov_33.742053	1268	1298	387	1	30	0.0333333
NODE_1331_length_2018_cov_33.742053	1268	1298	388	5	30	0.1666667
NODE_1331_length_2018_cov_33.742053	1268	1298	389	2	30	0.0666667
NODE_1331_length_2018_cov_33.742053	1268	1298	390	4	30	0.1333333
NODE_1331_length_2018_cov_33.742053	1268	1298	392	1	30	0.0333333
NODE_1331_length_2018_cov_33.742053	1268	1298	398	1	30	0.0333333
NODE_1331_length_2018_cov_33.742053	1876	1942	136	1	66	0.0151515
NODE_1331_length_2018_cov_33.742053	1876	1942	144	1	66	0.0151515
NODE_1331_length_2018_cov_33.742053	1876	1942	146	1	66	0.0151515
NODE_1331_length_2018_cov_33.742053	1876	1942	157	1	66	0.0151515
NODE_1331_length_2018_cov_33.742053	1876	1942	159	1	66	0.0151515
NODE_1331_length_2018_cov_33.742053	1876	1942	165	1	66	0.0151515
NODE_1331_length_2018_cov_33.742053	1876	1942	170	1	66	0.0151515
NODE_1331_length_2018_cov_33.742053	1876	1942	180	1	66	0.0151515
NODE_1331_length_2018_cov_33.742053	1876	1942	184	1	66	0.0151515
NODE_1331_length_2018_cov_33.742053	1876	1942	186	1	66	0.0151515
NODE_1331_length_2018_cov_33.742053	1876	1942	188	1	66	0.0151515
NODE_1331_length_2018_cov_33.742053	1876	1942	204	1	66	0.0151515
NODE_1331_length_2018_cov_33.742053	1876	1942	208	1	66	0.0151515
NODE_1331_length_2018_cov_33.742053	1876	1942	216	1	66	0.0151515
NODE_1331_length_2018_cov_33.742053	1876	1942	225	1	66	0.0151515
NODE_1331_length_2018_cov_33.742053	1876	1942	229	1	66	0.0151515
NODE_1331_length_2018_cov_33.742053	1876	1942	232	1	66	0.0151515
NODE_1331_length_2018_cov_33.742053	1876	1942	236	2	66	0.0303030
NODE_1331_length_2018_cov_33.742053	1876	1942	238	1	66	0.0151515
NODE_1331_length_2018_cov_33.742053	1876	1942	239	1	66	0.0151515
NODE_1331_length_2018_cov_33.742053	1876	1942	241	1	66	0.0151515
NODE_1331_length_2018_cov_33.742053	1876	1942	243	1	66	0.0151515
NODE_1331_length_2018_cov_33.742053	1876	1942	250	1	66	0.0151515
NODE_1331_length_2018_cov_33.742053	1876	1942	252	1	66	0.0151515
NODE_1331_length_2018_cov_33.742053	1876	1942	256	1	66	0.0151515
NODE_1331_length_2018_cov_33.742053	1876	1942	262	1	66	0.0151515
NODE_1331_length_2018_cov_33.742053	1876	1942	264	1	66	0.0151515
NODE_1331_length_2018_cov_33.742053	1876	1942	270	1	66	0.0151515
NODE_1331_length_2018_cov_33.742053	1876	1942	271	1	66	0.0151515
NODE_1331_length_2018_cov_33.742053	1876	1942	274	1	66	0.0151515
NODE_1331_length_2018_cov_33.742053	1876	1942	283	1	66	0.0151515
NODE_1331_length_2018_cov_33.742053	1876	1942	284	1	66	0.0151515
NODE_1331_length_2018_cov_33.742053	1876	1942	287	1	66	0.0151515
NODE_1331_length_2018_cov_33.742053	1876	1942	291	2	66	0.0303030
NODE_1331_length_2018_cov_33.742053	1876	1942	301	1	66	0.0151515
NODE_1331_length_2018_cov_33.742053	1876	1942	302	1	66	0.0151515
NODE_1331_length_2018_cov_33.742053	1876	1942	309	1	66	0.0151515
NODE_1331_length_2018_cov_33.742053	1876	1942	312	1	66	0.0151515
NODE_1331_length_2018_cov_33.742053	1876	1942	322	1	66	0.0151515
NODE_1331_length_2018_cov_33.742053	1876	1942	323	1	66	0.0151515
NODE_1331_length_2018_cov_33.742053	1876	1942	327	1	66	0.0151515
NODE_1331_length_2018_cov_33.742053	1876	1942	334	1	66	0.0151515
NODE_1331_length_2018_cov_33.742053	1876	1942	335	1	66	0.0151515
NODE_1331_length_2018_cov_33.742053	1876	1942	344	1	66	0.0151515
NODE_1331_length_2018_cov_33.742053	1876	1942	348	1	66	0.0151515
NODE_1331_length_2018_cov_33.742053	1876	1942	357	1	66	0.0151515
NODE_1331_length_2018_cov_33.742053	1876	1942	360	2	66	0.0303030
NODE_1331_length_2018_cov_33.742053	1876	1942	370	1	66	0.0151515
NODE_1331_length_2018_cov_33.742053	1876	1942	379	2	66	0.0303030
NODE_1331_length_2018_cov_33.742053	1876	1942	381	2	66	0.0303030
NODE_1331_length_2018_cov_33.742053	1876	1942	383	1	66	0.0151515
NODE_1331_length_2018_cov_33.742053	1876	1942	391	1	66	0.0151515
NODE_1331_length_2018_cov_33.742053	1876	1942	398	1	66	0.0151515
NODE_1331_length_2018_cov_33.742053	1876	1942	399	1	66	0.0151515
NODE_1331_length_2018_cov_33.742053	1876	1942	401	1	66	0.0151515
NODE_1331_length_2018_cov_33.742053	1876	1942	402	1	66	0.0151515
NODE_1331_length_2018_cov_33.742053	1876	1942	406	1	66	0.0151515
NODE_1331_length_2018_cov_33.742053	1876	1942	410	1	66	0.0151515
NODE_1331_length_2018_cov_33.742053	1876	1942	414	2	66	0.0303030
NODE_1331_length_2018_cov_33.742053	1876	1942	417	1	66	0.0151515
NODE_1331_length_2018_cov_33.742053	1915	1995	14	5	80	0.0625000
NODE_1331_length_2018_cov_33.742053	1915	1995	16	1	80	0.0125000
NODE_1331_length_2018_cov_33.742053	1915	1995	18	4	80	0.0500000
NODE_1331_length_2018_cov_33.742053	1915	1995	30	1	80	0.0125000
NODE_1331_length_2018_cov_33.742053	1915	1995	32	1	80	0.0125000
NODE_1331_length_2018_cov_33.742053	1915	1995	34	2	80	0.0250000
NODE_1331_length_2018_cov_33.742053	1915	1995	38	2	80	0.0250000
NODE_1331_length_2018_cov_33.742053	1915	1995	40	1	80	0.0125000
NODE_1331_length_2018_cov_33.742053	1915	1995	42	1	80	0.0125000
NODE_1331_length_2018_cov_33.742053	1915	1995	44	2	80	0.0250000
NODE_1331_length_2018_cov_33.742053	1915	1995	54	1	80	0.0125000
NODE_1331_length_2018_cov_33.742053	1915	1995	56	2	80	0.0250000
NODE_1331_length_2018_cov_33.742053	1915	1995	61	1	80	0.0125000
NODE_1331_length_2018_cov_33.742053	1915	1995	65	1	80	0.0125000
NODE_1331_length_2018_cov_33.742053	1915	1995	67	1	80	0.0125000
NODE_1331_length_2018_cov_33.742053	1915	1995	69	1	80	0.0125000
NODE_1331_length_2018_cov_33.742053	1915	1995	73	2	80	0.0250000
NODE_1331_length_2018_cov_33.742053	1915	1995	77	2	80	0.0250000
NODE_1331_length_2018_cov_33.742053	1915	1995	84	1	80	0.0125000
NODE_1331_length_2018_cov_33.742053	1915	1995	97	2	80	0.0250000
NODE_1331_length_2018_cov_33.742053	1915	1995	99	2	80	0.0250000
NODE_1331_length_2018_cov_33.742053	1915	1995	100	2	80	0.0250000
NODE_1331_length_2018_cov_33.742053	1915	1995	114	2	80	0.0250000
NODE_1331_length_2018_cov_33.742053	1915	1995	116	1	80	0.0125000
NODE_1331_length_2018_cov_33.742053	1915	1995	118	2	80	0.0250000
NODE_1331_length_2018_cov_33.742053	1915	1995	119	1	80	0.0125000
NODE_1331_length_2018_cov_33.742053	1915	1995	126	1	80	0.0125000
NODE_1331_length_2018_cov_33.742053	1915	1995	133	6	80	0.0750000
NODE_1331_length_2018_cov_33.742053	1915	1995	134	1	80	0.0125000
NODE_1331_length_2018_cov_33.742053	1915	1995	136	2	80	0.0250000
NODE_1331_length_2018_cov_33.742053	1915	1995	144	1	80	0.0125000
NODE_1331_length_2018_cov_33.742053	1915	1995	146	1	80	0.0125000
NODE_1331_length_2018_cov_33.742053	1915	1995	157	1	80	0.0125000
NODE_1331_length_2018_cov_33.742053	1915	1995	159	1	80	0.0125000
NODE_1331_length_2018_cov_33.742053	1915	1995	165	1	80	0.0125000
NODE_1331_length_2018_cov_33.742053	1915	1995	170	1	80	0.0125000
NODE_1331_length_2018_cov_33.742053	1915	1995	180	1	80	0.0125000
NODE_1331_length_2018_cov_33.742053	1915	1995	184	1	80	0.0125000
NODE_1331_length_2018_cov_33.742053	1915	1995	186	1	80	0.0125000
NODE_1331_length_2018_cov_33.742053	1915	1995	188	1	80	0.0125000
NODE_1331_length_2018_cov_33.742053	1915	1995	204	1	80	0.0125000
NODE_1331_length_2018_cov_33.742053	1915	1995	208	1	80	0.0125000
NODE_1331_length_2018_cov_33.742053	1915	1995	216	1	80	0.0125000
NODE_1331_length_2018_cov_33.742053	1915	1995	225	1	80	0.0125000
NODE_1331_length_2018_cov_33.742053	1915	1995	229	1	80	0.0125000
NODE_1331_length_2018_cov_33.742053	1915	1995	232	1	80	0.0125000
NODE_1331_length_2018_cov_33.742053	1915	1995	236	2	80	0.0250000
NODE_1331_length_2018_cov_33.742053	1915	1995	238	1	80	0.0125000
NODE_1331_length_2018_cov_33.742053	1915	1995	239	1	80	0.0125000
NODE_1331_length_2018_cov_33.742053	1915	1995	241	1	80	0.0125000
NODE_1331_length_2018_cov_33.742053	1915	1995	243	1	80	0.0125000
NODE_1331_length_2018_cov_33.742053	1915	1995	250	1	80	0.0125000
NODE_1331_length_2018_cov_33.742053	1915	1995	252	1	80	0.0125000
NODE_1331_length_2018_cov_33.742053	1915	1995	256	1	80	0.0125000
NODE_1331_length_2018_cov_33.742053	1915	1995	262	1	80	0.0125000
NODE_1337_length_2011_cov_22.430439	434	514	0	37	80	0.4625000
NODE_1337_length_2011_cov_22.430439	434	514	2	43	80	0.5375000
NODE_1337_length_2011_cov_22.430439	487	567	0	8	80	0.1000000
NODE_1337_length_2011_cov_22.430439	487	567	2	72	80	0.9000000
NODE_1337_length_2011_cov_22.430439	1124	1204	0	46	80	0.5750000
NODE_1337_length_2011_cov_22.430439	1124	1204	2	34	80	0.4250000
NODE_1337_length_2011_cov_22.430439	1177	1257	2	80	80	1.0000000
NODE_1343_length_2001_cov_10.416404	692	772	0	80	80	1.0000000
NODE_1343_length_2001_cov_10.416404	745	825	0	80	80	1.0000000
NODE_1350_length_1991_cov_112.926533	212	292	275	1	80	0.0125000
NODE_1350_length_1991_cov_112.926533	212	292	293	1	80	0.0125000
NODE_1350_length_1991_cov_112.926533	212	292	294	1	80	0.0125000
NODE_1350_length_1991_cov_112.926533	212	292	305	1	80	0.0125000
NODE_1350_length_1991_cov_112.926533	212	292	307	2	80	0.0250000
NODE_1350_length_1991_cov_112.926533	212	292	310	2	80	0.0250000
NODE_1350_length_1991_cov_112.926533	212	292	312	1	80	0.0125000
NODE_1350_length_1991_cov_112.926533	212	292	314	2	80	0.0250000
NODE_1350_length_1991_cov_112.926533	212	292	318	1	80	0.0125000
NODE_1350_length_1991_cov_112.926533	212	292	320	1	80	0.0125000
NODE_1350_length_1991_cov_112.926533	212	292	321	1	80	0.0125000
NODE_1350_length_1991_cov_112.926533	212	292	322	5	80	0.0625000
NODE_1350_length_1991_cov_112.926533	212	292	324	2	80	0.0250000
NODE_1350_length_1991_cov_112.926533	212	292	327	1	80	0.0125000
NODE_1350_length_1991_cov_112.926533	212	292	340	2	80	0.0250000
NODE_1350_length_1991_cov_112.926533	212	292	343	2	80	0.0250000
NODE_1350_length_1991_cov_112.926533	212	292	344	2	80	0.0250000
NODE_1350_length_1991_cov_112.926533	212	292	347	3	80	0.0375000
NODE_1350_length_1991_cov_112.926533	212	292	349	1	80	0.0125000
NODE_1350_length_1991_cov_112.926533	212	292	355	1	80	0.0125000
NODE_1350_length_1991_cov_112.926533	212	292	356	3	80	0.0375000
NODE_1350_length_1991_cov_112.926533	212	292	358	1	80	0.0125000
NODE_1350_length_1991_cov_112.926533	212	292	362	3	80	0.0375000
NODE_1350_length_1991_cov_112.926533	212	292	371	4	80	0.0500000
NODE_1350_length_1991_cov_112.926533	212	292	372	3	80	0.0375000
NODE_1350_length_1991_cov_112.926533	212	292	373	1	80	0.0125000
NODE_1350_length_1991_cov_112.926533	212	292	374	4	80	0.0500000
NODE_1350_length_1991_cov_112.926533	212	292	379	3	80	0.0375000
NODE_1350_length_1991_cov_112.926533	212	292	380	3	80	0.0375000
NODE_1350_length_1991_cov_112.926533	212	292	382	2	80	0.0250000
NODE_1350_length_1991_cov_112.926533	212	292	383	2	80	0.0250000
NODE_1350_length_1991_cov_112.926533	212	292	385	4	80	0.0500000
NODE_1350_length_1991_cov_112.926533	212	292	387	4	80	0.0500000
NODE_1350_length_1991_cov_112.926533	212	292	388	1	80	0.0125000
NODE_1350_length_1991_cov_112.926533	212	292	389	9	80	0.1125000
NODE_1352_length_1988_cov_13.736368	865	945	2	22	80	0.2750000
NODE_1352_length_1988_cov_13.736368	865	945	3	17	80	0.2125000
NODE_1352_length_1988_cov_13.736368	865	945	4	41	80	0.5125000
NODE_1352_length_1988_cov_13.736368	918	998	0	4	80	0.0500000
NODE_1352_length_1988_cov_13.736368	918	998	2	57	80	0.7125000
NODE_1352_length_1988_cov_13.736368	918	998	3	9	80	0.1125000
NODE_1352_length_1988_cov_13.736368	918	998	4	10	80	0.1250000
NODE_1353_length_1988_cov_9.980413	1616	1696	0	80	80	1.0000000
NODE_1353_length_1988_cov_9.980413	1669	1749	0	80	80	1.0000000
NODE_1356_length_1983_cov_17.332803	494	574	0	31	80	0.3875000
NODE_1356_length_1983_cov_17.332803	494	574	4	49	80	0.6125000
NODE_1356_length_1983_cov_17.332803	547	627	0	22	80	0.2750000
NODE_1356_length_1983_cov_17.332803	547	627	4	58	80	0.7250000
NODE_1356_length_1983_cov_17.332803	1600	1680	0	80	80	1.0000000
NODE_1356_length_1983_cov_17.332803	1653	1733	0	80	80	1.0000000
NODE_1359_length_1982_cov_17.164100	457	537	2	80	80	1.0000000
NODE_1359_length_1982_cov_17.164100	510	590	0	27	80	0.3375000
NODE_1359_length_1982_cov_17.164100	510	590	1	8	80	0.1000000
NODE_1359_length_1982_cov_17.164100	510	590	2	45	80	0.5625000
NODE_1359_length_1982_cov_17.164100	586	666	0	80	80	1.0000000
NODE_1359_length_1982_cov_17.164100	639	723	0	84	84	1.0000000
NODE_1360_length_1981_cov_46.444208	0	70	0	70	70	1.0000000
NODE_1362_length_1979_cov_1.630851	1554	1634	0	80	80	1.0000000
NODE_1364_length_1976_cov_1.959510	154	215	2	61	61	1.0000000
NODE_1364_length_1976_cov_1.959510	154	215	2	61	61	1.0000000
NODE_1364_length_1976_cov_1.959510	154	213	2	59	59	1.0000000
NODE_1365_length_1974_cov_8.058133	617	697	29	1	80	0.0125000
NODE_1365_length_1974_cov_8.058133	617	697	31	13	80	0.1625000
NODE_1365_length_1974_cov_8.058133	617	697	35	1	80	0.0125000
NODE_1365_length_1974_cov_8.058133	617	697	36	3	80	0.0375000
NODE_1365_length_1974_cov_8.058133	617	697	37	17	80	0.2125000
NODE_1365_length_1974_cov_8.058133	617	697	39	1	80	0.0125000
NODE_1365_length_1974_cov_8.058133	617	697	41	9	80	0.1125000
NODE_1365_length_1974_cov_8.058133	617	697	44	4	80	0.0500000
NODE_1365_length_1974_cov_8.058133	617	697	45	11	80	0.1375000
NODE_1365_length_1974_cov_8.058133	617	697	47	20	80	0.2500000
NODE_1365_length_1974_cov_8.058133	670	750	6	4	80	0.0500000
NODE_1365_length_1974_cov_8.058133	670	750	8	2	80	0.0250000
NODE_1365_length_1974_cov_8.058133	670	750	9	3	80	0.0375000
NODE_1365_length_1974_cov_8.058133	670	750	10	3	80	0.0375000
NODE_1365_length_1974_cov_8.058133	670	750	12	3	80	0.0375000
NODE_1365_length_1974_cov_8.058133	670	750	14	1	80	0.0125000
NODE_1365_length_1974_cov_8.058133	670	750	16	2	80	0.0250000
NODE_1365_length_1974_cov_8.058133	670	750	18	1	80	0.0125000
NODE_1365_length_1974_cov_8.058133	670	750	19	8	80	0.1000000
NODE_1365_length_1974_cov_8.058133	670	750	21	2	80	0.0250000
NODE_1365_length_1974_cov_8.058133	670	750	22	2	80	0.0250000
NODE_1365_length_1974_cov_8.058133	670	750	25	6	80	0.0750000
NODE_1365_length_1974_cov_8.058133	670	750	27	2	80	0.0250000
NODE_1365_length_1974_cov_8.058133	670	750	29	10	80	0.1250000
NODE_1365_length_1974_cov_8.058133	670	750	33	1	80	0.0125000
NODE_1365_length_1974_cov_8.058133	670	750	34	2	80	0.0250000
NODE_1365_length_1974_cov_8.058133	670	750	36	4	80	0.0500000
NODE_1365_length_1974_cov_8.058133	670	750	37	5	80	0.0625000
NODE_1365_length_1974_cov_8.058133	670	750	39	1	80	0.0125000
NODE_1365_length_1974_cov_8.058133	670	750	41	3	80	0.0375000
NODE_1365_length_1974_cov_8.058133	670	750	44	4	80	0.0500000
NODE_1365_length_1974_cov_8.058133	670	750	45	4	80	0.0500000
NODE_1365_length_1974_cov_8.058133	670	750	47	7	80	0.0875000
NODE_1366_length_1973_cov_14.885272	640	726	0	73	86	0.8488372
NODE_1366_length_1973_cov_14.885272	640	726	2	13	86	0.1511628
NODE_1366_length_1973_cov_14.885272	699	779	0	29	80	0.3625000
NODE_1366_length_1973_cov_14.885272	699	779	2	51	80	0.6375000
NODE_1366_length_1973_cov_14.885272	1389	1469	0	80	80	1.0000000
NODE_1366_length_1973_cov_14.885272	1442	1522	0	54	80	0.6750000
NODE_1366_length_1973_cov_14.885272	1442	1522	2	26	80	0.3250000
NODE_1372_length_1971_cov_3.126068	1662	1742	30	4	80	0.0500000
NODE_1372_length_1971_cov_3.126068	1662	1742	34	7	80	0.0875000
NODE_1372_length_1971_cov_3.126068	1662	1742	36	4	80	0.0500000
NODE_1372_length_1971_cov_3.126068	1662	1742	38	7	80	0.0875000
NODE_1372_length_1971_cov_3.126068	1662	1742	46	3	80	0.0375000
NODE_1372_length_1971_cov_3.126068	1662	1742	52	17	80	0.2125000
NODE_1372_length_1971_cov_3.126068	1662	1742	54	22	80	0.2750000
NODE_1372_length_1971_cov_3.126068	1662	1742	56	12	80	0.1500000
NODE_1372_length_1971_cov_3.126068	1662	1742	58	1	80	0.0125000
NODE_1372_length_1971_cov_3.126068	1662	1742	60	3	80	0.0375000
NODE_1372_length_1971_cov_3.126068	1715	1799	28	3	84	0.0357143
NODE_1372_length_1971_cov_3.126068	1715	1799	30	2	84	0.0238095
NODE_1372_length_1971_cov_3.126068	1715	1799	34	3	84	0.0357143
NODE_1372_length_1971_cov_3.126068	1715	1799	36	4	84	0.0476190
NODE_1372_length_1971_cov_3.126068	1715	1799	37	2	84	0.0238095
NODE_1372_length_1971_cov_3.126068	1715	1799	39	5	84	0.0595238
NODE_1372_length_1971_cov_3.126068	1715	1799	40	1	84	0.0119048
NODE_1372_length_1971_cov_3.126068	1715	1799	42	4	84	0.0476190
NODE_1372_length_1971_cov_3.126068	1715	1799	46	7	84	0.0833333
NODE_1372_length_1971_cov_3.126068	1715	1799	48	1	84	0.0119048
NODE_1372_length_1971_cov_3.126068	1715	1799	50	7	84	0.0833333
NODE_1372_length_1971_cov_3.126068	1715	1799	52	26	84	0.3095238
NODE_1372_length_1971_cov_3.126068	1715	1799	54	12	84	0.1428571
NODE_1372_length_1971_cov_3.126068	1715	1799	56	7	84	0.0833333
NODE_1386_length_1962_cov_23.774557	281	311	0	27	30	0.9000000
NODE_1386_length_1962_cov_23.774557	281	311	2	3	30	0.1000000
NODE_1386_length_1962_cov_23.774557	329	355	0	26	26	1.0000000
NODE_1386_length_1962_cov_23.774557	408	487	0	10	79	0.1265823
NODE_1386_length_1962_cov_23.774557	408	487	2	69	79	0.8734177
NODE_1386_length_1962_cov_23.774557	460	540	0	63	80	0.7875000
NODE_1386_length_1962_cov_23.774557	460	540	2	17	80	0.2125000
NODE_1386_length_1962_cov_23.774557	1417	1497	2	80	80	1.0000000
NODE_1386_length_1962_cov_23.774557	1470	1550	0	50	80	0.6250000
NODE_1386_length_1962_cov_23.774557	1470	1550	2	30	80	0.3750000
NODE_1386_length_1962_cov_23.774557	1607	1640	0	33	33	1.0000000
NODE_1395_length_1953_cov_26.183927	1	81	28	3	80	0.0375000
NODE_1395_length_1953_cov_26.183927	1	81	33	1	80	0.0125000
NODE_1395_length_1953_cov_26.183927	1	81	43	1	80	0.0125000
NODE_1395_length_1953_cov_26.183927	1	81	45	1	80	0.0125000
NODE_1395_length_1953_cov_26.183927	1	81	66	1	80	0.0125000
NODE_1395_length_1953_cov_26.183927	1	81	67	3	80	0.0375000
NODE_1395_length_1953_cov_26.183927	1	81	70	1	80	0.0125000
NODE_1395_length_1953_cov_26.183927	1	81	88	1	80	0.0125000
NODE_1395_length_1953_cov_26.183927	1	81	101	1	80	0.0125000
NODE_1395_length_1953_cov_26.183927	1	81	103	2	80	0.0250000
NODE_1395_length_1953_cov_26.183927	1	81	107	1	80	0.0125000
NODE_1395_length_1953_cov_26.183927	1	81	108	2	80	0.0250000
NODE_1395_length_1953_cov_26.183927	1	81	110	1	80	0.0125000
NODE_1395_length_1953_cov_26.183927	1	81	111	2	80	0.0250000
NODE_1395_length_1953_cov_26.183927	1	81	115	4	80	0.0500000
NODE_1395_length_1953_cov_26.183927	1	81	120	1	80	0.0125000
NODE_1395_length_1953_cov_26.183927	1	81	123	3	80	0.0375000
NODE_1395_length_1953_cov_26.183927	1	81	127	4	80	0.0500000
NODE_1395_length_1953_cov_26.183927	1	81	130	2	80	0.0250000
NODE_1395_length_1953_cov_26.183927	1	81	131	4	80	0.0500000
NODE_1395_length_1953_cov_26.183927	1	81	133	2	80	0.0250000
NODE_1395_length_1953_cov_26.183927	1	81	134	1	80	0.0125000
NODE_1395_length_1953_cov_26.183927	1	81	135	14	80	0.1750000
NODE_1395_length_1953_cov_26.183927	1	81	136	5	80	0.0625000
NODE_1395_length_1953_cov_26.183927	1	81	137	5	80	0.0625000
NODE_1395_length_1953_cov_26.183927	1	81	139	4	80	0.0500000
NODE_1395_length_1953_cov_26.183927	1	81	140	10	80	0.1250000
NODE_1395_length_1953_cov_26.183927	6	28	45	1	22	0.0454545
NODE_1395_length_1953_cov_26.183927	6	28	66	1	22	0.0454545
NODE_1395_length_1953_cov_26.183927	6	28	67	3	22	0.1363636
NODE_1395_length_1953_cov_26.183927	6	28	70	1	22	0.0454545
NODE_1395_length_1953_cov_26.183927	6	28	88	1	22	0.0454545
NODE_1395_length_1953_cov_26.183927	6	28	101	1	22	0.0454545
NODE_1395_length_1953_cov_26.183927	6	28	103	2	22	0.0909091
NODE_1395_length_1953_cov_26.183927	6	28	107	1	22	0.0454545
NODE_1395_length_1953_cov_26.183927	6	28	108	2	22	0.0909091
NODE_1395_length_1953_cov_26.183927	6	28	110	1	22	0.0454545
NODE_1395_length_1953_cov_26.183927	6	28	111	2	22	0.0909091
NODE_1395_length_1953_cov_26.183927	6	28	115	4	22	0.1818182
NODE_1395_length_1953_cov_26.183927	6	28	120	1	22	0.0454545
NODE_1395_length_1953_cov_26.183927	6	28	123	1	22	0.0454545
NODE_1395_length_1953_cov_26.183927	152	232	2	80	80	1.0000000
NODE_1395_length_1953_cov_26.183927	205	257	0	7	52	0.1346154
NODE_1395_length_1953_cov_26.183927	205	257	1	1	52	0.0192308
NODE_1395_length_1953_cov_26.183927	205	257	2	44	52	0.8461539
NODE_1405_length_1943_cov_11.218547	516	596	0	27	80	0.3375000
NODE_1405_length_1943_cov_11.218547	516	596	2	53	80	0.6625000
NODE_1405_length_1943_cov_11.218547	569	649	2	28	80	0.3500000
NODE_1405_length_1943_cov_11.218547	569	649	4	52	80	0.6500000
NODE_1408_length_1941_cov_14.407709	891	921	0	30	30	1.0000000
NODE_1408_length_1941_cov_14.407709	894	964	0	70	70	1.0000000
NODE_1408_length_1941_cov_14.407709	1878	1941	0	63	63	1.0000000
NODE_1409_length_1941_cov_9.632465	139	213	2	14	74	0.1891892
NODE_1409_length_1941_cov_9.632465	139	213	4	37	74	0.5000000
NODE_1409_length_1941_cov_9.632465	139	213	6	4	74	0.0540541
NODE_1409_length_1941_cov_9.632465	139	213	8	19	74	0.2567568
NODE_1409_length_1941_cov_9.632465	139	219	2	14	80	0.1750000
NODE_1409_length_1941_cov_9.632465	139	219	4	37	80	0.4625000
NODE_1409_length_1941_cov_9.632465	139	219	6	4	80	0.0500000
NODE_1409_length_1941_cov_9.632465	139	219	8	25	80	0.3125000
NODE_1409_length_1941_cov_9.632465	139	194	2	14	55	0.2545455
NODE_1409_length_1941_cov_9.632465	139	194	4	37	55	0.6727273
NODE_1409_length_1941_cov_9.632465	139	194	6	4	55	0.0727273
NODE_1409_length_1941_cov_9.632465	192	272	6	19	80	0.2375000
NODE_1409_length_1941_cov_9.632465	192	272	8	37	80	0.4625000
NODE_1409_length_1941_cov_9.632465	192	272	10	24	80	0.3000000
NODE_1414_length_1936_cov_13.338596	679	759	0	80	80	1.0000000
NODE_1414_length_1936_cov_13.338596	732	812	0	80	80	1.0000000
NODE_1414_length_1936_cov_13.338596	738	812	0	74	74	1.0000000
NODE_1414_length_1936_cov_13.338596	738	759	0	21	21	1.0000000
NODE_1415_length_1936_cov_12.592814	102	153	5	14	51	0.2745098
NODE_1415_length_1936_cov_12.592814	102	153	6	1	51	0.0196078
NODE_1415_length_1936_cov_12.592814	102	153	10	5	51	0.0980392
NODE_1415_length_1936_cov_12.592814	102	153	14	9	51	0.1764706
NODE_1415_length_1936_cov_12.592814	102	153	16	22	51	0.4313726
NODE_1415_length_1936_cov_12.592814	154	230	8	1	76	0.0131579
NODE_1415_length_1936_cov_12.592814	154	230	10	18	76	0.2368421
NODE_1415_length_1936_cov_12.592814	154	230	12	9	76	0.1184211
NODE_1415_length_1936_cov_12.592814	154	230	14	48	76	0.6315789
NODE_1415_length_1936_cov_12.592814	211	251	10	3	40	0.0750000
NODE_1415_length_1936_cov_12.592814	211	251	12	15	40	0.3750000
NODE_1415_length_1936_cov_12.592814	211	251	14	22	40	0.5500000
NODE_1416_length_1933_cov_86.724646	1044	1124	0	80	80	1.0000000
NODE_1416_length_1933_cov_86.724646	1097	1177	0	80	80	1.0000000
NODE_1416_length_1933_cov_86.724646	1173	1253	0	80	80	1.0000000
NODE_1416_length_1933_cov_86.724646	1226	1306	0	80	80	1.0000000
NODE_1419_length_1932_cov_5.905074	1534	1614	4	48	80	0.6000000
NODE_1419_length_1932_cov_5.905074	1534	1614	6	32	80	0.4000000
NODE_1422_length_1930_cov_3.005461	1700	1780	90	1	80	0.0125000
NODE_1422_length_1930_cov_3.005461	1700	1780	112	1	80	0.0125000
NODE_1422_length_1930_cov_3.005461	1700	1780	118	3	80	0.0375000
NODE_1422_length_1930_cov_3.005461	1700	1780	123	4	80	0.0500000
NODE_1422_length_1930_cov_3.005461	1700	1780	124	2	80	0.0250000
NODE_1422_length_1930_cov_3.005461	1700	1780	125	1	80	0.0125000
NODE_1422_length_1930_cov_3.005461	1700	1780	126	12	80	0.1500000
NODE_1422_length_1930_cov_3.005461	1700	1780	127	13	80	0.1625000
NODE_1422_length_1930_cov_3.005461	1700	1780	129	1	80	0.0125000
NODE_1422_length_1930_cov_3.005461	1700	1780	130	8	80	0.1000000
NODE_1422_length_1930_cov_3.005461	1700	1780	131	1	80	0.0125000
NODE_1422_length_1930_cov_3.005461	1700	1780	132	20	80	0.2500000
NODE_1422_length_1930_cov_3.005461	1700	1780	133	7	80	0.0875000
NODE_1422_length_1930_cov_3.005461	1700	1780	134	6	80	0.0750000
NODE_1427_length_1928_cov_2.580098	74	131	91	5	57	0.0877193
NODE_1427_length_1928_cov_2.580098	74	131	93	4	57	0.0701754
NODE_1427_length_1928_cov_2.580098	74	131	97	1	57	0.0175439
NODE_1427_length_1928_cov_2.580098	74	131	98	1	57	0.0175439
NODE_1427_length_1928_cov_2.580098	74	131	99	4	57	0.0701754
NODE_1427_length_1928_cov_2.580098	74	131	100	1	57	0.0175439
NODE_1427_length_1928_cov_2.580098	74	131	101	4	57	0.0701754
NODE_1427_length_1928_cov_2.580098	74	131	103	1	57	0.0175439
NODE_1427_length_1928_cov_2.580098	74	131	105	8	57	0.1403509
NODE_1427_length_1928_cov_2.580098	74	131	107	4	57	0.0701754
NODE_1427_length_1928_cov_2.580098	74	131	109	10	57	0.1754386
NODE_1427_length_1928_cov_2.580098	74	131	111	14	57	0.2456140
NODE_1427_length_1928_cov_2.580098	127	184	17	1	57	0.0175439
NODE_1427_length_1928_cov_2.580098	127	184	20	1	57	0.0175439
NODE_1427_length_1928_cov_2.580098	127	184	26	2	57	0.0350877
NODE_1427_length_1928_cov_2.580098	127	184	27	1	57	0.0175439
NODE_1427_length_1928_cov_2.580098	127	184	29	2	57	0.0350877
NODE_1427_length_1928_cov_2.580098	127	184	31	3	57	0.0526316
NODE_1427_length_1928_cov_2.580098	127	184	35	3	57	0.0526316
NODE_1427_length_1928_cov_2.580098	127	184	37	1	57	0.0175439
NODE_1427_length_1928_cov_2.580098	127	184	41	2	57	0.0350877
NODE_1427_length_1928_cov_2.580098	127	184	42	2	57	0.0350877
NODE_1427_length_1928_cov_2.580098	127	184	44	1	57	0.0175439
NODE_1427_length_1928_cov_2.580098	127	184	50	6	57	0.1052632
NODE_1427_length_1928_cov_2.580098	127	184	52	3	57	0.0526316
NODE_1427_length_1928_cov_2.580098	127	184	56	2	57	0.0350877
NODE_1427_length_1928_cov_2.580098	127	184	62	1	57	0.0175439
NODE_1427_length_1928_cov_2.580098	127	184	69	1	57	0.0175439
NODE_1427_length_1928_cov_2.580098	127	184	71	3	57	0.0526316
NODE_1427_length_1928_cov_2.580098	127	184	73	1	57	0.0175439
NODE_1427_length_1928_cov_2.580098	127	184	79	1	57	0.0175439
NODE_1427_length_1928_cov_2.580098	127	184	81	2	57	0.0350877
NODE_1427_length_1928_cov_2.580098	127	184	83	3	57	0.0526316
NODE_1427_length_1928_cov_2.580098	127	184	85	2	57	0.0350877
NODE_1427_length_1928_cov_2.580098	127	184	93	3	57	0.0526316
NODE_1427_length_1928_cov_2.580098	127	184	96	1	57	0.0175439
NODE_1427_length_1928_cov_2.580098	127	184	98	6	57	0.1052632
NODE_1427_length_1928_cov_2.580098	127	184	100	1	57	0.0175439
NODE_1427_length_1928_cov_2.580098	127	184	101	2	57	0.0350877
NODE_1434_length_1919_cov_17.901099	454	529	4	30	75	0.4000000
NODE_1434_length_1919_cov_17.901099	454	529	6	45	75	0.6000000
NODE_1434_length_1919_cov_17.901099	507	558	0	8	51	0.1568628
NODE_1434_length_1919_cov_17.901099	507	558	4	43	51	0.8431373
NODE_1436_length_1918_cov_14.876855	314	396	0	3	82	0.0365854
NODE_1436_length_1918_cov_14.876855	314	396	4	79	82	0.9634146
NODE_1438_length_1918_cov_3.493128	9	55	0	20	46	0.4347826
NODE_1438_length_1918_cov_3.493128	9	55	2	3	46	0.0652174
NODE_1438_length_1918_cov_3.493128	9	55	4	4	46	0.0869565
NODE_1438_length_1918_cov_3.493128	9	55	6	19	46	0.4130435
NODE_1438_length_1918_cov_3.493128	1480	1561	0	81	81	1.0000000
NODE_1440_length_1916_cov_4.426527	162	192	0	30	30	1.0000000
NODE_1442_length_1915_cov_35.787996	106	186	54	2	80	0.0250000
NODE_1442_length_1915_cov_35.787996	106	186	56	2	80	0.0250000
NODE_1442_length_1915_cov_35.787996	106	186	61	1	80	0.0125000
NODE_1442_length_1915_cov_35.787996	106	186	64	1	80	0.0125000
NODE_1442_length_1915_cov_35.787996	106	186	68	2	80	0.0250000
NODE_1442_length_1915_cov_35.787996	106	186	74	1	80	0.0125000
NODE_1442_length_1915_cov_35.787996	106	186	78	2	80	0.0250000
NODE_1442_length_1915_cov_35.787996	106	186	80	1	80	0.0125000
NODE_1442_length_1915_cov_35.787996	106	186	84	1	80	0.0125000
NODE_1442_length_1915_cov_35.787996	106	186	88	1	80	0.0125000
NODE_1442_length_1915_cov_35.787996	106	186	90	1	80	0.0125000
NODE_1442_length_1915_cov_35.787996	106	186	92	1	80	0.0125000
NODE_1442_length_1915_cov_35.787996	106	186	98	1	80	0.0125000
NODE_1442_length_1915_cov_35.787996	106	186	100	1	80	0.0125000
NODE_1442_length_1915_cov_35.787996	106	186	108	1	80	0.0125000
NODE_1442_length_1915_cov_35.787996	106	186	111	1	80	0.0125000
NODE_1442_length_1915_cov_35.787996	106	186	120	1	80	0.0125000
NODE_1442_length_1915_cov_35.787996	106	186	126	1	80	0.0125000
NODE_1442_length_1915_cov_35.787996	106	186	128	5	80	0.0625000
NODE_1442_length_1915_cov_35.787996	106	186	130	2	80	0.0250000
NODE_1442_length_1915_cov_35.787996	106	186	134	3	80	0.0375000
NODE_1442_length_1915_cov_35.787996	106	186	136	2	80	0.0250000
NODE_1442_length_1915_cov_35.787996	106	186	140	2	80	0.0250000
NODE_1442_length_1915_cov_35.787996	106	186	142	1	80	0.0125000
NODE_1442_length_1915_cov_35.787996	106	186	144	1	80	0.0125000
NODE_1442_length_1915_cov_35.787996	106	186	146	1	80	0.0125000
NODE_1442_length_1915_cov_35.787996	106	186	148	3	80	0.0375000
NODE_1442_length_1915_cov_35.787996	106	186	152	2	80	0.0250000
NODE_1442_length_1915_cov_35.787996	106	186	154	1	80	0.0125000
NODE_1442_length_1915_cov_35.787996	106	186	163	1	80	0.0125000
NODE_1442_length_1915_cov_35.787996	106	186	166	1	80	0.0125000
NODE_1442_length_1915_cov_35.787996	106	186	174	1	80	0.0125000
NODE_1442_length_1915_cov_35.787996	106	186	178	1	80	0.0125000
NODE_1442_length_1915_cov_35.787996	106	186	180	2	80	0.0250000
NODE_1442_length_1915_cov_35.787996	106	186	182	2	80	0.0250000
NODE_1442_length_1915_cov_35.787996	106	186	186	1	80	0.0125000
NODE_1442_length_1915_cov_35.787996	106	186	188	1	80	0.0125000
NODE_1442_length_1915_cov_35.787996	106	186	194	1	80	0.0125000
NODE_1442_length_1915_cov_35.787996	106	186	196	9	80	0.1125000
NODE_1442_length_1915_cov_35.787996	106	186	200	3	80	0.0375000
NODE_1442_length_1915_cov_35.787996	106	186	202	3	80	0.0375000
NODE_1442_length_1915_cov_35.787996	106	186	206	3	80	0.0375000
NODE_1442_length_1915_cov_35.787996	106	186	208	3	80	0.0375000
NODE_1442_length_1915_cov_35.787996	106	186	210	2	80	0.0250000
NODE_1442_length_1915_cov_35.787996	106	186	216	1	80	0.0125000
NODE_1451_length_1905_cov_18.464563	740	820	0	24	80	0.3000000
NODE_1451_length_1905_cov_18.464563	740	820	1	1	80	0.0125000
NODE_1451_length_1905_cov_18.464563	740	820	2	55	80	0.6875000
NODE_1451_length_1905_cov_18.464563	793	873	0	77	80	0.9625000
NODE_1451_length_1905_cov_18.464563	793	873	1	1	80	0.0125000
NODE_1451_length_1905_cov_18.464563	793	873	2	2	80	0.0250000
NODE_1451_length_1905_cov_18.464563	869	949	0	80	80	1.0000000
NODE_1451_length_1905_cov_18.464563	922	1010	0	88	88	1.0000000
NODE_1452_length_1905_cov_7.197121	596	676	0	46	80	0.5750000
NODE_1452_length_1905_cov_7.197121	596	676	2	1	80	0.0125000
NODE_1452_length_1905_cov_7.197121	596	676	4	33	80	0.4125000
NODE_1452_length_1905_cov_7.197121	649	682	2	1	33	0.0303030
NODE_1452_length_1905_cov_7.197121	649	682	4	32	33	0.9696970
NODE_1455_length_1902_cov_1.633943	1728	1792	61	1	64	0.0156250
NODE_1455_length_1902_cov_1.633943	1728	1792	63	1	64	0.0156250
NODE_1455_length_1902_cov_1.633943	1728	1792	69	1	64	0.0156250
NODE_1455_length_1902_cov_1.633943	1728	1792	70	1	64	0.0156250
NODE_1455_length_1902_cov_1.633943	1728	1792	76	1	64	0.0156250
NODE_1455_length_1902_cov_1.633943	1728	1792	79	5	64	0.0781250
NODE_1455_length_1902_cov_1.633943	1728	1792	83	1	64	0.0156250
NODE_1455_length_1902_cov_1.633943	1728	1792	85	2	64	0.0312500
NODE_1455_length_1902_cov_1.633943	1728	1792	91	1	64	0.0156250
NODE_1455_length_1902_cov_1.633943	1728	1792	92	1	64	0.0156250
NODE_1455_length_1902_cov_1.633943	1728	1792	96	2	64	0.0312500
NODE_1455_length_1902_cov_1.633943	1728	1792	100	3	64	0.0468750
NODE_1455_length_1902_cov_1.633943	1728	1792	102	1	64	0.0156250
NODE_1455_length_1902_cov_1.633943	1728	1792	104	1	64	0.0156250
NODE_1455_length_1902_cov_1.633943	1728	1792	108	1	64	0.0156250
NODE_1455_length_1902_cov_1.633943	1728	1792	114	2	64	0.0312500
NODE_1455_length_1902_cov_1.633943	1728	1792	116	3	64	0.0468750
NODE_1455_length_1902_cov_1.633943	1728	1792	118	3	64	0.0468750
NODE_1455_length_1902_cov_1.633943	1728	1792	119	6	64	0.0937500
NODE_1455_length_1902_cov_1.633943	1728	1792	121	5	64	0.0781250
NODE_1455_length_1902_cov_1.633943	1728	1792	127	2	64	0.0312500
NODE_1455_length_1902_cov_1.633943	1728	1792	128	1	64	0.0156250
NODE_1455_length_1902_cov_1.633943	1728	1792	130	1	64	0.0156250
NODE_1455_length_1902_cov_1.633943	1728	1792	132	1	64	0.0156250
NODE_1455_length_1902_cov_1.633943	1728	1792	142	6	64	0.0937500
NODE_1455_length_1902_cov_1.633943	1728	1792	144	2	64	0.0312500
NODE_1455_length_1902_cov_1.633943	1728	1792	148	1	64	0.0156250
NODE_1455_length_1902_cov_1.633943	1728	1792	150	1	64	0.0156250
NODE_1455_length_1902_cov_1.633943	1728	1792	152	3	64	0.0468750
NODE_1455_length_1902_cov_1.633943	1728	1792	156	4	64	0.0625000
NODE_1458_length_1900_cov_1.081066	1805	1851	1	46	46	1.0000000
NODE_1458_length_1900_cov_1.081066	1824	1900	0	1	76	0.0131579
NODE_1458_length_1900_cov_1.081066	1824	1900	1	75	76	0.9868421
NODE_1461_length_1895_cov_17.940980	1070	1150	0	80	80	1.0000000
NODE_1461_length_1895_cov_17.940980	1123	1203	0	80	80	1.0000000
NODE_1466_length_1893_cov_3.299331	918	998	0	25	80	0.3125000
NODE_1466_length_1893_cov_3.299331	918	998	2	15	80	0.1875000
NODE_1466_length_1893_cov_3.299331	918	998	3	40	80	0.5000000
NODE_1467_length_1892_cov_5.158394	317	397	0	80	80	1.0000000
NODE_1467_length_1892_cov_5.158394	370	445	0	75	75	1.0000000
NODE_1469_length_1889_cov_4.049162	1652	1686	2	34	34	1.0000000
NODE_1470_length_1889_cov_3.888268	960	1040	0	69	80	0.8625000
NODE_1470_length_1889_cov_3.888268	960	1040	2	11	80	0.1375000
NODE_1470_length_1889_cov_3.888268	1013	1093	0	80	80	1.0000000
NODE_1472_length_1888_cov_17.106764	15	96	50	2	81	0.0246914
NODE_1472_length_1888_cov_17.106764	15	96	52	3	81	0.0370370
NODE_1472_length_1888_cov_17.106764	15	96	56	1	81	0.0123457
NODE_1472_length_1888_cov_17.106764	15	96	62	2	81	0.0246914
NODE_1472_length_1888_cov_17.106764	15	96	69	1	81	0.0123457
NODE_1472_length_1888_cov_17.106764	15	96	74	1	81	0.0123457
NODE_1472_length_1888_cov_17.106764	15	96	85	1	81	0.0123457
NODE_1472_length_1888_cov_17.106764	15	96	86	8	81	0.0987654
NODE_1472_length_1888_cov_17.106764	15	96	87	9	81	0.1111111
NODE_1472_length_1888_cov_17.106764	15	96	93	18	81	0.2222222
NODE_1472_length_1888_cov_17.106764	15	96	95	4	81	0.0493827
NODE_1472_length_1888_cov_17.106764	15	96	96	5	81	0.0617284
NODE_1472_length_1888_cov_17.106764	15	96	98	2	81	0.0246914
NODE_1472_length_1888_cov_17.106764	15	96	99	21	81	0.2592593
NODE_1472_length_1888_cov_17.106764	15	96	101	3	81	0.0370370
NODE_1472_length_1888_cov_17.106764	68	143	37	4	75	0.0533333
NODE_1472_length_1888_cov_17.106764	68	143	38	1	75	0.0133333
NODE_1472_length_1888_cov_17.106764	68	143	39	5	75	0.0666667
NODE_1472_length_1888_cov_17.106764	68	143	45	1	75	0.0133333
NODE_1472_length_1888_cov_17.106764	68	143	53	1	75	0.0133333
NODE_1472_length_1888_cov_17.106764	68	143	55	2	75	0.0266667
NODE_1472_length_1888_cov_17.106764	68	143	57	1	75	0.0133333
NODE_1472_length_1888_cov_17.106764	68	143	61	1	75	0.0133333
NODE_1472_length_1888_cov_17.106764	68	143	67	3	75	0.0400000
NODE_1472_length_1888_cov_17.106764	68	143	69	2	75	0.0266667
NODE_1472_length_1888_cov_17.106764	68	143	73	1	75	0.0133333
NODE_1472_length_1888_cov_17.106764	68	143	75	3	75	0.0400000
NODE_1472_length_1888_cov_17.106764	68	143	77	1	75	0.0133333
NODE_1472_length_1888_cov_17.106764	68	143	79	1	75	0.0133333
NODE_1472_length_1888_cov_17.106764	68	143	81	2	75	0.0266667
NODE_1472_length_1888_cov_17.106764	68	143	89	1	75	0.0133333
NODE_1472_length_1888_cov_17.106764	68	143	91	2	75	0.0266667
NODE_1472_length_1888_cov_17.106764	68	143	95	1	75	0.0133333
NODE_1472_length_1888_cov_17.106764	68	143	96	2	75	0.0266667
NODE_1472_length_1888_cov_17.106764	68	143	97	1	75	0.0133333
NODE_1472_length_1888_cov_17.106764	68	143	98	2	75	0.0266667
NODE_1472_length_1888_cov_17.106764	68	143	99	21	75	0.2800000
NODE_1472_length_1888_cov_17.106764	68	143	100	1	75	0.0133333
NODE_1472_length_1888_cov_17.106764	68	143	101	4	75	0.0533333
NODE_1472_length_1888_cov_17.106764	68	143	103	10	75	0.1333333
NODE_1472_length_1888_cov_17.106764	68	143	104	1	75	0.0133333
NODE_1477_length_1885_cov_4.439530	441	521	0	80	80	1.0000000
NODE_1477_length_1885_cov_4.439530	494	574	0	80	80	1.0000000
NODE_1483_length_1882_cov_5.884464	1499	1579	0	80	80	1.0000000
NODE_1483_length_1882_cov_5.884464	1552	1632	0	55	80	0.6875000
NODE_1483_length_1882_cov_5.884464	1552	1632	4	25	80	0.3125000
NODE_1493_length_1875_cov_3.974662	1650	1730	16	17	80	0.2125000
NODE_1493_length_1875_cov_3.974662	1650	1730	18	14	80	0.1750000
NODE_1493_length_1875_cov_3.974662	1650	1730	19	18	80	0.2250000
NODE_1493_length_1875_cov_3.974662	1650	1730	20	5	80	0.0625000
NODE_1493_length_1875_cov_3.974662	1650	1730	21	1	80	0.0125000
NODE_1493_length_1875_cov_3.974662	1650	1730	22	13	80	0.1625000
NODE_1493_length_1875_cov_3.974662	1650	1730	24	12	80	0.1500000
NODE_1497_length_1872_cov_21.355330	153	201	0	48	48	1.0000000
NODE_1503_length_1868_cov_96.046919	1018	1098	17	2	80	0.0250000
NODE_1503_length_1868_cov_96.046919	1018	1098	23	2	80	0.0250000
NODE_1503_length_1868_cov_96.046919	1018	1098	29	2	80	0.0250000
NODE_1503_length_1868_cov_96.046919	1018	1098	38	1	80	0.0125000
NODE_1503_length_1868_cov_96.046919	1018	1098	42	4	80	0.0500000
NODE_1503_length_1868_cov_96.046919	1018	1098	46	3	80	0.0375000
NODE_1503_length_1868_cov_96.046919	1018	1098	52	6	80	0.0750000
NODE_1503_length_1868_cov_96.046919	1018	1098	62	5	80	0.0625000
NODE_1503_length_1868_cov_96.046919	1018	1098	74	1	80	0.0125000
NODE_1503_length_1868_cov_96.046919	1018	1098	79	1	80	0.0125000
NODE_1503_length_1868_cov_96.046919	1018	1098	80	1	80	0.0125000
NODE_1503_length_1868_cov_96.046919	1018	1098	94	5	80	0.0625000
NODE_1503_length_1868_cov_96.046919	1018	1098	96	7	80	0.0875000
NODE_1503_length_1868_cov_96.046919	1018	1098	100	3	80	0.0375000
NODE_1503_length_1868_cov_96.046919	1018	1098	102	1	80	0.0125000
NODE_1503_length_1868_cov_96.046919	1018	1098	106	1	80	0.0125000
NODE_1503_length_1868_cov_96.046919	1018	1098	112	1	80	0.0125000
NODE_1503_length_1868_cov_96.046919	1018	1098	116	1	80	0.0125000
NODE_1503_length_1868_cov_96.046919	1018	1098	118	1	80	0.0125000
NODE_1503_length_1868_cov_96.046919	1018	1098	120	2	80	0.0250000
NODE_1503_length_1868_cov_96.046919	1018	1098	126	1	80	0.0125000
NODE_1503_length_1868_cov_96.046919	1018	1098	127	1	80	0.0125000
NODE_1503_length_1868_cov_96.046919	1018	1098	129	5	80	0.0625000
NODE_1503_length_1868_cov_96.046919	1018	1098	131	3	80	0.0375000
NODE_1503_length_1868_cov_96.046919	1018	1098	133	1	80	0.0125000
NODE_1503_length_1868_cov_96.046919	1018	1098	141	1	80	0.0125000
NODE_1503_length_1868_cov_96.046919	1018	1098	143	4	80	0.0500000
NODE_1503_length_1868_cov_96.046919	1018	1098	145	1	80	0.0125000
NODE_1503_length_1868_cov_96.046919	1018	1098	153	2	80	0.0250000
NODE_1503_length_1868_cov_96.046919	1018	1098	155	3	80	0.0375000
NODE_1503_length_1868_cov_96.046919	1018	1098	157	1	80	0.0125000
NODE_1503_length_1868_cov_96.046919	1018	1098	164	3	80	0.0375000
NODE_1503_length_1868_cov_96.046919	1018	1098	168	2	80	0.0250000
NODE_1503_length_1868_cov_96.046919	1018	1098	169	2	80	0.0250000
NODE_1503_length_1868_cov_96.046919	1071	1151	129	4	80	0.0500000
NODE_1503_length_1868_cov_96.046919	1071	1151	131	3	80	0.0375000
NODE_1503_length_1868_cov_96.046919	1071	1151	133	1	80	0.0125000
NODE_1503_length_1868_cov_96.046919	1071	1151	141	1	80	0.0125000
NODE_1503_length_1868_cov_96.046919	1071	1151	142	2	80	0.0250000
NODE_1503_length_1868_cov_96.046919	1071	1151	143	4	80	0.0500000
NODE_1503_length_1868_cov_96.046919	1071	1151	144	1	80	0.0125000
NODE_1503_length_1868_cov_96.046919	1071	1151	145	1	80	0.0125000
NODE_1503_length_1868_cov_96.046919	1071	1151	152	4	80	0.0500000
NODE_1503_length_1868_cov_96.046919	1071	1151	153	2	80	0.0250000
NODE_1503_length_1868_cov_96.046919	1071	1151	154	3	80	0.0375000
NODE_1503_length_1868_cov_96.046919	1071	1151	155	3	80	0.0375000
NODE_1503_length_1868_cov_96.046919	1071	1151	156	1	80	0.0125000
NODE_1503_length_1868_cov_96.046919	1071	1151	157	1	80	0.0125000
NODE_1503_length_1868_cov_96.046919	1071	1151	158	9	80	0.1125000
NODE_1503_length_1868_cov_96.046919	1071	1151	159	1	80	0.0125000
NODE_1503_length_1868_cov_96.046919	1071	1151	160	5	80	0.0625000
NODE_1503_length_1868_cov_96.046919	1071	1151	162	2	80	0.0250000
NODE_1503_length_1868_cov_96.046919	1071	1151	163	5	80	0.0625000
NODE_1503_length_1868_cov_96.046919	1071	1151	164	11	80	0.1375000
NODE_1503_length_1868_cov_96.046919	1071	1151	165	11	80	0.1375000
NODE_1503_length_1868_cov_96.046919	1071	1151	167	1	80	0.0125000
NODE_1503_length_1868_cov_96.046919	1071	1151	168	2	80	0.0250000
NODE_1503_length_1868_cov_96.046919	1071	1151	169	2	80	0.0250000
NODE_1508_length_1866_cov_53.869270	1149	1229	0	80	80	1.0000000
NODE_1508_length_1866_cov_53.869270	1202	1282	0	80	80	1.0000000
NODE_1508_length_1866_cov_53.869270	1278	1358	0	80	80	1.0000000
NODE_1508_length_1866_cov_53.869270	1331	1411	0	80	80	1.0000000
NODE_1510_length_1866_cov_3.347482	888	966	0	78	78	1.0000000
NODE_1510_length_1866_cov_3.347482	939	1019	0	80	80	1.0000000
NODE_1513_length_1863_cov_11.265306	698	778	2	18	80	0.2250000
NODE_1513_length_1863_cov_11.265306	698	778	4	62	80	0.7750000
NODE_1513_length_1863_cov_11.265306	751	831	0	51	80	0.6375000
NODE_1513_length_1863_cov_11.265306	751	831	2	20	80	0.2500000
NODE_1513_length_1863_cov_11.265306	751	831	4	9	80	0.1125000
NODE_1518_length_1858_cov_19.019329	23	85	0	51	62	0.8225806
NODE_1518_length_1858_cov_19.019329	23	85	2	11	62	0.1774193
NODE_1518_length_1858_cov_19.019329	1125	1205	0	80	80	1.0000000
NODE_1518_length_1858_cov_19.019329	1178	1256	0	78	78	1.0000000
NODE_1518_length_1858_cov_19.019329	1387	1464	0	7	77	0.0909091
NODE_1518_length_1858_cov_19.019329	1387	1464	2	5	77	0.0649351
NODE_1518_length_1858_cov_19.019329	1387	1464	4	65	77	0.8441558
NODE_1518_length_1858_cov_19.019329	1440	1503	0	5	63	0.0793651
NODE_1518_length_1858_cov_19.019329	1440	1503	2	21	63	0.3333333
NODE_1518_length_1858_cov_19.019329	1440	1503	4	37	63	0.5873016
NODE_1519_length_1857_cov_18.402730	1282	1348	0	23	66	0.3484848
NODE_1519_length_1857_cov_18.402730	1282	1348	2	43	66	0.6515151
NODE_1519_length_1857_cov_18.402730	1321	1401	0	76	80	0.9500000
NODE_1519_length_1857_cov_18.402730	1321	1401	2	4	80	0.0500000
NODE_1519_length_1857_cov_18.402730	1397	1477	0	80	80	1.0000000
NODE_1519_length_1857_cov_18.402730	1450	1530	0	80	80	1.0000000
NODE_1531_length_1845_cov_12.653494	473	553	0	20	80	0.2500000
NODE_1531_length_1845_cov_12.653494	473	553	2	60	80	0.7500000
NODE_1531_length_1845_cov_12.653494	526	606	0	73	80	0.9125000
NODE_1531_length_1845_cov_12.653494	526	606	2	7	80	0.0875000
NODE_1546_length_1833_cov_31.337947	810	888	1	10	78	0.1282051
NODE_1546_length_1833_cov_31.337947	810	888	2	46	78	0.5897436
NODE_1546_length_1833_cov_31.337947	810	888	3	19	78	0.2435897
NODE_1546_length_1833_cov_31.337947	810	888	5	3	78	0.0384615
NODE_1546_length_1833_cov_31.337947	861	941	1	5	80	0.0625000
NODE_1546_length_1833_cov_31.337947	861	941	2	19	80	0.2375000
NODE_1546_length_1833_cov_31.337947	861	941	5	56	80	0.7000000
NODE_1546_length_1833_cov_31.337947	937	1017	0	33	80	0.4125000
NODE_1546_length_1833_cov_31.337947	937	1017	1	4	80	0.0500000
NODE_1546_length_1833_cov_31.337947	937	1017	5	43	80	0.5375000
NODE_1546_length_1833_cov_31.337947	990	1070	0	80	80	1.0000000
NODE_1550_length_1831_cov_3.065820	112	154	6	1	42	0.0238095
NODE_1550_length_1831_cov_3.065820	112	154	10	3	42	0.0714286
NODE_1550_length_1831_cov_3.065820	112	154	14	1	42	0.0238095
NODE_1550_length_1831_cov_3.065820	112	154	18	4	42	0.0952381
NODE_1550_length_1831_cov_3.065820	112	154	20	4	42	0.0952381
NODE_1550_length_1831_cov_3.065820	112	154	22	2	42	0.0476190
NODE_1550_length_1831_cov_3.065820	112	154	24	1	42	0.0238095
NODE_1550_length_1831_cov_3.065820	112	154	28	1	42	0.0238095
NODE_1550_length_1831_cov_3.065820	112	154	34	1	42	0.0238095
NODE_1550_length_1831_cov_3.065820	112	154	36	1	42	0.0238095
NODE_1550_length_1831_cov_3.065820	112	154	40	1	42	0.0238095
NODE_1550_length_1831_cov_3.065820	112	154	42	1	42	0.0238095
NODE_1550_length_1831_cov_3.065820	112	154	44	1	42	0.0238095
NODE_1550_length_1831_cov_3.065820	112	154	50	2	42	0.0476190
NODE_1550_length_1831_cov_3.065820	112	154	58	2	42	0.0476190
NODE_1550_length_1831_cov_3.065820	112	154	60	6	42	0.1428571
NODE_1550_length_1831_cov_3.065820	112	154	66	2	42	0.0476190
NODE_1550_length_1831_cov_3.065820	112	154	68	8	42	0.1904762
NODE_1553_length_1830_cov_2.512998	123	203	0	56	80	0.7000000
NODE_1553_length_1830_cov_2.512998	123	203	4	24	80	0.3000000
NODE_1553_length_1830_cov_2.512998	176	256	0	31	80	0.3875000
NODE_1553_length_1830_cov_2.512998	176	256	4	49	80	0.6125000
NODE_1553_length_1830_cov_2.512998	308	357	6	49	49	1.0000000
NODE_1554_length_1828_cov_40.437825	789	869	0	80	80	1.0000000
NODE_1554_length_1828_cov_40.437825	842	922	0	80	80	1.0000000
NODE_1554_length_1828_cov_40.437825	918	998	0	80	80	1.0000000
NODE_1554_length_1828_cov_40.437825	971	1051	0	80	80	1.0000000
NODE_1559_length_1825_cov_6.652955	641	689	0	48	48	1.0000000
NODE_1559_length_1825_cov_6.652955	694	744	0	11	50	0.2200000
NODE_1559_length_1825_cov_6.652955	694	744	2	39	50	0.7800000
NODE_1562_length_1824_cov_10.152464	685	765	0	49	80	0.6125000
NODE_1562_length_1824_cov_10.152464	685	765	2	31	80	0.3875000
NODE_1562_length_1824_cov_10.152464	738	818	0	26	80	0.3250000
NODE_1562_length_1824_cov_10.152464	738	818	2	54	80	0.6750000
NODE_1562_length_1824_cov_10.152464	1412	1433	2	21	21	1.0000000
NODE_1564_length_1821_cov_7.682346	953	1033	0	80	80	1.0000000
NODE_1564_length_1821_cov_7.682346	1006	1086	0	80	80	1.0000000
NODE_1566_length_1820_cov_12.061592	477	557	0	32	80	0.4000000
NODE_1566_length_1820_cov_12.061592	477	557	2	2	80	0.0250000
NODE_1566_length_1820_cov_12.061592	477	557	4	46	80	0.5750000
NODE_1566_length_1820_cov_12.061592	530	610	4	80	80	1.0000000
NODE_1566_length_1820_cov_12.061592	1232	1312	0	21	80	0.2625000
NODE_1566_length_1820_cov_12.061592	1232	1312	2	59	80	0.7375000
NODE_1566_length_1820_cov_12.061592	1285	1365	0	48	80	0.6000000
NODE_1566_length_1820_cov_12.061592	1285	1365	2	32	80	0.4000000
NODE_1572_length_1817_cov_8.302095	63	122	0	59	59	1.0000000
NODE_1572_length_1817_cov_8.302095	1195	1275	1	57	80	0.7125000
NODE_1572_length_1817_cov_8.302095	1195	1275	2	23	80	0.2875000
NODE_1572_length_1817_cov_8.302095	1248	1328	0	52	80	0.6500000
NODE_1572_length_1817_cov_8.302095	1248	1328	1	28	80	0.3500000
NODE_1573_length_1816_cov_25.489225	1059	1139	0	79	80	0.9875000
NODE_1573_length_1816_cov_25.489225	1059	1139	2	1	80	0.0125000
NODE_1573_length_1816_cov_25.489225	1112	1192	0	80	80	1.0000000
NODE_1578_length_1812_cov_11.453006	398	427	0	27	29	0.9310345
NODE_1578_length_1812_cov_11.453006	398	427	6	2	29	0.0689655
NODE_1578_length_1812_cov_11.453006	400	480	0	80	80	1.0000000
NODE_1586_length_1807_cov_3.977752	1743	1807	0	64	64	1.0000000
NODE_1590_length_1806_cov_2.681312	1461	1541	0	4	80	0.0500000
NODE_1590_length_1806_cov_2.681312	1461	1541	2	2	80	0.0250000
NODE_1590_length_1806_cov_2.681312	1461	1541	4	4	80	0.0500000
NODE_1590_length_1806_cov_2.681312	1461	1541	5	6	80	0.0750000
NODE_1590_length_1806_cov_2.681312	1461	1541	7	2	80	0.0250000
NODE_1590_length_1806_cov_2.681312	1461	1541	11	10	80	0.1250000
NODE_1590_length_1806_cov_2.681312	1461	1541	13	5	80	0.0625000
NODE_1590_length_1806_cov_2.681312	1461	1541	15	2	80	0.0250000
NODE_1590_length_1806_cov_2.681312	1461	1541	21	7	80	0.0875000
NODE_1590_length_1806_cov_2.681312	1461	1541	23	1	80	0.0125000
NODE_1590_length_1806_cov_2.681312	1461	1541	25	3	80	0.0375000
NODE_1590_length_1806_cov_2.681312	1461	1541	27	10	80	0.1250000
NODE_1590_length_1806_cov_2.681312	1461	1541	29	5	80	0.0625000
NODE_1590_length_1806_cov_2.681312	1461	1541	31	1	80	0.0125000
NODE_1590_length_1806_cov_2.681312	1461	1541	33	2	80	0.0250000
NODE_1590_length_1806_cov_2.681312	1461	1541	35	7	80	0.0875000
NODE_1590_length_1806_cov_2.681312	1461	1541	39	2	80	0.0250000
NODE_1590_length_1806_cov_2.681312	1461	1541	41	7	80	0.0875000
NODE_1590_length_1806_cov_2.681312	1517	1594	0	57	77	0.7402598
NODE_1590_length_1806_cov_2.681312	1517	1594	2	2	77	0.0259740
NODE_1590_length_1806_cov_2.681312	1517	1594	4	4	77	0.0519481
NODE_1590_length_1806_cov_2.681312	1517	1594	5	6	77	0.0779221
NODE_1590_length_1806_cov_2.681312	1517	1594	7	2	77	0.0259740
NODE_1590_length_1806_cov_2.681312	1517	1594	11	6	77	0.0779221
NODE_1593_length_1805_cov_10.271395	258	329	0	35	71	0.4929577
NODE_1593_length_1805_cov_10.271395	258	329	6	36	71	0.5070422
NODE_1593_length_1805_cov_10.271395	311	391	6	80	80	1.0000000
NODE_1598_length_1802_cov_11.546682	1284	1364	0	80	80	1.0000000
NODE_1598_length_1802_cov_11.546682	1337	1417	0	80	80	1.0000000
NODE_1600_length_1801_cov_12.145711	85	165	34	2	80	0.0250000
NODE_1600_length_1801_cov_12.145711	85	165	36	17	80	0.2125000
NODE_1600_length_1801_cov_12.145711	85	165	40	1	80	0.0125000
NODE_1600_length_1801_cov_12.145711	85	165	42	7	80	0.0875000
NODE_1600_length_1801_cov_12.145711	85	165	47	1	80	0.0125000
NODE_1600_length_1801_cov_12.145711	85	165	48	15	80	0.1875000
NODE_1600_length_1801_cov_12.145711	85	165	53	16	80	0.2000000
NODE_1600_length_1801_cov_12.145711	85	165	55	4	80	0.0500000
NODE_1600_length_1801_cov_12.145711	85	165	56	7	80	0.0875000
NODE_1600_length_1801_cov_12.145711	85	165	57	10	80	0.1250000
NODE_1600_length_1801_cov_12.145711	138	218	19	3	80	0.0375000
NODE_1600_length_1801_cov_12.145711	138	218	21	1	80	0.0125000
NODE_1600_length_1801_cov_12.145711	138	218	25	2	80	0.0250000
NODE_1600_length_1801_cov_12.145711	138	218	26	1	80	0.0125000
NODE_1600_length_1801_cov_12.145711	138	218	33	4	80	0.0500000
NODE_1600_length_1801_cov_12.145711	138	218	34	8	80	0.1000000
NODE_1600_length_1801_cov_12.145711	138	218	35	10	80	0.1250000
NODE_1600_length_1801_cov_12.145711	138	218	39	1	80	0.0125000
NODE_1600_length_1801_cov_12.145711	138	218	42	6	80	0.0750000
NODE_1600_length_1801_cov_12.145711	138	218	44	2	80	0.0250000
NODE_1600_length_1801_cov_12.145711	138	218	45	4	80	0.0500000
NODE_1600_length_1801_cov_12.145711	138	218	46	2	80	0.0250000
NODE_1600_length_1801_cov_12.145711	138	218	47	8	80	0.1000000
NODE_1600_length_1801_cov_12.145711	138	218	48	9	80	0.1125000
NODE_1600_length_1801_cov_12.145711	138	218	53	9	80	0.1125000
NODE_1600_length_1801_cov_12.145711	138	218	57	10	80	0.1250000
NODE_1601_length_1801_cov_9.793184	1010	1090	4	8	80	0.1000000
NODE_1601_length_1801_cov_9.793184	1010	1090	6	15	80	0.1875000
NODE_1601_length_1801_cov_9.793184	1010	1090	7	4	80	0.0500000
NODE_1601_length_1801_cov_9.793184	1010	1090	8	53	80	0.6625000
NODE_1601_length_1801_cov_9.793184	1063	1143	0	26	80	0.3250000
NODE_1601_length_1801_cov_9.793184	1063	1143	2	16	80	0.2000000
NODE_1601_length_1801_cov_9.793184	1063	1143	4	19	80	0.2375000
NODE_1601_length_1801_cov_9.793184	1063	1143	6	13	80	0.1625000
NODE_1601_length_1801_cov_9.793184	1063	1143	7	4	80	0.0500000
NODE_1601_length_1801_cov_9.793184	1063	1143	8	2	80	0.0250000
NODE_1604_length_1800_cov_15.074662	695	775	0	80	80	1.0000000
NODE_1604_length_1800_cov_15.074662	755	826	0	71	71	1.0000000
NODE_1605_length_1800_cov_7.281599	10	74	41	1	64	0.0156250
NODE_1605_length_1800_cov_7.281599	10	74	56	1	64	0.0156250
NODE_1605_length_1800_cov_7.281599	10	74	58	1	64	0.0156250
NODE_1605_length_1800_cov_7.281599	10	74	64	2	64	0.0312500
NODE_1605_length_1800_cov_7.281599	10	74	68	1	64	0.0156250
NODE_1605_length_1800_cov_7.281599	10	74	72	17	64	0.2656250
NODE_1605_length_1800_cov_7.281599	10	74	74	2	64	0.0312500
NODE_1605_length_1800_cov_7.281599	10	74	75	3	64	0.0468750
NODE_1605_length_1800_cov_7.281599	10	74	77	12	64	0.1875000
NODE_1605_length_1800_cov_7.281599	10	74	78	2	64	0.0312500
NODE_1605_length_1800_cov_7.281599	10	74	79	5	64	0.0781250
NODE_1605_length_1800_cov_7.281599	10	74	89	1	64	0.0156250
NODE_1605_length_1800_cov_7.281599	10	74	91	2	64	0.0312500
NODE_1605_length_1800_cov_7.281599	10	74	106	2	64	0.0312500
NODE_1605_length_1800_cov_7.281599	10	74	110	2	64	0.0312500
NODE_1605_length_1800_cov_7.281599	10	74	112	2	64	0.0312500
NODE_1605_length_1800_cov_7.281599	10	74	132	1	64	0.0156250
NODE_1605_length_1800_cov_7.281599	10	74	133	1	64	0.0156250
NODE_1605_length_1800_cov_7.281599	10	74	137	1	64	0.0156250
NODE_1605_length_1800_cov_7.281599	10	74	138	3	64	0.0468750
NODE_1605_length_1800_cov_7.281599	10	74	140	1	64	0.0156250
NODE_1605_length_1800_cov_7.281599	10	74	143	1	64	0.0156250
NODE_1605_length_1800_cov_7.281599	10	74	41	1	64	0.0156250
NODE_1605_length_1800_cov_7.281599	10	74	56	1	64	0.0156250
NODE_1605_length_1800_cov_7.281599	10	74	58	1	64	0.0156250
NODE_1605_length_1800_cov_7.281599	10	74	64	2	64	0.0312500
NODE_1605_length_1800_cov_7.281599	10	74	68	1	64	0.0156250
NODE_1605_length_1800_cov_7.281599	10	74	72	17	64	0.2656250
NODE_1605_length_1800_cov_7.281599	10	74	74	2	64	0.0312500
NODE_1605_length_1800_cov_7.281599	10	74	75	3	64	0.0468750
NODE_1605_length_1800_cov_7.281599	10	74	77	12	64	0.1875000
NODE_1605_length_1800_cov_7.281599	10	74	78	2	64	0.0312500
NODE_1605_length_1800_cov_7.281599	10	74	79	5	64	0.0781250
NODE_1605_length_1800_cov_7.281599	10	74	89	1	64	0.0156250
NODE_1605_length_1800_cov_7.281599	10	74	91	2	64	0.0312500
NODE_1605_length_1800_cov_7.281599	10	74	106	2	64	0.0312500
NODE_1605_length_1800_cov_7.281599	10	74	110	2	64	0.0312500
NODE_1605_length_1800_cov_7.281599	10	74	112	2	64	0.0312500
NODE_1605_length_1800_cov_7.281599	10	74	132	1	64	0.0156250
NODE_1605_length_1800_cov_7.281599	10	74	133	1	64	0.0156250
NODE_1605_length_1800_cov_7.281599	10	74	137	1	64	0.0156250
NODE_1605_length_1800_cov_7.281599	10	74	138	3	64	0.0468750
NODE_1605_length_1800_cov_7.281599	10	74	140	1	64	0.0156250
NODE_1605_length_1800_cov_7.281599	10	74	143	1	64	0.0156250
NODE_1605_length_1800_cov_7.281599	10	74	41	1	64	0.0156250
NODE_1605_length_1800_cov_7.281599	10	74	56	1	64	0.0156250
NODE_1605_length_1800_cov_7.281599	10	74	58	1	64	0.0156250
NODE_1605_length_1800_cov_7.281599	10	74	64	2	64	0.0312500
NODE_1605_length_1800_cov_7.281599	10	74	68	1	64	0.0156250
NODE_1605_length_1800_cov_7.281599	10	74	72	17	64	0.2656250
NODE_1605_length_1800_cov_7.281599	10	74	74	2	64	0.0312500
NODE_1605_length_1800_cov_7.281599	10	74	75	3	64	0.0468750
NODE_1605_length_1800_cov_7.281599	10	74	77	12	64	0.1875000
NODE_1605_length_1800_cov_7.281599	10	74	78	2	64	0.0312500
NODE_1605_length_1800_cov_7.281599	10	74	79	5	64	0.0781250
NODE_1605_length_1800_cov_7.281599	10	74	89	1	64	0.0156250
NODE_1605_length_1800_cov_7.281599	10	74	91	2	64	0.0312500
NODE_1605_length_1800_cov_7.281599	10	74	106	2	64	0.0312500
NODE_1605_length_1800_cov_7.281599	10	74	110	2	64	0.0312500
NODE_1605_length_1800_cov_7.281599	10	74	112	2	64	0.0312500
NODE_1605_length_1800_cov_7.281599	10	74	132	1	64	0.0156250
NODE_1605_length_1800_cov_7.281599	10	74	133	1	64	0.0156250
NODE_1605_length_1800_cov_7.281599	10	74	137	1	64	0.0156250
NODE_1605_length_1800_cov_7.281599	10	74	138	3	64	0.0468750
NODE_1605_length_1800_cov_7.281599	10	74	140	1	64	0.0156250
NODE_1605_length_1800_cov_7.281599	10	74	143	1	64	0.0156250
NODE_1605_length_1800_cov_7.281599	47	127	77	3	80	0.0375000
NODE_1605_length_1800_cov_7.281599	47	127	78	2	80	0.0250000
NODE_1605_length_1800_cov_7.281599	47	127	79	5	80	0.0625000
NODE_1605_length_1800_cov_7.281599	47	127	89	1	80	0.0125000
NODE_1605_length_1800_cov_7.281599	47	127	91	2	80	0.0250000
NODE_1605_length_1800_cov_7.281599	47	127	106	2	80	0.0250000
NODE_1605_length_1800_cov_7.281599	47	127	110	2	80	0.0250000
NODE_1605_length_1800_cov_7.281599	47	127	112	2	80	0.0250000
NODE_1605_length_1800_cov_7.281599	47	127	132	1	80	0.0125000
NODE_1605_length_1800_cov_7.281599	47	127	133	1	80	0.0125000
NODE_1605_length_1800_cov_7.281599	47	127	137	1	80	0.0125000
NODE_1605_length_1800_cov_7.281599	47	127	138	3	80	0.0375000
NODE_1605_length_1800_cov_7.281599	47	127	140	1	80	0.0125000
NODE_1605_length_1800_cov_7.281599	47	127	143	1	80	0.0125000
NODE_1605_length_1800_cov_7.281599	47	127	149	2	80	0.0250000
NODE_1605_length_1800_cov_7.281599	47	127	150	8	80	0.1000000
NODE_1605_length_1800_cov_7.281599	47	127	153	4	80	0.0500000
NODE_1605_length_1800_cov_7.281599	47	127	154	1	80	0.0125000
NODE_1605_length_1800_cov_7.281599	47	127	156	2	80	0.0250000
NODE_1605_length_1800_cov_7.281599	47	127	164	10	80	0.1250000
NODE_1605_length_1800_cov_7.281599	47	127	165	3	80	0.0375000
NODE_1605_length_1800_cov_7.281599	47	127	166	15	80	0.1875000
NODE_1605_length_1800_cov_7.281599	47	127	167	8	80	0.1000000
NODE_1605_length_1800_cov_7.281599	63	126	110	1	63	0.0158730
NODE_1605_length_1800_cov_7.281599	63	126	112	2	63	0.0317460
NODE_1605_length_1800_cov_7.281599	63	126	132	1	63	0.0158730
NODE_1605_length_1800_cov_7.281599	63	126	133	1	63	0.0158730
NODE_1605_length_1800_cov_7.281599	63	126	137	1	63	0.0158730
NODE_1605_length_1800_cov_7.281599	63	126	138	3	63	0.0476190
NODE_1605_length_1800_cov_7.281599	63	126	140	1	63	0.0158730
NODE_1605_length_1800_cov_7.281599	63	126	143	1	63	0.0158730
NODE_1605_length_1800_cov_7.281599	63	126	149	2	63	0.0317460
NODE_1605_length_1800_cov_7.281599	63	126	150	7	63	0.1111111
NODE_1605_length_1800_cov_7.281599	63	126	153	4	63	0.0634921
NODE_1605_length_1800_cov_7.281599	63	126	154	1	63	0.0158730
NODE_1605_length_1800_cov_7.281599	63	126	156	2	63	0.0317460
NODE_1605_length_1800_cov_7.281599	63	126	164	10	63	0.1587302
NODE_1605_length_1800_cov_7.281599	63	126	165	3	63	0.0476190
NODE_1605_length_1800_cov_7.281599	63	126	166	15	63	0.2380952
NODE_1605_length_1800_cov_7.281599	63	126	167	8	63	0.1269841
NODE_1616_length_1793_cov_16.161157	539	619	0	64	80	0.8000000
NODE_1616_length_1793_cov_16.161157	539	619	2	16	80	0.2000000
NODE_1616_length_1793_cov_16.161157	592	672	0	11	80	0.1375000
NODE_1616_length_1793_cov_16.161157	592	672	2	69	80	0.8625000
NODE_1616_length_1793_cov_16.161157	1202	1281	0	36	79	0.4556962
NODE_1616_length_1793_cov_16.161157	1202	1281	4	43	79	0.5443038
NODE_1616_length_1793_cov_16.161157	1254	1335	4	81	81	1.0000000
NODE_1617_length_1793_cov_14.322904	521	601	0	80	80	1.0000000
NODE_1617_length_1793_cov_14.322904	574	654	0	80	80	1.0000000
NODE_1617_length_1793_cov_14.322904	1230	1310	0	80	80	1.0000000
NODE_1618_length_1791_cov_5.516548	1190	1261	0	71	71	1.0000000
NODE_1621_length_1790_cov_4.282082	684	764	0	80	80	1.0000000
NODE_1621_length_1790_cov_4.282082	737	817	0	80	80	1.0000000
NODE_1623_length_1788_cov_39.558911	385	465	0	80	80	1.0000000
NODE_1623_length_1788_cov_39.558911	438	518	0	80	80	1.0000000
NODE_1623_length_1788_cov_39.558911	514	594	0	64	80	0.8000000
NODE_1623_length_1788_cov_39.558911	514	594	1	2	80	0.0250000
NODE_1623_length_1788_cov_39.558911	514	594	2	14	80	0.1750000
NODE_1623_length_1788_cov_39.558911	567	647	0	11	80	0.1375000
NODE_1623_length_1788_cov_39.558911	567	647	1	2	80	0.0250000
NODE_1623_length_1788_cov_39.558911	567	647	2	67	80	0.8375000
NODE_1624_length_1787_cov_44.927133	530	610	55	5	80	0.0625000
NODE_1624_length_1787_cov_44.927133	530	610	57	2	80	0.0250000
NODE_1624_length_1787_cov_44.927133	530	610	59	4	80	0.0500000
NODE_1624_length_1787_cov_44.927133	530	610	61	4	80	0.0500000
NODE_1624_length_1787_cov_44.927133	530	610	63	8	80	0.1000000
NODE_1624_length_1787_cov_44.927133	530	610	65	8	80	0.1000000
NODE_1624_length_1787_cov_44.927133	530	610	66	4	80	0.0500000
NODE_1624_length_1787_cov_44.927133	530	610	67	1	80	0.0125000
NODE_1624_length_1787_cov_44.927133	530	610	69	6	80	0.0750000
NODE_1624_length_1787_cov_44.927133	530	610	70	1	80	0.0125000
NODE_1624_length_1787_cov_44.927133	530	610	71	1	80	0.0125000
NODE_1624_length_1787_cov_44.927133	530	610	73	1	80	0.0125000
NODE_1624_length_1787_cov_44.927133	530	610	75	2	80	0.0250000
NODE_1624_length_1787_cov_44.927133	530	610	76	2	80	0.0250000
NODE_1624_length_1787_cov_44.927133	530	610	78	1	80	0.0125000
NODE_1624_length_1787_cov_44.927133	530	610	79	5	80	0.0625000
NODE_1624_length_1787_cov_44.927133	530	610	80	7	80	0.0875000
NODE_1624_length_1787_cov_44.927133	530	610	81	13	80	0.1625000
NODE_1624_length_1787_cov_44.927133	530	610	83	3	80	0.0375000
NODE_1624_length_1787_cov_44.927133	530	610	85	2	80	0.0250000
NODE_1625_length_1787_cov_2.752370	675	755	4	41	80	0.5125000
NODE_1625_length_1787_cov_2.752370	675	755	6	21	80	0.2625000
NODE_1625_length_1787_cov_2.752370	675	755	8	18	80	0.2250000
NODE_1625_length_1787_cov_2.752370	728	806	4	32	78	0.4102564
NODE_1625_length_1787_cov_2.752370	728	806	6	38	78	0.4871795
NODE_1625_length_1787_cov_2.752370	728	806	8	8	78	0.1025641
NODE_1626_length_1786_cov_13.459395	523	603	0	80	80	1.0000000
NODE_1626_length_1786_cov_13.459395	576	656	0	42	80	0.5250000
NODE_1626_length_1786_cov_13.459395	576	656	2	38	80	0.4750000
NODE_1633_length_1784_cov_40.769733	358	438	0	80	80	1.0000000
NODE_1633_length_1784_cov_40.769733	411	491	0	80	80	1.0000000
NODE_1633_length_1784_cov_40.769733	1057	1137	0	67	80	0.8375000
NODE_1633_length_1784_cov_40.769733	1057	1137	2	13	80	0.1625000
NODE_1633_length_1784_cov_40.769733	1110	1190	0	18	80	0.2250000
NODE_1633_length_1784_cov_40.769733	1110	1190	2	62	80	0.7750000
NODE_1633_length_1784_cov_40.769733	1186	1266	0	55	80	0.6875000
NODE_1633_length_1784_cov_40.769733	1186	1266	10	1	80	0.0125000
NODE_1633_length_1784_cov_40.769733	1186	1266	12	24	80	0.3000000
NODE_1633_length_1784_cov_40.769733	1239	1319	0	2	80	0.0250000
NODE_1633_length_1784_cov_40.769733	1239	1319	10	1	80	0.0125000
NODE_1633_length_1784_cov_40.769733	1239	1319	11	4	80	0.0500000
NODE_1633_length_1784_cov_40.769733	1239	1319	12	73	80	0.9125000
NODE_1634_length_1784_cov_6.049258	1646	1725	0	79	79	1.0000000
NODE_1637_length_1783_cov_45.569477	600	680	0	33	80	0.4125000
NODE_1637_length_1783_cov_45.569477	600	680	4	47	80	0.5875000
NODE_1637_length_1783_cov_45.569477	653	733	4	80	80	1.0000000
NODE_1640_length_1780_cov_21.089233	361	441	0	80	80	1.0000000
NODE_1640_length_1780_cov_21.089233	414	494	0	80	80	1.0000000
NODE_1640_length_1780_cov_21.089233	1031	1104	1	2	73	0.0273973
NODE_1640_length_1780_cov_21.089233	1031	1104	2	3	73	0.0410959
NODE_1640_length_1780_cov_21.089233	1031	1104	4	1	73	0.0136986
NODE_1640_length_1780_cov_21.089233	1031	1104	8	2	73	0.0273973
NODE_1640_length_1780_cov_21.089233	1031	1104	10	6	73	0.0821918
NODE_1640_length_1780_cov_21.089233	1031	1104	12	7	73	0.0958904
NODE_1640_length_1780_cov_21.089233	1031	1104	14	6	73	0.0821918
NODE_1640_length_1780_cov_21.089233	1031	1104	18	2	73	0.0273973
NODE_1640_length_1780_cov_21.089233	1031	1104	20	1	73	0.0136986
NODE_1640_length_1780_cov_21.089233	1031	1104	24	1	73	0.0136986
NODE_1640_length_1780_cov_21.089233	1031	1104	25	3	73	0.0410959
NODE_1640_length_1780_cov_21.089233	1031	1104	27	12	73	0.1643836
NODE_1640_length_1780_cov_21.089233	1031	1104	29	3	73	0.0410959
NODE_1640_length_1780_cov_21.089233	1031	1104	31	1	73	0.0136986
NODE_1640_length_1780_cov_21.089233	1031	1104	33	6	73	0.0821918
NODE_1640_length_1780_cov_21.089233	1031	1104	35	1	73	0.0136986
NODE_1640_length_1780_cov_21.089233	1031	1104	37	3	73	0.0410959
NODE_1640_length_1780_cov_21.089233	1031	1104	39	1	73	0.0136986
NODE_1640_length_1780_cov_21.089233	1031	1104	41	1	73	0.0136986
NODE_1640_length_1780_cov_21.089233	1031	1104	42	4	73	0.0547945
NODE_1640_length_1780_cov_21.089233	1031	1104	43	2	73	0.0273973
NODE_1640_length_1780_cov_21.089233	1031	1104	46	2	73	0.0273973
NODE_1640_length_1780_cov_21.089233	1031	1104	47	3	73	0.0410959
NODE_1640_length_1780_cov_21.089233	1071	1112	27	6	41	0.1463415
NODE_1640_length_1780_cov_21.089233	1071	1112	29	3	41	0.0731707
NODE_1640_length_1780_cov_21.089233	1071	1112	31	1	41	0.0243902
NODE_1640_length_1780_cov_21.089233	1071	1112	33	6	41	0.1463415
NODE_1640_length_1780_cov_21.089233	1071	1112	35	1	41	0.0243902
NODE_1640_length_1780_cov_21.089233	1071	1112	37	3	41	0.0731707
NODE_1640_length_1780_cov_21.089233	1071	1112	39	1	41	0.0243902
NODE_1640_length_1780_cov_21.089233	1071	1112	41	1	41	0.0243902
NODE_1640_length_1780_cov_21.089233	1071	1112	42	4	41	0.0975610
NODE_1640_length_1780_cov_21.089233	1071	1112	43	2	41	0.0487805
NODE_1640_length_1780_cov_21.089233	1071	1112	46	2	41	0.0487805
NODE_1640_length_1780_cov_21.089233	1071	1112	47	3	41	0.0731707
NODE_1640_length_1780_cov_21.089233	1071	1112	53	4	41	0.0975610
NODE_1640_length_1780_cov_21.089233	1071	1112	55	1	41	0.0243902
NODE_1640_length_1780_cov_21.089233	1071	1112	56	2	41	0.0487805
NODE_1640_length_1780_cov_21.089233	1071	1112	57	1	41	0.0243902
NODE_1641_length_1780_cov_7.837597	1682	1747	2	65	65	1.0000000
NODE_1649_length_1778_cov_52.804050	1528	1568	1	8	40	0.2000000
NODE_1649_length_1778_cov_52.804050	1528	1568	18	1	40	0.0250000
NODE_1649_length_1778_cov_52.804050	1528	1568	19	2	40	0.0500000
NODE_1649_length_1778_cov_52.804050	1528	1568	21	2	40	0.0500000
NODE_1649_length_1778_cov_52.804050	1528	1568	23	5	40	0.1250000
NODE_1649_length_1778_cov_52.804050	1528	1568	25	9	40	0.2250000
NODE_1649_length_1778_cov_52.804050	1528	1568	27	4	40	0.1000000
NODE_1649_length_1778_cov_52.804050	1528	1568	30	1	40	0.0250000
NODE_1649_length_1778_cov_52.804050	1528	1568	31	2	40	0.0500000
NODE_1649_length_1778_cov_52.804050	1528	1568	37	5	40	0.1250000
NODE_1649_length_1778_cov_52.804050	1528	1568	39	1	40	0.0250000
NODE_1649_length_1778_cov_52.804050	1541	1621	23	5	80	0.0625000
NODE_1649_length_1778_cov_52.804050	1541	1621	25	9	80	0.1125000
NODE_1649_length_1778_cov_52.804050	1541	1621	27	4	80	0.0500000
NODE_1649_length_1778_cov_52.804050	1541	1621	30	1	80	0.0125000
NODE_1649_length_1778_cov_52.804050	1541	1621	31	2	80	0.0250000
NODE_1649_length_1778_cov_52.804050	1541	1621	37	5	80	0.0625000
NODE_1649_length_1778_cov_52.804050	1541	1621	39	2	80	0.0250000
NODE_1649_length_1778_cov_52.804050	1541	1621	43	4	80	0.0500000
NODE_1649_length_1778_cov_52.804050	1541	1621	45	19	80	0.2375000
NODE_1649_length_1778_cov_52.804050	1541	1621	57	28	80	0.3500000
NODE_1649_length_1778_cov_52.804050	1541	1621	67	1	80	0.0125000
NODE_1649_length_1778_cov_52.804050	1541	1621	23	5	80	0.0625000
NODE_1649_length_1778_cov_52.804050	1541	1621	25	9	80	0.1125000
NODE_1649_length_1778_cov_52.804050	1541	1621	27	4	80	0.0500000
NODE_1649_length_1778_cov_52.804050	1541	1621	30	1	80	0.0125000
NODE_1649_length_1778_cov_52.804050	1541	1621	31	2	80	0.0250000
NODE_1649_length_1778_cov_52.804050	1541	1621	37	5	80	0.0625000
NODE_1649_length_1778_cov_52.804050	1541	1621	39	2	80	0.0250000
NODE_1649_length_1778_cov_52.804050	1541	1621	43	4	80	0.0500000
NODE_1649_length_1778_cov_52.804050	1541	1621	45	19	80	0.2375000
NODE_1649_length_1778_cov_52.804050	1541	1621	57	28	80	0.3500000
NODE_1649_length_1778_cov_52.804050	1541	1621	67	1	80	0.0125000
NODE_1649_length_1778_cov_52.804050	1541	1621	23	5	80	0.0625000
NODE_1649_length_1778_cov_52.804050	1541	1621	25	9	80	0.1125000
NODE_1649_length_1778_cov_52.804050	1541	1621	27	4	80	0.0500000
NODE_1649_length_1778_cov_52.804050	1541	1621	30	1	80	0.0125000
NODE_1649_length_1778_cov_52.804050	1541	1621	31	2	80	0.0250000
NODE_1649_length_1778_cov_52.804050	1541	1621	37	5	80	0.0625000
NODE_1649_length_1778_cov_52.804050	1541	1621	39	2	80	0.0250000
NODE_1649_length_1778_cov_52.804050	1541	1621	43	4	80	0.0500000
NODE_1649_length_1778_cov_52.804050	1541	1621	45	19	80	0.2375000
NODE_1649_length_1778_cov_52.804050	1541	1621	57	28	80	0.3500000
NODE_1649_length_1778_cov_52.804050	1541	1621	67	1	80	0.0125000
NODE_1649_length_1778_cov_52.804050	1541	1621	23	5	80	0.0625000
NODE_1649_length_1778_cov_52.804050	1541	1621	25	9	80	0.1125000
NODE_1649_length_1778_cov_52.804050	1541	1621	27	4	80	0.0500000
NODE_1649_length_1778_cov_52.804050	1541	1621	30	1	80	0.0125000
NODE_1649_length_1778_cov_52.804050	1541	1621	31	2	80	0.0250000
NODE_1649_length_1778_cov_52.804050	1541	1621	37	5	80	0.0625000
NODE_1649_length_1778_cov_52.804050	1541	1621	39	2	80	0.0250000
NODE_1649_length_1778_cov_52.804050	1541	1621	43	4	80	0.0500000
NODE_1649_length_1778_cov_52.804050	1541	1621	45	19	80	0.2375000
NODE_1649_length_1778_cov_52.804050	1541	1621	57	28	80	0.3500000
NODE_1649_length_1778_cov_52.804050	1541	1621	67	1	80	0.0125000
NODE_1649_length_1778_cov_52.804050	1541	1621	23	5	80	0.0625000
NODE_1649_length_1778_cov_52.804050	1541	1621	25	9	80	0.1125000
NODE_1649_length_1778_cov_52.804050	1541	1621	27	4	80	0.0500000
NODE_1649_length_1778_cov_52.804050	1541	1621	30	1	80	0.0125000
NODE_1649_length_1778_cov_52.804050	1541	1621	31	2	80	0.0250000
NODE_1649_length_1778_cov_52.804050	1541	1621	37	5	80	0.0625000
NODE_1649_length_1778_cov_52.804050	1541	1621	39	2	80	0.0250000
NODE_1649_length_1778_cov_52.804050	1541	1621	43	4	80	0.0500000
NODE_1649_length_1778_cov_52.804050	1541	1621	45	19	80	0.2375000
NODE_1649_length_1778_cov_52.804050	1541	1621	57	28	80	0.3500000
NODE_1649_length_1778_cov_52.804050	1541	1621	67	1	80	0.0125000
NODE_1649_length_1778_cov_52.804050	1541	1621	23	5	80	0.0625000
NODE_1649_length_1778_cov_52.804050	1541	1621	25	9	80	0.1125000
NODE_1649_length_1778_cov_52.804050	1541	1621	27	4	80	0.0500000
NODE_1649_length_1778_cov_52.804050	1541	1621	30	1	80	0.0125000
NODE_1649_length_1778_cov_52.804050	1541	1621	31	2	80	0.0250000
NODE_1649_length_1778_cov_52.804050	1541	1621	37	5	80	0.0625000
NODE_1649_length_1778_cov_52.804050	1541	1621	39	2	80	0.0250000
NODE_1649_length_1778_cov_52.804050	1541	1621	43	4	80	0.0500000
NODE_1649_length_1778_cov_52.804050	1541	1621	45	19	80	0.2375000
NODE_1649_length_1778_cov_52.804050	1541	1621	57	28	80	0.3500000
NODE_1649_length_1778_cov_52.804050	1541	1621	67	1	80	0.0125000
NODE_1649_length_1778_cov_52.804050	1617	1697	57	3	80	0.0375000
NODE_1649_length_1778_cov_52.804050	1617	1697	62	19	80	0.2375000
NODE_1649_length_1778_cov_52.804050	1617	1697	64	1	80	0.0125000
NODE_1649_length_1778_cov_52.804050	1617	1697	65	1	80	0.0125000
NODE_1649_length_1778_cov_52.804050	1617	1697	67	4	80	0.0500000
NODE_1649_length_1778_cov_52.804050	1617	1697	69	1	80	0.0125000
NODE_1649_length_1778_cov_52.804050	1617	1697	71	5	80	0.0625000
NODE_1649_length_1778_cov_52.804050	1617	1697	75	1	80	0.0125000
NODE_1649_length_1778_cov_52.804050	1617	1697	77	1	80	0.0125000
NODE_1649_length_1778_cov_52.804050	1617	1697	83	2	80	0.0250000
NODE_1649_length_1778_cov_52.804050	1617	1697	86	1	80	0.0125000
NODE_1649_length_1778_cov_52.804050	1617	1697	87	1	80	0.0125000
NODE_1649_length_1778_cov_52.804050	1617	1697	89	1	80	0.0125000
NODE_1649_length_1778_cov_52.804050	1617	1697	92	4	80	0.0500000
NODE_1649_length_1778_cov_52.804050	1617	1697	95	5	80	0.0625000
NODE_1649_length_1778_cov_52.804050	1617	1697	97	7	80	0.0875000
NODE_1649_length_1778_cov_52.804050	1617	1697	99	17	80	0.2125000
NODE_1649_length_1778_cov_52.804050	1617	1697	101	2	80	0.0250000
NODE_1649_length_1778_cov_52.804050	1617	1697	103	4	80	0.0500000
NODE_1649_length_1778_cov_52.804050	1617	1697	57	3	80	0.0375000
NODE_1649_length_1778_cov_52.804050	1617	1697	62	19	80	0.2375000
NODE_1649_length_1778_cov_52.804050	1617	1697	64	1	80	0.0125000
NODE_1649_length_1778_cov_52.804050	1617	1697	65	1	80	0.0125000
NODE_1649_length_1778_cov_52.804050	1617	1697	67	4	80	0.0500000
NODE_1649_length_1778_cov_52.804050	1617	1697	69	1	80	0.0125000
NODE_1649_length_1778_cov_52.804050	1617	1697	71	5	80	0.0625000
NODE_1649_length_1778_cov_52.804050	1617	1697	75	1	80	0.0125000
NODE_1649_length_1778_cov_52.804050	1617	1697	77	1	80	0.0125000
NODE_1649_length_1778_cov_52.804050	1617	1697	83	2	80	0.0250000
NODE_1649_length_1778_cov_52.804050	1617	1697	86	1	80	0.0125000
NODE_1649_length_1778_cov_52.804050	1617	1697	87	1	80	0.0125000
NODE_1649_length_1778_cov_52.804050	1617	1697	89	1	80	0.0125000
NODE_1649_length_1778_cov_52.804050	1617	1697	92	4	80	0.0500000
NODE_1649_length_1778_cov_52.804050	1617	1697	95	5	80	0.0625000
NODE_1649_length_1778_cov_52.804050	1617	1697	97	7	80	0.0875000
NODE_1649_length_1778_cov_52.804050	1617	1697	99	17	80	0.2125000
NODE_1649_length_1778_cov_52.804050	1617	1697	101	2	80	0.0250000
NODE_1649_length_1778_cov_52.804050	1617	1697	103	4	80	0.0500000
NODE_1649_length_1778_cov_52.804050	1617	1697	57	3	80	0.0375000
NODE_1649_length_1778_cov_52.804050	1617	1697	62	19	80	0.2375000
NODE_1649_length_1778_cov_52.804050	1617	1697	64	1	80	0.0125000
NODE_1649_length_1778_cov_52.804050	1617	1697	65	1	80	0.0125000
NODE_1649_length_1778_cov_52.804050	1617	1697	67	4	80	0.0500000
NODE_1649_length_1778_cov_52.804050	1617	1697	69	1	80	0.0125000
NODE_1649_length_1778_cov_52.804050	1617	1697	71	5	80	0.0625000
NODE_1649_length_1778_cov_52.804050	1617	1697	75	1	80	0.0125000
NODE_1649_length_1778_cov_52.804050	1617	1697	77	1	80	0.0125000
NODE_1649_length_1778_cov_52.804050	1617	1697	83	2	80	0.0250000
NODE_1649_length_1778_cov_52.804050	1617	1697	86	1	80	0.0125000
NODE_1649_length_1778_cov_52.804050	1617	1697	87	1	80	0.0125000
NODE_1649_length_1778_cov_52.804050	1617	1697	89	1	80	0.0125000
NODE_1649_length_1778_cov_52.804050	1617	1697	92	4	80	0.0500000
NODE_1649_length_1778_cov_52.804050	1617	1697	95	5	80	0.0625000
NODE_1649_length_1778_cov_52.804050	1617	1697	97	7	80	0.0875000
NODE_1649_length_1778_cov_52.804050	1617	1697	99	17	80	0.2125000
NODE_1649_length_1778_cov_52.804050	1617	1697	101	2	80	0.0250000
NODE_1649_length_1778_cov_52.804050	1617	1697	103	4	80	0.0500000
NODE_1649_length_1778_cov_52.804050	1617	1697	57	3	80	0.0375000
NODE_1649_length_1778_cov_52.804050	1617	1697	62	19	80	0.2375000
NODE_1649_length_1778_cov_52.804050	1617	1697	64	1	80	0.0125000
NODE_1649_length_1778_cov_52.804050	1617	1697	65	1	80	0.0125000
NODE_1649_length_1778_cov_52.804050	1617	1697	67	4	80	0.0500000
NODE_1649_length_1778_cov_52.804050	1617	1697	69	1	80	0.0125000
NODE_1649_length_1778_cov_52.804050	1617	1697	71	5	80	0.0625000
NODE_1649_length_1778_cov_52.804050	1617	1697	75	1	80	0.0125000
NODE_1649_length_1778_cov_52.804050	1617	1697	77	1	80	0.0125000
NODE_1649_length_1778_cov_52.804050	1617	1697	83	2	80	0.0250000
NODE_1649_length_1778_cov_52.804050	1617	1697	86	1	80	0.0125000
NODE_1649_length_1778_cov_52.804050	1617	1697	87	1	80	0.0125000
NODE_1649_length_1778_cov_52.804050	1617	1697	89	1	80	0.0125000
NODE_1649_length_1778_cov_52.804050	1617	1697	92	4	80	0.0500000
NODE_1649_length_1778_cov_52.804050	1617	1697	95	5	80	0.0625000
NODE_1649_length_1778_cov_52.804050	1617	1697	97	7	80	0.0875000
NODE_1649_length_1778_cov_52.804050	1617	1697	99	17	80	0.2125000
NODE_1649_length_1778_cov_52.804050	1617	1697	101	2	80	0.0250000
NODE_1649_length_1778_cov_52.804050	1617	1697	103	4	80	0.0500000
NODE_1649_length_1778_cov_52.804050	1670	1750	14	3	80	0.0375000
NODE_1649_length_1778_cov_52.804050	1670	1750	18	1	80	0.0125000
NODE_1649_length_1778_cov_52.804050	1670	1750	24	2	80	0.0250000
NODE_1649_length_1778_cov_52.804050	1670	1750	30	2	80	0.0250000
NODE_1649_length_1778_cov_52.804050	1670	1750	34	2	80	0.0250000
NODE_1649_length_1778_cov_52.804050	1670	1750	38	12	80	0.1500000
NODE_1649_length_1778_cov_52.804050	1670	1750	50	22	80	0.2750000
NODE_1649_length_1778_cov_52.804050	1670	1750	62	28	80	0.3500000
NODE_1649_length_1778_cov_52.804050	1670	1750	64	1	80	0.0125000
NODE_1649_length_1778_cov_52.804050	1670	1750	65	1	80	0.0125000
NODE_1649_length_1778_cov_52.804050	1670	1750	67	1	80	0.0125000
NODE_1649_length_1778_cov_52.804050	1670	1750	69	1	80	0.0125000
NODE_1649_length_1778_cov_52.804050	1670	1750	86	1	80	0.0125000
NODE_1649_length_1778_cov_52.804050	1670	1750	92	3	80	0.0375000
NODE_1649_length_1778_cov_52.804050	1670	1750	14	3	80	0.0375000
NODE_1649_length_1778_cov_52.804050	1670	1750	18	1	80	0.0125000
NODE_1649_length_1778_cov_52.804050	1670	1750	24	2	80	0.0250000
NODE_1649_length_1778_cov_52.804050	1670	1750	30	2	80	0.0250000
NODE_1649_length_1778_cov_52.804050	1670	1750	34	2	80	0.0250000
NODE_1649_length_1778_cov_52.804050	1670	1750	38	12	80	0.1500000
NODE_1649_length_1778_cov_52.804050	1670	1750	50	22	80	0.2750000
NODE_1649_length_1778_cov_52.804050	1670	1750	62	28	80	0.3500000
NODE_1649_length_1778_cov_52.804050	1670	1750	64	1	80	0.0125000
NODE_1649_length_1778_cov_52.804050	1670	1750	65	1	80	0.0125000
NODE_1649_length_1778_cov_52.804050	1670	1750	67	1	80	0.0125000
NODE_1649_length_1778_cov_52.804050	1670	1750	69	1	80	0.0125000
NODE_1649_length_1778_cov_52.804050	1670	1750	86	1	80	0.0125000
NODE_1649_length_1778_cov_52.804050	1670	1750	92	3	80	0.0375000
NODE_1649_length_1778_cov_52.804050	1670	1750	14	3	80	0.0375000
NODE_1649_length_1778_cov_52.804050	1670	1750	18	1	80	0.0125000
NODE_1649_length_1778_cov_52.804050	1670	1750	24	2	80	0.0250000
NODE_1649_length_1778_cov_52.804050	1670	1750	30	2	80	0.0250000
NODE_1649_length_1778_cov_52.804050	1670	1750	34	2	80	0.0250000
NODE_1649_length_1778_cov_52.804050	1670	1750	38	12	80	0.1500000
NODE_1649_length_1778_cov_52.804050	1670	1750	50	22	80	0.2750000
NODE_1649_length_1778_cov_52.804050	1670	1750	62	28	80	0.3500000
NODE_1649_length_1778_cov_52.804050	1670	1750	64	1	80	0.0125000
NODE_1649_length_1778_cov_52.804050	1670	1750	65	1	80	0.0125000
NODE_1649_length_1778_cov_52.804050	1670	1750	67	1	80	0.0125000
NODE_1649_length_1778_cov_52.804050	1670	1750	69	1	80	0.0125000
NODE_1649_length_1778_cov_52.804050	1670	1750	86	1	80	0.0125000
NODE_1649_length_1778_cov_52.804050	1670	1750	92	3	80	0.0375000
NODE_1649_length_1778_cov_52.804050	1670	1741	34	1	71	0.0140845
NODE_1649_length_1778_cov_52.804050	1670	1741	38	12	71	0.1690141
NODE_1649_length_1778_cov_52.804050	1670	1741	50	22	71	0.3098592
NODE_1649_length_1778_cov_52.804050	1670	1741	62	28	71	0.3943662
NODE_1649_length_1778_cov_52.804050	1670	1741	64	1	71	0.0140845
NODE_1649_length_1778_cov_52.804050	1670	1741	65	1	71	0.0140845
NODE_1649_length_1778_cov_52.804050	1670	1741	67	1	71	0.0140845
NODE_1649_length_1778_cov_52.804050	1670	1741	69	1	71	0.0140845
NODE_1649_length_1778_cov_52.804050	1670	1741	86	1	71	0.0140845
NODE_1649_length_1778_cov_52.804050	1670	1741	92	3	71	0.0422535
NODE_1649_length_1778_cov_52.804050	1673	1743	30	1	70	0.0142857
NODE_1649_length_1778_cov_52.804050	1673	1743	34	2	70	0.0285714
NODE_1649_length_1778_cov_52.804050	1673	1743	38	12	70	0.1714286
NODE_1649_length_1778_cov_52.804050	1673	1743	50	22	70	0.3142857
NODE_1649_length_1778_cov_52.804050	1673	1743	62	28	70	0.4000000
NODE_1649_length_1778_cov_52.804050	1673	1743	64	1	70	0.0142857
NODE_1649_length_1778_cov_52.804050	1673	1743	65	1	70	0.0142857
NODE_1649_length_1778_cov_52.804050	1673	1743	67	1	70	0.0142857
NODE_1649_length_1778_cov_52.804050	1673	1743	69	1	70	0.0142857
NODE_1649_length_1778_cov_52.804050	1673	1743	86	1	70	0.0142857
NODE_1649_length_1778_cov_52.804050	1679	1750	14	3	71	0.0422535
NODE_1649_length_1778_cov_52.804050	1679	1750	18	1	71	0.0140845
NODE_1649_length_1778_cov_52.804050	1679	1750	24	2	71	0.0281690
NODE_1649_length_1778_cov_52.804050	1679	1750	30	2	71	0.0281690
NODE_1649_length_1778_cov_52.804050	1679	1750	34	2	71	0.0281690
NODE_1649_length_1778_cov_52.804050	1679	1750	38	12	71	0.1690141
NODE_1649_length_1778_cov_52.804050	1679	1750	50	22	71	0.3098592
NODE_1649_length_1778_cov_52.804050	1679	1750	62	27	71	0.3802817
NODE_1651_length_1776_cov_43.081694	1246	1308	0	28	62	0.4516129
NODE_1651_length_1776_cov_43.081694	1246	1308	1	1	62	0.0161290
NODE_1651_length_1776_cov_43.081694	1246	1308	6	28	62	0.4516129
NODE_1651_length_1776_cov_43.081694	1246	1308	7	1	62	0.0161290
NODE_1651_length_1776_cov_43.081694	1246	1308	9	1	62	0.0161290
NODE_1651_length_1776_cov_43.081694	1246	1308	12	2	62	0.0322581
NODE_1651_length_1776_cov_43.081694	1246	1308	68	1	62	0.0161290
NODE_1651_length_1776_cov_43.081694	1281	1361	6	80	80	1.0000000
NODE_1652_length_1776_cov_9.256410	1120	1200	0	77	80	0.9625000
NODE_1652_length_1776_cov_9.256410	1120	1200	2	3	80	0.0375000
NODE_1652_length_1776_cov_9.256410	1173	1253	0	24	80	0.3000000
NODE_1652_length_1776_cov_9.256410	1173	1253	2	42	80	0.5250000
NODE_1652_length_1776_cov_9.256410	1173	1253	18	1	80	0.0125000
NODE_1652_length_1776_cov_9.256410	1173	1253	19	13	80	0.1625000
NODE_1652_length_1776_cov_9.256410	1249	1329	18	44	80	0.5500000
NODE_1652_length_1776_cov_9.256410	1249	1329	19	18	80	0.2250000
NODE_1652_length_1776_cov_9.256410	1249	1329	20	18	80	0.2250000
NODE_1652_length_1776_cov_9.256410	1302	1382	17	22	80	0.2750000
NODE_1652_length_1776_cov_9.256410	1302	1382	18	58	80	0.7250000
NODE_1657_length_1775_cov_54.208234	1103	1167	153	3	64	0.0468750
NODE_1657_length_1775_cov_54.208234	1103	1167	155	2	64	0.0312500
NODE_1657_length_1775_cov_54.208234	1103	1167	159	1	64	0.0156250
NODE_1657_length_1775_cov_54.208234	1103	1167	161	1	64	0.0156250
NODE_1657_length_1775_cov_54.208234	1103	1167	163	6	64	0.0937500
NODE_1657_length_1775_cov_54.208234	1103	1167	164	2	64	0.0312500
NODE_1657_length_1775_cov_54.208234	1103	1167	165	8	64	0.1250000
NODE_1657_length_1775_cov_54.208234	1103	1167	166	2	64	0.0312500
NODE_1657_length_1775_cov_54.208234	1103	1167	167	7	64	0.1093750
NODE_1657_length_1775_cov_54.208234	1103	1167	169	3	64	0.0468750
NODE_1657_length_1775_cov_54.208234	1103	1167	171	2	64	0.0312500
NODE_1657_length_1775_cov_54.208234	1103	1167	172	1	64	0.0156250
NODE_1657_length_1775_cov_54.208234	1103	1167	173	3	64	0.0468750
NODE_1657_length_1775_cov_54.208234	1103	1167	174	2	64	0.0312500
NODE_1657_length_1775_cov_54.208234	1103	1167	175	2	64	0.0312500
NODE_1657_length_1775_cov_54.208234	1103	1167	176	5	64	0.0781250
NODE_1657_length_1775_cov_54.208234	1103	1167	177	1	64	0.0156250
NODE_1657_length_1775_cov_54.208234	1103	1167	178	2	64	0.0312500
NODE_1657_length_1775_cov_54.208234	1103	1167	179	2	64	0.0312500
NODE_1657_length_1775_cov_54.208234	1103	1167	180	2	64	0.0312500
NODE_1657_length_1775_cov_54.208234	1103	1167	183	4	64	0.0625000
NODE_1657_length_1775_cov_54.208234	1103	1167	184	1	64	0.0156250
NODE_1657_length_1775_cov_54.208234	1103	1167	185	1	64	0.0156250
NODE_1657_length_1775_cov_54.208234	1103	1167	186	1	64	0.0156250
NODE_1657_length_1775_cov_54.208234	1103	1167	153	3	64	0.0468750
NODE_1657_length_1775_cov_54.208234	1103	1167	155	2	64	0.0312500
NODE_1657_length_1775_cov_54.208234	1103	1167	159	1	64	0.0156250
NODE_1657_length_1775_cov_54.208234	1103	1167	161	1	64	0.0156250
NODE_1657_length_1775_cov_54.208234	1103	1167	163	6	64	0.0937500
NODE_1657_length_1775_cov_54.208234	1103	1167	164	2	64	0.0312500
NODE_1657_length_1775_cov_54.208234	1103	1167	165	8	64	0.1250000
NODE_1657_length_1775_cov_54.208234	1103	1167	166	2	64	0.0312500
NODE_1657_length_1775_cov_54.208234	1103	1167	167	7	64	0.1093750
NODE_1657_length_1775_cov_54.208234	1103	1167	169	3	64	0.0468750
NODE_1657_length_1775_cov_54.208234	1103	1167	171	2	64	0.0312500
NODE_1657_length_1775_cov_54.208234	1103	1167	172	1	64	0.0156250
NODE_1657_length_1775_cov_54.208234	1103	1167	173	3	64	0.0468750
NODE_1657_length_1775_cov_54.208234	1103	1167	174	2	64	0.0312500
NODE_1657_length_1775_cov_54.208234	1103	1167	175	2	64	0.0312500
NODE_1657_length_1775_cov_54.208234	1103	1167	176	5	64	0.0781250
NODE_1657_length_1775_cov_54.208234	1103	1167	177	1	64	0.0156250
NODE_1657_length_1775_cov_54.208234	1103	1167	178	2	64	0.0312500
NODE_1657_length_1775_cov_54.208234	1103	1167	179	2	64	0.0312500
NODE_1657_length_1775_cov_54.208234	1103	1167	180	2	64	0.0312500
NODE_1657_length_1775_cov_54.208234	1103	1167	183	4	64	0.0625000
NODE_1657_length_1775_cov_54.208234	1103	1167	184	1	64	0.0156250
NODE_1657_length_1775_cov_54.208234	1103	1167	185	1	64	0.0156250
NODE_1657_length_1775_cov_54.208234	1103	1167	186	1	64	0.0156250
NODE_1657_length_1775_cov_54.208234	1140	1200	97	1	60	0.0166667
NODE_1657_length_1775_cov_54.208234	1140	1200	104	6	60	0.1000000
NODE_1657_length_1775_cov_54.208234	1140	1200	112	5	60	0.0833333
NODE_1657_length_1775_cov_54.208234	1140	1200	116	5	60	0.0833333
NODE_1657_length_1775_cov_54.208234	1140	1200	119	1	60	0.0166667
NODE_1657_length_1775_cov_54.208234	1140	1200	123	1	60	0.0166667
NODE_1657_length_1775_cov_54.208234	1140	1200	127	1	60	0.0166667
NODE_1657_length_1775_cov_54.208234	1140	1200	130	2	60	0.0333333
NODE_1657_length_1775_cov_54.208234	1140	1200	135	1	60	0.0166667
NODE_1657_length_1775_cov_54.208234	1140	1200	137	4	60	0.0666667
NODE_1657_length_1775_cov_54.208234	1140	1200	147	2	60	0.0333333
NODE_1657_length_1775_cov_54.208234	1140	1200	149	3	60	0.0500000
NODE_1657_length_1775_cov_54.208234	1140	1200	153	4	60	0.0666667
NODE_1657_length_1775_cov_54.208234	1140	1200	155	2	60	0.0333333
NODE_1657_length_1775_cov_54.208234	1140	1200	159	1	60	0.0166667
NODE_1657_length_1775_cov_54.208234	1140	1200	161	1	60	0.0166667
NODE_1657_length_1775_cov_54.208234	1140	1200	163	6	60	0.1000000
NODE_1657_length_1775_cov_54.208234	1140	1200	164	2	60	0.0333333
NODE_1657_length_1775_cov_54.208234	1140	1200	165	3	60	0.0500000
NODE_1657_length_1775_cov_54.208234	1140	1200	166	2	60	0.0333333
NODE_1657_length_1775_cov_54.208234	1140	1200	167	4	60	0.0666667
NODE_1657_length_1775_cov_54.208234	1140	1200	171	2	60	0.0333333
NODE_1657_length_1775_cov_54.208234	1140	1200	173	1	60	0.0166667
NODE_1658_length_1775_cov_13.181981	1170	1250	0	1	80	0.0125000
NODE_1658_length_1775_cov_13.181981	1170	1250	4	79	80	0.9875000
NODE_1658_length_1775_cov_13.181981	1223	1303	0	54	80	0.6750000
NODE_1658_length_1775_cov_13.181981	1223	1303	4	26	80	0.3250000
NODE_1659_length_1775_cov_4.218974	1304	1384	0	80	80	1.0000000
NODE_1659_length_1775_cov_4.218974	1357	1437	0	80	80	1.0000000
NODE_1660_length_1774_cov_48.617313	345	425	0	80	80	1.0000000
NODE_1660_length_1774_cov_48.617313	398	478	0	80	80	1.0000000
NODE_1660_length_1774_cov_48.617313	474	554	0	80	80	1.0000000
NODE_1660_length_1774_cov_48.617313	527	607	0	64	80	0.8000000
NODE_1660_length_1774_cov_48.617313	527	607	2	16	80	0.2000000
NODE_1660_length_1774_cov_48.617313	1027	1107	0	22	80	0.2750000
NODE_1660_length_1774_cov_48.617313	1027	1107	2	38	80	0.4750000
NODE_1660_length_1774_cov_48.617313	1027	1107	4	2	80	0.0250000
NODE_1660_length_1774_cov_48.617313	1027	1107	6	18	80	0.2250000
NODE_1660_length_1774_cov_48.617313	1080	1160	0	75	80	0.9375000
NODE_1660_length_1774_cov_48.617313	1080	1160	2	5	80	0.0625000
NODE_1660_length_1774_cov_48.617313	1156	1236	0	80	80	1.0000000
NODE_1660_length_1774_cov_48.617313	1209	1289	0	80	80	1.0000000
NODE_1662_length_1774_cov_8.011343	1655	1735	0	80	80	1.0000000
NODE_1663_length_1773_cov_5.547192	433	513	0	80	80	1.0000000
NODE_1663_length_1773_cov_5.547192	486	566	0	80	80	1.0000000
NODE_1664_length_1773_cov_3.925329	267	347	0	25	80	0.3125000
NODE_1664_length_1773_cov_3.925329	267	347	4	55	80	0.6875000
NODE_1664_length_1773_cov_3.925329	320	400	0	2	80	0.0250000
NODE_1664_length_1773_cov_3.925329	320	400	4	78	80	0.9750000
NODE_1666_length_1770_cov_9.912029	369	437	0	68	68	1.0000000
NODE_1666_length_1770_cov_9.912029	388	431	0	43	43	1.0000000
NODE_1666_length_1770_cov_9.912029	509	577	0	68	68	1.0000000
NODE_1666_length_1770_cov_9.912029	515	571	0	56	56	1.0000000
NODE_1666_length_1770_cov_9.912029	579	618	0	39	39	1.0000000
NODE_1666_length_1770_cov_9.912029	697	776	0	79	79	1.0000000
NODE_1666_length_1770_cov_9.912029	714	794	0	80	80	1.0000000
NODE_1666_length_1770_cov_9.912029	767	819	0	52	52	1.0000000
NODE_1666_length_1770_cov_9.912029	785	819	0	34	34	1.0000000
NODE_1667_length_1768_cov_9.134811	687	736	52	5	49	0.1020408
NODE_1667_length_1768_cov_9.134811	687	736	53	3	49	0.0612245
NODE_1667_length_1768_cov_9.134811	687	736	54	9	49	0.1836735
NODE_1667_length_1768_cov_9.134811	687	736	56	3	49	0.0612245
NODE_1667_length_1768_cov_9.134811	687	736	57	1	49	0.0204082
NODE_1667_length_1768_cov_9.134811	687	736	58	4	49	0.0816327
NODE_1667_length_1768_cov_9.134811	687	736	59	1	49	0.0204082
NODE_1667_length_1768_cov_9.134811	687	736	60	11	49	0.2244898
NODE_1667_length_1768_cov_9.134811	687	736	61	3	49	0.0612245
NODE_1667_length_1768_cov_9.134811	687	736	62	5	49	0.1020408
NODE_1667_length_1768_cov_9.134811	687	736	63	1	49	0.0204082
NODE_1667_length_1768_cov_9.134811	687	736	64	1	49	0.0204082
NODE_1667_length_1768_cov_9.134811	687	736	67	1	49	0.0204082
NODE_1667_length_1768_cov_9.134811	687	736	68	1	49	0.0204082
NODE_1668_length_1768_cov_6.605153	1207	1287	0	80	80	1.0000000
NODE_1668_length_1768_cov_6.605153	1260	1340	0	80	80	1.0000000
NODE_1668_length_1768_cov_6.605153	1336	1416	0	80	80	1.0000000
NODE_1668_length_1768_cov_6.605153	1389	1469	0	80	80	1.0000000
NODE_1669_length_1767_cov_5.475420	508	588	18	6	80	0.0750000
NODE_1669_length_1767_cov_5.475420	508	588	20	1	80	0.0125000
NODE_1669_length_1767_cov_5.475420	508	588	22	1	80	0.0125000
NODE_1669_length_1767_cov_5.475420	508	588	24	5	80	0.0625000
NODE_1669_length_1767_cov_5.475420	508	588	27	10	80	0.1250000
NODE_1669_length_1767_cov_5.475420	508	588	29	10	80	0.1250000
NODE_1669_length_1767_cov_5.475420	508	588	30	2	80	0.0250000
NODE_1669_length_1767_cov_5.475420	508	588	32	7	80	0.0875000
NODE_1669_length_1767_cov_5.475420	508	588	33	1	80	0.0125000
NODE_1669_length_1767_cov_5.475420	508	588	34	10	80	0.1250000
NODE_1669_length_1767_cov_5.475420	508	588	35	4	80	0.0500000
NODE_1669_length_1767_cov_5.475420	508	588	36	20	80	0.2500000
NODE_1669_length_1767_cov_5.475420	508	588	37	3	80	0.0375000
NODE_1680_length_1762_cov_18.673482	606	686	0	38	80	0.4750000
NODE_1680_length_1762_cov_18.673482	606	686	2	6	80	0.0750000
NODE_1680_length_1762_cov_18.673482	606	686	6	36	80	0.4500000
NODE_1680_length_1762_cov_18.673482	659	739	4	14	80	0.1750000
NODE_1680_length_1762_cov_18.673482	659	739	6	66	80	0.8250000
NODE_1680_length_1762_cov_18.673482	735	815	0	39	80	0.4875000
NODE_1680_length_1762_cov_18.673482	735	815	2	10	80	0.1250000
NODE_1680_length_1762_cov_18.673482	735	815	4	31	80	0.3875000
NODE_1680_length_1762_cov_18.673482	788	868	0	15	80	0.1875000
NODE_1680_length_1762_cov_18.673482	788	868	2	10	80	0.1250000
NODE_1680_length_1762_cov_18.673482	788	868	4	45	80	0.5625000
NODE_1680_length_1762_cov_18.673482	788	868	6	10	80	0.1250000
NODE_1681_length_1762_cov_6.760072	1033	1113	0	29	80	0.3625000
NODE_1681_length_1762_cov_6.760072	1033	1113	2	51	80	0.6375000
NODE_1681_length_1762_cov_6.760072	1086	1166	2	80	80	1.0000000
NODE_1685_length_1760_cov_8.064419	941	1021	0	80	80	1.0000000
NODE_1685_length_1760_cov_8.064419	994	1074	0	80	80	1.0000000
NODE_1692_length_1758_cov_99.869198	599	679	4	24	80	0.3000000
NODE_1692_length_1758_cov_99.869198	599	679	6	55	80	0.6875000
NODE_1692_length_1758_cov_99.869198	599	679	10	1	80	0.0125000
NODE_1692_length_1758_cov_99.869198	652	732	4	19	80	0.2375000
NODE_1692_length_1758_cov_99.869198	652	732	6	7	80	0.0875000
NODE_1692_length_1758_cov_99.869198	652	732	9	18	80	0.2250000
NODE_1692_length_1758_cov_99.869198	652	732	10	19	80	0.2375000
NODE_1692_length_1758_cov_99.869198	652	732	11	14	80	0.1750000
NODE_1692_length_1758_cov_99.869198	652	732	12	3	80	0.0375000
NODE_1692_length_1758_cov_99.869198	728	808	9	3	80	0.0375000
NODE_1692_length_1758_cov_99.869198	728	808	10	18	80	0.2250000
NODE_1692_length_1758_cov_99.869198	728	808	18	15	80	0.1875000
NODE_1692_length_1758_cov_99.869198	728	808	20	44	80	0.5500000
NODE_1692_length_1758_cov_99.869198	781	861	7	23	80	0.2875000
NODE_1692_length_1758_cov_99.869198	781	861	9	8	80	0.1000000
NODE_1692_length_1758_cov_99.869198	781	861	13	9	80	0.1125000
NODE_1692_length_1758_cov_99.869198	781	861	18	18	80	0.2250000
NODE_1692_length_1758_cov_99.869198	781	861	19	6	80	0.0750000
NODE_1692_length_1758_cov_99.869198	781	861	20	16	80	0.2000000
NODE_1693_length_1757_cov_3.126659	49	121	6	72	72	1.0000000
NODE_1696_length_1755_cov_9.938406	231	311	0	46	80	0.5750000
NODE_1696_length_1755_cov_9.938406	231	311	1	14	80	0.1750000
NODE_1696_length_1755_cov_9.938406	231	311	2	20	80	0.2500000
NODE_1696_length_1755_cov_9.938406	284	364	1	7	80	0.0875000
NODE_1696_length_1755_cov_9.938406	284	364	2	73	80	0.9125000
NODE_1698_length_1755_cov_3.614130	171	222	2	32	51	0.6274510
NODE_1698_length_1755_cov_3.614130	171	222	3	7	51	0.1372549
NODE_1698_length_1755_cov_3.614130	171	222	5	1	51	0.0196078
NODE_1698_length_1755_cov_3.614130	171	222	9	10	51	0.1960784
NODE_1698_length_1755_cov_3.614130	171	222	10	1	51	0.0196078
NODE_1699_length_1754_cov_8.523263	0	77	0	77	77	1.0000000
NODE_1699_length_1754_cov_8.523263	0	77	0	77	77	1.0000000
NODE_1699_length_1754_cov_8.523263	0	77	0	77	77	1.0000000
NODE_1699_length_1754_cov_8.523263	50	99	0	28	49	0.5714286
NODE_1699_length_1754_cov_8.523263	50	99	2	21	49	0.4285714
NODE_1699_length_1754_cov_8.523263	53	99	0	25	46	0.5434783
NODE_1699_length_1754_cov_8.523263	53	99	2	21	46	0.4565217
NODE_1699_length_1754_cov_8.523263	55	99	0	23	44	0.5227273
NODE_1699_length_1754_cov_8.523263	55	99	2	21	44	0.4772727
NODE_1700_length_1753_cov_26.851874	356	436	0	80	80	1.0000000
NODE_1700_length_1753_cov_26.851874	409	489	0	80	80	1.0000000
NODE_1701_length_1753_cov_12.297461	355	435	0	80	80	1.0000000
NODE_1701_length_1753_cov_12.297461	408	488	0	80	80	1.0000000
NODE_1705_length_1750_cov_90.732283	1191	1254	374	1	63	0.0158730
NODE_1705_length_1750_cov_90.732283	1191	1254	376	2	63	0.0317460
NODE_1705_length_1750_cov_90.732283	1191	1254	379	2	63	0.0317460
NODE_1705_length_1750_cov_90.732283	1191	1254	380	1	63	0.0158730
NODE_1705_length_1750_cov_90.732283	1191	1254	382	2	63	0.0317460
NODE_1705_length_1750_cov_90.732283	1191	1254	383	1	63	0.0158730
NODE_1705_length_1750_cov_90.732283	1191	1254	384	1	63	0.0158730
NODE_1705_length_1750_cov_90.732283	1191	1254	386	1	63	0.0158730
NODE_1705_length_1750_cov_90.732283	1191	1254	387	2	63	0.0317460
NODE_1705_length_1750_cov_90.732283	1191	1254	391	1	63	0.0158730
NODE_1705_length_1750_cov_90.732283	1191	1254	398	1	63	0.0158730
NODE_1705_length_1750_cov_90.732283	1191	1254	408	1	63	0.0158730
NODE_1705_length_1750_cov_90.732283	1191	1254	419	1	63	0.0158730
NODE_1705_length_1750_cov_90.732283	1191	1254	423	1	63	0.0158730
NODE_1705_length_1750_cov_90.732283	1191	1254	431	2	63	0.0317460
NODE_1705_length_1750_cov_90.732283	1191	1254	436	1	63	0.0158730
NODE_1705_length_1750_cov_90.732283	1191	1254	443	1	63	0.0158730
NODE_1705_length_1750_cov_90.732283	1191	1254	446	1	63	0.0158730
NODE_1705_length_1750_cov_90.732283	1191	1254	447	1	63	0.0158730
NODE_1705_length_1750_cov_90.732283	1191	1254	449	1	63	0.0158730
NODE_1705_length_1750_cov_90.732283	1191	1254	461	1	63	0.0158730
NODE_1705_length_1750_cov_90.732283	1191	1254	465	1	63	0.0158730
NODE_1705_length_1750_cov_90.732283	1191	1254	471	2	63	0.0317460
NODE_1705_length_1750_cov_90.732283	1191	1254	473	1	63	0.0158730
NODE_1705_length_1750_cov_90.732283	1191	1254	475	1	63	0.0158730
NODE_1705_length_1750_cov_90.732283	1191	1254	480	1	63	0.0158730
NODE_1705_length_1750_cov_90.732283	1191	1254	495	1	63	0.0158730
NODE_1705_length_1750_cov_90.732283	1191	1254	507	1	63	0.0158730
NODE_1705_length_1750_cov_90.732283	1191	1254	510	1	63	0.0158730
NODE_1705_length_1750_cov_90.732283	1191	1254	511	1	63	0.0158730
NODE_1705_length_1750_cov_90.732283	1191	1254	513	1	63	0.0158730
NODE_1705_length_1750_cov_90.732283	1191	1254	527	1	63	0.0158730
NODE_1705_length_1750_cov_90.732283	1191	1254	530	1	63	0.0158730
NODE_1705_length_1750_cov_90.732283	1191	1254	533	1	63	0.0158730
NODE_1705_length_1750_cov_90.732283	1191	1254	538	1	63	0.0158730
NODE_1705_length_1750_cov_90.732283	1191	1254	549	1	63	0.0158730
NODE_1705_length_1750_cov_90.732283	1191	1254	574	1	63	0.0158730
NODE_1705_length_1750_cov_90.732283	1191	1254	575	1	63	0.0158730
NODE_1705_length_1750_cov_90.732283	1191	1254	584	1	63	0.0158730
NODE_1705_length_1750_cov_90.732283	1191	1254	588	1	63	0.0158730
NODE_1705_length_1750_cov_90.732283	1191	1254	590	1	63	0.0158730
NODE_1705_length_1750_cov_90.732283	1191	1254	596	1	63	0.0158730
NODE_1705_length_1750_cov_90.732283	1191	1254	604	1	63	0.0158730
NODE_1705_length_1750_cov_90.732283	1191	1254	609	2	63	0.0317460
NODE_1705_length_1750_cov_90.732283	1191	1254	611	1	63	0.0158730
NODE_1705_length_1750_cov_90.732283	1191	1254	612	1	63	0.0158730
NODE_1705_length_1750_cov_90.732283	1191	1254	613	1	63	0.0158730
NODE_1705_length_1750_cov_90.732283	1191	1254	614	1	63	0.0158730
NODE_1705_length_1750_cov_90.732283	1191	1254	615	2	63	0.0317460
NODE_1705_length_1750_cov_90.732283	1191	1254	616	1	63	0.0158730
NODE_1705_length_1750_cov_90.732283	1191	1254	624	1	63	0.0158730
NODE_1705_length_1750_cov_90.732283	1191	1254	633	1	63	0.0158730
NODE_1705_length_1750_cov_90.732283	1191	1254	641	1	63	0.0158730
NODE_1705_length_1750_cov_90.732283	1191	1254	650	1	63	0.0158730
NODE_1705_length_1750_cov_90.732283	1191	1254	658	1	63	0.0158730
NODE_1705_length_1750_cov_90.732283	1239	1310	604	1	71	0.0140845
NODE_1705_length_1750_cov_90.732283	1239	1310	609	2	71	0.0281690
NODE_1705_length_1750_cov_90.732283	1239	1310	611	1	71	0.0140845
NODE_1705_length_1750_cov_90.732283	1239	1310	612	1	71	0.0140845
NODE_1705_length_1750_cov_90.732283	1239	1310	613	1	71	0.0140845
NODE_1705_length_1750_cov_90.732283	1239	1310	614	1	71	0.0140845
NODE_1705_length_1750_cov_90.732283	1239	1310	615	2	71	0.0281690
NODE_1705_length_1750_cov_90.732283	1239	1310	616	1	71	0.0140845
NODE_1705_length_1750_cov_90.732283	1239	1310	624	1	71	0.0140845
NODE_1705_length_1750_cov_90.732283	1239	1310	633	1	71	0.0140845
NODE_1705_length_1750_cov_90.732283	1239	1310	641	1	71	0.0140845
NODE_1705_length_1750_cov_90.732283	1239	1310	650	1	71	0.0140845
NODE_1705_length_1750_cov_90.732283	1239	1310	658	1	71	0.0140845
NODE_1705_length_1750_cov_90.732283	1239	1310	678	2	71	0.0281690
NODE_1705_length_1750_cov_90.732283	1239	1310	687	1	71	0.0140845
NODE_1705_length_1750_cov_90.732283	1239	1310	700	1	71	0.0140845
NODE_1705_length_1750_cov_90.732283	1239	1310	708	1	71	0.0140845
NODE_1705_length_1750_cov_90.732283	1239	1310	713	1	71	0.0140845
NODE_1705_length_1750_cov_90.732283	1239	1310	726	2	71	0.0281690
NODE_1705_length_1750_cov_90.732283	1239	1310	736	1	71	0.0140845
NODE_1705_length_1750_cov_90.732283	1239	1310	747	1	71	0.0140845
NODE_1705_length_1750_cov_90.732283	1239	1310	748	1	71	0.0140845
NODE_1705_length_1750_cov_90.732283	1239	1310	753	1	71	0.0140845
NODE_1705_length_1750_cov_90.732283	1239	1310	757	1	71	0.0140845
NODE_1705_length_1750_cov_90.732283	1239	1310	758	1	71	0.0140845
NODE_1705_length_1750_cov_90.732283	1239	1310	761	1	71	0.0140845
NODE_1705_length_1750_cov_90.732283	1239	1310	763	1	71	0.0140845
NODE_1705_length_1750_cov_90.732283	1239	1310	769	1	71	0.0140845
NODE_1705_length_1750_cov_90.732283	1239	1310	773	1	71	0.0140845
NODE_1705_length_1750_cov_90.732283	1239	1310	775	2	71	0.0281690
NODE_1705_length_1750_cov_90.732283	1239	1310	776	1	71	0.0140845
NODE_1705_length_1750_cov_90.732283	1239	1310	787	2	71	0.0281690
NODE_1705_length_1750_cov_90.732283	1239	1310	788	1	71	0.0140845
NODE_1705_length_1750_cov_90.732283	1239	1310	789	1	71	0.0140845
NODE_1705_length_1750_cov_90.732283	1239	1310	792	3	71	0.0422535
NODE_1705_length_1750_cov_90.732283	1239	1310	793	1	71	0.0140845
NODE_1705_length_1750_cov_90.732283	1239	1310	794	2	71	0.0281690
NODE_1705_length_1750_cov_90.732283	1239	1310	795	2	71	0.0281690
NODE_1705_length_1750_cov_90.732283	1239	1310	796	2	71	0.0281690
NODE_1705_length_1750_cov_90.732283	1239	1310	797	1	71	0.0140845
NODE_1705_length_1750_cov_90.732283	1239	1310	798	1	71	0.0140845
NODE_1705_length_1750_cov_90.732283	1239	1310	799	1	71	0.0140845
NODE_1705_length_1750_cov_90.732283	1239	1310	800	2	71	0.0281690
NODE_1705_length_1750_cov_90.732283	1239	1310	801	2	71	0.0281690
NODE_1705_length_1750_cov_90.732283	1239	1310	804	2	71	0.0281690
NODE_1705_length_1750_cov_90.732283	1239	1310	805	1	71	0.0140845
NODE_1705_length_1750_cov_90.732283	1239	1310	810	1	71	0.0140845
NODE_1705_length_1750_cov_90.732283	1239	1310	813	1	71	0.0140845
NODE_1705_length_1750_cov_90.732283	1239	1310	814	1	71	0.0140845
NODE_1705_length_1750_cov_90.732283	1239	1310	815	1	71	0.0140845
NODE_1705_length_1750_cov_90.732283	1239	1310	816	2	71	0.0281690
NODE_1705_length_1750_cov_90.732283	1239	1310	818	2	71	0.0281690
NODE_1705_length_1750_cov_90.732283	1239	1310	820	1	71	0.0140845
NODE_1705_length_1750_cov_90.732283	1239	1310	825	1	71	0.0140845
NODE_1705_length_1750_cov_90.732283	1239	1310	827	1	71	0.0140845
NODE_1711_length_1746_cov_3.095932	458	524	0	36	66	0.5454546
NODE_1711_length_1746_cov_3.095932	458	524	2	30	66	0.4545455
NODE_1712_length_1745_cov_7.646416	430	510	0	80	80	1.0000000
NODE_1712_length_1745_cov_7.646416	483	563	0	80	80	1.0000000
NODE_1715_length_1744_cov_10.144681	1213	1289	4	19	76	0.2500000
NODE_1715_length_1744_cov_10.144681	1213	1289	6	14	76	0.1842105
NODE_1715_length_1744_cov_10.144681	1213	1289	7	3	76	0.0394737
NODE_1715_length_1744_cov_10.144681	1213	1289	8	35	76	0.4605263
NODE_1715_length_1744_cov_10.144681	1213	1289	10	3	76	0.0394737
NODE_1715_length_1744_cov_10.144681	1213	1289	11	2	76	0.0263158
NODE_1715_length_1744_cov_10.144681	1262	1342	8	32	80	0.4000000
NODE_1715_length_1744_cov_10.144681	1262	1342	10	3	80	0.0375000
NODE_1715_length_1744_cov_10.144681	1262	1342	11	5	80	0.0625000
NODE_1715_length_1744_cov_10.144681	1262	1342	12	14	80	0.1750000
NODE_1715_length_1744_cov_10.144681	1262	1342	13	1	80	0.0125000
NODE_1715_length_1744_cov_10.144681	1262	1342	14	1	80	0.0125000
NODE_1715_length_1744_cov_10.144681	1262	1342	15	1	80	0.0125000
NODE_1715_length_1744_cov_10.144681	1262	1342	16	23	80	0.2875000
NODE_1719_length_1742_cov_18.923311	699	776	0	77	77	1.0000000
NODE_1719_length_1742_cov_18.923311	749	829	0	80	80	1.0000000
NODE_1722_length_1741_cov_7.657734	1234	1314	6	2	80	0.0250000
NODE_1722_length_1741_cov_7.657734	1234	1314	8	78	80	0.9750000
NODE_1722_length_1741_cov_7.657734	1287	1367	0	15	80	0.1875000
NODE_1722_length_1741_cov_7.657734	1287	1367	2	29	80	0.3625000
NODE_1722_length_1741_cov_7.657734	1287	1367	8	36	80	0.4500000
NODE_1722_length_1741_cov_7.657734	1363	1443	0	46	80	0.5750000
NODE_1722_length_1741_cov_7.657734	1363	1443	4	34	80	0.4250000
NODE_1722_length_1741_cov_7.657734	1416	1496	4	42	80	0.5250000
NODE_1722_length_1741_cov_7.657734	1416	1496	6	16	80	0.2000000
NODE_1722_length_1741_cov_7.657734	1416	1496	8	21	80	0.2625000
NODE_1722_length_1741_cov_7.657734	1416	1496	10	1	80	0.0125000
NODE_1726_length_1740_cov_38.411335	517	597	46	10	80	0.1250000
NODE_1726_length_1740_cov_38.411335	517	597	52	5	80	0.0625000
NODE_1726_length_1740_cov_38.411335	517	597	53	14	80	0.1750000
NODE_1726_length_1740_cov_38.411335	517	597	54	51	80	0.6375000
NODE_1726_length_1740_cov_38.411335	570	650	0	24	80	0.3000000
NODE_1726_length_1740_cov_38.411335	570	650	44	1	80	0.0125000
NODE_1726_length_1740_cov_38.411335	570	650	45	23	80	0.2875000
NODE_1726_length_1740_cov_38.411335	570	650	46	15	80	0.1875000
NODE_1726_length_1740_cov_38.411335	570	650	52	5	80	0.0625000
NODE_1726_length_1740_cov_38.411335	570	650	53	12	80	0.1500000
NODE_1726_length_1740_cov_38.411335	646	726	0	23	80	0.2875000
NODE_1726_length_1740_cov_38.411335	646	726	6	57	80	0.7125000
NODE_1726_length_1740_cov_38.411335	699	779	6	80	80	1.0000000
NODE_1727_length_1740_cov_10.843388	552	632	0	18	80	0.2250000
NODE_1727_length_1740_cov_10.843388	552	632	2	62	80	0.7750000
NODE_1727_length_1740_cov_10.843388	708	788	0	80	80	1.0000000
NODE_1727_length_1740_cov_10.843388	708	788	0	80	80	1.0000000
NODE_1727_length_1740_cov_10.843388	708	788	0	80	80	1.0000000
NODE_1727_length_1740_cov_10.843388	761	841	0	80	80	1.0000000
NODE_1727_length_1740_cov_10.843388	761	808	0	47	47	1.0000000
NODE_1727_length_1740_cov_10.843388	761	808	0	47	47	1.0000000
NODE_1737_length_1736_cov_71.959682	841	901	527	1	60	0.0166667
NODE_1737_length_1736_cov_71.959682	841	901	529	1	60	0.0166667
NODE_1737_length_1736_cov_71.959682	841	901	534	1	60	0.0166667
NODE_1737_length_1736_cov_71.959682	841	901	536	1	60	0.0166667
NODE_1737_length_1736_cov_71.959682	841	901	538	1	60	0.0166667
NODE_1737_length_1736_cov_71.959682	841	901	542	1	60	0.0166667
NODE_1737_length_1736_cov_71.959682	841	901	565	1	60	0.0166667
NODE_1737_length_1736_cov_71.959682	841	901	570	3	60	0.0500000
NODE_1737_length_1736_cov_71.959682	841	901	590	2	60	0.0333333
NODE_1737_length_1736_cov_71.959682	841	901	592	1	60	0.0166667
NODE_1737_length_1736_cov_71.959682	841	901	600	1	60	0.0166667
NODE_1737_length_1736_cov_71.959682	841	901	601	1	60	0.0166667
NODE_1737_length_1736_cov_71.959682	841	901	612	1	60	0.0166667
NODE_1737_length_1736_cov_71.959682	841	901	614	1	60	0.0166667
NODE_1737_length_1736_cov_71.959682	841	901	615	1	60	0.0166667
NODE_1737_length_1736_cov_71.959682	841	901	616	2	60	0.0333333
NODE_1737_length_1736_cov_71.959682	841	901	617	2	60	0.0333333
NODE_1737_length_1736_cov_71.959682	841	901	619	2	60	0.0333333
NODE_1737_length_1736_cov_71.959682	841	901	620	1	60	0.0166667
NODE_1737_length_1736_cov_71.959682	841	901	621	2	60	0.0333333
NODE_1737_length_1736_cov_71.959682	841	901	622	1	60	0.0166667
NODE_1737_length_1736_cov_71.959682	841	901	626	1	60	0.0166667
NODE_1737_length_1736_cov_71.959682	841	901	627	1	60	0.0166667
NODE_1737_length_1736_cov_71.959682	841	901	628	1	60	0.0166667
NODE_1737_length_1736_cov_71.959682	841	901	629	1	60	0.0166667
NODE_1737_length_1736_cov_71.959682	841	901	631	2	60	0.0333333
NODE_1737_length_1736_cov_71.959682	841	901	633	1	60	0.0166667
NODE_1737_length_1736_cov_71.959682	841	901	636	1	60	0.0166667
NODE_1737_length_1736_cov_71.959682	841	901	640	1	60	0.0166667
NODE_1737_length_1736_cov_71.959682	841	901	642	1	60	0.0166667
NODE_1737_length_1736_cov_71.959682	841	901	644	1	60	0.0166667
NODE_1737_length_1736_cov_71.959682	841	901	645	2	60	0.0333333
NODE_1737_length_1736_cov_71.959682	841	901	647	1	60	0.0166667
NODE_1737_length_1736_cov_71.959682	841	901	653	2	60	0.0333333
NODE_1737_length_1736_cov_71.959682	841	901	654	1	60	0.0166667
NODE_1737_length_1736_cov_71.959682	841	901	655	1	60	0.0166667
NODE_1737_length_1736_cov_71.959682	841	901	658	1	60	0.0166667
NODE_1737_length_1736_cov_71.959682	841	901	661	1	60	0.0166667
NODE_1737_length_1736_cov_71.959682	841	901	662	2	60	0.0333333
NODE_1737_length_1736_cov_71.959682	841	901	663	2	60	0.0333333
NODE_1737_length_1736_cov_71.959682	841	901	664	4	60	0.0666667
NODE_1737_length_1736_cov_71.959682	841	901	665	1	60	0.0166667
NODE_1737_length_1736_cov_71.959682	841	901	669	3	60	0.0500000
NODE_1738_length_1736_cov_29.174710	1361	1390	205	1	29	0.0344828
NODE_1738_length_1736_cov_29.174710	1361	1390	206	1	29	0.0344828
NODE_1738_length_1736_cov_29.174710	1361	1390	207	3	29	0.1034483
NODE_1738_length_1736_cov_29.174710	1361	1390	209	2	29	0.0689655
NODE_1738_length_1736_cov_29.174710	1361	1390	210	1	29	0.0344828
NODE_1738_length_1736_cov_29.174710	1361	1390	211	2	29	0.0689655
NODE_1738_length_1736_cov_29.174710	1361	1390	212	2	29	0.0689655
NODE_1738_length_1736_cov_29.174710	1361	1390	213	3	29	0.1034483
NODE_1738_length_1736_cov_29.174710	1361	1390	214	2	29	0.0689655
NODE_1738_length_1736_cov_29.174710	1361	1390	215	1	29	0.0344828
NODE_1738_length_1736_cov_29.174710	1361	1390	216	2	29	0.0689655
NODE_1738_length_1736_cov_29.174710	1361	1390	217	1	29	0.0344828
NODE_1738_length_1736_cov_29.174710	1361	1390	218	1	29	0.0344828
NODE_1738_length_1736_cov_29.174710	1361	1390	219	4	29	0.1379310
NODE_1738_length_1736_cov_29.174710	1361	1390	220	1	29	0.0344828
NODE_1738_length_1736_cov_29.174710	1361	1390	221	1	29	0.0344828
NODE_1738_length_1736_cov_29.174710	1361	1390	223	1	29	0.0344828
NODE_1738_length_1736_cov_29.174710	1566	1628	276	1	62	0.0161290
NODE_1738_length_1736_cov_29.174710	1566	1628	278	2	62	0.0322581
NODE_1738_length_1736_cov_29.174710	1566	1628	280	4	62	0.0645161
NODE_1738_length_1736_cov_29.174710	1566	1628	290	2	62	0.0322581
NODE_1738_length_1736_cov_29.174710	1566	1628	291	1	62	0.0161290
NODE_1738_length_1736_cov_29.174710	1566	1628	292	1	62	0.0161290
NODE_1738_length_1736_cov_29.174710	1566	1628	294	1	62	0.0161290
NODE_1738_length_1736_cov_29.174710	1566	1628	297	1	62	0.0161290
NODE_1738_length_1736_cov_29.174710	1566	1628	302	1	62	0.0161290
NODE_1738_length_1736_cov_29.174710	1566	1628	315	1	62	0.0161290
NODE_1738_length_1736_cov_29.174710	1566	1628	321	1	62	0.0161290
NODE_1738_length_1736_cov_29.174710	1566	1628	325	2	62	0.0322581
NODE_1738_length_1736_cov_29.174710	1566	1628	335	1	62	0.0161290
NODE_1738_length_1736_cov_29.174710	1566	1628	345	1	62	0.0161290
NODE_1738_length_1736_cov_29.174710	1566	1628	347	1	62	0.0161290
NODE_1738_length_1736_cov_29.174710	1566	1628	348	2	62	0.0322581
NODE_1738_length_1736_cov_29.174710	1566	1628	349	1	62	0.0161290
NODE_1738_length_1736_cov_29.174710	1566	1628	352	2	62	0.0322581
NODE_1738_length_1736_cov_29.174710	1566	1628	354	2	62	0.0322581
NODE_1738_length_1736_cov_29.174710	1566	1628	355	1	62	0.0161290
NODE_1738_length_1736_cov_29.174710	1566	1628	356	2	62	0.0322581
NODE_1738_length_1736_cov_29.174710	1566	1628	357	1	62	0.0161290
NODE_1738_length_1736_cov_29.174710	1566	1628	358	2	62	0.0322581
NODE_1738_length_1736_cov_29.174710	1566	1628	359	2	62	0.0322581
NODE_1738_length_1736_cov_29.174710	1566	1628	360	1	62	0.0161290
NODE_1738_length_1736_cov_29.174710	1566	1628	362	2	62	0.0322581
NODE_1738_length_1736_cov_29.174710	1566	1628	363	1	62	0.0161290
NODE_1738_length_1736_cov_29.174710	1566	1628	364	11	62	0.1774193
NODE_1738_length_1736_cov_29.174710	1566	1628	365	1	62	0.0161290
NODE_1738_length_1736_cov_29.174710	1566	1628	366	3	62	0.0483871
NODE_1738_length_1736_cov_29.174710	1566	1628	367	2	62	0.0322581
NODE_1738_length_1736_cov_29.174710	1566	1628	370	1	62	0.0161290
NODE_1738_length_1736_cov_29.174710	1566	1628	373	2	62	0.0322581
NODE_1738_length_1736_cov_29.174710	1566	1628	375	1	62	0.0161290
NODE_1738_length_1736_cov_29.174710	1566	1628	382	1	62	0.0161290
NODE_1743_length_1732_cov_6.162890	807	887	0	4	80	0.0500000
NODE_1743_length_1732_cov_6.162890	807	887	1	11	80	0.1375000
NODE_1743_length_1732_cov_6.162890	807	887	2	65	80	0.8125000
NODE_1743_length_1732_cov_6.162890	860	940	2	80	80	1.0000000
NODE_1749_length_1729_cov_23.708589	364	443	0	79	79	1.0000000
NODE_1749_length_1729_cov_23.708589	416	496	0	70	80	0.8750000
NODE_1749_length_1729_cov_23.708589	416	496	2	5	80	0.0625000
NODE_1749_length_1729_cov_23.708589	416	496	4	5	80	0.0625000
NODE_1749_length_1729_cov_23.708589	492	572	4	80	80	1.0000000
NODE_1749_length_1729_cov_23.708589	545	625	2	49	80	0.6125000
NODE_1749_length_1729_cov_23.708589	545	625	4	31	80	0.3875000
NODE_1753_length_1728_cov_26.505832	259	339	0	80	80	1.0000000
NODE_1753_length_1728_cov_26.505832	312	392	0	72	80	0.9000000
NODE_1753_length_1728_cov_26.505832	312	392	2	8	80	0.1000000
NODE_1757_length_1725_cov_142.158057	767	814	431	1	47	0.0212766
NODE_1757_length_1725_cov_142.158057	767	814	436	1	47	0.0212766
NODE_1757_length_1725_cov_142.158057	767	814	441	1	47	0.0212766
NODE_1757_length_1725_cov_142.158057	767	814	442	1	47	0.0212766
NODE_1757_length_1725_cov_142.158057	767	814	452	1	47	0.0212766
NODE_1757_length_1725_cov_142.158057	767	814	456	1	47	0.0212766
NODE_1757_length_1725_cov_142.158057	767	814	462	1	47	0.0212766
NODE_1757_length_1725_cov_142.158057	767	814	465	1	47	0.0212766
NODE_1757_length_1725_cov_142.158057	767	814	466	1	47	0.0212766
NODE_1757_length_1725_cov_142.158057	767	814	467	2	47	0.0425532
NODE_1757_length_1725_cov_142.158057	767	814	470	1	47	0.0212766
NODE_1757_length_1725_cov_142.158057	767	814	475	1	47	0.0212766
NODE_1757_length_1725_cov_142.158057	767	814	481	1	47	0.0212766
NODE_1757_length_1725_cov_142.158057	767	814	490	1	47	0.0212766
NODE_1757_length_1725_cov_142.158057	767	814	491	1	47	0.0212766
NODE_1757_length_1725_cov_142.158057	767	814	499	3	47	0.0638298
NODE_1757_length_1725_cov_142.158057	767	814	505	1	47	0.0212766
NODE_1757_length_1725_cov_142.158057	767	814	509	1	47	0.0212766
NODE_1757_length_1725_cov_142.158057	767	814	511	1	47	0.0212766
NODE_1757_length_1725_cov_142.158057	767	814	517	1	47	0.0212766
NODE_1757_length_1725_cov_142.158057	767	814	520	1	47	0.0212766
NODE_1757_length_1725_cov_142.158057	767	814	528	1	47	0.0212766
NODE_1757_length_1725_cov_142.158057	767	814	530	1	47	0.0212766
NODE_1757_length_1725_cov_142.158057	767	814	532	1	47	0.0212766
NODE_1757_length_1725_cov_142.158057	767	814	541	1	47	0.0212766
NODE_1757_length_1725_cov_142.158057	767	814	545	2	47	0.0425532
NODE_1757_length_1725_cov_142.158057	767	814	554	4	47	0.0851064
NODE_1757_length_1725_cov_142.158057	767	814	557	1	47	0.0212766
NODE_1757_length_1725_cov_142.158057	767	814	562	1	47	0.0212766
NODE_1757_length_1725_cov_142.158057	767	814	564	2	47	0.0425532
NODE_1757_length_1725_cov_142.158057	767	814	566	1	47	0.0212766
NODE_1757_length_1725_cov_142.158057	767	814	568	1	47	0.0212766
NODE_1757_length_1725_cov_142.158057	767	814	569	3	47	0.0638298
NODE_1757_length_1725_cov_142.158057	767	814	571	3	47	0.0638298
NODE_1757_length_1725_cov_142.158057	767	814	574	1	47	0.0212766
NODE_1757_length_1725_cov_142.158057	803	867	417	1	64	0.0156250
NODE_1757_length_1725_cov_142.158057	803	867	419	1	64	0.0156250
NODE_1757_length_1725_cov_142.158057	803	867	421	1	64	0.0156250
NODE_1757_length_1725_cov_142.158057	803	867	427	1	64	0.0156250
NODE_1757_length_1725_cov_142.158057	803	867	434	1	64	0.0156250
NODE_1757_length_1725_cov_142.158057	803	867	440	1	64	0.0156250
NODE_1757_length_1725_cov_142.158057	803	867	446	1	64	0.0156250
NODE_1757_length_1725_cov_142.158057	803	867	449	1	64	0.0156250
NODE_1757_length_1725_cov_142.158057	803	867	451	1	64	0.0156250
NODE_1757_length_1725_cov_142.158057	803	867	453	1	64	0.0156250
NODE_1757_length_1725_cov_142.158057	803	867	460	1	64	0.0156250
NODE_1757_length_1725_cov_142.158057	803	867	461	2	64	0.0312500
NODE_1757_length_1725_cov_142.158057	803	867	464	1	64	0.0156250
NODE_1757_length_1725_cov_142.158057	803	867	467	1	64	0.0156250
NODE_1757_length_1725_cov_142.158057	803	867	479	1	64	0.0156250
NODE_1757_length_1725_cov_142.158057	803	867	489	1	64	0.0156250
NODE_1757_length_1725_cov_142.158057	803	867	496	1	64	0.0156250
NODE_1757_length_1725_cov_142.158057	803	867	504	1	64	0.0156250
NODE_1757_length_1725_cov_142.158057	803	867	507	2	64	0.0312500
NODE_1757_length_1725_cov_142.158057	803	867	520	1	64	0.0156250
NODE_1757_length_1725_cov_142.158057	803	867	528	1	64	0.0156250
NODE_1757_length_1725_cov_142.158057	803	867	534	1	64	0.0156250
NODE_1757_length_1725_cov_142.158057	803	867	538	3	64	0.0468750
NODE_1757_length_1725_cov_142.158057	803	867	541	1	64	0.0156250
NODE_1757_length_1725_cov_142.158057	803	867	543	2	64	0.0312500
NODE_1757_length_1725_cov_142.158057	803	867	562	1	64	0.0156250
NODE_1757_length_1725_cov_142.158057	803	867	564	2	64	0.0312500
NODE_1757_length_1725_cov_142.158057	803	867	565	1	64	0.0156250
NODE_1757_length_1725_cov_142.158057	803	867	566	1	64	0.0156250
NODE_1757_length_1725_cov_142.158057	803	867	567	1	64	0.0156250
NODE_1757_length_1725_cov_142.158057	803	867	568	2	64	0.0312500
NODE_1757_length_1725_cov_142.158057	803	867	569	4	64	0.0625000
NODE_1757_length_1725_cov_142.158057	803	867	570	1	64	0.0156250
NODE_1757_length_1725_cov_142.158057	803	867	571	4	64	0.0625000
NODE_1757_length_1725_cov_142.158057	803	867	572	1	64	0.0156250
NODE_1757_length_1725_cov_142.158057	803	867	574	1	64	0.0156250
NODE_1757_length_1725_cov_142.158057	803	867	576	1	64	0.0156250
NODE_1757_length_1725_cov_142.158057	803	867	579	1	64	0.0156250
NODE_1757_length_1725_cov_142.158057	803	867	581	4	64	0.0625000
NODE_1757_length_1725_cov_142.158057	803	867	582	1	64	0.0156250
NODE_1757_length_1725_cov_142.158057	803	867	583	1	64	0.0156250
NODE_1757_length_1725_cov_142.158057	803	867	585	2	64	0.0312500
NODE_1757_length_1725_cov_142.158057	803	867	586	4	64	0.0625000
NODE_1757_length_1725_cov_142.158057	803	867	588	1	64	0.0156250
NODE_1759_length_1724_cov_17.931077	677	746	2	5	69	0.0724638
NODE_1759_length_1724_cov_17.931077	677	746	4	64	69	0.9275362
NODE_1759_length_1724_cov_17.931077	788	850	0	6	62	0.0967742
NODE_1759_length_1724_cov_17.931077	788	850	1	9	62	0.1451613
NODE_1759_length_1724_cov_17.931077	788	850	2	3	62	0.0483871
NODE_1759_length_1724_cov_17.931077	788	850	4	44	62	0.7096774
NODE_1761_length_1723_cov_35.355296	1174	1254	3	19	80	0.2375000
NODE_1761_length_1723_cov_35.355296	1174	1254	6	61	80	0.7625000
NODE_1761_length_1723_cov_35.355296	1227	1307	0	44	80	0.5500000
NODE_1761_length_1723_cov_35.355296	1227	1307	3	28	80	0.3500000
NODE_1761_length_1723_cov_35.355296	1227	1307	6	8	80	0.1000000
NODE_1763_length_1722_cov_13.235367	708	788	0	80	80	1.0000000
NODE_1763_length_1722_cov_13.235367	761	841	0	80	80	1.0000000
NODE_1763_length_1722_cov_13.235367	1319	1399	0	80	80	1.0000000
NODE_1763_length_1722_cov_13.235367	1372	1452	0	80	80	1.0000000
NODE_1765_length_1720_cov_27.328192	1248	1307	106	1	59	0.0169492
NODE_1765_length_1720_cov_27.328192	1248	1307	116	11	59	0.1864407
NODE_1765_length_1720_cov_27.328192	1248	1307	117	2	59	0.0338983
NODE_1765_length_1720_cov_27.328192	1248	1307	118	1	59	0.0169492
NODE_1765_length_1720_cov_27.328192	1248	1307	122	4	59	0.0677966
NODE_1765_length_1720_cov_27.328192	1248	1307	128	9	59	0.1525424
NODE_1765_length_1720_cov_27.328192	1248	1307	130	18	59	0.3050847
NODE_1765_length_1720_cov_27.328192	1248	1307	132	13	59	0.2203390
NODE_1765_length_1720_cov_27.328192	1280	1360	67	2	80	0.0250000
NODE_1765_length_1720_cov_27.328192	1280	1360	69	1	80	0.0125000
NODE_1765_length_1720_cov_27.328192	1280	1360	71	4	80	0.0500000
NODE_1765_length_1720_cov_27.328192	1280	1360	72	1	80	0.0125000
NODE_1765_length_1720_cov_27.328192	1280	1360	73	4	80	0.0500000
NODE_1765_length_1720_cov_27.328192	1280	1360	78	1	80	0.0125000
NODE_1765_length_1720_cov_27.328192	1280	1360	79	1	80	0.0125000
NODE_1765_length_1720_cov_27.328192	1280	1360	80	2	80	0.0250000
NODE_1765_length_1720_cov_27.328192	1280	1360	84	7	80	0.0875000
NODE_1765_length_1720_cov_27.328192	1280	1360	91	1	80	0.0125000
NODE_1765_length_1720_cov_27.328192	1280	1360	96	1	80	0.0125000
NODE_1765_length_1720_cov_27.328192	1280	1360	98	7	80	0.0875000
NODE_1765_length_1720_cov_27.328192	1280	1360	102	1	80	0.0125000
NODE_1765_length_1720_cov_27.328192	1280	1360	104	3	80	0.0375000
NODE_1765_length_1720_cov_27.328192	1280	1360	106	5	80	0.0625000
NODE_1765_length_1720_cov_27.328192	1280	1360	110	3	80	0.0375000
NODE_1765_length_1720_cov_27.328192	1280	1360	114	3	80	0.0375000
NODE_1765_length_1720_cov_27.328192	1280	1360	122	4	80	0.0500000
NODE_1765_length_1720_cov_27.328192	1280	1360	124	2	80	0.0250000
NODE_1765_length_1720_cov_27.328192	1280	1360	128	8	80	0.1000000
NODE_1765_length_1720_cov_27.328192	1280	1360	130	14	80	0.1750000
NODE_1765_length_1720_cov_27.328192	1280	1360	132	5	80	0.0625000
NODE_1766_length_1720_cov_4.129550	241	321	0	20	80	0.2500000
NODE_1766_length_1720_cov_4.129550	241	321	2	60	80	0.7500000
NODE_1766_length_1720_cov_4.129550	294	374	2	80	80	1.0000000
NODE_1768_length_1719_cov_9.878395	410	490	0	80	80	1.0000000
NODE_1768_length_1719_cov_9.878395	463	543	0	69	80	0.8625000
NODE_1768_length_1719_cov_9.878395	463	543	2	11	80	0.1375000
NODE_1768_length_1719_cov_9.878395	539	619	0	9	80	0.1125000
NODE_1768_length_1719_cov_9.878395	539	619	2	71	80	0.8875000
NODE_1768_length_1719_cov_9.878395	592	672	0	62	80	0.7750000
NODE_1768_length_1719_cov_9.878395	592	672	2	18	80	0.2250000
NODE_1772_length_1717_cov_5.159456	145	219	9	7	74	0.0945946
NODE_1772_length_1717_cov_5.159456	145	219	15	1	74	0.0135135
NODE_1772_length_1717_cov_5.159456	145	219	19	2	74	0.0270270
NODE_1772_length_1717_cov_5.159456	145	219	21	2	74	0.0270270
NODE_1772_length_1717_cov_5.159456	145	219	22	3	74	0.0405405
NODE_1772_length_1717_cov_5.159456	145	219	24	3	74	0.0405405
NODE_1772_length_1717_cov_5.159456	145	219	26	3	74	0.0405405
NODE_1772_length_1717_cov_5.159456	145	219	28	4	74	0.0540541
NODE_1772_length_1717_cov_5.159456	145	219	31	1	74	0.0135135
NODE_1772_length_1717_cov_5.159456	145	219	33	1	74	0.0135135
NODE_1772_length_1717_cov_5.159456	145	219	39	1	74	0.0135135
NODE_1772_length_1717_cov_5.159456	145	219	41	2	74	0.0270270
NODE_1772_length_1717_cov_5.159456	145	219	43	2	74	0.0270270
NODE_1772_length_1717_cov_5.159456	145	219	47	2	74	0.0270270
NODE_1772_length_1717_cov_5.159456	145	219	49	7	74	0.0945946
NODE_1772_length_1717_cov_5.159456	145	219	54	7	74	0.0945946
NODE_1772_length_1717_cov_5.159456	145	219	56	3	74	0.0405405
NODE_1772_length_1717_cov_5.159456	145	219	62	2	74	0.0270270
NODE_1772_length_1717_cov_5.159456	145	219	64	13	74	0.1756757
NODE_1772_length_1717_cov_5.159456	145	219	66	8	74	0.1081081
NODE_1772_length_1717_cov_5.159456	1450	1508	8	10	58	0.1724138
NODE_1772_length_1717_cov_5.159456	1450	1508	10	48	58	0.8275862
NODE_1772_length_1717_cov_5.159456	1503	1561	10	56	58	0.9655172
NODE_1772_length_1717_cov_5.159456	1503	1561	12	2	58	0.0344828
NODE_1778_length_1715_cov_12.607054	555	635	0	80	80	1.0000000
NODE_1778_length_1715_cov_12.607054	608	688	0	80	80	1.0000000
NODE_1778_length_1715_cov_12.607054	684	764	0	15	80	0.1875000
NODE_1778_length_1715_cov_12.607054	684	764	4	65	80	0.8125000
NODE_1778_length_1715_cov_12.607054	737	817	0	18	80	0.2250000
NODE_1778_length_1715_cov_12.607054	737	817	4	62	80	0.7750000
NODE_1788_length_1707_cov_16.909204	397	477	0	12	80	0.1500000
NODE_1788_length_1707_cov_16.909204	397	477	2	68	80	0.8500000
NODE_1788_length_1707_cov_16.909204	450	530	0	65	80	0.8125000
NODE_1788_length_1707_cov_16.909204	450	530	2	15	80	0.1875000
NODE_1788_length_1707_cov_16.909204	1151	1231	0	20	80	0.2500000
NODE_1788_length_1707_cov_16.909204	1151	1231	2	60	80	0.7500000
NODE_1788_length_1707_cov_16.909204	1204	1284	0	65	80	0.8125000
NODE_1788_length_1707_cov_16.909204	1204	1284	2	15	80	0.1875000
NODE_1792_length_1705_cov_19.645081	451	531	0	80	80	1.0000000
NODE_1792_length_1705_cov_19.645081	504	584	0	80	80	1.0000000
NODE_1792_length_1705_cov_19.645081	580	660	0	80	80	1.0000000
NODE_1792_length_1705_cov_19.645081	633	714	0	81	81	1.0000000
NODE_1792_length_1705_cov_19.645081	1315	1395	0	80	80	1.0000000
NODE_1792_length_1705_cov_19.645081	1368	1448	0	80	80	1.0000000
NODE_1796_length_1703_cov_26.016833	1201	1264	0	13	63	0.2063492
NODE_1796_length_1703_cov_26.016833	1201	1264	2	11	63	0.1746032
NODE_1796_length_1703_cov_26.016833	1201	1264	5	28	63	0.4444444
NODE_1796_length_1703_cov_26.016833	1201	1264	9	1	63	0.0158730
NODE_1796_length_1703_cov_26.016833	1201	1264	13	1	63	0.0158730
NODE_1796_length_1703_cov_26.016833	1201	1264	15	1	63	0.0158730
NODE_1796_length_1703_cov_26.016833	1201	1264	19	1	63	0.0158730
NODE_1796_length_1703_cov_26.016833	1201	1264	20	1	63	0.0158730
NODE_1796_length_1703_cov_26.016833	1201	1264	22	1	63	0.0158730
NODE_1796_length_1703_cov_26.016833	1201	1264	28	1	63	0.0158730
NODE_1796_length_1703_cov_26.016833	1201	1264	34	1	63	0.0158730
NODE_1796_length_1703_cov_26.016833	1201	1264	36	1	63	0.0158730
NODE_1796_length_1703_cov_26.016833	1201	1264	40	2	63	0.0317460
NODE_1796_length_1703_cov_26.016833	1207	1264	0	13	57	0.2280702
NODE_1796_length_1703_cov_26.016833	1207	1264	2	11	57	0.1929825
NODE_1796_length_1703_cov_26.016833	1207	1264	5	28	57	0.4912281
NODE_1796_length_1703_cov_26.016833	1207	1264	9	1	57	0.0175439
NODE_1796_length_1703_cov_26.016833	1207	1264	13	1	57	0.0175439
NODE_1796_length_1703_cov_26.016833	1207	1264	15	1	57	0.0175439
NODE_1796_length_1703_cov_26.016833	1207	1264	19	1	57	0.0175439
NODE_1796_length_1703_cov_26.016833	1207	1264	20	1	57	0.0175439
NODE_1796_length_1703_cov_26.016833	1207	1264	0	13	57	0.2280702
NODE_1796_length_1703_cov_26.016833	1207	1264	2	11	57	0.1929825
NODE_1796_length_1703_cov_26.016833	1207	1264	5	28	57	0.4912281
NODE_1796_length_1703_cov_26.016833	1207	1264	9	1	57	0.0175439
NODE_1796_length_1703_cov_26.016833	1207	1264	13	1	57	0.0175439
NODE_1796_length_1703_cov_26.016833	1207	1264	15	1	57	0.0175439
NODE_1796_length_1703_cov_26.016833	1207	1264	19	1	57	0.0175439
NODE_1796_length_1703_cov_26.016833	1207	1264	20	1	57	0.0175439
NODE_1799_length_1701_cov_15.969413	1490	1565	19	1	75	0.0133333
NODE_1799_length_1701_cov_15.969413	1490	1565	20	1	75	0.0133333
NODE_1799_length_1701_cov_15.969413	1490	1565	25	1	75	0.0133333
NODE_1799_length_1701_cov_15.969413	1490	1565	32	2	75	0.0266667
NODE_1799_length_1701_cov_15.969413	1490	1565	36	1	75	0.0133333
NODE_1799_length_1701_cov_15.969413	1490	1565	39	2	75	0.0266667
NODE_1799_length_1701_cov_15.969413	1490	1565	42	2	75	0.0266667
NODE_1799_length_1701_cov_15.969413	1490	1565	44	3	75	0.0400000
NODE_1799_length_1701_cov_15.969413	1490	1565	45	6	75	0.0800000
NODE_1799_length_1701_cov_15.969413	1490	1565	47	1	75	0.0133333
NODE_1799_length_1701_cov_15.969413	1490	1565	49	1	75	0.0133333
NODE_1799_length_1701_cov_15.969413	1490	1565	51	1	75	0.0133333
NODE_1799_length_1701_cov_15.969413	1490	1565	52	1	75	0.0133333
NODE_1799_length_1701_cov_15.969413	1490	1565	53	1	75	0.0133333
NODE_1799_length_1701_cov_15.969413	1490	1565	56	1	75	0.0133333
NODE_1799_length_1701_cov_15.969413	1490	1565	60	2	75	0.0266667
NODE_1799_length_1701_cov_15.969413	1490	1565	65	1	75	0.0133333
NODE_1799_length_1701_cov_15.969413	1490	1565	67	2	75	0.0266667
NODE_1799_length_1701_cov_15.969413	1490	1565	70	6	75	0.0800000
NODE_1799_length_1701_cov_15.969413	1490	1565	72	1	75	0.0133333
NODE_1799_length_1701_cov_15.969413	1490	1565	74	2	75	0.0266667
NODE_1799_length_1701_cov_15.969413	1490	1565	78	3	75	0.0400000
NODE_1799_length_1701_cov_15.969413	1490	1565	79	1	75	0.0133333
NODE_1799_length_1701_cov_15.969413	1490	1565	80	1	75	0.0133333
NODE_1799_length_1701_cov_15.969413	1490	1565	81	3	75	0.0400000
NODE_1799_length_1701_cov_15.969413	1490	1565	83	1	75	0.0133333
NODE_1799_length_1701_cov_15.969413	1490	1565	85	1	75	0.0133333
NODE_1799_length_1701_cov_15.969413	1490	1565	87	11	75	0.1466667
NODE_1799_length_1701_cov_15.969413	1490	1565	89	5	75	0.0666667
NODE_1799_length_1701_cov_15.969413	1490	1565	93	3	75	0.0400000
NODE_1799_length_1701_cov_15.969413	1490	1565	95	2	75	0.0266667
NODE_1799_length_1701_cov_15.969413	1490	1565	97	2	75	0.0266667
NODE_1799_length_1701_cov_15.969413	1490	1565	99	2	75	0.0266667
NODE_1799_length_1701_cov_15.969413	1490	1565	101	1	75	0.0133333
NODE_1799_length_1701_cov_15.969413	1538	1603	85	1	65	0.0153846
NODE_1799_length_1701_cov_15.969413	1538	1603	87	11	65	0.1692308
NODE_1799_length_1701_cov_15.969413	1538	1603	89	5	65	0.0769231
NODE_1799_length_1701_cov_15.969413	1538	1603	93	3	65	0.0461538
NODE_1799_length_1701_cov_15.969413	1538	1603	95	2	65	0.0307692
NODE_1799_length_1701_cov_15.969413	1538	1603	97	2	65	0.0307692
NODE_1799_length_1701_cov_15.969413	1538	1603	99	2	65	0.0307692
NODE_1799_length_1701_cov_15.969413	1538	1603	101	6	65	0.0923077
NODE_1799_length_1701_cov_15.969413	1538	1603	103	2	65	0.0307692
NODE_1799_length_1701_cov_15.969413	1538	1603	106	1	65	0.0153846
NODE_1799_length_1701_cov_15.969413	1538	1603	107	8	65	0.1230769
NODE_1799_length_1701_cov_15.969413	1538	1603	108	1	65	0.0153846
NODE_1799_length_1701_cov_15.969413	1538	1603	110	1	65	0.0153846
NODE_1799_length_1701_cov_15.969413	1538	1603	112	3	65	0.0461538
NODE_1799_length_1701_cov_15.969413	1538	1603	113	1	65	0.0153846
NODE_1799_length_1701_cov_15.969413	1538	1603	118	2	65	0.0307692
NODE_1799_length_1701_cov_15.969413	1538	1603	120	4	65	0.0615385
NODE_1799_length_1701_cov_15.969413	1538	1603	121	9	65	0.1384615
NODE_1799_length_1701_cov_15.969413	1538	1603	122	1	65	0.0153846
NODE_1800_length_1701_cov_13.549313	607	687	1	53	80	0.6625000
NODE_1800_length_1701_cov_13.549313	607	687	2	27	80	0.3375000
NODE_1800_length_1701_cov_13.549313	660	740	1	80	80	1.0000000
NODE_1805_length_1700_cov_20.003123	1168	1197	304	1	29	0.0344828
NODE_1805_length_1700_cov_20.003123	1168	1197	308	1	29	0.0344828
NODE_1805_length_1700_cov_20.003123	1168	1197	314	2	29	0.0689655
NODE_1805_length_1700_cov_20.003123	1168	1197	316	1	29	0.0344828
NODE_1805_length_1700_cov_20.003123	1168	1197	317	1	29	0.0344828
NODE_1805_length_1700_cov_20.003123	1168	1197	320	1	29	0.0344828
NODE_1805_length_1700_cov_20.003123	1168	1197	322	3	29	0.1034483
NODE_1805_length_1700_cov_20.003123	1168	1197	324	1	29	0.0344828
NODE_1805_length_1700_cov_20.003123	1168	1197	325	2	29	0.0689655
NODE_1805_length_1700_cov_20.003123	1168	1197	326	1	29	0.0344828
NODE_1805_length_1700_cov_20.003123	1168	1197	329	1	29	0.0344828
NODE_1805_length_1700_cov_20.003123	1168	1197	330	2	29	0.0689655
NODE_1805_length_1700_cov_20.003123	1168	1197	332	1	29	0.0344828
NODE_1805_length_1700_cov_20.003123	1168	1197	341	1	29	0.0344828
NODE_1805_length_1700_cov_20.003123	1168	1197	344	1	29	0.0344828
NODE_1805_length_1700_cov_20.003123	1168	1197	345	1	29	0.0344828
NODE_1805_length_1700_cov_20.003123	1168	1197	349	1	29	0.0344828
NODE_1805_length_1700_cov_20.003123	1168	1197	355	1	29	0.0344828
NODE_1805_length_1700_cov_20.003123	1168	1197	369	2	29	0.0689655
NODE_1805_length_1700_cov_20.003123	1168	1197	382	1	29	0.0344828
NODE_1805_length_1700_cov_20.003123	1168	1197	383	1	29	0.0344828
NODE_1805_length_1700_cov_20.003123	1168	1197	385	2	29	0.0689655
NODE_1805_length_1700_cov_20.003123	1184	1263	304	1	79	0.0126582
NODE_1805_length_1700_cov_20.003123	1184	1263	308	1	79	0.0126582
NODE_1805_length_1700_cov_20.003123	1184	1263	311	1	79	0.0126582
NODE_1805_length_1700_cov_20.003123	1184	1263	312	1	79	0.0126582
NODE_1805_length_1700_cov_20.003123	1184	1263	314	3	79	0.0379747
NODE_1805_length_1700_cov_20.003123	1184	1263	315	2	79	0.0253165
NODE_1805_length_1700_cov_20.003123	1184	1263	318	3	79	0.0379747
NODE_1805_length_1700_cov_20.003123	1184	1263	319	4	79	0.0506329
NODE_1805_length_1700_cov_20.003123	1184	1263	320	1	79	0.0126582
NODE_1805_length_1700_cov_20.003123	1184	1263	321	3	79	0.0379747
NODE_1805_length_1700_cov_20.003123	1184	1263	322	5	79	0.0632911
NODE_1805_length_1700_cov_20.003123	1184	1263	323	1	79	0.0126582
NODE_1805_length_1700_cov_20.003123	1184	1263	325	3	79	0.0379747
NODE_1805_length_1700_cov_20.003123	1184	1263	326	1	79	0.0126582
NODE_1805_length_1700_cov_20.003123	1184	1263	329	2	79	0.0253165
NODE_1805_length_1700_cov_20.003123	1184	1263	330	2	79	0.0253165
NODE_1805_length_1700_cov_20.003123	1184	1263	332	1	79	0.0126582
NODE_1805_length_1700_cov_20.003123	1184	1263	335	1	79	0.0126582
NODE_1805_length_1700_cov_20.003123	1184	1263	336	5	79	0.0632911
NODE_1805_length_1700_cov_20.003123	1184	1263	337	2	79	0.0253165
NODE_1805_length_1700_cov_20.003123	1184	1263	338	2	79	0.0253165
NODE_1805_length_1700_cov_20.003123	1184	1263	339	1	79	0.0126582
NODE_1805_length_1700_cov_20.003123	1184	1263	340	4	79	0.0506329
NODE_1805_length_1700_cov_20.003123	1184	1263	341	2	79	0.0253165
NODE_1805_length_1700_cov_20.003123	1184	1263	345	1	79	0.0126582
NODE_1805_length_1700_cov_20.003123	1184	1263	346	2	79	0.0253165
NODE_1805_length_1700_cov_20.003123	1184	1263	349	2	79	0.0253165
NODE_1805_length_1700_cov_20.003123	1184	1263	353	2	79	0.0253165
NODE_1805_length_1700_cov_20.003123	1184	1263	354	1	79	0.0126582
NODE_1805_length_1700_cov_20.003123	1184	1263	355	1	79	0.0126582
NODE_1805_length_1700_cov_20.003123	1184	1263	359	1	79	0.0126582
NODE_1805_length_1700_cov_20.003123	1184	1263	367	1	79	0.0126582
NODE_1805_length_1700_cov_20.003123	1184	1263	369	1	79	0.0126582
NODE_1805_length_1700_cov_20.003123	1184	1263	371	2	79	0.0253165
NODE_1805_length_1700_cov_20.003123	1184	1263	373	1	79	0.0126582
NODE_1805_length_1700_cov_20.003123	1184	1263	374	3	79	0.0379747
NODE_1805_length_1700_cov_20.003123	1184	1263	375	2	79	0.0253165
NODE_1805_length_1700_cov_20.003123	1184	1263	377	1	79	0.0126582
NODE_1805_length_1700_cov_20.003123	1184	1263	378	3	79	0.0379747
NODE_1805_length_1700_cov_20.003123	1184	1263	379	1	79	0.0126582
NODE_1805_length_1700_cov_20.003123	1184	1263	382	2	79	0.0253165
NODE_1810_length_1698_cov_19.175735	1001	1081	0	7	80	0.0875000
NODE_1810_length_1698_cov_19.175735	1001	1081	1	33	80	0.4125000
NODE_1810_length_1698_cov_19.175735	1001	1081	2	40	80	0.5000000
NODE_1810_length_1698_cov_19.175735	1054	1134	0	60	80	0.7500000
NODE_1810_length_1698_cov_19.175735	1054	1134	1	20	80	0.2500000
NODE_1814_length_1696_cov_11.494678	590	670	0	80	80	1.0000000
NODE_1814_length_1696_cov_11.494678	643	723	0	80	80	1.0000000
NODE_1815_length_1696_cov_6.620539	369	449	0	80	80	1.0000000
NODE_1815_length_1696_cov_6.620539	422	502	0	80	80	1.0000000
NODE_1816_length_1695_cov_27.783208	399	479	6	41	80	0.5125000
NODE_1816_length_1695_cov_27.783208	399	479	10	3	80	0.0375000
NODE_1816_length_1695_cov_27.783208	399	479	12	13	80	0.1625000
NODE_1816_length_1695_cov_27.783208	399	479	14	23	80	0.2875000
NODE_1816_length_1695_cov_27.783208	452	532	6	1	80	0.0125000
NODE_1816_length_1695_cov_27.783208	452	532	8	7	80	0.0875000
NODE_1816_length_1695_cov_27.783208	452	532	10	34	80	0.4250000
NODE_1816_length_1695_cov_27.783208	452	532	12	4	80	0.0500000
NODE_1816_length_1695_cov_27.783208	452	532	14	23	80	0.2875000
NODE_1816_length_1695_cov_27.783208	452	532	16	11	80	0.1375000
NODE_1817_length_1695_cov_12.084586	1047	1127	0	19	80	0.2375000
NODE_1817_length_1695_cov_12.084586	1047	1127	6	61	80	0.7625000
NODE_1817_length_1695_cov_12.084586	1100	1180	0	11	80	0.1375000
NODE_1817_length_1695_cov_12.084586	1100	1180	6	69	80	0.8625000
NODE_1825_length_1692_cov_4.557439	727	807	0	19	80	0.2375000
NODE_1825_length_1692_cov_4.557439	727	807	1	1	80	0.0125000
NODE_1825_length_1692_cov_4.557439	727	807	2	60	80	0.7500000
NODE_1825_length_1692_cov_4.557439	780	860	0	72	80	0.9000000
NODE_1825_length_1692_cov_4.557439	780	860	1	1	80	0.0125000
NODE_1825_length_1692_cov_4.557439	780	860	2	7	80	0.0875000
NODE_1830_length_1689_cov_5.844025	1210	1285	2	6	75	0.0800000
NODE_1830_length_1689_cov_5.844025	1210	1285	4	19	75	0.2533333
NODE_1830_length_1689_cov_5.844025	1210	1285	6	45	75	0.6000000
NODE_1830_length_1689_cov_5.844025	1210	1285	10	5	75	0.0666667
NODE_1830_length_1689_cov_5.844025	1260	1338	2	6	78	0.0769231
NODE_1830_length_1689_cov_5.844025	1260	1338	4	11	78	0.1410256
NODE_1830_length_1689_cov_5.844025	1260	1338	6	3	78	0.0384615
NODE_1830_length_1689_cov_5.844025	1260	1338	10	13	78	0.1666667
NODE_1830_length_1689_cov_5.844025	1260	1338	12	18	78	0.2307692
NODE_1830_length_1689_cov_5.844025	1260	1338	14	27	78	0.3461539
NODE_1837_length_1682_cov_14.416930	1183	1263	0	53	80	0.6625000
NODE_1837_length_1682_cov_14.416930	1183	1263	2	27	80	0.3375000
NODE_1837_length_1682_cov_14.416930	1236	1315	0	25	79	0.3164557
NODE_1837_length_1682_cov_14.416930	1236	1315	2	54	79	0.6835443
NODE_1843_length_1678_cov_23.965168	636	716	0	21	80	0.2625000
NODE_1843_length_1678_cov_23.965168	636	716	2	59	80	0.7375000
NODE_1843_length_1678_cov_23.965168	689	769	0	31	80	0.3875000
NODE_1843_length_1678_cov_23.965168	689	769	2	49	80	0.6125000
NODE_1843_length_1678_cov_23.965168	1145	1225	0	80	80	1.0000000
NODE_1843_length_1678_cov_23.965168	1198	1278	0	80	80	1.0000000
NODE_1846_length_1677_cov_3.578580	407	487	0	80	80	1.0000000
NODE_1846_length_1677_cov_3.578580	460	530	0	70	70	1.0000000
NODE_1846_length_1677_cov_3.578580	666	724	0	58	58	1.0000000
NODE_1856_length_1670_cov_29.264163	741	821	0	80	80	1.0000000
NODE_1856_length_1670_cov_29.264163	794	874	0	80	80	1.0000000
NODE_1857_length_1669_cov_5.913376	246	326	2	37	80	0.4625000
NODE_1857_length_1669_cov_5.913376	246	326	4	43	80	0.5375000
NODE_1857_length_1669_cov_5.913376	299	379	2	42	80	0.5250000
NODE_1857_length_1669_cov_5.913376	299	379	4	38	80	0.4750000
NODE_1860_length_1668_cov_18.372212	1100	1180	0	21	80	0.2625000
NODE_1860_length_1668_cov_18.372212	1100	1180	2	59	80	0.7375000
NODE_1860_length_1668_cov_18.372212	1153	1233	0	27	80	0.3375000
NODE_1860_length_1668_cov_18.372212	1153	1233	2	53	80	0.6625000
NODE_1861_length_1667_cov_15.651786	902	982	0	57	80	0.7125000
NODE_1861_length_1667_cov_15.651786	902	982	2	23	80	0.2875000
NODE_1861_length_1667_cov_15.651786	955	1035	0	80	80	1.0000000
NODE_1862_length_1667_cov_3.661352	649	679	0	30	30	1.0000000
NODE_1865_length_1666_cov_4.601149	1541	1623	12	82	82	1.0000000
NODE_1865_length_1666_cov_4.601149	1553	1613	12	60	60	1.0000000
NODE_1865_length_1666_cov_4.601149	1553	1613	12	60	60	1.0000000
NODE_1865_length_1666_cov_4.601149	1557	1623	12	66	66	1.0000000
NODE_1865_length_1666_cov_4.601149	1596	1666	0	4	70	0.0571429
NODE_1865_length_1666_cov_4.601149	1596	1666	8	3	70	0.0428571
NODE_1865_length_1666_cov_4.601149	1596	1666	12	63	70	0.9000000
NODE_1865_length_1666_cov_4.601149	1596	1666	0	4	70	0.0571429
NODE_1865_length_1666_cov_4.601149	1596	1666	8	3	70	0.0428571
NODE_1865_length_1666_cov_4.601149	1596	1666	12	63	70	0.9000000
NODE_1865_length_1666_cov_4.601149	1596	1666	0	4	70	0.0571429
NODE_1865_length_1666_cov_4.601149	1596	1666	8	3	70	0.0428571
NODE_1865_length_1666_cov_4.601149	1596	1666	12	63	70	0.9000000
NODE_1872_length_1662_cov_16.638516	538	618	0	22	80	0.2750000
NODE_1872_length_1662_cov_16.638516	538	618	2	58	80	0.7250000
NODE_1872_length_1662_cov_16.638516	591	671	0	12	80	0.1500000
NODE_1872_length_1662_cov_16.638516	591	671	2	68	80	0.8500000
NODE_1872_length_1662_cov_16.638516	667	747	0	29	80	0.3625000
NODE_1872_length_1662_cov_16.638516	667	747	4	51	80	0.6375000
NODE_1872_length_1662_cov_16.638516	720	800	0	20	80	0.2500000
NODE_1872_length_1662_cov_16.638516	720	800	4	60	80	0.7500000
NODE_1876_length_1660_cov_28.297886	415	495	0	39	80	0.4875000
NODE_1876_length_1660_cov_28.297886	415	495	2	41	80	0.5125000
NODE_1876_length_1660_cov_28.297886	468	548	0	23	80	0.2875000
NODE_1876_length_1660_cov_28.297886	468	548	2	57	80	0.7125000
NODE_1886_length_1654_cov_17.245016	631	711	0	37	80	0.4625000
NODE_1886_length_1654_cov_17.245016	631	711	2	43	80	0.5375000
NODE_1886_length_1654_cov_17.245016	684	764	2	80	80	1.0000000
NODE_1888_length_1653_cov_34.827542	0	41	0	41	41	1.0000000
NODE_1888_length_1653_cov_34.827542	14	44	0	30	30	1.0000000
NODE_1888_length_1653_cov_34.827542	1081	1161	10	24	80	0.3000000
NODE_1888_length_1653_cov_34.827542	1081	1161	11	22	80	0.2750000
NODE_1888_length_1653_cov_34.827542	1081	1161	12	14	80	0.1750000
NODE_1888_length_1653_cov_34.827542	1081	1161	13	20	80	0.2500000
NODE_1888_length_1653_cov_34.827542	1134	1214	6	13	80	0.1625000
NODE_1888_length_1653_cov_34.827542	1134	1214	7	1	80	0.0125000
NODE_1888_length_1653_cov_34.827542	1134	1214	8	18	80	0.2250000
NODE_1888_length_1653_cov_34.827542	1134	1214	10	13	80	0.1625000
NODE_1888_length_1653_cov_34.827542	1134	1214	12	26	80	0.3250000
NODE_1888_length_1653_cov_34.827542	1134	1214	13	2	80	0.0250000
NODE_1888_length_1653_cov_34.827542	1134	1214	15	3	80	0.0375000
NODE_1888_length_1653_cov_34.827542	1134	1214	17	2	80	0.0250000
NODE_1888_length_1653_cov_34.827542	1134	1214	19	2	80	0.0250000
NODE_1888_length_1653_cov_34.827542	1210	1290	17	22	80	0.2750000
NODE_1888_length_1653_cov_34.827542	1210	1290	19	2	80	0.0250000
NODE_1888_length_1653_cov_34.827542	1210	1290	22	6	80	0.0750000
NODE_1888_length_1653_cov_34.827542	1210	1290	23	2	80	0.0250000
NODE_1888_length_1653_cov_34.827542	1210	1290	24	5	80	0.0625000
NODE_1888_length_1653_cov_34.827542	1210	1290	25	11	80	0.1375000
NODE_1888_length_1653_cov_34.827542	1210	1290	26	32	80	0.4000000
NODE_1888_length_1653_cov_34.827542	1263	1339	4	6	76	0.0789474
NODE_1888_length_1653_cov_34.827542	1263	1339	13	3	76	0.0394737
NODE_1888_length_1653_cov_34.827542	1263	1339	22	6	76	0.0789474
NODE_1888_length_1653_cov_34.827542	1263	1339	23	42	76	0.5526316
NODE_1888_length_1653_cov_34.827542	1263	1339	24	5	76	0.0657895
NODE_1888_length_1653_cov_34.827542	1263	1339	26	14	76	0.1842105
NODE_1892_length_1652_cov_23.939472	1352	1432	0	80	80	1.0000000
NODE_1892_length_1652_cov_23.939472	1405	1485	0	80	80	1.0000000
NODE_1894_length_1651_cov_3.916881	1552	1617	2	65	65	1.0000000
NODE_1899_length_1649_cov_7.480000	774	854	0	80	80	1.0000000
NODE_1899_length_1649_cov_7.480000	827	907	0	80	80	1.0000000
NODE_1903_length_1647_cov_3.534238	1012	1075	4	32	63	0.5079365
NODE_1903_length_1647_cov_3.534238	1012	1075	6	15	63	0.2380952
NODE_1903_length_1647_cov_3.534238	1012	1075	8	9	63	0.1428571
NODE_1903_length_1647_cov_3.534238	1012	1075	10	7	63	0.1111111
NODE_1906_length_1645_cov_16.040103	155	235	0	54	80	0.6750000
NODE_1906_length_1645_cov_16.040103	155	235	2	26	80	0.3250000
NODE_1906_length_1645_cov_16.040103	208	288	0	10	80	0.1250000
NODE_1906_length_1645_cov_16.040103	208	288	2	70	80	0.8750000
NODE_1906_length_1645_cov_16.040103	1090	1170	0	8	80	0.1000000
NODE_1906_length_1645_cov_16.040103	1090	1170	3	1	80	0.0125000
NODE_1906_length_1645_cov_16.040103	1090	1170	4	10	80	0.1250000
NODE_1906_length_1645_cov_16.040103	1090	1170	6	20	80	0.2500000
NODE_1906_length_1645_cov_16.040103	1090	1170	8	18	80	0.2250000
NODE_1906_length_1645_cov_16.040103	1090	1170	12	23	80	0.2875000
NODE_1906_length_1645_cov_16.040103	1143	1222	0	60	79	0.7594936
NODE_1906_length_1645_cov_16.040103	1143	1222	3	1	79	0.0126582
NODE_1906_length_1645_cov_16.040103	1143	1222	4	10	79	0.1265823
NODE_1906_length_1645_cov_16.040103	1143	1222	6	8	79	0.1012658
NODE_1908_length_1644_cov_2.902913	1160	1240	8	10	80	0.1250000
NODE_1908_length_1644_cov_2.902913	1160	1240	10	22	80	0.2750000
NODE_1908_length_1644_cov_2.902913	1160	1240	12	6	80	0.0750000
NODE_1908_length_1644_cov_2.902913	1160	1240	14	26	80	0.3250000
NODE_1908_length_1644_cov_2.902913	1160	1240	16	16	80	0.2000000
NODE_1917_length_1641_cov_34.032425	487	567	0	20	80	0.2500000
NODE_1917_length_1641_cov_34.032425	487	567	3	1	80	0.0125000
NODE_1917_length_1641_cov_34.032425	487	567	4	59	80	0.7375000
NODE_1917_length_1641_cov_34.032425	540	620	0	29	80	0.3625000
NODE_1917_length_1641_cov_34.032425	540	620	4	51	80	0.6375000
NODE_1917_length_1641_cov_34.032425	616	696	0	80	80	1.0000000
NODE_1917_length_1641_cov_34.032425	669	749	0	80	80	1.0000000
NODE_1917_length_1641_cov_34.032425	1168	1248	0	80	80	1.0000000
NODE_1917_length_1641_cov_34.032425	1219	1301	0	82	82	1.0000000
NODE_1918_length_1641_cov_7.042802	339	390	0	51	51	1.0000000
NODE_1922_length_1640_cov_33.097339	943	1023	0	80	80	1.0000000
NODE_1922_length_1640_cov_33.097339	996	1076	0	35	80	0.4375000
NODE_1922_length_1640_cov_33.097339	996	1076	2	45	80	0.5625000
NODE_1922_length_1640_cov_33.097339	1072	1152	0	22	80	0.2750000
NODE_1922_length_1640_cov_33.097339	1072	1152	2	58	80	0.7250000
NODE_1922_length_1640_cov_33.097339	1125	1206	0	76	81	0.9382716
NODE_1922_length_1640_cov_33.097339	1125	1206	2	5	81	0.0617284
NODE_1923_length_1640_cov_18.519143	471	551	0	74	80	0.9250000
NODE_1923_length_1640_cov_18.519143	471	551	2	6	80	0.0750000
NODE_1923_length_1640_cov_18.519143	524	604	0	21	80	0.2625000
NODE_1923_length_1640_cov_18.519143	524	604	2	44	80	0.5500000
NODE_1923_length_1640_cov_18.519143	524	604	4	15	80	0.1875000
NODE_1925_length_1639_cov_6.585714	975	1056	0	1	81	0.0123457
NODE_1925_length_1639_cov_6.585714	975	1056	2	80	81	0.9876543
NODE_1925_length_1639_cov_6.585714	1028	1109	0	54	81	0.6666667
NODE_1925_length_1639_cov_6.585714	1028	1109	2	27	81	0.3333333
NODE_1926_length_1639_cov_2.163636	1260	1334	0	74	74	1.0000000
NODE_1926_length_1639_cov_2.163636	1312	1387	0	43	75	0.5733333
NODE_1926_length_1639_cov_2.163636	1312	1387	2	7	75	0.0933333
NODE_1926_length_1639_cov_2.163636	1312	1387	4	25	75	0.3333333
NODE_1928_length_1638_cov_18.598441	443	523	2	26	80	0.3250000
NODE_1928_length_1638_cov_18.598441	443	523	4	30	80	0.3750000
NODE_1928_length_1638_cov_18.598441	443	523	6	24	80	0.3000000
NODE_1928_length_1638_cov_18.598441	496	576	2	45	80	0.5625000
NODE_1928_length_1638_cov_18.598441	496	576	4	34	80	0.4250000
NODE_1928_length_1638_cov_18.598441	496	576	6	1	80	0.0125000
NODE_1928_length_1638_cov_18.598441	1157	1237	0	80	80	1.0000000
NODE_1928_length_1638_cov_18.598441	1210	1290	0	80	80	1.0000000
NODE_1932_length_1637_cov_12.048765	410	490	0	51	80	0.6375000
NODE_1932_length_1637_cov_12.048765	410	490	4	29	80	0.3625000
NODE_1932_length_1637_cov_12.048765	463	543	4	80	80	1.0000000
NODE_1932_length_1637_cov_12.048765	1081	1161	0	80	80	1.0000000
NODE_1932_length_1637_cov_12.048765	1134	1214	0	80	80	1.0000000
NODE_1934_length_1635_cov_21.022786	958	1038	0	62	80	0.7750000
NODE_1934_length_1635_cov_21.022786	958	1038	1	18	80	0.2250000
NODE_1934_length_1635_cov_21.022786	1011	1091	0	9	80	0.1125000
NODE_1934_length_1635_cov_21.022786	1011	1091	1	71	80	0.8875000
NODE_1934_length_1635_cov_21.022786	1087	1167	1	80	80	1.0000000
NODE_1934_length_1635_cov_21.022786	1140	1220	0	50	80	0.6250000
NODE_1934_length_1635_cov_21.022786	1140	1220	1	30	80	0.3750000
NODE_1936_length_1633_cov_16.743807	1067	1147	0	80	80	1.0000000
NODE_1936_length_1633_cov_16.743807	1120	1200	0	80	80	1.0000000
NODE_1937_length_1633_cov_14.271838	977	1057	0	80	80	1.0000000
NODE_1937_length_1633_cov_14.271838	1030	1110	0	80	80	1.0000000
NODE_1937_length_1633_cov_14.271838	1106	1186	0	80	80	1.0000000
NODE_1937_length_1633_cov_14.271838	1159	1239	0	51	80	0.6375000
NODE_1937_length_1633_cov_14.271838	1159	1239	4	29	80	0.3625000
NODE_1939_length_1631_cov_25.881201	424	504	0	44	80	0.5500000
NODE_1939_length_1631_cov_25.881201	424	504	2	36	80	0.4500000
NODE_1939_length_1631_cov_25.881201	477	557	2	36	80	0.4500000
NODE_1939_length_1631_cov_25.881201	477	557	4	44	80	0.5500000
NODE_1939_length_1631_cov_25.881201	553	633	2	80	80	1.0000000
NODE_1939_length_1631_cov_25.881201	606	686	0	50	80	0.6250000
NODE_1939_length_1631_cov_25.881201	606	686	2	30	80	0.3750000
NODE_1943_length_1629_cov_32.733987	518	598	0	80	80	1.0000000
NODE_1943_length_1629_cov_32.733987	635	715	0	80	80	1.0000000
NODE_1943_length_1629_cov_32.733987	688	768	0	80	80	1.0000000
NODE_1946_length_1628_cov_15.551995	1454	1518	505	1	64	0.0156250
NODE_1946_length_1628_cov_15.551995	1454	1518	510	1	64	0.0156250
NODE_1946_length_1628_cov_15.551995	1454	1518	543	1	64	0.0156250
NODE_1946_length_1628_cov_15.551995	1454	1518	568	1	64	0.0156250
NODE_1946_length_1628_cov_15.551995	1454	1518	620	1	64	0.0156250
NODE_1946_length_1628_cov_15.551995	1454	1518	633	1	64	0.0156250
NODE_1946_length_1628_cov_15.551995	1454	1518	643	1	64	0.0156250
NODE_1946_length_1628_cov_15.551995	1454	1518	660	1	64	0.0156250
NODE_1946_length_1628_cov_15.551995	1454	1518	675	1	64	0.0156250
NODE_1946_length_1628_cov_15.551995	1454	1518	695	1	64	0.0156250
NODE_1946_length_1628_cov_15.551995	1454	1518	697	1	64	0.0156250
NODE_1946_length_1628_cov_15.551995	1454	1518	709	1	64	0.0156250
NODE_1946_length_1628_cov_15.551995	1454	1518	715	1	64	0.0156250
NODE_1946_length_1628_cov_15.551995	1454	1518	750	1	64	0.0156250
NODE_1946_length_1628_cov_15.551995	1454	1518	765	1	64	0.0156250
NODE_1946_length_1628_cov_15.551995	1454	1518	788	1	64	0.0156250
NODE_1946_length_1628_cov_15.551995	1454	1518	811	1	64	0.0156250
NODE_1946_length_1628_cov_15.551995	1454	1518	837	1	64	0.0156250
NODE_1946_length_1628_cov_15.551995	1454	1518	857	1	64	0.0156250
NODE_1946_length_1628_cov_15.551995	1454	1518	871	1	64	0.0156250
NODE_1946_length_1628_cov_15.551995	1454	1518	904	1	64	0.0156250
NODE_1946_length_1628_cov_15.551995	1454	1518	906	1	64	0.0156250
NODE_1946_length_1628_cov_15.551995	1454	1518	929	1	64	0.0156250
NODE_1946_length_1628_cov_15.551995	1454	1518	960	1	64	0.0156250
NODE_1946_length_1628_cov_15.551995	1454	1518	969	1	64	0.0156250
NODE_1946_length_1628_cov_15.551995	1454	1518	971	1	64	0.0156250
NODE_1946_length_1628_cov_15.551995	1454	1518	986	1	64	0.0156250
NODE_1946_length_1628_cov_15.551995	1454	1518	998	1	64	0.0156250
NODE_1946_length_1628_cov_15.551995	1454	1518	1026	1	64	0.0156250
NODE_1946_length_1628_cov_15.551995	1454	1518	1036	1	64	0.0156250
NODE_1946_length_1628_cov_15.551995	1454	1518	1064	2	64	0.0312500
NODE_1946_length_1628_cov_15.551995	1454	1518	1083	1	64	0.0156250
NODE_1946_length_1628_cov_15.551995	1454	1518	1100	1	64	0.0156250
NODE_1946_length_1628_cov_15.551995	1454	1518	1104	1	64	0.0156250
NODE_1946_length_1628_cov_15.551995	1454	1518	1106	2	64	0.0312500
NODE_1946_length_1628_cov_15.551995	1454	1518	1109	1	64	0.0156250
NODE_1946_length_1628_cov_15.551995	1454	1518	1126	1	64	0.0156250
NODE_1946_length_1628_cov_15.551995	1454	1518	1129	1	64	0.0156250
NODE_1946_length_1628_cov_15.551995	1454	1518	1137	1	64	0.0156250
NODE_1946_length_1628_cov_15.551995	1454	1518	1153	1	64	0.0156250
NODE_1946_length_1628_cov_15.551995	1454	1518	1159	1	64	0.0156250
NODE_1946_length_1628_cov_15.551995	1454	1518	1162	1	64	0.0156250
NODE_1946_length_1628_cov_15.551995	1454	1518	1172	1	64	0.0156250
NODE_1946_length_1628_cov_15.551995	1454	1518	1186	1	64	0.0156250
NODE_1946_length_1628_cov_15.551995	1454	1518	1196	1	64	0.0156250
NODE_1946_length_1628_cov_15.551995	1454	1518	1212	1	64	0.0156250
NODE_1946_length_1628_cov_15.551995	1454	1518	1224	2	64	0.0312500
NODE_1946_length_1628_cov_15.551995	1454	1518	1228	1	64	0.0156250
NODE_1946_length_1628_cov_15.551995	1454	1518	1254	1	64	0.0156250
NODE_1946_length_1628_cov_15.551995	1454	1518	1262	1	64	0.0156250
NODE_1946_length_1628_cov_15.551995	1454	1518	1264	1	64	0.0156250
NODE_1946_length_1628_cov_15.551995	1454	1518	1266	1	64	0.0156250
NODE_1946_length_1628_cov_15.551995	1454	1518	1284	1	64	0.0156250
NODE_1946_length_1628_cov_15.551995	1454	1518	1291	1	64	0.0156250
NODE_1946_length_1628_cov_15.551995	1454	1518	1300	1	64	0.0156250
NODE_1946_length_1628_cov_15.551995	1454	1518	1312	1	64	0.0156250
NODE_1946_length_1628_cov_15.551995	1454	1518	1318	1	64	0.0156250
NODE_1946_length_1628_cov_15.551995	1454	1518	1322	1	64	0.0156250
NODE_1946_length_1628_cov_15.551995	1454	1518	1324	2	64	0.0312500
NODE_1946_length_1628_cov_15.551995	1454	1518	1326	1	64	0.0156250
NODE_1947_length_1628_cov_4.852845	81	163	24	3	82	0.0365854
NODE_1947_length_1628_cov_4.852845	81	163	26	1	82	0.0121951
NODE_1947_length_1628_cov_4.852845	81	163	28	4	82	0.0487805
NODE_1947_length_1628_cov_4.852845	81	163	30	9	82	0.1097561
NODE_1947_length_1628_cov_4.852845	81	163	32	9	82	0.1097561
NODE_1947_length_1628_cov_4.852845	81	163	34	13	82	0.1585366
NODE_1947_length_1628_cov_4.852845	81	163	36	8	82	0.0975610
NODE_1947_length_1628_cov_4.852845	81	163	38	4	82	0.0487805
NODE_1947_length_1628_cov_4.852845	81	163	40	11	82	0.1341463
NODE_1947_length_1628_cov_4.852845	81	163	42	17	82	0.2073171
NODE_1947_length_1628_cov_4.852845	81	163	44	3	82	0.0365854
NODE_1952_length_1626_cov_20.549443	495	575	0	72	80	0.9000000
NODE_1952_length_1626_cov_20.549443	495	575	1	6	80	0.0750000
NODE_1952_length_1626_cov_20.549443	495	575	2	2	80	0.0250000
NODE_1952_length_1626_cov_20.549443	548	628	0	21	80	0.2625000
NODE_1952_length_1626_cov_20.549443	548	628	1	59	80	0.7375000
NODE_1953_length_1626_cov_6.552718	1189	1269	0	10	80	0.1250000
NODE_1953_length_1626_cov_6.552718	1189	1269	2	1	80	0.0125000
NODE_1953_length_1626_cov_6.552718	1189	1269	4	69	80	0.8625000
NODE_1953_length_1626_cov_6.552718	1242	1321	0	48	79	0.6075949
NODE_1953_length_1626_cov_6.552718	1242	1321	2	1	79	0.0126582
NODE_1953_length_1626_cov_6.552718	1242	1321	4	30	79	0.3797468
NODE_1954_length_1626_cov_4.728880	247	329	4	4	82	0.0487805
NODE_1954_length_1626_cov_4.728880	247	329	6	54	82	0.6585366
NODE_1954_length_1626_cov_4.728880	247	329	8	24	82	0.2926829
NODE_1954_length_1626_cov_4.728880	302	382	4	15	80	0.1875000
NODE_1954_length_1626_cov_4.728880	302	382	6	52	80	0.6500000
NODE_1954_length_1626_cov_4.728880	302	382	8	13	80	0.1625000
NODE_1956_length_1625_cov_20.598952	938	1018	0	80	80	1.0000000
NODE_1956_length_1625_cov_20.598952	991	1071	0	80	80	1.0000000
NODE_1962_length_1623_cov_28.551181	416	486	31	1	70	0.0142857
NODE_1962_length_1623_cov_28.551181	416	486	32	2	70	0.0285714
NODE_1962_length_1623_cov_28.551181	416	486	36	2	70	0.0285714
NODE_1962_length_1623_cov_28.551181	416	486	38	2	70	0.0285714
NODE_1962_length_1623_cov_28.551181	416	486	39	12	70	0.1714286
NODE_1962_length_1623_cov_28.551181	416	486	41	7	70	0.1000000
NODE_1962_length_1623_cov_28.551181	416	486	42	2	70	0.0285714
NODE_1962_length_1623_cov_28.551181	416	486	46	16	70	0.2285714
NODE_1962_length_1623_cov_28.551181	416	486	47	9	70	0.1285714
NODE_1962_length_1623_cov_28.551181	416	486	50	11	70	0.1571429
NODE_1962_length_1623_cov_28.551181	416	486	52	6	70	0.0857143
NODE_1962_length_1623_cov_28.551181	459	507	25	16	48	0.3333333
NODE_1962_length_1623_cov_28.551181	459	507	27	2	48	0.0416667
NODE_1962_length_1623_cov_28.551181	459	507	31	1	48	0.0208333
NODE_1962_length_1623_cov_28.551181	459	507	32	2	48	0.0416667
NODE_1962_length_1623_cov_28.551181	459	507	36	2	48	0.0416667
NODE_1962_length_1623_cov_28.551181	459	507	38	3	48	0.0625000
NODE_1962_length_1623_cov_28.551181	459	507	39	12	48	0.2500000
NODE_1962_length_1623_cov_28.551181	459	507	40	1	48	0.0208333
NODE_1962_length_1623_cov_28.551181	459	507	41	7	48	0.1458333
NODE_1962_length_1623_cov_28.551181	459	507	42	2	48	0.0416667
NODE_1965_length_1622_cov_7.969140	645	725	0	80	80	1.0000000
NODE_1965_length_1622_cov_7.969140	698	778	0	80	80	1.0000000
NODE_1970_length_1621_cov_2.192510	330	401	8	3	71	0.0422535
NODE_1970_length_1621_cov_2.192510	330	401	10	2	71	0.0281690
NODE_1970_length_1621_cov_2.192510	330	401	12	28	71	0.3943662
NODE_1970_length_1621_cov_2.192510	330	401	14	1	71	0.0140845
NODE_1970_length_1621_cov_2.192510	330	401	16	11	71	0.1549296
NODE_1970_length_1621_cov_2.192510	330	401	18	18	71	0.2535211
NODE_1970_length_1621_cov_2.192510	330	401	20	8	71	0.1126761
NODE_1975_length_1618_cov_44.138907	361	441	0	15	80	0.1875000
NODE_1975_length_1618_cov_44.138907	361	441	13	65	80	0.8125000
NODE_1975_length_1618_cov_44.138907	414	494	0	12	80	0.1500000
NODE_1975_length_1618_cov_44.138907	414	494	4	3	80	0.0375000
NODE_1975_length_1618_cov_44.138907	414	494	12	1	80	0.0125000
NODE_1975_length_1618_cov_44.138907	414	494	13	64	80	0.8000000
NODE_1975_length_1618_cov_44.138907	1063	1143	0	58	80	0.7250000
NODE_1975_length_1618_cov_44.138907	1063	1143	6	21	80	0.2625000
NODE_1975_length_1618_cov_44.138907	1063	1143	8	1	80	0.0125000
NODE_1975_length_1618_cov_44.138907	1116	1196	0	5	80	0.0625000
NODE_1975_length_1618_cov_44.138907	1116	1196	6	21	80	0.2625000
NODE_1975_length_1618_cov_44.138907	1116	1196	8	4	80	0.0500000
NODE_1975_length_1618_cov_44.138907	1116	1196	9	50	80	0.6250000
NODE_1976_length_1618_cov_5.779460	332	414	0	8	82	0.0975610
NODE_1976_length_1618_cov_5.779460	332	414	1	4	82	0.0487805
NODE_1976_length_1618_cov_5.779460	332	414	2	70	82	0.8536586
NODE_1976_length_1618_cov_5.779460	387	467	2	30	80	0.3750000
NODE_1976_length_1618_cov_5.779460	387	467	4	50	80	0.6250000
NODE_1976_length_1618_cov_5.779460	972	1028	2	6	56	0.1071429
NODE_1976_length_1618_cov_5.779460	972	1028	4	5	56	0.0892857
NODE_1976_length_1618_cov_5.779460	972	1028	7	42	56	0.7500000
NODE_1976_length_1618_cov_5.779460	972	1028	9	3	56	0.0535714
NODE_1980_length_1616_cov_5.313777	589	669	0	4	80	0.0500000
NODE_1980_length_1616_cov_5.313777	589	669	2	1	80	0.0125000
NODE_1980_length_1616_cov_5.313777	589	669	4	75	80	0.9375000
NODE_1980_length_1616_cov_5.313777	642	722	0	57	80	0.7125000
NODE_1980_length_1616_cov_5.313777	642	722	2	1	80	0.0125000
NODE_1980_length_1616_cov_5.313777	642	722	4	22	80	0.2750000
NODE_1981_length_1615_cov_12.575858	1032	1112	0	1	80	0.0125000
NODE_1981_length_1615_cov_12.575858	1032	1112	2	79	80	0.9875000
NODE_1981_length_1615_cov_12.575858	1085	1162	0	51	77	0.6623377
NODE_1981_length_1615_cov_12.575858	1085	1162	2	26	77	0.3376623
NODE_1981_length_1615_cov_12.575858	1158	1238	0	8	80	0.1000000
NODE_1981_length_1615_cov_12.575858	1158	1238	2	1	80	0.0125000
NODE_1981_length_1615_cov_12.575858	1158	1238	4	31	80	0.3875000
NODE_1981_length_1615_cov_12.575858	1158	1238	5	5	80	0.0625000
NODE_1981_length_1615_cov_12.575858	1158	1238	6	35	80	0.4375000
NODE_1981_length_1615_cov_12.575858	1211	1291	0	2	80	0.0250000
NODE_1981_length_1615_cov_12.575858	1211	1291	2	25	80	0.3125000
NODE_1981_length_1615_cov_12.575858	1211	1291	3	17	80	0.2125000
NODE_1981_length_1615_cov_12.575858	1211	1291	5	14	80	0.1750000
NODE_1981_length_1615_cov_12.575858	1211	1291	6	22	80	0.2750000
NODE_1983_length_1614_cov_94.900990	0	46	0	12	46	0.2608696
NODE_1983_length_1614_cov_94.900990	0	46	10	34	46	0.7391304
NODE_1983_length_1614_cov_94.900990	23	99	10	76	76	1.0000000
NODE_1984_length_1614_cov_18.799340	655	735	0	80	80	1.0000000
NODE_1984_length_1614_cov_18.799340	708	788	0	80	80	1.0000000
NODE_1986_length_1613_cov_6.865258	1128	1203	10	19	75	0.2533333
NODE_1986_length_1613_cov_6.865258	1128	1203	11	2	75	0.0266667
NODE_1986_length_1613_cov_6.865258	1128	1203	12	16	75	0.2133333
NODE_1986_length_1613_cov_6.865258	1128	1203	13	22	75	0.2933333
NODE_1986_length_1613_cov_6.865258	1128	1203	14	10	75	0.1333333
NODE_1986_length_1613_cov_6.865258	1128	1203	15	6	75	0.0800000
NODE_1986_length_1613_cov_6.865258	1176	1256	10	20	80	0.2500000
NODE_1986_length_1613_cov_6.865258	1176	1256	11	1	80	0.0125000
NODE_1986_length_1613_cov_6.865258	1176	1256	12	49	80	0.6125000
NODE_1986_length_1613_cov_6.865258	1176	1256	14	10	80	0.1250000
NODE_1993_length_1610_cov_18.014560	1035	1115	0	80	80	1.0000000
NODE_1993_length_1610_cov_18.014560	1088	1168	0	80	80	1.0000000
NODE_2001_length_1603_cov_9.128324	1109	1189	0	21	80	0.2625000
NODE_2001_length_1603_cov_9.128324	1109	1189	3	23	80	0.2875000
NODE_2001_length_1603_cov_9.128324	1109	1189	7	36	80	0.4500000
NODE_2001_length_1603_cov_9.128324	1162	1242	2	8	80	0.1000000
NODE_2001_length_1603_cov_9.128324	1162	1242	6	18	80	0.2250000
NODE_2001_length_1603_cov_9.128324	1162	1242	7	37	80	0.4625000
NODE_2001_length_1603_cov_9.128324	1162	1242	9	17	80	0.2125000
NODE_2003_length_1602_cov_79.840319	1378	1445	53	3	67	0.0447761
NODE_2003_length_1602_cov_79.840319	1378	1445	55	5	67	0.0746269
NODE_2003_length_1602_cov_79.840319	1378	1445	57	9	67	0.1343284
NODE_2003_length_1602_cov_79.840319	1378	1445	59	2	67	0.0298507
NODE_2003_length_1602_cov_79.840319	1378	1445	63	1	67	0.0149254
NODE_2003_length_1602_cov_79.840319	1378	1445	64	2	67	0.0298507
NODE_2003_length_1602_cov_79.840319	1378	1445	67	2	67	0.0298507
NODE_2003_length_1602_cov_79.840319	1378	1445	68	1	67	0.0149254
NODE_2003_length_1602_cov_79.840319	1378	1445	70	1	67	0.0149254
NODE_2003_length_1602_cov_79.840319	1378	1445	72	3	67	0.0447761
NODE_2003_length_1602_cov_79.840319	1378	1445	73	1	67	0.0149254
NODE_2003_length_1602_cov_79.840319	1378	1445	75	1	67	0.0149254
NODE_2003_length_1602_cov_79.840319	1378	1445	78	2	67	0.0298507
NODE_2003_length_1602_cov_79.840319	1378	1445	80	2	67	0.0298507
NODE_2003_length_1602_cov_79.840319	1378	1445	84	1	67	0.0149254
NODE_2003_length_1602_cov_79.840319	1378	1445	91	2	67	0.0298507
NODE_2003_length_1602_cov_79.840319	1378	1445	93	1	67	0.0149254
NODE_2003_length_1602_cov_79.840319	1378	1445	97	1	67	0.0149254
NODE_2003_length_1602_cov_79.840319	1378	1445	99	4	67	0.0597015
NODE_2003_length_1602_cov_79.840319	1378	1445	101	5	67	0.0746269
NODE_2003_length_1602_cov_79.840319	1378	1445	102	2	67	0.0298507
NODE_2003_length_1602_cov_79.840319	1378	1445	103	1	67	0.0149254
NODE_2003_length_1602_cov_79.840319	1378	1445	107	1	67	0.0149254
NODE_2003_length_1602_cov_79.840319	1378	1445	108	2	67	0.0298507
NODE_2003_length_1602_cov_79.840319	1378	1445	112	1	67	0.0149254
NODE_2003_length_1602_cov_79.840319	1378	1445	117	1	67	0.0149254
NODE_2003_length_1602_cov_79.840319	1378	1445	118	1	67	0.0149254
NODE_2003_length_1602_cov_79.840319	1378	1445	120	7	67	0.1044776
NODE_2003_length_1602_cov_79.840319	1378	1445	124	2	67	0.0298507
NODE_2003_length_1602_cov_79.840319	1462	1508	18	1	46	0.0217391
NODE_2003_length_1602_cov_79.840319	1462	1508	20	7	46	0.1521739
NODE_2003_length_1602_cov_79.840319	1462	1508	21	7	46	0.1521739
NODE_2003_length_1602_cov_79.840319	1462	1508	27	2	46	0.0434783
NODE_2003_length_1602_cov_79.840319	1462	1508	31	4	46	0.0869565
NODE_2003_length_1602_cov_79.840319	1462	1508	32	7	46	0.1521739
NODE_2003_length_1602_cov_79.840319	1462	1508	33	4	46	0.0869565
NODE_2003_length_1602_cov_79.840319	1462	1508	34	1	46	0.0217391
NODE_2003_length_1602_cov_79.840319	1462	1508	36	1	46	0.0217391
NODE_2003_length_1602_cov_79.840319	1462	1508	39	2	46	0.0434783
NODE_2003_length_1602_cov_79.840319	1462	1508	41	1	46	0.0217391
NODE_2003_length_1602_cov_79.840319	1462	1508	42	4	46	0.0869565
NODE_2003_length_1602_cov_79.840319	1462	1508	43	1	46	0.0217391
NODE_2003_length_1602_cov_79.840319	1462	1508	46	2	46	0.0434783
NODE_2003_length_1602_cov_79.840319	1462	1508	47	2	46	0.0434783
NODE_2004_length_1602_cov_2.701264	1490	1570	0	7	80	0.0875000
NODE_2004_length_1602_cov_2.701264	1490	1570	2	26	80	0.3250000
NODE_2004_length_1602_cov_2.701264	1490	1570	4	3	80	0.0375000
NODE_2004_length_1602_cov_2.701264	1490	1570	6	44	80	0.5500000
NODE_2009_length_1600_cov_34.988008	785	865	0	26	80	0.3250000
NODE_2009_length_1600_cov_34.988008	785	865	2	54	80	0.6750000
NODE_2009_length_1600_cov_34.988008	838	918	0	75	80	0.9375000
NODE_2009_length_1600_cov_34.988008	838	918	2	5	80	0.0625000
NODE_2009_length_1600_cov_34.988008	914	994	2	70	80	0.8750000
NODE_2009_length_1600_cov_34.988008	914	994	4	10	80	0.1250000
NODE_2009_length_1600_cov_34.988008	967	1047	2	42	80	0.5250000
NODE_2009_length_1600_cov_34.988008	967	1047	4	38	80	0.4750000
NODE_2011_length_1600_cov_11.383744	0	72	0	72	72	1.0000000
NODE_2011_length_1600_cov_11.383744	45	99	0	54	54	1.0000000
NODE_2011_length_1600_cov_11.383744	891	971	4	35	80	0.4375000
NODE_2011_length_1600_cov_11.383744	891	971	6	20	80	0.2500000
NODE_2011_length_1600_cov_11.383744	891	971	8	25	80	0.3125000
NODE_2011_length_1600_cov_11.383744	944	1024	0	11	80	0.1375000
NODE_2011_length_1600_cov_11.383744	944	1024	2	18	80	0.2250000
NODE_2011_length_1600_cov_11.383744	944	1024	4	36	80	0.4500000
NODE_2011_length_1600_cov_11.383744	944	1024	6	2	80	0.0250000
NODE_2011_length_1600_cov_11.383744	944	1024	8	13	80	0.1625000
NODE_2013_length_1600_cov_7.236509	1037	1109	0	56	72	0.7777778
NODE_2013_length_1600_cov_7.236509	1037	1109	2	4	72	0.0555556
NODE_2013_length_1600_cov_7.236509	1037	1109	4	12	72	0.1666667
NODE_2013_length_1600_cov_7.236509	1090	1160	0	70	70	1.0000000
NODE_2018_length_1598_cov_29.337558	335	415	0	5	80	0.0625000
NODE_2018_length_1598_cov_29.337558	335	415	2	75	80	0.9375000
NODE_2018_length_1598_cov_29.337558	388	468	0	56	80	0.7000000
NODE_2018_length_1598_cov_29.337558	388	468	2	22	80	0.2750000
NODE_2018_length_1598_cov_29.337558	388	468	3	1	80	0.0125000
NODE_2018_length_1598_cov_29.337558	388	468	5	1	80	0.0125000
NODE_2018_length_1598_cov_29.337558	464	516	0	2	52	0.0384615
NODE_2018_length_1598_cov_29.337558	464	516	3	1	52	0.0192308
NODE_2018_length_1598_cov_29.337558	464	516	5	3	52	0.0576923
NODE_2018_length_1598_cov_29.337558	464	516	7	1	52	0.0192308
NODE_2018_length_1598_cov_29.337558	464	516	8	1	52	0.0192308
NODE_2018_length_1598_cov_29.337558	464	516	10	2	52	0.0384615
NODE_2018_length_1598_cov_29.337558	464	516	14	18	52	0.3461539
NODE_2018_length_1598_cov_29.337558	464	516	16	1	52	0.0192308
NODE_2018_length_1598_cov_29.337558	464	516	18	12	52	0.2307692
NODE_2018_length_1598_cov_29.337558	464	516	20	8	52	0.1538462
NODE_2018_length_1598_cov_29.337558	464	516	22	3	52	0.0576923
NODE_2018_length_1598_cov_29.337558	1026	1106	0	80	80	1.0000000
NODE_2018_length_1598_cov_29.337558	1079	1159	0	80	80	1.0000000
NODE_2019_length_1598_cov_3.730487	1117	1197	0	80	80	1.0000000
NODE_2021_length_1597_cov_7.434579	1373	1453	9	2	80	0.0250000
NODE_2021_length_1597_cov_7.434579	1373	1453	13	30	80	0.3750000
NODE_2021_length_1597_cov_7.434579	1373	1453	15	8	80	0.1000000
NODE_2021_length_1597_cov_7.434579	1373	1453	17	8	80	0.1000000
NODE_2021_length_1597_cov_7.434579	1373	1453	25	2	80	0.0250000
NODE_2021_length_1597_cov_7.434579	1373	1453	29	8	80	0.1000000
NODE_2021_length_1597_cov_7.434579	1373	1453	33	2	80	0.0250000
NODE_2021_length_1597_cov_7.434579	1373	1453	38	1	80	0.0125000
NODE_2021_length_1597_cov_7.434579	1373	1453	67	1	80	0.0125000
NODE_2021_length_1597_cov_7.434579	1373	1453	73	1	80	0.0125000
NODE_2021_length_1597_cov_7.434579	1373	1453	80	1	80	0.0125000
NODE_2021_length_1597_cov_7.434579	1373	1453	82	1	80	0.0125000
NODE_2021_length_1597_cov_7.434579	1373	1453	102	1	80	0.0125000
NODE_2021_length_1597_cov_7.434579	1373	1453	108	1	80	0.0125000
NODE_2021_length_1597_cov_7.434579	1373	1453	131	2	80	0.0250000
NODE_2021_length_1597_cov_7.434579	1373	1453	133	1	80	0.0125000
NODE_2021_length_1597_cov_7.434579	1373	1453	143	1	80	0.0125000
NODE_2021_length_1597_cov_7.434579	1373	1453	151	1	80	0.0125000
NODE_2021_length_1597_cov_7.434579	1373	1453	159	1	80	0.0125000
NODE_2021_length_1597_cov_7.434579	1373	1453	167	1	80	0.0125000
NODE_2021_length_1597_cov_7.434579	1373	1453	174	1	80	0.0125000
NODE_2021_length_1597_cov_7.434579	1373	1453	189	1	80	0.0125000
NODE_2021_length_1597_cov_7.434579	1373	1453	191	1	80	0.0125000
NODE_2021_length_1597_cov_7.434579	1373	1453	194	1	80	0.0125000
NODE_2021_length_1597_cov_7.434579	1373	1453	198	1	80	0.0125000
NODE_2021_length_1597_cov_7.434579	1373	1453	209	1	80	0.0125000
NODE_2021_length_1597_cov_7.434579	1382	1453	13	23	71	0.3239437
NODE_2021_length_1597_cov_7.434579	1382	1453	15	8	71	0.1126761
NODE_2021_length_1597_cov_7.434579	1382	1453	17	8	71	0.1126761
NODE_2021_length_1597_cov_7.434579	1382	1453	25	2	71	0.0281690
NODE_2021_length_1597_cov_7.434579	1382	1453	29	8	71	0.1126761
NODE_2021_length_1597_cov_7.434579	1382	1453	33	2	71	0.0281690
NODE_2021_length_1597_cov_7.434579	1382	1453	38	1	71	0.0140845
NODE_2021_length_1597_cov_7.434579	1382	1453	67	1	71	0.0140845
NODE_2021_length_1597_cov_7.434579	1382	1453	73	1	71	0.0140845
NODE_2021_length_1597_cov_7.434579	1382	1453	80	1	71	0.0140845
NODE_2021_length_1597_cov_7.434579	1382	1453	82	1	71	0.0140845
NODE_2021_length_1597_cov_7.434579	1382	1453	102	1	71	0.0140845
NODE_2021_length_1597_cov_7.434579	1382	1453	108	1	71	0.0140845
NODE_2021_length_1597_cov_7.434579	1382	1453	131	2	71	0.0281690
NODE_2021_length_1597_cov_7.434579	1382	1453	133	1	71	0.0140845
NODE_2021_length_1597_cov_7.434579	1382	1453	143	1	71	0.0140845
NODE_2021_length_1597_cov_7.434579	1382	1453	151	1	71	0.0140845
NODE_2021_length_1597_cov_7.434579	1382	1453	159	1	71	0.0140845
NODE_2021_length_1597_cov_7.434579	1382	1453	167	1	71	0.0140845
NODE_2021_length_1597_cov_7.434579	1382	1453	174	1	71	0.0140845
NODE_2021_length_1597_cov_7.434579	1382	1453	189	1	71	0.0140845
NODE_2021_length_1597_cov_7.434579	1382	1453	191	1	71	0.0140845
NODE_2021_length_1597_cov_7.434579	1382	1453	194	1	71	0.0140845
NODE_2021_length_1597_cov_7.434579	1382	1453	198	1	71	0.0140845
NODE_2021_length_1597_cov_7.434579	1382	1453	209	1	71	0.0140845
NODE_2022_length_1595_cov_16.788770	215	267	12	11	52	0.2115385
NODE_2022_length_1595_cov_16.788770	215	267	14	41	52	0.7884616
NODE_2022_length_1595_cov_16.788770	614	673	12	3	59	0.0508475
NODE_2022_length_1595_cov_16.788770	614	673	14	17	59	0.2881356
NODE_2022_length_1595_cov_16.788770	614	673	16	39	59	0.6610169
NODE_2025_length_1593_cov_22.412316	144	224	0	21	80	0.2625000
NODE_2025_length_1593_cov_22.412316	144	224	2	59	80	0.7375000
NODE_2025_length_1593_cov_22.412316	197	277	0	2	80	0.0250000
NODE_2025_length_1593_cov_22.412316	197	277	2	78	80	0.9750000
NODE_2025_length_1593_cov_22.412316	1192	1272	6	48	80	0.6000000
NODE_2025_length_1593_cov_22.412316	1192	1272	7	12	80	0.1500000
NODE_2025_length_1593_cov_22.412316	1192	1272	9	20	80	0.2500000
NODE_2025_length_1593_cov_22.412316	1245	1325	3	8	80	0.1000000
NODE_2025_length_1593_cov_22.412316	1245	1325	5	3	80	0.0375000
NODE_2025_length_1593_cov_22.412316	1245	1325	6	9	80	0.1125000
NODE_2025_length_1593_cov_22.412316	1245	1325	7	12	80	0.1500000
NODE_2025_length_1593_cov_22.412316	1245	1325	8	1	80	0.0125000
NODE_2025_length_1593_cov_22.412316	1245	1325	9	47	80	0.5875000
NODE_2026_length_1593_cov_14.092369	357	437	0	33	80	0.4125000
NODE_2026_length_1593_cov_14.092369	357	437	2	47	80	0.5875000
NODE_2026_length_1593_cov_14.092369	410	490	0	18	80	0.2250000
NODE_2026_length_1593_cov_14.092369	410	490	2	62	80	0.7750000
NODE_2026_length_1593_cov_14.092369	1061	1141	0	80	80	1.0000000
NODE_2026_length_1593_cov_14.092369	1114	1194	0	80	80	1.0000000
NODE_2031_length_1592_cov_4.576691	277	357	2	23	80	0.2875000
NODE_2031_length_1592_cov_4.576691	277	357	6	57	80	0.7125000
NODE_2031_length_1592_cov_4.576691	330	410	0	52	80	0.6500000
NODE_2031_length_1592_cov_4.576691	330	410	2	24	80	0.3000000
NODE_2031_length_1592_cov_4.576691	330	410	6	4	80	0.0500000
NODE_2034_length_1591_cov_15.481233	841	921	2	17	80	0.2125000
NODE_2034_length_1591_cov_15.481233	841	921	17	23	80	0.2875000
NODE_2034_length_1591_cov_15.481233	841	921	18	29	80	0.3625000
NODE_2034_length_1591_cov_15.481233	841	921	20	11	80	0.1375000
NODE_2034_length_1591_cov_15.481233	894	974	18	33	80	0.4125000
NODE_2034_length_1591_cov_15.481233	894	974	20	47	80	0.5875000
NODE_2035_length_1591_cov_4.040885	35	65	0	30	30	1.0000000
NODE_2035_length_1591_cov_4.040885	38	99	0	60	61	0.9836066
NODE_2035_length_1591_cov_4.040885	38	99	2	1	61	0.0163934
NODE_2042_length_1589_cov_10.184564	379	459	0	31	80	0.3875000
NODE_2042_length_1589_cov_10.184564	379	459	2	49	80	0.6125000
NODE_2042_length_1589_cov_10.184564	432	512	2	80	80	1.0000000
NODE_2042_length_1589_cov_10.184564	473	512	2	39	39	1.0000000
NODE_2042_length_1589_cov_10.184564	508	588	0	74	80	0.9250000
NODE_2042_length_1589_cov_10.184564	508	588	2	6	80	0.0750000
NODE_2042_length_1589_cov_10.184564	561	641	0	80	80	1.0000000
NODE_2043_length_1588_cov_9.955675	415	495	0	80	80	1.0000000
NODE_2043_length_1588_cov_9.955675	468	548	0	80	80	1.0000000
NODE_2046_length_1587_cov_7.942204	710	790	2	5	80	0.0625000
NODE_2046_length_1587_cov_7.942204	710	790	6	7	80	0.0875000
NODE_2046_length_1587_cov_7.942204	710	790	8	20	80	0.2500000
NODE_2046_length_1587_cov_7.942204	710	790	12	3	80	0.0375000
NODE_2046_length_1587_cov_7.942204	710	790	14	23	80	0.2875000
NODE_2046_length_1587_cov_7.942204	710	790	16	8	80	0.1000000
NODE_2046_length_1587_cov_7.942204	710	790	18	14	80	0.1750000
NODE_2046_length_1587_cov_7.942204	763	843	0	52	80	0.6500000
NODE_2046_length_1587_cov_7.942204	763	843	2	6	80	0.0750000
NODE_2046_length_1587_cov_7.942204	763	843	6	7	80	0.0875000
NODE_2046_length_1587_cov_7.942204	763	843	8	15	80	0.1875000
NODE_2049_length_1586_cov_6.488231	447	474	0	27	27	1.0000000
NODE_2049_length_1586_cov_6.488231	447	527	0	80	80	1.0000000
NODE_2049_length_1586_cov_6.488231	500	580	0	44	80	0.5500000
NODE_2049_length_1586_cov_6.488231	500	580	2	36	80	0.4500000
NODE_2056_length_1583_cov_27.825472	800	880	0	30	80	0.3750000
NODE_2056_length_1583_cov_27.825472	800	880	2	50	80	0.6250000
NODE_2056_length_1583_cov_27.825472	853	933	2	63	80	0.7875000
NODE_2056_length_1583_cov_27.825472	853	933	4	17	80	0.2125000
NODE_2056_length_1583_cov_27.825472	929	1009	0	13	80	0.1625000
NODE_2056_length_1583_cov_27.825472	929	1009	2	49	80	0.6125000
NODE_2056_length_1583_cov_27.825472	929	1009	4	18	80	0.2250000
NODE_2056_length_1583_cov_27.825472	982	1062	0	66	80	0.8250000
NODE_2056_length_1583_cov_27.825472	982	1062	2	14	80	0.1750000
NODE_2060_length_1581_cov_10.610661	457	537	0	2	80	0.0250000
NODE_2060_length_1581_cov_10.610661	457	537	4	2	80	0.0250000
NODE_2060_length_1581_cov_10.610661	457	537	6	76	80	0.9500000
NODE_2060_length_1581_cov_10.610661	510	590	0	55	80	0.6875000
NODE_2060_length_1581_cov_10.610661	510	590	4	2	80	0.0250000
NODE_2060_length_1581_cov_10.610661	510	590	6	23	80	0.2875000
NODE_2065_length_1579_cov_7.395946	5	80	0	75	75	1.0000000
NODE_2065_length_1579_cov_7.395946	58	126	0	68	68	1.0000000
NODE_2066_length_1579_cov_7.152027	1331	1409	0	78	78	1.0000000
NODE_2066_length_1579_cov_7.152027	1382	1462	0	80	80	1.0000000
NODE_2067_length_1579_cov_6.741892	4	52	14	3	48	0.0625000
NODE_2067_length_1579_cov_6.741892	4	52	23	1	48	0.0208333
NODE_2067_length_1579_cov_6.741892	4	52	28	1	48	0.0208333
NODE_2067_length_1579_cov_6.741892	4	52	32	1	48	0.0208333
NODE_2067_length_1579_cov_6.741892	4	52	40	1	48	0.0208333
NODE_2067_length_1579_cov_6.741892	4	52	42	1	48	0.0208333
NODE_2067_length_1579_cov_6.741892	4	52	50	4	48	0.0833333
NODE_2067_length_1579_cov_6.741892	4	52	61	2	48	0.0416667
NODE_2067_length_1579_cov_6.741892	4	52	63	1	48	0.0208333
NODE_2067_length_1579_cov_6.741892	4	52	67	10	48	0.2083333
NODE_2067_length_1579_cov_6.741892	4	52	75	2	48	0.0416667
NODE_2067_length_1579_cov_6.741892	4	52	81	4	48	0.0833333
NODE_2067_length_1579_cov_6.741892	4	52	83	1	48	0.0208333
NODE_2067_length_1579_cov_6.741892	4	52	87	3	48	0.0625000
NODE_2067_length_1579_cov_6.741892	4	52	93	2	48	0.0416667
NODE_2067_length_1579_cov_6.741892	4	52	101	3	48	0.0625000
NODE_2067_length_1579_cov_6.741892	4	52	103	1	48	0.0208333
NODE_2067_length_1579_cov_6.741892	4	52	109	7	48	0.1458333
NODE_2067_length_1579_cov_6.741892	4	52	14	3	48	0.0625000
NODE_2067_length_1579_cov_6.741892	4	52	23	1	48	0.0208333
NODE_2067_length_1579_cov_6.741892	4	52	28	1	48	0.0208333
NODE_2067_length_1579_cov_6.741892	4	52	32	1	48	0.0208333
NODE_2067_length_1579_cov_6.741892	4	52	40	1	48	0.0208333
NODE_2067_length_1579_cov_6.741892	4	52	42	1	48	0.0208333
NODE_2067_length_1579_cov_6.741892	4	52	50	4	48	0.0833333
NODE_2067_length_1579_cov_6.741892	4	52	61	2	48	0.0416667
NODE_2067_length_1579_cov_6.741892	4	52	63	1	48	0.0208333
NODE_2067_length_1579_cov_6.741892	4	52	67	10	48	0.2083333
NODE_2067_length_1579_cov_6.741892	4	52	75	2	48	0.0416667
NODE_2067_length_1579_cov_6.741892	4	52	81	4	48	0.0833333
NODE_2067_length_1579_cov_6.741892	4	52	83	1	48	0.0208333
NODE_2067_length_1579_cov_6.741892	4	52	87	3	48	0.0625000
NODE_2067_length_1579_cov_6.741892	4	52	93	2	48	0.0416667
NODE_2067_length_1579_cov_6.741892	4	52	101	3	48	0.0625000
NODE_2067_length_1579_cov_6.741892	4	52	103	1	48	0.0208333
NODE_2067_length_1579_cov_6.741892	4	52	109	7	48	0.1458333
NODE_2067_length_1579_cov_6.741892	4	52	14	3	48	0.0625000
NODE_2067_length_1579_cov_6.741892	4	52	23	1	48	0.0208333
NODE_2067_length_1579_cov_6.741892	4	52	28	1	48	0.0208333
NODE_2067_length_1579_cov_6.741892	4	52	32	1	48	0.0208333
NODE_2067_length_1579_cov_6.741892	4	52	40	1	48	0.0208333
NODE_2067_length_1579_cov_6.741892	4	52	42	1	48	0.0208333
NODE_2067_length_1579_cov_6.741892	4	52	50	4	48	0.0833333
NODE_2067_length_1579_cov_6.741892	4	52	61	2	48	0.0416667
NODE_2067_length_1579_cov_6.741892	4	52	63	1	48	0.0208333
NODE_2067_length_1579_cov_6.741892	4	52	67	10	48	0.2083333
NODE_2067_length_1579_cov_6.741892	4	52	75	2	48	0.0416667
NODE_2067_length_1579_cov_6.741892	4	52	81	4	48	0.0833333
NODE_2067_length_1579_cov_6.741892	4	52	83	1	48	0.0208333
NODE_2067_length_1579_cov_6.741892	4	52	87	3	48	0.0625000
NODE_2067_length_1579_cov_6.741892	4	52	93	2	48	0.0416667
NODE_2067_length_1579_cov_6.741892	4	52	101	3	48	0.0625000
NODE_2067_length_1579_cov_6.741892	4	52	103	1	48	0.0208333
NODE_2067_length_1579_cov_6.741892	4	52	109	7	48	0.1458333
NODE_2067_length_1579_cov_6.741892	25	105	67	4	80	0.0500000
NODE_2067_length_1579_cov_6.741892	25	105	75	2	80	0.0250000
NODE_2067_length_1579_cov_6.741892	25	105	81	4	80	0.0500000
NODE_2067_length_1579_cov_6.741892	25	105	83	1	80	0.0125000
NODE_2067_length_1579_cov_6.741892	25	105	87	3	80	0.0375000
NODE_2067_length_1579_cov_6.741892	25	105	93	2	80	0.0250000
NODE_2067_length_1579_cov_6.741892	25	105	101	3	80	0.0375000
NODE_2067_length_1579_cov_6.741892	25	105	103	1	80	0.0125000
NODE_2067_length_1579_cov_6.741892	25	105	109	7	80	0.0875000
NODE_2067_length_1579_cov_6.741892	25	105	114	1	80	0.0125000
NODE_2067_length_1579_cov_6.741892	25	105	116	1	80	0.0125000
NODE_2067_length_1579_cov_6.741892	25	105	117	1	80	0.0125000
NODE_2067_length_1579_cov_6.741892	25	105	118	3	80	0.0375000
NODE_2067_length_1579_cov_6.741892	25	105	119	1	80	0.0125000
NODE_2067_length_1579_cov_6.741892	25	105	121	7	80	0.0875000
NODE_2067_length_1579_cov_6.741892	25	105	125	10	80	0.1250000
NODE_2067_length_1579_cov_6.741892	25	105	140	2	80	0.0250000
NODE_2067_length_1579_cov_6.741892	25	105	142	27	80	0.3375000
NODE_2067_length_1579_cov_6.741892	25	91	67	4	66	0.0606061
NODE_2067_length_1579_cov_6.741892	25	91	75	2	66	0.0303030
NODE_2067_length_1579_cov_6.741892	25	91	81	4	66	0.0606061
NODE_2067_length_1579_cov_6.741892	25	91	83	1	66	0.0151515
NODE_2067_length_1579_cov_6.741892	25	91	87	3	66	0.0454545
NODE_2067_length_1579_cov_6.741892	25	91	93	2	66	0.0303030
NODE_2067_length_1579_cov_6.741892	25	91	101	3	66	0.0454545
NODE_2067_length_1579_cov_6.741892	25	91	103	1	66	0.0151515
NODE_2067_length_1579_cov_6.741892	25	91	109	7	66	0.1060606
NODE_2067_length_1579_cov_6.741892	25	91	114	1	66	0.0151515
NODE_2067_length_1579_cov_6.741892	25	91	116	1	66	0.0151515
NODE_2067_length_1579_cov_6.741892	25	91	117	1	66	0.0151515
NODE_2067_length_1579_cov_6.741892	25	91	118	3	66	0.0454545
NODE_2067_length_1579_cov_6.741892	25	91	119	1	66	0.0151515
NODE_2067_length_1579_cov_6.741892	25	91	121	7	66	0.1060606
NODE_2067_length_1579_cov_6.741892	25	91	125	10	66	0.1515152
NODE_2067_length_1579_cov_6.741892	25	91	140	2	66	0.0303030
NODE_2067_length_1579_cov_6.741892	25	91	142	13	66	0.1969697
NODE_2067_length_1579_cov_6.741892	25	96	67	4	71	0.0563380
NODE_2067_length_1579_cov_6.741892	25	96	75	2	71	0.0281690
NODE_2067_length_1579_cov_6.741892	25	96	81	4	71	0.0563380
NODE_2067_length_1579_cov_6.741892	25	96	83	1	71	0.0140845
NODE_2067_length_1579_cov_6.741892	25	96	87	3	71	0.0422535
NODE_2067_length_1579_cov_6.741892	25	96	93	2	71	0.0281690
NODE_2067_length_1579_cov_6.741892	25	96	101	3	71	0.0422535
NODE_2067_length_1579_cov_6.741892	25	96	103	1	71	0.0140845
NODE_2067_length_1579_cov_6.741892	25	96	109	7	71	0.0985916
NODE_2067_length_1579_cov_6.741892	25	96	114	1	71	0.0140845
NODE_2067_length_1579_cov_6.741892	25	96	116	1	71	0.0140845
NODE_2067_length_1579_cov_6.741892	25	96	117	1	71	0.0140845
NODE_2067_length_1579_cov_6.741892	25	96	118	3	71	0.0422535
NODE_2067_length_1579_cov_6.741892	25	96	119	1	71	0.0140845
NODE_2067_length_1579_cov_6.741892	25	96	121	7	71	0.0985916
NODE_2067_length_1579_cov_6.741892	25	96	125	10	71	0.1408451
NODE_2067_length_1579_cov_6.741892	25	96	140	2	71	0.0281690
NODE_2067_length_1579_cov_6.741892	25	96	142	18	71	0.2535211
NODE_2076_length_1575_cov_4.250000	993	1073	0	80	80	1.0000000
NODE_2076_length_1575_cov_4.250000	1046	1126	0	80	80	1.0000000
NODE_2078_length_1574_cov_40.682034	551	631	2	32	80	0.4000000
NODE_2078_length_1574_cov_40.682034	551	631	3	3	80	0.0375000
NODE_2078_length_1574_cov_40.682034	551	631	4	45	80	0.5625000
NODE_2078_length_1574_cov_40.682034	604	684	2	17	80	0.2125000
NODE_2078_length_1574_cov_40.682034	604	684	3	56	80	0.7000000
NODE_2078_length_1574_cov_40.682034	604	684	4	7	80	0.0875000
NODE_2078_length_1574_cov_40.682034	680	760	1	2	80	0.0250000
NODE_2078_length_1574_cov_40.682034	680	760	3	36	80	0.4500000
NODE_2078_length_1574_cov_40.682034	680	760	7	12	80	0.1500000
NODE_2078_length_1574_cov_40.682034	680	760	8	30	80	0.3750000
NODE_2078_length_1574_cov_40.682034	733	813	7	35	80	0.4375000
NODE_2078_length_1574_cov_40.682034	733	813	8	45	80	0.5625000
NODE_2079_length_1574_cov_7.572203	1306	1386	4	80	80	1.0000000
NODE_2079_length_1574_cov_7.572203	1359	1439	0	50	80	0.6250000
NODE_2079_length_1574_cov_7.572203	1359	1439	4	30	80	0.3750000
NODE_2081_length_1573_cov_16.107191	437	512	0	75	75	1.0000000
NODE_2081_length_1573_cov_16.107191	485	565	0	80	80	1.0000000
NODE_2081_length_1573_cov_16.107191	561	639	0	78	78	1.0000000
NODE_2081_length_1573_cov_16.107191	612	692	0	80	80	1.0000000
NODE_2085_length_1572_cov_25.966735	359	404	229	2	45	0.0444444
NODE_2085_length_1572_cov_25.966735	359	404	234	3	45	0.0666667
NODE_2085_length_1572_cov_25.966735	359	404	237	3	45	0.0666667
NODE_2085_length_1572_cov_25.966735	359	404	240	1	45	0.0222222
NODE_2085_length_1572_cov_25.966735	359	404	241	2	45	0.0444444
NODE_2085_length_1572_cov_25.966735	359	404	243	1	45	0.0222222
NODE_2085_length_1572_cov_25.966735	359	404	257	1	45	0.0222222
NODE_2085_length_1572_cov_25.966735	359	404	261	1	45	0.0222222
NODE_2085_length_1572_cov_25.966735	359	404	266	1	45	0.0222222
NODE_2085_length_1572_cov_25.966735	359	404	276	2	45	0.0444444
NODE_2085_length_1572_cov_25.966735	359	404	281	1	45	0.0222222
NODE_2085_length_1572_cov_25.966735	359	404	283	1	45	0.0222222
NODE_2085_length_1572_cov_25.966735	359	404	285	1	45	0.0222222
NODE_2085_length_1572_cov_25.966735	359	404	292	1	45	0.0222222
NODE_2085_length_1572_cov_25.966735	359	404	296	1	45	0.0222222
NODE_2085_length_1572_cov_25.966735	359	404	301	2	45	0.0444444
NODE_2085_length_1572_cov_25.966735	359	404	303	1	45	0.0222222
NODE_2085_length_1572_cov_25.966735	359	404	306	1	45	0.0222222
NODE_2085_length_1572_cov_25.966735	359	404	308	1	45	0.0222222
NODE_2085_length_1572_cov_25.966735	359	404	312	1	45	0.0222222
NODE_2085_length_1572_cov_25.966735	359	404	313	2	45	0.0444444
NODE_2085_length_1572_cov_25.966735	359	404	315	1	45	0.0222222
NODE_2085_length_1572_cov_25.966735	359	404	316	1	45	0.0222222
NODE_2085_length_1572_cov_25.966735	359	404	317	1	45	0.0222222
NODE_2085_length_1572_cov_25.966735	359	404	324	2	45	0.0444444
NODE_2085_length_1572_cov_25.966735	359	404	326	1	45	0.0222222
NODE_2085_length_1572_cov_25.966735	359	404	328	1	45	0.0222222
NODE_2085_length_1572_cov_25.966735	359	404	330	1	45	0.0222222
NODE_2085_length_1572_cov_25.966735	359	404	336	1	45	0.0222222
NODE_2085_length_1572_cov_25.966735	359	404	346	1	45	0.0222222
NODE_2085_length_1572_cov_25.966735	359	404	352	1	45	0.0222222
NODE_2085_length_1572_cov_25.966735	359	404	360	1	45	0.0222222
NODE_2085_length_1572_cov_25.966735	359	404	371	1	45	0.0222222
NODE_2085_length_1572_cov_25.966735	359	404	381	1	45	0.0222222
NODE_2085_length_1572_cov_25.966735	359	404	383	1	45	0.0222222
NODE_2085_length_1572_cov_25.966735	405	477	165	2	72	0.0277778
NODE_2085_length_1572_cov_25.966735	405	477	169	6	72	0.0833333
NODE_2085_length_1572_cov_25.966735	405	477	171	1	72	0.0138889
NODE_2085_length_1572_cov_25.966735	405	477	172	1	72	0.0138889
NODE_2085_length_1572_cov_25.966735	405	477	173	1	72	0.0138889
NODE_2085_length_1572_cov_25.966735	405	477	175	1	72	0.0138889
NODE_2085_length_1572_cov_25.966735	405	477	176	1	72	0.0138889
NODE_2085_length_1572_cov_25.966735	405	477	178	1	72	0.0138889
NODE_2085_length_1572_cov_25.966735	405	477	181	1	72	0.0138889
NODE_2085_length_1572_cov_25.966735	405	477	182	1	72	0.0138889
NODE_2085_length_1572_cov_25.966735	405	477	184	3	72	0.0416667
NODE_2085_length_1572_cov_25.966735	405	477	186	3	72	0.0416667
NODE_2085_length_1572_cov_25.966735	405	477	187	3	72	0.0416667
NODE_2085_length_1572_cov_25.966735	405	477	188	7	72	0.0972222
NODE_2085_length_1572_cov_25.966735	405	477	189	1	72	0.0138889
NODE_2085_length_1572_cov_25.966735	405	477	190	4	72	0.0555556
NODE_2085_length_1572_cov_25.966735	405	477	191	1	72	0.0138889
NODE_2085_length_1572_cov_25.966735	405	477	192	1	72	0.0138889
NODE_2085_length_1572_cov_25.966735	405	477	193	1	72	0.0138889
NODE_2085_length_1572_cov_25.966735	405	477	194	1	72	0.0138889
NODE_2085_length_1572_cov_25.966735	405	477	195	1	72	0.0138889
NODE_2085_length_1572_cov_25.966735	405	477	196	3	72	0.0416667
NODE_2085_length_1572_cov_25.966735	405	477	197	1	72	0.0138889
NODE_2085_length_1572_cov_25.966735	405	477	198	1	72	0.0138889
NODE_2085_length_1572_cov_25.966735	405	477	200	1	72	0.0138889
NODE_2085_length_1572_cov_25.966735	405	477	202	1	72	0.0138889
NODE_2085_length_1572_cov_25.966735	405	477	206	2	72	0.0277778
NODE_2085_length_1572_cov_25.966735	405	477	208	1	72	0.0138889
NODE_2085_length_1572_cov_25.966735	405	477	212	1	72	0.0138889
NODE_2085_length_1572_cov_25.966735	405	477	214	1	72	0.0138889
NODE_2085_length_1572_cov_25.966735	405	477	216	1	72	0.0138889
NODE_2085_length_1572_cov_25.966735	405	477	218	1	72	0.0138889
NODE_2085_length_1572_cov_25.966735	405	477	220	1	72	0.0138889
NODE_2085_length_1572_cov_25.966735	405	477	221	3	72	0.0416667
NODE_2085_length_1572_cov_25.966735	405	477	222	2	72	0.0277778
NODE_2085_length_1572_cov_25.966735	405	477	223	3	72	0.0416667
NODE_2085_length_1572_cov_25.966735	405	477	224	4	72	0.0555556
NODE_2085_length_1572_cov_25.966735	405	477	225	1	72	0.0138889
NODE_2085_length_1572_cov_25.966735	405	477	227	2	72	0.0277778
NODE_2085_length_1572_cov_25.966735	1016	1096	0	80	80	1.0000000
NODE_2085_length_1572_cov_25.966735	1069	1149	0	80	80	1.0000000
NODE_2086_length_1572_cov_3.513238	1386	1462	2	19	76	0.2500000
NODE_2086_length_1572_cov_3.513238	1386	1462	4	13	76	0.1710526
NODE_2086_length_1572_cov_3.513238	1386	1462	6	5	76	0.0657895
NODE_2086_length_1572_cov_3.513238	1386	1462	8	5	76	0.0657895
NODE_2086_length_1572_cov_3.513238	1386	1462	10	34	76	0.4473684
NODE_2090_length_1570_cov_21.745071	700	780	0	19	80	0.2375000
NODE_2090_length_1570_cov_21.745071	700	780	3	2	80	0.0250000
NODE_2090_length_1570_cov_21.745071	700	780	5	17	80	0.2125000
NODE_2090_length_1570_cov_21.745071	700	780	6	5	80	0.0625000
NODE_2090_length_1570_cov_21.745071	700	780	10	22	80	0.2750000
NODE_2090_length_1570_cov_21.745071	700	780	12	15	80	0.1875000
NODE_2090_length_1570_cov_21.745071	753	833	8	22	80	0.2750000
NODE_2090_length_1570_cov_21.745071	753	833	10	12	80	0.1500000
NODE_2090_length_1570_cov_21.745071	753	833	12	46	80	0.5750000
NODE_2091_length_1570_cov_3.276003	387	467	0	80	80	1.0000000
NODE_2091_length_1570_cov_3.276003	440	520	0	44	80	0.5500000
NODE_2091_length_1570_cov_3.276003	440	520	2	36	80	0.4500000
NODE_2093_length_1569_cov_53.941497	741	821	0	80	80	1.0000000
NODE_2093_length_1569_cov_53.941497	794	874	0	80	80	1.0000000
NODE_2093_length_1569_cov_53.941497	870	950	0	80	80	1.0000000
NODE_2093_length_1569_cov_53.941497	923	1003	0	80	80	1.0000000
NODE_2094_length_1569_cov_12.426531	640	720	0	80	80	1.0000000
NODE_2094_length_1569_cov_12.426531	693	773	0	80	80	1.0000000
NODE_2094_length_1569_cov_12.426531	769	849	0	80	80	1.0000000
NODE_2094_length_1569_cov_12.426531	822	902	0	80	80	1.0000000
NODE_2095_length_1569_cov_12.365986	450	530	0	26	80	0.3250000
NODE_2095_length_1569_cov_12.365986	450	530	2	23	80	0.2875000
NODE_2095_length_1569_cov_12.365986	450	530	4	4	80	0.0500000
NODE_2095_length_1569_cov_12.365986	450	530	6	27	80	0.3375000
NODE_2095_length_1569_cov_12.365986	450	530	0	26	80	0.3250000
NODE_2095_length_1569_cov_12.365986	450	530	2	23	80	0.2875000
NODE_2095_length_1569_cov_12.365986	450	530	4	4	80	0.0500000
NODE_2095_length_1569_cov_12.365986	450	530	6	27	80	0.3375000
NODE_2095_length_1569_cov_12.365986	503	564	6	61	61	1.0000000
NODE_2095_length_1569_cov_12.365986	503	556	6	53	53	1.0000000
NODE_2096_length_1569_cov_11.599320	798	878	0	80	80	1.0000000
NODE_2096_length_1569_cov_11.599320	851	931	0	80	80	1.0000000
NODE_2097_length_1569_cov_10.917687	521	601	0	80	80	1.0000000
NODE_2097_length_1569_cov_10.917687	574	654	0	80	80	1.0000000
NODE_2108_length_1563_cov_15.357240	590	670	0	80	80	1.0000000
NODE_2108_length_1563_cov_15.357240	643	723	0	80	80	1.0000000
NODE_2110_length_1561_cov_18.420657	354	434	0	80	80	1.0000000
NODE_2110_length_1561_cov_18.420657	407	487	0	33	80	0.4125000
NODE_2110_length_1561_cov_18.420657	407	487	2	47	80	0.5875000
NODE_2110_length_1561_cov_18.420657	483	563	0	39	80	0.4875000
NODE_2110_length_1561_cov_18.420657	483	563	2	41	80	0.5125000
NODE_2110_length_1561_cov_18.420657	536	616	0	80	80	1.0000000
NODE_2116_length_1559_cov_7.071233	347	427	2	49	80	0.6125000
NODE_2116_length_1559_cov_7.071233	347	427	4	31	80	0.3875000
NODE_2116_length_1559_cov_7.071233	400	478	0	9	78	0.1153846
NODE_2116_length_1559_cov_7.071233	400	478	2	66	78	0.8461539
NODE_2116_length_1559_cov_7.071233	400	478	4	3	78	0.0384615
NODE_2116_length_1559_cov_7.071233	1187	1238	0	51	51	1.0000000
NODE_2118_length_1558_cov_3.486635	338	418	0	80	80	1.0000000
NODE_2118_length_1558_cov_3.486635	391	471	0	48	80	0.6000000
NODE_2118_length_1558_cov_3.486635	391	471	2	32	80	0.4000000
NODE_2119_length_1557_cov_17.089163	542	622	0	42	80	0.5250000
NODE_2119_length_1557_cov_17.089163	542	622	2	19	80	0.2375000
NODE_2119_length_1557_cov_17.089163	542	622	4	19	80	0.2375000
NODE_2119_length_1557_cov_17.089163	595	675	2	8	80	0.1000000
NODE_2119_length_1557_cov_17.089163	595	675	4	72	80	0.9000000
NODE_2120_length_1557_cov_4.639918	0	56	0	56	56	1.0000000
NODE_2120_length_1557_cov_4.639918	49	112	0	63	63	1.0000000
NODE_2120_length_1557_cov_4.639918	85	161	0	76	76	1.0000000
NODE_2123_length_1556_cov_23.289636	456	536	0	65	80	0.8125000
NODE_2123_length_1556_cov_23.289636	456	536	2	15	80	0.1875000
NODE_2123_length_1556_cov_23.289636	509	589	0	12	80	0.1500000
NODE_2123_length_1556_cov_23.289636	509	589	2	68	80	0.8500000
NODE_2123_length_1556_cov_23.289636	681	761	0	18	80	0.2250000
NODE_2123_length_1556_cov_23.289636	681	761	5	1	80	0.0125000
NODE_2123_length_1556_cov_23.289636	681	761	6	32	80	0.4000000
NODE_2123_length_1556_cov_23.289636	681	761	7	29	80	0.3625000
NODE_2123_length_1556_cov_23.289636	734	814	1	18	80	0.2250000
NODE_2123_length_1556_cov_23.289636	734	814	7	62	80	0.7750000
NODE_2123_length_1556_cov_23.289636	1445	1525	87	1	80	0.0125000
NODE_2123_length_1556_cov_23.289636	1445	1525	88	3	80	0.0375000
NODE_2123_length_1556_cov_23.289636	1445	1525	96	2	80	0.0250000
NODE_2123_length_1556_cov_23.289636	1445	1525	98	1	80	0.0125000
NODE_2123_length_1556_cov_23.289636	1445	1525	102	3	80	0.0375000
NODE_2123_length_1556_cov_23.289636	1445	1525	104	70	80	0.8750000
NODE_2124_length_1556_cov_7.494166	300	380	0	72	80	0.9000000
NODE_2124_length_1556_cov_7.494166	300	380	2	8	80	0.1000000
NODE_2124_length_1556_cov_7.494166	353	433	0	19	80	0.2375000
NODE_2124_length_1556_cov_7.494166	353	433	2	41	80	0.5125000
NODE_2124_length_1556_cov_7.494166	353	433	4	20	80	0.2500000
NODE_2126_length_1555_cov_13.461538	666	746	0	80	80	1.0000000
NODE_2126_length_1555_cov_13.461538	719	799	0	80	80	1.0000000
NODE_2127_length_1554_cov_30.239175	144	226	2	65	82	0.7926829
NODE_2127_length_1554_cov_30.239175	144	226	6	1	82	0.0121951
NODE_2127_length_1554_cov_30.239175	144	226	7	2	82	0.0243902
NODE_2127_length_1554_cov_30.239175	144	226	9	6	82	0.0731707
NODE_2127_length_1554_cov_30.239175	144	226	10	2	82	0.0243902
NODE_2127_length_1554_cov_30.239175	144	226	11	6	82	0.0731707
NODE_2127_length_1554_cov_30.239175	199	279	2	10	80	0.1250000
NODE_2127_length_1554_cov_30.239175	199	279	6	1	80	0.0125000
NODE_2127_length_1554_cov_30.239175	199	279	7	2	80	0.0250000
NODE_2127_length_1554_cov_30.239175	199	279	9	6	80	0.0750000
NODE_2127_length_1554_cov_30.239175	199	279	10	2	80	0.0250000
NODE_2127_length_1554_cov_30.239175	199	279	11	7	80	0.0875000
NODE_2127_length_1554_cov_30.239175	199	279	13	1	80	0.0125000
NODE_2127_length_1554_cov_30.239175	199	279	15	5	80	0.0625000
NODE_2127_length_1554_cov_30.239175	199	279	19	5	80	0.0625000
NODE_2127_length_1554_cov_30.239175	199	279	20	5	80	0.0625000
NODE_2127_length_1554_cov_30.239175	199	279	24	3	80	0.0375000
NODE_2127_length_1554_cov_30.239175	199	279	25	1	80	0.0125000
NODE_2127_length_1554_cov_30.239175	199	279	26	1	80	0.0125000
NODE_2127_length_1554_cov_30.239175	199	279	28	5	80	0.0625000
NODE_2127_length_1554_cov_30.239175	199	279	30	5	80	0.0625000
NODE_2127_length_1554_cov_30.239175	199	279	31	1	80	0.0125000
NODE_2127_length_1554_cov_30.239175	199	279	33	2	80	0.0250000
NODE_2127_length_1554_cov_30.239175	199	279	35	1	80	0.0125000
NODE_2127_length_1554_cov_30.239175	199	279	39	1	80	0.0125000
NODE_2127_length_1554_cov_30.239175	199	279	41	1	80	0.0125000
NODE_2127_length_1554_cov_30.239175	199	279	43	2	80	0.0250000
NODE_2127_length_1554_cov_30.239175	199	279	45	1	80	0.0125000
NODE_2127_length_1554_cov_30.239175	199	279	47	2	80	0.0250000
NODE_2127_length_1554_cov_30.239175	199	279	51	10	80	0.1250000
NODE_2127_length_1554_cov_30.239175	877	903	0	26	26	1.0000000
NODE_2127_length_1554_cov_30.239175	930	1010	0	74	80	0.9250000
NODE_2127_length_1554_cov_30.239175	930	1010	2	6	80	0.0750000
NODE_2127_length_1554_cov_30.239175	983	1063	0	21	80	0.2625000
NODE_2127_length_1554_cov_30.239175	983	1063	2	59	80	0.7375000
NODE_2128_length_1554_cov_5.381443	1494	1554	8	1	60	0.0166667
NODE_2128_length_1554_cov_5.381443	1494	1554	12	3	60	0.0500000
NODE_2128_length_1554_cov_5.381443	1494	1554	18	1	60	0.0166667
NODE_2128_length_1554_cov_5.381443	1494	1554	24	2	60	0.0333333
NODE_2128_length_1554_cov_5.381443	1494	1554	28	7	60	0.1166667
NODE_2128_length_1554_cov_5.381443	1494	1554	34	46	60	0.7666667
NODE_2132_length_1552_cov_11.367515	379	445	0	66	66	1.0000000
NODE_2132_length_1552_cov_11.367515	418	484	0	66	66	1.0000000
NODE_2138_length_1549_cov_15.480000	1288	1368	0	21	80	0.2625000
NODE_2138_length_1549_cov_15.480000	1288	1368	4	43	80	0.5375000
NODE_2138_length_1549_cov_15.480000	1288	1368	6	16	80	0.2000000
NODE_2138_length_1549_cov_15.480000	1341	1421	2	6	80	0.0750000
NODE_2138_length_1549_cov_15.480000	1341	1421	4	11	80	0.1375000
NODE_2138_length_1549_cov_15.480000	1341	1421	6	63	80	0.7875000
NODE_2142_length_1548_cov_12.789510	770	850	0	80	80	1.0000000
NODE_2142_length_1548_cov_12.789510	823	903	0	80	80	1.0000000
NODE_2149_length_1546_cov_24.069800	775	855	0	80	80	1.0000000
NODE_2149_length_1546_cov_24.069800	828	908	0	80	80	1.0000000
NODE_2150_length_1546_cov_10.911541	417	497	0	80	80	1.0000000
NODE_2150_length_1546_cov_10.911541	470	550	0	80	80	1.0000000
NODE_2150_length_1546_cov_10.911541	1065	1145	0	6	80	0.0750000
NODE_2150_length_1546_cov_10.911541	1065	1145	2	68	80	0.8500000
NODE_2150_length_1546_cov_10.911541	1065	1145	4	1	80	0.0125000
NODE_2150_length_1546_cov_10.911541	1065	1145	6	5	80	0.0625000
NODE_2150_length_1546_cov_10.911541	1118	1198	2	21	80	0.2625000
NODE_2150_length_1546_cov_10.911541	1118	1198	4	1	80	0.0125000
NODE_2150_length_1546_cov_10.911541	1118	1198	6	58	80	0.7250000
NODE_2155_length_1543_cov_10.400970	480	560	2	14	80	0.1750000
NODE_2155_length_1543_cov_10.400970	480	560	4	36	80	0.4500000
NODE_2155_length_1543_cov_10.400970	480	560	6	30	80	0.3750000
NODE_2155_length_1543_cov_10.400970	533	613	0	3	80	0.0375000
NODE_2155_length_1543_cov_10.400970	533	613	2	33	80	0.4125000
NODE_2155_length_1543_cov_10.400970	533	613	4	14	80	0.1750000
NODE_2155_length_1543_cov_10.400970	533	613	6	30	80	0.3750000
NODE_2156_length_1543_cov_4.532548	43	98	0	55	55	1.0000000
NODE_2162_length_1541_cov_7.316921	523	603	0	24	80	0.3000000
NODE_2162_length_1541_cov_7.316921	523	603	2	56	80	0.7000000
NODE_2162_length_1541_cov_7.316921	576	658	0	37	82	0.4512195
NODE_2162_length_1541_cov_7.316921	576	658	2	45	82	0.5487805
NODE_2165_length_1539_cov_19.067361	334	414	0	3	80	0.0375000
NODE_2165_length_1539_cov_19.067361	334	414	2	77	80	0.9625000
NODE_2165_length_1539_cov_19.067361	387	467	0	56	80	0.7000000
NODE_2165_length_1539_cov_19.067361	387	467	2	24	80	0.3000000
NODE_2165_length_1539_cov_19.067361	463	543	0	80	80	1.0000000
NODE_2165_length_1539_cov_19.067361	516	596	0	80	80	1.0000000
NODE_2171_length_1538_cov_68.273801	604	684	0	15	80	0.1875000
NODE_2171_length_1538_cov_68.273801	604	684	2	56	80	0.7000000
NODE_2171_length_1538_cov_68.273801	604	684	6	9	80	0.1125000
NODE_2171_length_1538_cov_68.273801	657	737	2	18	80	0.2250000
NODE_2171_length_1538_cov_68.273801	657	737	6	62	80	0.7750000
NODE_2172_length_1538_cov_2.402363	1456	1499	2	43	43	1.0000000
NODE_2173_length_1537_cov_39.413074	782	862	0	80	80	1.0000000
NODE_2173_length_1537_cov_39.413074	835	915	0	80	80	1.0000000
NODE_2173_length_1537_cov_39.413074	911	991	0	80	80	1.0000000
NODE_2173_length_1537_cov_39.413074	964	1044	0	39	80	0.4875000
NODE_2173_length_1537_cov_39.413074	964	1044	6	41	80	0.5125000
NODE_2174_length_1537_cov_30.412378	739	819	0	21	80	0.2625000
NODE_2174_length_1537_cov_30.412378	739	819	2	59	80	0.7375000
NODE_2174_length_1537_cov_30.412378	792	872	0	33	80	0.4125000
NODE_2174_length_1537_cov_30.412378	792	872	2	47	80	0.5875000
NODE_2174_length_1537_cov_30.412378	868	948	0	80	80	1.0000000
NODE_2174_length_1537_cov_30.412378	921	1001	0	80	80	1.0000000
NODE_2175_length_1537_cov_18.707232	669	749	2	1	80	0.0125000
NODE_2175_length_1537_cov_18.707232	669	749	10	1	80	0.0125000
NODE_2175_length_1537_cov_18.707232	669	749	11	7	80	0.0875000
NODE_2175_length_1537_cov_18.707232	669	749	12	65	80	0.8125000
NODE_2175_length_1537_cov_18.707232	669	749	13	3	80	0.0375000
NODE_2175_length_1537_cov_18.707232	669	749	14	3	80	0.0375000
NODE_2175_length_1537_cov_18.707232	722	802	2	54	80	0.6750000
NODE_2175_length_1537_cov_18.707232	722	802	10	1	80	0.0125000
NODE_2175_length_1537_cov_18.707232	722	802	11	7	80	0.0875000
NODE_2175_length_1537_cov_18.707232	722	802	12	18	80	0.2250000
NODE_2176_length_1536_cov_24.991649	832	912	0	80	80	1.0000000
NODE_2176_length_1536_cov_24.991649	885	965	0	80	80	1.0000000
NODE_2176_length_1536_cov_24.991649	961	1041	0	30	80	0.3750000
NODE_2176_length_1536_cov_24.991649	961	1041	14	50	80	0.6250000
NODE_2176_length_1536_cov_24.991649	1014	1094	14	80	80	1.0000000
NODE_2183_length_1535_cov_46.662256	992	1072	2	40	80	0.5000000
NODE_2183_length_1535_cov_46.662256	992	1072	4	23	80	0.2875000
NODE_2183_length_1535_cov_46.662256	992	1072	6	17	80	0.2125000
NODE_2183_length_1535_cov_46.662256	1045	1125	0	20	80	0.2500000
NODE_2183_length_1535_cov_46.662256	1045	1125	4	56	80	0.7000000
NODE_2183_length_1535_cov_46.662256	1045	1125	6	4	80	0.0500000
NODE_2183_length_1535_cov_46.662256	1127	1203	0	76	76	1.0000000
NODE_2183_length_1535_cov_46.662256	1176	1256	0	80	80	1.0000000
NODE_2184_length_1535_cov_32.610724	992	1072	0	80	80	1.0000000
NODE_2184_length_1535_cov_32.610724	1045	1125	0	80	80	1.0000000
NODE_2184_length_1535_cov_32.610724	1121	1201	0	80	80	1.0000000
NODE_2184_length_1535_cov_32.610724	1174	1254	0	80	80	1.0000000
NODE_2185_length_1535_cov_25.406685	619	699	2	13	80	0.1625000
NODE_2185_length_1535_cov_25.406685	619	699	4	7	80	0.0875000
NODE_2185_length_1535_cov_25.406685	619	699	5	6	80	0.0750000
NODE_2185_length_1535_cov_25.406685	619	699	8	29	80	0.3625000
NODE_2185_length_1535_cov_25.406685	619	699	10	5	80	0.0625000
NODE_2185_length_1535_cov_25.406685	619	699	14	20	80	0.2500000
NODE_2185_length_1535_cov_25.406685	672	752	8	2	80	0.0250000
NODE_2185_length_1535_cov_25.406685	672	752	10	5	80	0.0625000
NODE_2185_length_1535_cov_25.406685	672	752	14	42	80	0.5250000
NODE_2185_length_1535_cov_25.406685	672	752	16	11	80	0.1375000
NODE_2185_length_1535_cov_25.406685	672	752	17	1	80	0.0125000
NODE_2185_length_1535_cov_25.406685	672	752	18	1	80	0.0125000
NODE_2185_length_1535_cov_25.406685	672	752	20	18	80	0.2250000
NODE_2190_length_1534_cov_13.542857	439	519	0	80	80	1.0000000
NODE_2190_length_1534_cov_13.542857	492	567	0	75	75	1.0000000
NODE_2197_length_1531_cov_17.336592	324	404	2	7	80	0.0875000
NODE_2197_length_1531_cov_17.336592	324	404	8	55	80	0.6875000
NODE_2197_length_1531_cov_17.336592	324	404	10	18	80	0.2250000
NODE_2198_length_1531_cov_6.267458	606	686	0	72	80	0.9000000
NODE_2198_length_1531_cov_6.267458	606	686	1	7	80	0.0875000
NODE_2198_length_1531_cov_6.267458	606	686	2	1	80	0.0125000
NODE_2198_length_1531_cov_6.267458	659	739	0	19	80	0.2375000
NODE_2198_length_1531_cov_6.267458	659	739	1	7	80	0.0875000
NODE_2198_length_1531_cov_6.267458	659	739	2	16	80	0.2000000
NODE_2198_length_1531_cov_6.267458	659	739	4	2	80	0.0250000
NODE_2198_length_1531_cov_6.267458	659	739	8	36	80	0.4500000
NODE_2199_length_1530_cov_13.514326	323	403	2	33	80	0.4125000
NODE_2199_length_1530_cov_13.514326	323	403	6	13	80	0.1625000
NODE_2199_length_1530_cov_13.514326	323	403	8	34	80	0.4250000
NODE_2199_length_1530_cov_13.514326	376	456	0	26	80	0.3250000
NODE_2199_length_1530_cov_13.514326	376	456	6	40	80	0.5000000
NODE_2199_length_1530_cov_13.514326	376	456	8	14	80	0.1750000
NODE_2199_length_1530_cov_13.514326	1465	1513	0	48	48	1.0000000
NODE_2200_length_1530_cov_9.012579	637	717	3	8	80	0.1000000
NODE_2200_length_1530_cov_9.012579	637	717	4	46	80	0.5750000
NODE_2200_length_1530_cov_9.012579	637	717	7	26	80	0.3250000
NODE_2200_length_1530_cov_9.012579	690	770	0	3	80	0.0375000
NODE_2200_length_1530_cov_9.012579	690	770	2	2	80	0.0250000
NODE_2200_length_1530_cov_9.012579	690	770	3	1	80	0.0125000
NODE_2200_length_1530_cov_9.012579	690	770	7	74	80	0.9250000
NODE_2203_length_1529_cov_21.061538	983	1063	0	80	80	1.0000000
NODE_2203_length_1529_cov_21.061538	1036	1116	0	80	80	1.0000000
NODE_2205_length_1529_cov_1.380420	219	282	2	55	63	0.8730159
NODE_2205_length_1529_cov_1.380420	219	282	4	8	63	0.1269841
NODE_2205_length_1529_cov_1.380420	272	323	2	16	51	0.3137255
NODE_2205_length_1529_cov_1.380420	272	323	4	35	51	0.6862745
NODE_2206_length_1528_cov_8.578027	449	529	4	80	80	1.0000000
NODE_2206_length_1528_cov_8.578027	502	582	0	19	80	0.2375000
NODE_2206_length_1528_cov_8.578027	502	582	4	61	80	0.7625000
NODE_2210_length_1526_cov_92.265592	986	1066	0	31	80	0.3875000
NODE_2210_length_1526_cov_92.265592	986	1066	2	49	80	0.6125000
NODE_2210_length_1526_cov_92.265592	1039	1119	0	17	80	0.2125000
NODE_2210_length_1526_cov_92.265592	1039	1119	2	63	80	0.7875000
NODE_2211_length_1526_cov_4.051857	291	370	0	16	79	0.2025317
NODE_2211_length_1526_cov_4.051857	291	370	3	18	79	0.2278481
NODE_2211_length_1526_cov_4.051857	291	370	6	45	79	0.5696203
NODE_2213_length_1525_cov_20.232118	1014	1090	135	1	76	0.0131579
NODE_2213_length_1525_cov_20.232118	1014	1090	137	2	76	0.0263158
NODE_2213_length_1525_cov_20.232118	1014	1090	141	1	76	0.0131579
NODE_2213_length_1525_cov_20.232118	1014	1090	143	5	76	0.0657895
NODE_2213_length_1525_cov_20.232118	1014	1090	149	3	76	0.0394737
NODE_2213_length_1525_cov_20.232118	1014	1090	155	2	76	0.0263158
NODE_2213_length_1525_cov_20.232118	1014	1090	157	2	76	0.0263158
NODE_2213_length_1525_cov_20.232118	1014	1090	158	1	76	0.0131579
NODE_2213_length_1525_cov_20.232118	1014	1090	159	2	76	0.0263158
NODE_2213_length_1525_cov_20.232118	1014	1090	160	3	76	0.0394737
NODE_2213_length_1525_cov_20.232118	1014	1090	162	1	76	0.0131579
NODE_2213_length_1525_cov_20.232118	1014	1090	164	6	76	0.0789474
NODE_2213_length_1525_cov_20.232118	1014	1090	166	1	76	0.0131579
NODE_2213_length_1525_cov_20.232118	1014	1090	168	1	76	0.0131579
NODE_2213_length_1525_cov_20.232118	1014	1090	169	1	76	0.0131579
NODE_2213_length_1525_cov_20.232118	1014	1090	170	3	76	0.0394737
NODE_2213_length_1525_cov_20.232118	1014	1090	171	1	76	0.0131579
NODE_2213_length_1525_cov_20.232118	1014	1090	172	4	76	0.0526316
NODE_2213_length_1525_cov_20.232118	1014	1090	173	1	76	0.0131579
NODE_2213_length_1525_cov_20.232118	1014	1090	174	1	76	0.0131579
NODE_2213_length_1525_cov_20.232118	1014	1090	175	2	76	0.0263158
NODE_2213_length_1525_cov_20.232118	1014	1090	176	5	76	0.0657895
NODE_2213_length_1525_cov_20.232118	1014	1090	177	2	76	0.0263158
NODE_2213_length_1525_cov_20.232118	1014	1090	179	1	76	0.0131579
NODE_2213_length_1525_cov_20.232118	1014	1090	180	1	76	0.0131579
NODE_2213_length_1525_cov_20.232118	1014	1090	181	1	76	0.0131579
NODE_2213_length_1525_cov_20.232118	1014	1090	183	5	76	0.0657895
NODE_2213_length_1525_cov_20.232118	1014	1090	184	3	76	0.0394737
NODE_2213_length_1525_cov_20.232118	1014	1090	185	5	76	0.0657895
NODE_2213_length_1525_cov_20.232118	1014	1090	186	2	76	0.0263158
NODE_2213_length_1525_cov_20.232118	1014	1090	187	3	76	0.0394737
NODE_2213_length_1525_cov_20.232118	1014	1090	189	1	76	0.0131579
NODE_2213_length_1525_cov_20.232118	1014	1090	190	1	76	0.0131579
NODE_2213_length_1525_cov_20.232118	1014	1090	192	2	76	0.0263158
NODE_2213_length_1525_cov_20.232118	1281	1338	0	57	57	1.0000000
NODE_2214_length_1525_cov_11.421459	804	884	0	80	80	1.0000000
NODE_2214_length_1525_cov_11.421459	857	937	0	80	80	1.0000000
NODE_2217_length_1524_cov_130.874386	171	243	434	1	72	0.0138889
NODE_2217_length_1524_cov_130.874386	171	243	441	1	72	0.0138889
NODE_2217_length_1524_cov_130.874386	171	243	449	1	72	0.0138889
NODE_2217_length_1524_cov_130.874386	171	243	462	1	72	0.0138889
NODE_2217_length_1524_cov_130.874386	171	243	463	1	72	0.0138889
NODE_2217_length_1524_cov_130.874386	171	243	467	1	72	0.0138889
NODE_2217_length_1524_cov_130.874386	171	243	473	2	72	0.0277778
NODE_2217_length_1524_cov_130.874386	171	243	484	1	72	0.0138889
NODE_2217_length_1524_cov_130.874386	171	243	493	1	72	0.0138889
NODE_2217_length_1524_cov_130.874386	171	243	500	1	72	0.0138889
NODE_2217_length_1524_cov_130.874386	171	243	511	1	72	0.0138889
NODE_2217_length_1524_cov_130.874386	171	243	519	1	72	0.0138889
NODE_2217_length_1524_cov_130.874386	171	243	528	1	72	0.0138889
NODE_2217_length_1524_cov_130.874386	171	243	534	1	72	0.0138889
NODE_2217_length_1524_cov_130.874386	171	243	535	1	72	0.0138889
NODE_2217_length_1524_cov_130.874386	171	243	549	1	72	0.0138889
NODE_2217_length_1524_cov_130.874386	171	243	550	1	72	0.0138889
NODE_2217_length_1524_cov_130.874386	171	243	555	1	72	0.0138889
NODE_2217_length_1524_cov_130.874386	171	243	559	1	72	0.0138889
NODE_2217_length_1524_cov_130.874386	171	243	567	1	72	0.0138889
NODE_2217_length_1524_cov_130.874386	171	243	583	1	72	0.0138889
NODE_2217_length_1524_cov_130.874386	171	243	594	1	72	0.0138889
NODE_2217_length_1524_cov_130.874386	171	243	615	1	72	0.0138889
NODE_2217_length_1524_cov_130.874386	171	243	622	1	72	0.0138889
NODE_2217_length_1524_cov_130.874386	171	243	629	1	72	0.0138889
NODE_2217_length_1524_cov_130.874386	171	243	633	1	72	0.0138889
NODE_2217_length_1524_cov_130.874386	171	243	643	1	72	0.0138889
NODE_2217_length_1524_cov_130.874386	171	243	645	1	72	0.0138889
NODE_2217_length_1524_cov_130.874386	171	243	648	1	72	0.0138889
NODE_2217_length_1524_cov_130.874386	171	243	649	1	72	0.0138889
NODE_2217_length_1524_cov_130.874386	171	243	657	2	72	0.0277778
NODE_2217_length_1524_cov_130.874386	171	243	659	1	72	0.0138889
NODE_2217_length_1524_cov_130.874386	171	243	663	1	72	0.0138889
NODE_2217_length_1524_cov_130.874386	171	243	664	1	72	0.0138889
NODE_2217_length_1524_cov_130.874386	171	243	665	1	72	0.0138889
NODE_2217_length_1524_cov_130.874386	171	243	667	1	72	0.0138889
NODE_2217_length_1524_cov_130.874386	171	243	676	4	72	0.0555556
NODE_2217_length_1524_cov_130.874386	171	243	680	1	72	0.0138889
NODE_2217_length_1524_cov_130.874386	171	243	681	1	72	0.0138889
NODE_2217_length_1524_cov_130.874386	171	243	682	2	72	0.0277778
NODE_2217_length_1524_cov_130.874386	171	243	685	1	72	0.0138889
NODE_2217_length_1524_cov_130.874386	171	243	688	1	72	0.0138889
NODE_2217_length_1524_cov_130.874386	171	243	693	3	72	0.0416667
NODE_2217_length_1524_cov_130.874386	171	243	695	1	72	0.0138889
NODE_2217_length_1524_cov_130.874386	171	243	696	1	72	0.0138889
NODE_2217_length_1524_cov_130.874386	171	243	697	1	72	0.0138889
NODE_2217_length_1524_cov_130.874386	171	243	699	1	72	0.0138889
NODE_2217_length_1524_cov_130.874386	171	243	701	1	72	0.0138889
NODE_2217_length_1524_cov_130.874386	171	243	703	1	72	0.0138889
NODE_2217_length_1524_cov_130.874386	171	243	704	2	72	0.0277778
NODE_2217_length_1524_cov_130.874386	171	243	705	1	72	0.0138889
NODE_2217_length_1524_cov_130.874386	171	243	706	2	72	0.0277778
NODE_2217_length_1524_cov_130.874386	171	243	707	1	72	0.0138889
NODE_2217_length_1524_cov_130.874386	171	243	708	1	72	0.0138889
NODE_2217_length_1524_cov_130.874386	171	243	710	1	72	0.0138889
NODE_2217_length_1524_cov_130.874386	171	243	711	1	72	0.0138889
NODE_2217_length_1524_cov_130.874386	171	243	717	1	72	0.0138889
NODE_2217_length_1524_cov_130.874386	171	243	721	1	72	0.0138889
NODE_2217_length_1524_cov_130.874386	171	243	722	2	72	0.0277778
NODE_2217_length_1524_cov_130.874386	171	243	723	1	72	0.0138889
NODE_2217_length_1524_cov_130.874386	171	243	724	1	72	0.0138889
NODE_2217_length_1524_cov_130.874386	191	247	567	1	56	0.0178571
NODE_2217_length_1524_cov_130.874386	191	247	583	1	56	0.0178571
NODE_2217_length_1524_cov_130.874386	191	247	594	1	56	0.0178571
NODE_2217_length_1524_cov_130.874386	191	247	615	1	56	0.0178571
NODE_2217_length_1524_cov_130.874386	191	247	622	1	56	0.0178571
NODE_2217_length_1524_cov_130.874386	191	247	626	1	56	0.0178571
NODE_2217_length_1524_cov_130.874386	191	247	629	1	56	0.0178571
NODE_2217_length_1524_cov_130.874386	191	247	633	1	56	0.0178571
NODE_2217_length_1524_cov_130.874386	191	247	638	1	56	0.0178571
NODE_2217_length_1524_cov_130.874386	191	247	639	1	56	0.0178571
NODE_2217_length_1524_cov_130.874386	191	247	643	2	56	0.0357143
NODE_2217_length_1524_cov_130.874386	191	247	645	1	56	0.0178571
NODE_2217_length_1524_cov_130.874386	191	247	648	1	56	0.0178571
NODE_2217_length_1524_cov_130.874386	191	247	649	1	56	0.0178571
NODE_2217_length_1524_cov_130.874386	191	247	657	2	56	0.0357143
NODE_2217_length_1524_cov_130.874386	191	247	659	1	56	0.0178571
NODE_2217_length_1524_cov_130.874386	191	247	663	1	56	0.0178571
NODE_2217_length_1524_cov_130.874386	191	247	664	1	56	0.0178571
NODE_2217_length_1524_cov_130.874386	191	247	665	1	56	0.0178571
NODE_2217_length_1524_cov_130.874386	191	247	667	1	56	0.0178571
NODE_2217_length_1524_cov_130.874386	191	247	676	4	56	0.0714286
NODE_2217_length_1524_cov_130.874386	191	247	680	1	56	0.0178571
NODE_2217_length_1524_cov_130.874386	191	247	681	1	56	0.0178571
NODE_2217_length_1524_cov_130.874386	191	247	682	2	56	0.0357143
NODE_2217_length_1524_cov_130.874386	191	247	685	1	56	0.0178571
NODE_2217_length_1524_cov_130.874386	191	247	688	1	56	0.0178571
NODE_2217_length_1524_cov_130.874386	191	247	693	3	56	0.0535714
NODE_2217_length_1524_cov_130.874386	191	247	695	1	56	0.0178571
NODE_2217_length_1524_cov_130.874386	191	247	696	1	56	0.0178571
NODE_2217_length_1524_cov_130.874386	191	247	697	1	56	0.0178571
NODE_2217_length_1524_cov_130.874386	191	247	699	1	56	0.0178571
NODE_2217_length_1524_cov_130.874386	191	247	701	1	56	0.0178571
NODE_2217_length_1524_cov_130.874386	191	247	703	1	56	0.0178571
NODE_2217_length_1524_cov_130.874386	191	247	704	2	56	0.0357143
NODE_2217_length_1524_cov_130.874386	191	247	705	1	56	0.0178571
NODE_2217_length_1524_cov_130.874386	191	247	706	2	56	0.0357143
NODE_2217_length_1524_cov_130.874386	191	247	707	1	56	0.0178571
NODE_2217_length_1524_cov_130.874386	191	247	708	1	56	0.0178571
NODE_2217_length_1524_cov_130.874386	191	247	710	1	56	0.0178571
NODE_2217_length_1524_cov_130.874386	191	247	711	1	56	0.0178571
NODE_2217_length_1524_cov_130.874386	191	247	717	1	56	0.0178571
NODE_2217_length_1524_cov_130.874386	191	247	721	1	56	0.0178571
NODE_2217_length_1524_cov_130.874386	191	247	722	2	56	0.0357143
NODE_2217_length_1524_cov_130.874386	191	247	723	1	56	0.0178571
NODE_2217_length_1524_cov_130.874386	191	247	724	1	56	0.0178571
NODE_2217_length_1524_cov_130.874386	219	296	288	1	77	0.0129870
NODE_2217_length_1524_cov_130.874386	219	296	297	1	77	0.0129870
NODE_2217_length_1524_cov_130.874386	219	296	313	1	77	0.0129870
NODE_2217_length_1524_cov_130.874386	219	296	335	1	77	0.0129870
NODE_2217_length_1524_cov_130.874386	219	296	348	1	77	0.0129870
NODE_2217_length_1524_cov_130.874386	219	296	386	1	77	0.0129870
NODE_2217_length_1524_cov_130.874386	219	296	396	1	77	0.0129870
NODE_2217_length_1524_cov_130.874386	219	296	397	1	77	0.0129870
NODE_2217_length_1524_cov_130.874386	219	296	399	1	77	0.0129870
NODE_2217_length_1524_cov_130.874386	219	296	406	1	77	0.0129870
NODE_2217_length_1524_cov_130.874386	219	296	411	1	77	0.0129870
NODE_2217_length_1524_cov_130.874386	219	296	424	1	77	0.0129870
NODE_2217_length_1524_cov_130.874386	219	296	442	1	77	0.0129870
NODE_2217_length_1524_cov_130.874386	219	296	446	1	77	0.0129870
NODE_2217_length_1524_cov_130.874386	219	296	449	1	77	0.0129870
NODE_2217_length_1524_cov_130.874386	219	296	459	1	77	0.0129870
NODE_2217_length_1524_cov_130.874386	219	296	475	1	77	0.0129870
NODE_2217_length_1524_cov_130.874386	219	296	484	1	77	0.0129870
NODE_2217_length_1524_cov_130.874386	219	296	491	1	77	0.0129870
NODE_2217_length_1524_cov_130.874386	219	296	493	1	77	0.0129870
NODE_2217_length_1524_cov_130.874386	219	296	499	2	77	0.0259740
NODE_2217_length_1524_cov_130.874386	219	296	509	1	77	0.0129870
NODE_2217_length_1524_cov_130.874386	219	296	517	1	77	0.0129870
NODE_2217_length_1524_cov_130.874386	219	296	521	1	77	0.0129870
NODE_2217_length_1524_cov_130.874386	219	296	525	1	77	0.0129870
NODE_2217_length_1524_cov_130.874386	219	296	526	1	77	0.0129870
NODE_2217_length_1524_cov_130.874386	219	296	542	1	77	0.0129870
NODE_2217_length_1524_cov_130.874386	219	296	546	3	77	0.0389610
NODE_2217_length_1524_cov_130.874386	219	296	549	1	77	0.0129870
NODE_2217_length_1524_cov_130.874386	219	296	553	1	77	0.0129870
NODE_2217_length_1524_cov_130.874386	219	296	563	1	77	0.0129870
NODE_2217_length_1524_cov_130.874386	219	296	565	1	77	0.0129870
NODE_2217_length_1524_cov_130.874386	219	296	573	1	77	0.0129870
NODE_2217_length_1524_cov_130.874386	219	296	574	1	77	0.0129870
NODE_2217_length_1524_cov_130.874386	219	296	587	1	77	0.0129870
NODE_2217_length_1524_cov_130.874386	219	296	589	1	77	0.0129870
NODE_2217_length_1524_cov_130.874386	219	296	592	2	77	0.0259740
NODE_2217_length_1524_cov_130.874386	219	296	594	1	77	0.0129870
NODE_2217_length_1524_cov_130.874386	219	296	595	2	77	0.0259740
NODE_2217_length_1524_cov_130.874386	219	296	596	3	77	0.0389610
NODE_2217_length_1524_cov_130.874386	219	296	615	1	77	0.0129870
NODE_2217_length_1524_cov_130.874386	219	296	619	1	77	0.0129870
NODE_2217_length_1524_cov_130.874386	219	296	626	1	77	0.0129870
NODE_2217_length_1524_cov_130.874386	219	296	638	1	77	0.0129870
NODE_2217_length_1524_cov_130.874386	219	296	639	1	77	0.0129870
NODE_2217_length_1524_cov_130.874386	219	296	643	2	77	0.0259740
NODE_2217_length_1524_cov_130.874386	219	296	645	1	77	0.0129870
NODE_2217_length_1524_cov_130.874386	219	296	648	1	77	0.0129870
NODE_2217_length_1524_cov_130.874386	219	296	657	2	77	0.0259740
NODE_2217_length_1524_cov_130.874386	219	296	663	1	77	0.0129870
NODE_2217_length_1524_cov_130.874386	219	296	664	1	77	0.0129870
NODE_2217_length_1524_cov_130.874386	219	296	665	1	77	0.0129870
NODE_2217_length_1524_cov_130.874386	219	296	667	1	77	0.0129870
NODE_2217_length_1524_cov_130.874386	219	296	676	3	77	0.0389610
NODE_2217_length_1524_cov_130.874386	219	296	681	1	77	0.0129870
NODE_2217_length_1524_cov_130.874386	219	296	682	1	77	0.0129870
NODE_2217_length_1524_cov_130.874386	219	296	685	1	77	0.0129870
NODE_2217_length_1524_cov_130.874386	219	296	693	2	77	0.0259740
NODE_2217_length_1524_cov_130.874386	219	296	695	1	77	0.0129870
NODE_2217_length_1524_cov_130.874386	219	296	696	1	77	0.0129870
NODE_2217_length_1524_cov_130.874386	219	296	697	1	77	0.0129870
NODE_2217_length_1524_cov_130.874386	219	296	699	1	77	0.0129870
NODE_2217_length_1524_cov_130.874386	219	296	701	1	77	0.0129870
NODE_2217_length_1524_cov_130.874386	219	296	704	1	77	0.0129870
NODE_2217_length_1524_cov_130.874386	219	296	706	1	77	0.0129870
NODE_2217_length_1524_cov_130.874386	253	333	96	1	80	0.0125000
NODE_2217_length_1524_cov_130.874386	253	333	98	1	80	0.0125000
NODE_2217_length_1524_cov_130.874386	253	333	99	1	80	0.0125000
NODE_2217_length_1524_cov_130.874386	253	333	101	1	80	0.0125000
NODE_2217_length_1524_cov_130.874386	253	333	113	1	80	0.0125000
NODE_2217_length_1524_cov_130.874386	253	333	116	1	80	0.0125000
NODE_2217_length_1524_cov_130.874386	253	333	121	1	80	0.0125000
NODE_2217_length_1524_cov_130.874386	253	333	122	1	80	0.0125000
NODE_2217_length_1524_cov_130.874386	253	333	123	3	80	0.0375000
NODE_2217_length_1524_cov_130.874386	253	333	129	1	80	0.0125000
NODE_2217_length_1524_cov_130.874386	253	333	133	1	80	0.0125000
NODE_2217_length_1524_cov_130.874386	253	333	136	1	80	0.0125000
NODE_2217_length_1524_cov_130.874386	253	333	142	1	80	0.0125000
NODE_2217_length_1524_cov_130.874386	253	333	147	1	80	0.0125000
NODE_2217_length_1524_cov_130.874386	253	333	148	2	80	0.0250000
NODE_2217_length_1524_cov_130.874386	253	333	158	3	80	0.0375000
NODE_2217_length_1524_cov_130.874386	253	333	160	1	80	0.0125000
NODE_2217_length_1524_cov_130.874386	253	333	178	1	80	0.0125000
NODE_2217_length_1524_cov_130.874386	253	333	193	1	80	0.0125000
NODE_2217_length_1524_cov_130.874386	253	333	203	1	80	0.0125000
NODE_2217_length_1524_cov_130.874386	253	333	205	1	80	0.0125000
NODE_2217_length_1524_cov_130.874386	253	333	212	1	80	0.0125000
NODE_2217_length_1524_cov_130.874386	253	333	216	1	80	0.0125000
NODE_2217_length_1524_cov_130.874386	253	333	222	1	80	0.0125000
NODE_2217_length_1524_cov_130.874386	253	333	240	1	80	0.0125000
NODE_2217_length_1524_cov_130.874386	253	333	242	1	80	0.0125000
NODE_2217_length_1524_cov_130.874386	253	333	249	1	80	0.0125000
NODE_2217_length_1524_cov_130.874386	253	333	262	1	80	0.0125000
NODE_2217_length_1524_cov_130.874386	253	333	264	1	80	0.0125000
NODE_2217_length_1524_cov_130.874386	253	333	268	2	80	0.0250000
NODE_2217_length_1524_cov_130.874386	253	333	277	1	80	0.0125000
NODE_2217_length_1524_cov_130.874386	253	333	288	1	80	0.0125000
NODE_2217_length_1524_cov_130.874386	253	333	297	1	80	0.0125000
NODE_2217_length_1524_cov_130.874386	253	333	313	1	80	0.0125000
NODE_2217_length_1524_cov_130.874386	253	333	335	1	80	0.0125000
NODE_2217_length_1524_cov_130.874386	253	333	348	1	80	0.0125000
NODE_2217_length_1524_cov_130.874386	253	333	386	1	80	0.0125000
NODE_2217_length_1524_cov_130.874386	253	333	396	1	80	0.0125000
NODE_2217_length_1524_cov_130.874386	253	333	397	1	80	0.0125000
NODE_2217_length_1524_cov_130.874386	253	333	399	1	80	0.0125000
NODE_2217_length_1524_cov_130.874386	253	333	406	1	80	0.0125000
NODE_2217_length_1524_cov_130.874386	253	333	411	1	80	0.0125000
NODE_2217_length_1524_cov_130.874386	253	333	424	1	80	0.0125000
NODE_2217_length_1524_cov_130.874386	253	333	442	1	80	0.0125000
NODE_2217_length_1524_cov_130.874386	253	333	446	1	80	0.0125000
NODE_2217_length_1524_cov_130.874386	253	333	449	1	80	0.0125000
NODE_2217_length_1524_cov_130.874386	253	333	459	1	80	0.0125000
NODE_2217_length_1524_cov_130.874386	253	333	475	1	80	0.0125000
NODE_2217_length_1524_cov_130.874386	253	333	484	1	80	0.0125000
NODE_2217_length_1524_cov_130.874386	253	333	491	1	80	0.0125000
NODE_2217_length_1524_cov_130.874386	253	333	493	1	80	0.0125000
NODE_2217_length_1524_cov_130.874386	253	333	499	2	80	0.0250000
NODE_2217_length_1524_cov_130.874386	253	333	509	1	80	0.0125000
NODE_2217_length_1524_cov_130.874386	253	333	517	1	80	0.0125000
NODE_2217_length_1524_cov_130.874386	253	333	521	1	80	0.0125000
NODE_2217_length_1524_cov_130.874386	253	333	525	1	80	0.0125000
NODE_2217_length_1524_cov_130.874386	253	333	526	1	80	0.0125000
NODE_2217_length_1524_cov_130.874386	253	333	542	1	80	0.0125000
NODE_2217_length_1524_cov_130.874386	253	333	546	3	80	0.0375000
NODE_2217_length_1524_cov_130.874386	253	333	549	1	80	0.0125000
NODE_2217_length_1524_cov_130.874386	253	333	553	1	80	0.0125000
NODE_2217_length_1524_cov_130.874386	253	333	563	1	80	0.0125000
NODE_2217_length_1524_cov_130.874386	253	333	565	1	80	0.0125000
NODE_2217_length_1524_cov_130.874386	253	333	573	1	80	0.0125000
NODE_2217_length_1524_cov_130.874386	253	333	574	1	80	0.0125000
NODE_2217_length_1524_cov_130.874386	253	333	587	1	80	0.0125000
NODE_2217_length_1524_cov_130.874386	253	333	592	2	80	0.0250000
NODE_2217_length_1524_cov_130.874386	253	333	595	1	80	0.0125000
NODE_2217_length_1524_cov_130.874386	253	333	596	2	80	0.0250000
NODE_2217_length_1524_cov_130.874386	306	386	42	1	80	0.0125000
NODE_2217_length_1524_cov_130.874386	306	386	43	1	80	0.0125000
NODE_2217_length_1524_cov_130.874386	306	386	47	6	80	0.0750000
NODE_2217_length_1524_cov_130.874386	306	386	48	7	80	0.0875000
NODE_2217_length_1524_cov_130.874386	306	386	49	8	80	0.1000000
NODE_2217_length_1524_cov_130.874386	306	386	52	1	80	0.0125000
NODE_2217_length_1524_cov_130.874386	306	386	59	2	80	0.0250000
NODE_2217_length_1524_cov_130.874386	306	386	61	1	80	0.0125000
NODE_2217_length_1524_cov_130.874386	306	386	63	4	80	0.0500000
NODE_2217_length_1524_cov_130.874386	306	386	67	2	80	0.0250000
NODE_2217_length_1524_cov_130.874386	306	386	69	2	80	0.0250000
NODE_2217_length_1524_cov_130.874386	306	386	75	2	80	0.0250000
NODE_2217_length_1524_cov_130.874386	306	386	81	2	80	0.0250000
NODE_2217_length_1524_cov_130.874386	306	386	83	3	80	0.0375000
NODE_2217_length_1524_cov_130.874386	306	386	84	1	80	0.0125000
NODE_2217_length_1524_cov_130.874386	306	386	86	1	80	0.0125000
NODE_2217_length_1524_cov_130.874386	306	386	90	5	80	0.0625000
NODE_2217_length_1524_cov_130.874386	306	386	92	2	80	0.0250000
NODE_2217_length_1524_cov_130.874386	306	386	95	1	80	0.0125000
NODE_2217_length_1524_cov_130.874386	306	386	96	2	80	0.0250000
NODE_2217_length_1524_cov_130.874386	306	386	98	1	80	0.0125000
NODE_2217_length_1524_cov_130.874386	306	386	99	1	80	0.0125000
NODE_2217_length_1524_cov_130.874386	306	386	101	1	80	0.0125000
NODE_2217_length_1524_cov_130.874386	306	386	113	1	80	0.0125000
NODE_2217_length_1524_cov_130.874386	306	386	116	1	80	0.0125000
NODE_2217_length_1524_cov_130.874386	306	386	121	1	80	0.0125000
NODE_2217_length_1524_cov_130.874386	306	386	122	1	80	0.0125000
NODE_2217_length_1524_cov_130.874386	306	386	123	3	80	0.0375000
NODE_2217_length_1524_cov_130.874386	306	386	129	1	80	0.0125000
NODE_2217_length_1524_cov_130.874386	306	386	133	1	80	0.0125000
NODE_2217_length_1524_cov_130.874386	306	386	136	1	80	0.0125000
NODE_2217_length_1524_cov_130.874386	306	386	142	1	80	0.0125000
NODE_2217_length_1524_cov_130.874386	306	386	147	1	80	0.0125000
NODE_2217_length_1524_cov_130.874386	306	386	148	2	80	0.0250000
NODE_2217_length_1524_cov_130.874386	306	386	158	3	80	0.0375000
NODE_2217_length_1524_cov_130.874386	306	386	160	1	80	0.0125000
NODE_2217_length_1524_cov_130.874386	306	386	178	1	80	0.0125000
NODE_2217_length_1524_cov_130.874386	306	386	193	1	80	0.0125000
NODE_2217_length_1524_cov_130.874386	306	386	203	1	80	0.0125000
NODE_2217_length_1524_cov_130.874386	306	386	205	1	80	0.0125000
NODE_2217_length_1524_cov_130.874386	306	386	212	1	80	0.0125000
NODE_2219_length_1523_cov_24.115169	366	446	6	80	80	1.0000000
NODE_2219_length_1523_cov_24.115169	419	499	0	14	80	0.1750000
NODE_2219_length_1523_cov_24.115169	419	499	2	8	80	0.1000000
NODE_2219_length_1523_cov_24.115169	419	499	4	18	80	0.2250000
NODE_2219_length_1523_cov_24.115169	419	499	6	40	80	0.5000000
NODE_2219_length_1523_cov_24.115169	495	575	4	66	80	0.8250000
NODE_2219_length_1523_cov_24.115169	495	575	8	14	80	0.1750000
NODE_2219_length_1523_cov_24.115169	548	628	4	66	80	0.8250000
NODE_2219_length_1523_cov_24.115169	548	628	8	14	80	0.1750000
NODE_2223_length_1522_cov_13.278988	361	441	0	80	80	1.0000000
NODE_2223_length_1522_cov_13.278988	414	494	0	80	80	1.0000000
NODE_2225_length_1521_cov_20.965541	772	852	0	75	80	0.9375000
NODE_2225_length_1521_cov_20.965541	772	852	1	5	80	0.0625000
NODE_2225_length_1521_cov_20.965541	825	905	0	22	80	0.2750000
NODE_2225_length_1521_cov_20.965541	825	905	1	10	80	0.1250000
NODE_2225_length_1521_cov_20.965541	825	905	2	31	80	0.3875000
NODE_2225_length_1521_cov_20.965541	825	905	6	17	80	0.2125000
NODE_2226_length_1521_cov_15.381153	907	987	6	17	80	0.2125000
NODE_2226_length_1521_cov_15.381153	907	987	8	11	80	0.1375000
NODE_2226_length_1521_cov_15.381153	907	987	12	30	80	0.3750000
NODE_2226_length_1521_cov_15.381153	907	987	14	22	80	0.2750000
NODE_2226_length_1521_cov_15.381153	960	1040	2	9	80	0.1125000
NODE_2226_length_1521_cov_15.381153	960	1040	4	11	80	0.1375000
NODE_2226_length_1521_cov_15.381153	960	1040	8	12	80	0.1500000
NODE_2226_length_1521_cov_15.381153	960	1040	10	32	80	0.4000000
NODE_2226_length_1521_cov_15.381153	960	1040	14	16	80	0.2000000
NODE_2226_length_1521_cov_15.381153	988	1040	2	9	52	0.1730769
NODE_2226_length_1521_cov_15.381153	988	1040	4	11	52	0.2115385
NODE_2226_length_1521_cov_15.381153	988	1040	10	32	52	0.6153846
NODE_2227_length_1521_cov_7.682138	525	605	0	80	80	1.0000000
NODE_2227_length_1521_cov_7.682138	578	658	0	80	80	1.0000000
NODE_2236_length_1519_cov_20.792958	714	794	1	2	80	0.0250000
NODE_2236_length_1519_cov_20.792958	714	794	2	78	80	0.9750000
NODE_2236_length_1519_cov_20.792958	767	847	0	42	80	0.5250000
NODE_2236_length_1519_cov_20.792958	767	847	1	13	80	0.1625000
NODE_2236_length_1519_cov_20.792958	767	847	2	25	80	0.3125000
NODE_2239_length_1517_cov_24.074048	413	450	2	4	37	0.1081081
NODE_2239_length_1517_cov_24.074048	413	450	4	33	37	0.8918919
NODE_2239_length_1517_cov_24.074048	842	922	2	80	80	1.0000000
NODE_2239_length_1517_cov_24.074048	895	975	1	51	80	0.6375000
NODE_2239_length_1517_cov_24.074048	895	975	2	29	80	0.3625000
NODE_2240_length_1517_cov_22.897743	383	463	0	78	80	0.9750000
NODE_2240_length_1517_cov_22.897743	383	463	2	2	80	0.0250000
NODE_2240_length_1517_cov_22.897743	436	516	0	80	80	1.0000000
NODE_2241_length_1517_cov_11.781382	381	461	6	21	80	0.2625000
NODE_2241_length_1517_cov_11.781382	381	461	8	59	80	0.7375000
NODE_2241_length_1517_cov_11.781382	434	514	2	11	80	0.1375000
NODE_2241_length_1517_cov_11.781382	434	514	4	3	80	0.0375000
NODE_2241_length_1517_cov_11.781382	434	514	6	5	80	0.0625000
NODE_2241_length_1517_cov_11.781382	434	514	8	35	80	0.4375000
NODE_2241_length_1517_cov_11.781382	434	514	9	1	80	0.0125000
NODE_2241_length_1517_cov_11.781382	434	514	10	25	80	0.3125000
NODE_2243_length_1517_cov_4.944993	393	473	6	15	80	0.1875000
NODE_2243_length_1517_cov_4.944993	393	473	8	65	80	0.8125000
NODE_2243_length_1517_cov_4.944993	446	526	0	44	80	0.5500000
NODE_2243_length_1517_cov_4.944993	446	526	6	24	80	0.3000000
NODE_2243_length_1517_cov_4.944993	446	526	8	12	80	0.1500000
NODE_2247_length_1516_cov_11.177135	230	310	0	80	80	1.0000000
NODE_2247_length_1516_cov_11.177135	283	363	0	80	80	1.0000000
NODE_2248_length_1516_cov_8.608327	580	660	0	57	80	0.7125000
NODE_2248_length_1516_cov_8.608327	580	660	2	23	80	0.2875000
NODE_2248_length_1516_cov_8.608327	633	713	0	80	80	1.0000000
NODE_2250_length_1515_cov_16.990819	333	413	18	5	80	0.0625000
NODE_2250_length_1515_cov_16.990819	333	413	20	23	80	0.2875000
NODE_2250_length_1515_cov_16.990819	333	413	22	1	80	0.0125000
NODE_2250_length_1515_cov_16.990819	333	413	26	2	80	0.0250000
NODE_2250_length_1515_cov_16.990819	333	413	28	1	80	0.0125000
NODE_2250_length_1515_cov_16.990819	333	413	30	1	80	0.0125000
NODE_2250_length_1515_cov_16.990819	333	413	32	1	80	0.0125000
NODE_2250_length_1515_cov_16.990819	333	413	39	2	80	0.0250000
NODE_2250_length_1515_cov_16.990819	333	413	43	4	80	0.0500000
NODE_2250_length_1515_cov_16.990819	333	413	44	3	80	0.0375000
NODE_2250_length_1515_cov_16.990819	333	413	45	2	80	0.0250000
NODE_2250_length_1515_cov_16.990819	333	413	46	2	80	0.0250000
NODE_2250_length_1515_cov_16.990819	333	413	47	1	80	0.0125000
NODE_2250_length_1515_cov_16.990819	333	413	49	1	80	0.0125000
NODE_2250_length_1515_cov_16.990819	333	413	54	1	80	0.0125000
NODE_2250_length_1515_cov_16.990819	333	413	56	2	80	0.0250000
NODE_2250_length_1515_cov_16.990819	333	413	58	5	80	0.0625000
NODE_2250_length_1515_cov_16.990819	333	413	59	2	80	0.0250000
NODE_2250_length_1515_cov_16.990819	333	413	60	1	80	0.0125000
NODE_2250_length_1515_cov_16.990819	333	413	61	6	80	0.0750000
NODE_2250_length_1515_cov_16.990819	333	413	63	3	80	0.0375000
NODE_2250_length_1515_cov_16.990819	333	413	64	2	80	0.0250000
NODE_2250_length_1515_cov_16.990819	333	413	65	1	80	0.0125000
NODE_2250_length_1515_cov_16.990819	333	413	67	1	80	0.0125000
NODE_2250_length_1515_cov_16.990819	333	413	68	1	80	0.0125000
NODE_2250_length_1515_cov_16.990819	333	413	70	1	80	0.0125000
NODE_2250_length_1515_cov_16.990819	333	413	72	1	80	0.0125000
NODE_2250_length_1515_cov_16.990819	333	413	76	4	80	0.0500000
NODE_2250_length_1515_cov_16.990819	386	448	8	20	62	0.3225806
NODE_2250_length_1515_cov_16.990819	386	448	12	6	62	0.0967742
NODE_2250_length_1515_cov_16.990819	386	448	16	6	62	0.0967742
NODE_2250_length_1515_cov_16.990819	386	448	18	8	62	0.1290323
NODE_2250_length_1515_cov_16.990819	386	448	20	22	62	0.3548387
NODE_2258_length_1512_cov_5.111819	506	560	2	54	54	1.0000000
NODE_2258_length_1512_cov_5.111819	677	698	2	21	21	1.0000000
NODE_2258_length_1512_cov_5.111819	677	698	2	21	21	1.0000000
NODE_2258_length_1512_cov_5.111819	1057	1137	0	80	80	1.0000000
NODE_2258_length_1512_cov_5.111819	1110	1190	0	80	80	1.0000000
NODE_2258_length_1512_cov_5.111819	1144	1190	0	46	46	1.0000000
NODE_2259_length_1512_cov_4.251946	132	204	0	72	72	1.0000000
NODE_2262_length_1511_cov_30.963173	787	867	0	2	80	0.0250000
NODE_2262_length_1511_cov_30.963173	787	867	2	78	80	0.9750000
NODE_2262_length_1511_cov_30.963173	840	920	0	2	80	0.0250000
NODE_2262_length_1511_cov_30.963173	840	920	2	78	80	0.9750000
NODE_2262_length_1511_cov_30.963173	916	996	0	50	80	0.6250000
NODE_2262_length_1511_cov_30.963173	916	996	2	30	80	0.3750000
NODE_2262_length_1511_cov_30.963173	969	1059	0	90	90	1.0000000
NODE_2265_length_1510_cov_24.184975	434	514	6	15	80	0.1875000
NODE_2265_length_1510_cov_24.184975	434	514	8	50	80	0.6250000
NODE_2265_length_1510_cov_24.184975	434	514	10	15	80	0.1875000
NODE_2265_length_1510_cov_24.184975	487	567	2	20	80	0.2500000
NODE_2265_length_1510_cov_24.184975	487	567	4	31	80	0.3875000
NODE_2265_length_1510_cov_24.184975	487	567	6	1	80	0.0125000
NODE_2265_length_1510_cov_24.184975	487	567	8	28	80	0.3500000
NODE_2265_length_1510_cov_24.184975	563	643	0	28	80	0.3500000
NODE_2265_length_1510_cov_24.184975	563	643	2	52	80	0.6500000
NODE_2265_length_1510_cov_24.184975	616	696	0	80	80	1.0000000
NODE_2269_length_1509_cov_51.836170	655	735	0	20	80	0.2500000
NODE_2269_length_1509_cov_51.836170	655	735	2	14	80	0.1750000
NODE_2269_length_1509_cov_51.836170	655	735	6	46	80	0.5750000
NODE_2269_length_1509_cov_51.836170	708	788	0	15	80	0.1875000
NODE_2269_length_1509_cov_51.836170	708	788	2	18	80	0.2250000
NODE_2269_length_1509_cov_51.836170	708	788	6	47	80	0.5875000
NODE_2269_length_1509_cov_51.836170	784	864	0	78	80	0.9750000
NODE_2269_length_1509_cov_51.836170	784	864	2	2	80	0.0250000
NODE_2269_length_1509_cov_51.836170	837	917	0	25	80	0.3125000
NODE_2269_length_1509_cov_51.836170	837	917	2	4	80	0.0500000
NODE_2269_length_1509_cov_51.836170	837	917	4	51	80	0.6375000
NODE_2270_length_1509_cov_16.010638	497	577	0	80	80	1.0000000
NODE_2270_length_1509_cov_16.010638	550	630	0	80	80	1.0000000
NODE_2270_length_1509_cov_16.010638	626	706	0	80	80	1.0000000
NODE_2270_length_1509_cov_16.010638	679	759	0	80	80	1.0000000
NODE_2271_length_1509_cov_8.883688	252	332	0	70	80	0.8750000
NODE_2271_length_1509_cov_8.883688	252	332	2	10	80	0.1250000
NODE_2271_length_1509_cov_8.883688	305	385	0	44	80	0.5500000
NODE_2271_length_1509_cov_8.883688	305	385	2	36	80	0.4500000
NODE_2271_length_1509_cov_8.883688	327	385	0	22	58	0.3793103
NODE_2271_length_1509_cov_8.883688	327	385	2	36	58	0.6206896
NODE_2271_length_1509_cov_8.883688	381	461	2	80	80	1.0000000
NODE_2271_length_1509_cov_8.883688	434	514	0	42	80	0.5250000
NODE_2271_length_1509_cov_8.883688	434	514	2	38	80	0.4750000
NODE_2272_length_1509_cov_5.826950	1029	1109	0	70	80	0.8750000
NODE_2272_length_1509_cov_5.826950	1029	1109	2	10	80	0.1250000
NODE_2272_length_1509_cov_5.826950	1082	1162	0	17	80	0.2125000
NODE_2272_length_1509_cov_5.826950	1082	1162	2	63	80	0.7875000
NODE_2277_length_1508_cov_24.176011	765	845	0	80	80	1.0000000
NODE_2277_length_1508_cov_24.176011	818	898	0	80	80	1.0000000
NODE_2290_length_1504_cov_17.449822	596	676	0	69	80	0.8625000
NODE_2290_length_1504_cov_17.449822	596	676	2	11	80	0.1375000
NODE_2290_length_1504_cov_17.449822	649	729	0	16	80	0.2000000
NODE_2290_length_1504_cov_17.449822	649	729	2	64	80	0.8000000
NODE_2293_length_1502_cov_42.989309	559	639	0	80	80	1.0000000
NODE_2293_length_1502_cov_42.989309	612	692	0	80	80	1.0000000
NODE_2294_length_1501_cov_22.828816	421	500	0	79	79	1.0000000
NODE_2294_length_1501_cov_22.828816	473	553	0	80	80	1.0000000
NODE_2294_length_1501_cov_22.828816	549	629	0	80	80	1.0000000
NODE_2294_length_1501_cov_22.828816	602	682	0	80	80	1.0000000
NODE_2295_length_1501_cov_14.422254	973	1053	2	35	80	0.4375000
NODE_2295_length_1501_cov_14.422254	973	1053	4	45	80	0.5625000
NODE_2295_length_1501_cov_14.422254	1026	1106	0	47	80	0.5875000
NODE_2295_length_1501_cov_14.422254	1026	1106	2	33	80	0.4125000
NODE_2296_length_1501_cov_14.060628	225	305	0	45	80	0.5625000
NODE_2296_length_1501_cov_14.060628	225	305	2	5	80	0.0625000
NODE_2296_length_1501_cov_14.060628	225	305	6	30	80	0.3750000
NODE_2296_length_1501_cov_14.060628	278	358	6	80	80	1.0000000
NODE_2296_length_1501_cov_14.060628	986	1066	0	80	80	1.0000000
NODE_2296_length_1501_cov_14.060628	1039	1119	0	80	80	1.0000000
NODE_2300_length_1500_cov_40.056388	619	699	1	4	80	0.0500000
NODE_2300_length_1500_cov_40.056388	619	699	2	76	80	0.9500000
NODE_2300_length_1500_cov_40.056388	672	752	2	80	80	1.0000000
NODE_2305_length_1497_cov_38.344063	1401	1481	59	1	80	0.0125000
NODE_2305_length_1497_cov_38.344063	1401	1481	61	1	80	0.0125000
NODE_2305_length_1497_cov_38.344063	1401	1481	62	1	80	0.0125000
NODE_2305_length_1497_cov_38.344063	1401	1481	69	1	80	0.0125000
NODE_2305_length_1497_cov_38.344063	1401	1481	71	1	80	0.0125000
NODE_2305_length_1497_cov_38.344063	1401	1481	75	2	80	0.0250000
NODE_2305_length_1497_cov_38.344063	1401	1481	79	1	80	0.0125000
NODE_2305_length_1497_cov_38.344063	1401	1481	81	1	80	0.0125000
NODE_2305_length_1497_cov_38.344063	1401	1481	87	1	80	0.0125000
NODE_2305_length_1497_cov_38.344063	1401	1481	91	1	80	0.0125000
NODE_2305_length_1497_cov_38.344063	1401	1481	95	1	80	0.0125000
NODE_2305_length_1497_cov_38.344063	1401	1481	97	3	80	0.0375000
NODE_2305_length_1497_cov_38.344063	1401	1481	101	14	80	0.1750000
NODE_2305_length_1497_cov_38.344063	1401	1481	102	8	80	0.1000000
NODE_2305_length_1497_cov_38.344063	1401	1481	103	5	80	0.0625000
NODE_2305_length_1497_cov_38.344063	1401	1481	105	9	80	0.1125000
NODE_2305_length_1497_cov_38.344063	1401	1481	107	10	80	0.1250000
NODE_2305_length_1497_cov_38.344063	1401	1481	109	2	80	0.0250000
NODE_2305_length_1497_cov_38.344063	1401	1481	113	2	80	0.0250000
NODE_2305_length_1497_cov_38.344063	1401	1481	115	2	80	0.0250000
NODE_2305_length_1497_cov_38.344063	1401	1481	123	1	80	0.0125000
NODE_2305_length_1497_cov_38.344063	1401	1481	133	2	80	0.0250000
NODE_2305_length_1497_cov_38.344063	1401	1481	136	2	80	0.0250000
NODE_2305_length_1497_cov_38.344063	1401	1481	142	1	80	0.0125000
NODE_2305_length_1497_cov_38.344063	1401	1481	144	2	80	0.0250000
NODE_2305_length_1497_cov_38.344063	1401	1481	146	4	80	0.0500000
NODE_2305_length_1497_cov_38.344063	1401	1481	150	1	80	0.0125000
NODE_2308_length_1496_cov_3.936292	0	44	0	44	44	1.0000000
NODE_2308_length_1496_cov_3.936292	17	97	0	80	80	1.0000000
NODE_2311_length_1496_cov_1.103794	405	428	0	23	23	1.0000000
NODE_2313_length_1494_cov_65.437276	460	540	0	12	80	0.1500000
NODE_2313_length_1494_cov_65.437276	460	540	6	68	80	0.8500000
NODE_2313_length_1494_cov_65.437276	513	594	0	66	81	0.8148148
NODE_2313_length_1494_cov_65.437276	513	594	6	15	81	0.1851852
NODE_2313_length_1494_cov_65.437276	787	854	2	24	67	0.3582090
NODE_2313_length_1494_cov_65.437276	787	854	4	26	67	0.3880597
NODE_2313_length_1494_cov_65.437276	787	854	6	17	67	0.2537313
NODE_2313_length_1494_cov_65.437276	827	907	0	2	80	0.0250000
NODE_2313_length_1494_cov_65.437276	827	907	2	1	80	0.0125000
NODE_2313_length_1494_cov_65.437276	827	907	4	19	80	0.2375000
NODE_2313_length_1494_cov_65.437276	827	907	6	58	80	0.7250000
NODE_2316_length_1493_cov_100.467719	947	1028	92	1	81	0.0123457
NODE_2316_length_1493_cov_100.467719	947	1028	102	1	81	0.0123457
NODE_2316_length_1493_cov_100.467719	947	1028	106	2	81	0.0246914
NODE_2316_length_1493_cov_100.467719	947	1028	108	1	81	0.0123457
NODE_2316_length_1493_cov_100.467719	947	1028	112	1	81	0.0123457
NODE_2316_length_1493_cov_100.467719	947	1028	114	2	81	0.0246914
NODE_2316_length_1493_cov_100.467719	947	1028	124	1	81	0.0123457
NODE_2316_length_1493_cov_100.467719	947	1028	126	3	81	0.0370370
NODE_2316_length_1493_cov_100.467719	947	1028	128	1	81	0.0123457
NODE_2316_length_1493_cov_100.467719	947	1028	129	1	81	0.0123457
NODE_2316_length_1493_cov_100.467719	947	1028	133	1	81	0.0123457
NODE_2316_length_1493_cov_100.467719	947	1028	137	1	81	0.0123457
NODE_2316_length_1493_cov_100.467719	947	1028	140	4	81	0.0493827
NODE_2316_length_1493_cov_100.467719	947	1028	141	1	81	0.0123457
NODE_2316_length_1493_cov_100.467719	947	1028	145	1	81	0.0123457
NODE_2316_length_1493_cov_100.467719	947	1028	160	1	81	0.0123457
NODE_2316_length_1493_cov_100.467719	947	1028	163	1	81	0.0123457
NODE_2316_length_1493_cov_100.467719	947	1028	165	1	81	0.0123457
NODE_2316_length_1493_cov_100.467719	947	1028	171	1	81	0.0123457
NODE_2316_length_1493_cov_100.467719	947	1028	173	1	81	0.0123457
NODE_2316_length_1493_cov_100.467719	947	1028	183	1	81	0.0123457
NODE_2316_length_1493_cov_100.467719	947	1028	185	1	81	0.0123457
NODE_2316_length_1493_cov_100.467719	947	1028	193	1	81	0.0123457
NODE_2316_length_1493_cov_100.467719	947	1028	199	1	81	0.0123457
NODE_2316_length_1493_cov_100.467719	947	1028	201	1	81	0.0123457
NODE_2316_length_1493_cov_100.467719	947	1028	207	1	81	0.0123457
NODE_2316_length_1493_cov_100.467719	947	1028	213	1	81	0.0123457
NODE_2316_length_1493_cov_100.467719	947	1028	221	1	81	0.0123457
NODE_2316_length_1493_cov_100.467719	947	1028	223	1	81	0.0123457
NODE_2316_length_1493_cov_100.467719	947	1028	229	1	81	0.0123457
NODE_2316_length_1493_cov_100.467719	947	1028	230	2	81	0.0246914
NODE_2316_length_1493_cov_100.467719	947	1028	231	2	81	0.0246914
NODE_2316_length_1493_cov_100.467719	947	1028	232	2	81	0.0246914
NODE_2316_length_1493_cov_100.467719	947	1028	235	3	81	0.0370370
NODE_2316_length_1493_cov_100.467719	947	1028	237	1	81	0.0123457
NODE_2316_length_1493_cov_100.467719	947	1028	242	2	81	0.0246914
NODE_2316_length_1493_cov_100.467719	947	1028	246	3	81	0.0370370
NODE_2316_length_1493_cov_100.467719	947	1028	250	1	81	0.0123457
NODE_2316_length_1493_cov_100.467719	947	1028	253	1	81	0.0123457
NODE_2316_length_1493_cov_100.467719	947	1028	254	1	81	0.0123457
NODE_2316_length_1493_cov_100.467719	947	1028	255	1	81	0.0123457
NODE_2316_length_1493_cov_100.467719	947	1028	256	1	81	0.0123457
NODE_2316_length_1493_cov_100.467719	947	1028	262	1	81	0.0123457
NODE_2316_length_1493_cov_100.467719	947	1028	264	1	81	0.0123457
NODE_2316_length_1493_cov_100.467719	947	1028	267	1	81	0.0123457
NODE_2316_length_1493_cov_100.467719	947	1028	273	1	81	0.0123457
NODE_2316_length_1493_cov_100.467719	947	1028	275	1	81	0.0123457
NODE_2316_length_1493_cov_100.467719	947	1028	278	1	81	0.0123457
NODE_2316_length_1493_cov_100.467719	947	1028	282	1	81	0.0123457
NODE_2316_length_1493_cov_100.467719	947	1028	284	1	81	0.0123457
NODE_2316_length_1493_cov_100.467719	947	1028	296	1	81	0.0123457
NODE_2316_length_1493_cov_100.467719	947	1028	298	1	81	0.0123457
NODE_2316_length_1493_cov_100.467719	947	1028	300	1	81	0.0123457
NODE_2316_length_1493_cov_100.467719	947	1028	314	2	81	0.0246914
NODE_2316_length_1493_cov_100.467719	947	1028	316	1	81	0.0123457
NODE_2316_length_1493_cov_100.467719	947	1028	321	1	81	0.0123457
NODE_2316_length_1493_cov_100.467719	947	1028	324	1	81	0.0123457
NODE_2316_length_1493_cov_100.467719	947	1028	325	1	81	0.0123457
NODE_2316_length_1493_cov_100.467719	947	1028	338	1	81	0.0123457
NODE_2316_length_1493_cov_100.467719	947	1028	346	1	81	0.0123457
NODE_2316_length_1493_cov_100.467719	947	1028	354	1	81	0.0123457
NODE_2316_length_1493_cov_100.467719	947	1028	366	1	81	0.0123457
NODE_2316_length_1493_cov_100.467719	947	1028	367	1	81	0.0123457
NODE_2316_length_1493_cov_100.467719	947	1028	369	1	81	0.0123457
NODE_2316_length_1493_cov_100.467719	947	1028	370	1	81	0.0123457
NODE_2316_length_1493_cov_100.467719	1001	1071	254	1	70	0.0142857
NODE_2316_length_1493_cov_100.467719	1001	1071	255	1	70	0.0142857
NODE_2316_length_1493_cov_100.467719	1001	1071	256	1	70	0.0142857
NODE_2316_length_1493_cov_100.467719	1001	1071	262	1	70	0.0142857
NODE_2316_length_1493_cov_100.467719	1001	1071	264	1	70	0.0142857
NODE_2316_length_1493_cov_100.467719	1001	1071	267	1	70	0.0142857
NODE_2316_length_1493_cov_100.467719	1001	1071	273	1	70	0.0142857
NODE_2316_length_1493_cov_100.467719	1001	1071	275	1	70	0.0142857
NODE_2316_length_1493_cov_100.467719	1001	1071	278	1	70	0.0142857
NODE_2316_length_1493_cov_100.467719	1001	1071	282	1	70	0.0142857
NODE_2316_length_1493_cov_100.467719	1001	1071	284	1	70	0.0142857
NODE_2316_length_1493_cov_100.467719	1001	1071	296	1	70	0.0142857
NODE_2316_length_1493_cov_100.467719	1001	1071	298	1	70	0.0142857
NODE_2316_length_1493_cov_100.467719	1001	1071	300	1	70	0.0142857
NODE_2316_length_1493_cov_100.467719	1001	1071	314	2	70	0.0285714
NODE_2316_length_1493_cov_100.467719	1001	1071	316	1	70	0.0142857
NODE_2316_length_1493_cov_100.467719	1001	1071	321	1	70	0.0142857
NODE_2316_length_1493_cov_100.467719	1001	1071	324	1	70	0.0142857
NODE_2316_length_1493_cov_100.467719	1001	1071	325	1	70	0.0142857
NODE_2316_length_1493_cov_100.467719	1001	1071	338	1	70	0.0142857
NODE_2316_length_1493_cov_100.467719	1001	1071	346	1	70	0.0142857
NODE_2316_length_1493_cov_100.467719	1001	1071	354	1	70	0.0142857
NODE_2316_length_1493_cov_100.467719	1001	1071	366	1	70	0.0142857
NODE_2316_length_1493_cov_100.467719	1001	1071	367	1	70	0.0142857
NODE_2316_length_1493_cov_100.467719	1001	1071	369	1	70	0.0142857
NODE_2316_length_1493_cov_100.467719	1001	1071	370	1	70	0.0142857
NODE_2316_length_1493_cov_100.467719	1001	1071	378	1	70	0.0142857
NODE_2316_length_1493_cov_100.467719	1001	1071	387	1	70	0.0142857
NODE_2316_length_1493_cov_100.467719	1001	1071	395	1	70	0.0142857
NODE_2316_length_1493_cov_100.467719	1001	1071	398	1	70	0.0142857
NODE_2316_length_1493_cov_100.467719	1001	1071	399	3	70	0.0428571
NODE_2316_length_1493_cov_100.467719	1001	1071	401	1	70	0.0142857
NODE_2316_length_1493_cov_100.467719	1001	1071	402	2	70	0.0285714
NODE_2316_length_1493_cov_100.467719	1001	1071	406	1	70	0.0142857
NODE_2316_length_1493_cov_100.467719	1001	1071	410	1	70	0.0142857
NODE_2316_length_1493_cov_100.467719	1001	1071	418	1	70	0.0142857
NODE_2316_length_1493_cov_100.467719	1001	1071	422	1	70	0.0142857
NODE_2316_length_1493_cov_100.467719	1001	1071	427	1	70	0.0142857
NODE_2316_length_1493_cov_100.467719	1001	1071	430	1	70	0.0142857
NODE_2316_length_1493_cov_100.467719	1001	1071	449	1	70	0.0142857
NODE_2316_length_1493_cov_100.467719	1001	1071	471	1	70	0.0142857
NODE_2316_length_1493_cov_100.467719	1001	1071	472	1	70	0.0142857
NODE_2316_length_1493_cov_100.467719	1001	1071	507	1	70	0.0142857
NODE_2316_length_1493_cov_100.467719	1001	1071	510	1	70	0.0142857
NODE_2316_length_1493_cov_100.467719	1001	1071	519	1	70	0.0142857
NODE_2316_length_1493_cov_100.467719	1001	1071	523	1	70	0.0142857
NODE_2316_length_1493_cov_100.467719	1001	1071	532	1	70	0.0142857
NODE_2316_length_1493_cov_100.467719	1001	1071	538	1	70	0.0142857
NODE_2316_length_1493_cov_100.467719	1001	1071	542	1	70	0.0142857
NODE_2316_length_1493_cov_100.467719	1001	1071	549	1	70	0.0142857
NODE_2316_length_1493_cov_100.467719	1001	1071	550	2	70	0.0285714
NODE_2316_length_1493_cov_100.467719	1001	1071	551	1	70	0.0142857
NODE_2316_length_1493_cov_100.467719	1001	1071	553	1	70	0.0142857
NODE_2316_length_1493_cov_100.467719	1001	1071	556	1	70	0.0142857
NODE_2316_length_1493_cov_100.467719	1001	1071	557	1	70	0.0142857
NODE_2316_length_1493_cov_100.467719	1001	1071	562	1	70	0.0142857
NODE_2316_length_1493_cov_100.467719	1001	1071	572	1	70	0.0142857
NODE_2316_length_1493_cov_100.467719	1001	1071	574	1	70	0.0142857
NODE_2316_length_1493_cov_100.467719	1001	1071	576	2	70	0.0285714
NODE_2316_length_1493_cov_100.467719	1001	1071	581	1	70	0.0142857
NODE_2316_length_1493_cov_100.467719	1001	1071	587	1	70	0.0142857
NODE_2316_length_1493_cov_100.467719	1001	1071	591	1	70	0.0142857
NODE_2316_length_1493_cov_100.467719	1001	1071	592	1	70	0.0142857
NODE_2316_length_1493_cov_100.467719	1001	1071	594	1	70	0.0142857
NODE_2316_length_1493_cov_100.467719	1077	1157	612	1	80	0.0125000
NODE_2316_length_1493_cov_100.467719	1077	1157	622	1	80	0.0125000
NODE_2316_length_1493_cov_100.467719	1077	1157	630	1	80	0.0125000
NODE_2316_length_1493_cov_100.467719	1077	1157	632	1	80	0.0125000
NODE_2316_length_1493_cov_100.467719	1077	1157	646	1	80	0.0125000
NODE_2316_length_1493_cov_100.467719	1077	1157	653	1	80	0.0125000
NODE_2316_length_1493_cov_100.467719	1077	1157	681	1	80	0.0125000
NODE_2316_length_1493_cov_100.467719	1077	1157	685	1	80	0.0125000
NODE_2316_length_1493_cov_100.467719	1077	1157	689	1	80	0.0125000
NODE_2316_length_1493_cov_100.467719	1077	1157	698	1	80	0.0125000
NODE_2316_length_1493_cov_100.467719	1077	1157	699	1	80	0.0125000
NODE_2316_length_1493_cov_100.467719	1077	1157	704	1	80	0.0125000
NODE_2316_length_1493_cov_100.467719	1077	1157	705	2	80	0.0250000
NODE_2316_length_1493_cov_100.467719	1077	1157	706	1	80	0.0125000
NODE_2316_length_1493_cov_100.467719	1077	1157	707	1	80	0.0125000
NODE_2316_length_1493_cov_100.467719	1077	1157	708	1	80	0.0125000
NODE_2316_length_1493_cov_100.467719	1077	1157	709	2	80	0.0250000
NODE_2316_length_1493_cov_100.467719	1077	1157	710	1	80	0.0125000
NODE_2316_length_1493_cov_100.467719	1077	1157	711	1	80	0.0125000
NODE_2316_length_1493_cov_100.467719	1077	1157	713	1	80	0.0125000
NODE_2316_length_1493_cov_100.467719	1077	1157	714	1	80	0.0125000
NODE_2316_length_1493_cov_100.467719	1077	1157	715	1	80	0.0125000
NODE_2316_length_1493_cov_100.467719	1077	1157	719	1	80	0.0125000
NODE_2316_length_1493_cov_100.467719	1077	1157	725	1	80	0.0125000
NODE_2316_length_1493_cov_100.467719	1077	1157	732	1	80	0.0125000
NODE_2316_length_1493_cov_100.467719	1077	1157	743	1	80	0.0125000
NODE_2316_length_1493_cov_100.467719	1077	1157	749	1	80	0.0125000
NODE_2316_length_1493_cov_100.467719	1077	1157	764	1	80	0.0125000
NODE_2316_length_1493_cov_100.467719	1077	1157	773	1	80	0.0125000
NODE_2316_length_1493_cov_100.467719	1077	1157	777	2	80	0.0250000
NODE_2316_length_1493_cov_100.467719	1077	1157	780	1	80	0.0125000
NODE_2316_length_1493_cov_100.467719	1077	1157	795	1	80	0.0125000
NODE_2316_length_1493_cov_100.467719	1077	1157	798	1	80	0.0125000
NODE_2316_length_1493_cov_100.467719	1077	1157	799	2	80	0.0250000
NODE_2316_length_1493_cov_100.467719	1077	1157	807	1	80	0.0125000
NODE_2316_length_1493_cov_100.467719	1077	1157	809	2	80	0.0250000
NODE_2316_length_1493_cov_100.467719	1077	1157	813	1	80	0.0125000
NODE_2316_length_1493_cov_100.467719	1077	1157	814	1	80	0.0125000
NODE_2316_length_1493_cov_100.467719	1077	1157	816	1	80	0.0125000
NODE_2316_length_1493_cov_100.467719	1077	1157	817	1	80	0.0125000
NODE_2316_length_1493_cov_100.467719	1077	1157	820	1	80	0.0125000
NODE_2316_length_1493_cov_100.467719	1077	1157	830	1	80	0.0125000
NODE_2316_length_1493_cov_100.467719	1077	1157	831	1	80	0.0125000
NODE_2316_length_1493_cov_100.467719	1077	1157	838	1	80	0.0125000
NODE_2316_length_1493_cov_100.467719	1077	1157	846	1	80	0.0125000
NODE_2316_length_1493_cov_100.467719	1077	1157	847	1	80	0.0125000
NODE_2316_length_1493_cov_100.467719	1077	1157	873	1	80	0.0125000
NODE_2316_length_1493_cov_100.467719	1077	1157	877	1	80	0.0125000
NODE_2316_length_1493_cov_100.467719	1077	1157	885	1	80	0.0125000
NODE_2316_length_1493_cov_100.467719	1077	1157	889	1	80	0.0125000
NODE_2316_length_1493_cov_100.467719	1077	1157	899	1	80	0.0125000
NODE_2316_length_1493_cov_100.467719	1077	1157	900	1	80	0.0125000
NODE_2316_length_1493_cov_100.467719	1077	1157	905	1	80	0.0125000
NODE_2316_length_1493_cov_100.467719	1077	1157	922	1	80	0.0125000
NODE_2316_length_1493_cov_100.467719	1077	1157	923	1	80	0.0125000
NODE_2316_length_1493_cov_100.467719	1077	1157	926	1	80	0.0125000
NODE_2316_length_1493_cov_100.467719	1077	1157	927	1	80	0.0125000
NODE_2316_length_1493_cov_100.467719	1077	1157	932	2	80	0.0250000
NODE_2316_length_1493_cov_100.467719	1077	1157	934	1	80	0.0125000
NODE_2316_length_1493_cov_100.467719	1077	1157	935	1	80	0.0125000
NODE_2316_length_1493_cov_100.467719	1077	1157	938	1	80	0.0125000
NODE_2316_length_1493_cov_100.467719	1077	1157	943	1	80	0.0125000
NODE_2316_length_1493_cov_100.467719	1077	1157	946	1	80	0.0125000
NODE_2316_length_1493_cov_100.467719	1077	1157	948	2	80	0.0250000
NODE_2316_length_1493_cov_100.467719	1077	1157	961	1	80	0.0125000
NODE_2316_length_1493_cov_100.467719	1077	1157	965	1	80	0.0125000
NODE_2316_length_1493_cov_100.467719	1077	1157	967	1	80	0.0125000
NODE_2316_length_1493_cov_100.467719	1077	1157	972	2	80	0.0250000
NODE_2316_length_1493_cov_100.467719	1077	1157	976	1	80	0.0125000
NODE_2316_length_1493_cov_100.467719	1077	1157	978	1	80	0.0125000
NODE_2316_length_1493_cov_100.467719	1077	1157	985	1	80	0.0125000
NODE_2316_length_1493_cov_100.467719	1077	1157	995	1	80	0.0125000
NODE_2316_length_1493_cov_100.467719	1130	1210	872	1	80	0.0125000
NODE_2316_length_1493_cov_100.467719	1130	1210	878	2	80	0.0250000
NODE_2316_length_1493_cov_100.467719	1130	1210	885	1	80	0.0125000
NODE_2316_length_1493_cov_100.467719	1130	1210	889	3	80	0.0375000
NODE_2316_length_1493_cov_100.467719	1130	1210	891	1	80	0.0125000
NODE_2316_length_1493_cov_100.467719	1130	1210	894	1	80	0.0125000
NODE_2316_length_1493_cov_100.467719	1130	1210	898	2	80	0.0250000
NODE_2316_length_1493_cov_100.467719	1130	1210	899	2	80	0.0250000
NODE_2316_length_1493_cov_100.467719	1130	1210	900	1	80	0.0125000
NODE_2316_length_1493_cov_100.467719	1130	1210	905	2	80	0.0250000
NODE_2316_length_1493_cov_100.467719	1130	1210	915	1	80	0.0125000
NODE_2316_length_1493_cov_100.467719	1130	1210	922	1	80	0.0125000
NODE_2316_length_1493_cov_100.467719	1130	1210	923	1	80	0.0125000
NODE_2316_length_1493_cov_100.467719	1130	1210	926	1	80	0.0125000
NODE_2316_length_1493_cov_100.467719	1130	1210	927	1	80	0.0125000
NODE_2316_length_1493_cov_100.467719	1130	1210	932	2	80	0.0250000
NODE_2316_length_1493_cov_100.467719	1130	1210	934	1	80	0.0125000
NODE_2316_length_1493_cov_100.467719	1130	1210	935	1	80	0.0125000
NODE_2316_length_1493_cov_100.467719	1130	1210	938	1	80	0.0125000
NODE_2316_length_1493_cov_100.467719	1130	1210	940	1	80	0.0125000
NODE_2316_length_1493_cov_100.467719	1130	1210	942	2	80	0.0250000
NODE_2316_length_1493_cov_100.467719	1130	1210	943	3	80	0.0375000
NODE_2316_length_1493_cov_100.467719	1130	1210	946	1	80	0.0125000
NODE_2316_length_1493_cov_100.467719	1130	1210	948	2	80	0.0250000
NODE_2316_length_1493_cov_100.467719	1130	1210	950	2	80	0.0250000
NODE_2316_length_1493_cov_100.467719	1130	1210	951	1	80	0.0125000
NODE_2316_length_1493_cov_100.467719	1130	1210	953	2	80	0.0250000
NODE_2316_length_1493_cov_100.467719	1130	1210	957	1	80	0.0125000
NODE_2316_length_1493_cov_100.467719	1130	1210	961	1	80	0.0125000
NODE_2316_length_1493_cov_100.467719	1130	1210	965	3	80	0.0375000
NODE_2316_length_1493_cov_100.467719	1130	1210	967	1	80	0.0125000
NODE_2316_length_1493_cov_100.467719	1130	1210	969	1	80	0.0125000
NODE_2316_length_1493_cov_100.467719	1130	1210	970	1	80	0.0125000
NODE_2316_length_1493_cov_100.467719	1130	1210	972	2	80	0.0250000
NODE_2316_length_1493_cov_100.467719	1130	1210	973	1	80	0.0125000
NODE_2316_length_1493_cov_100.467719	1130	1210	975	1	80	0.0125000
NODE_2316_length_1493_cov_100.467719	1130	1210	976	3	80	0.0375000
NODE_2316_length_1493_cov_100.467719	1130	1210	978	1	80	0.0125000
NODE_2316_length_1493_cov_100.467719	1130	1210	981	1	80	0.0125000
NODE_2316_length_1493_cov_100.467719	1130	1210	983	1	80	0.0125000
NODE_2316_length_1493_cov_100.467719	1130	1210	985	1	80	0.0125000
NODE_2316_length_1493_cov_100.467719	1130	1210	989	3	80	0.0375000
NODE_2316_length_1493_cov_100.467719	1130	1210	992	1	80	0.0125000
NODE_2316_length_1493_cov_100.467719	1130	1210	994	1	80	0.0125000
NODE_2316_length_1493_cov_100.467719	1130	1210	995	3	80	0.0375000
NODE_2316_length_1493_cov_100.467719	1130	1210	996	2	80	0.0250000
NODE_2316_length_1493_cov_100.467719	1130	1210	997	1	80	0.0125000
NODE_2316_length_1493_cov_100.467719	1130	1210	998	1	80	0.0125000
NODE_2316_length_1493_cov_100.467719	1130	1210	1000	1	80	0.0125000
NODE_2316_length_1493_cov_100.467719	1130	1210	1001	1	80	0.0125000
NODE_2316_length_1493_cov_100.467719	1130	1210	1004	1	80	0.0125000
NODE_2316_length_1493_cov_100.467719	1130	1210	1007	1	80	0.0125000
NODE_2316_length_1493_cov_100.467719	1130	1210	1010	1	80	0.0125000
NODE_2316_length_1493_cov_100.467719	1130	1210	1012	1	80	0.0125000
NODE_2316_length_1493_cov_100.467719	1130	1210	1015	1	80	0.0125000
NODE_2316_length_1493_cov_100.467719	1130	1210	1016	1	80	0.0125000
NODE_2316_length_1493_cov_100.467719	1130	1210	1018	1	80	0.0125000
NODE_2321_length_1493_cov_1.138451	1341	1420	8	16	79	0.2025317
NODE_2321_length_1493_cov_1.138451	1341	1420	9	32	79	0.4050633
NODE_2321_length_1493_cov_1.138451	1341	1420	10	6	79	0.0759494
NODE_2321_length_1493_cov_1.138451	1341	1420	11	9	79	0.1139240
NODE_2321_length_1493_cov_1.138451	1341	1420	12	11	79	0.1392405
NODE_2321_length_1493_cov_1.138451	1341	1420	13	5	79	0.0632911
NODE_2321_length_1493_cov_1.138451	1341	1420	8	16	79	0.2025317
NODE_2321_length_1493_cov_1.138451	1341	1420	9	32	79	0.4050633
NODE_2321_length_1493_cov_1.138451	1341	1420	10	6	79	0.0759494
NODE_2321_length_1493_cov_1.138451	1341	1420	11	9	79	0.1139240
NODE_2321_length_1493_cov_1.138451	1341	1420	12	11	79	0.1392405
NODE_2321_length_1493_cov_1.138451	1341	1420	13	5	79	0.0632911
NODE_2321_length_1493_cov_1.138451	1393	1459	7	20	66	0.3030303
NODE_2321_length_1493_cov_1.138451	1393	1459	9	46	66	0.6969697
NODE_2332_length_1490_cov_5.726096	233	295	0	6	62	0.0967742
NODE_2332_length_1490_cov_5.726096	233	295	3	5	62	0.0806452
NODE_2332_length_1490_cov_5.726096	233	295	4	1	62	0.0161290
NODE_2332_length_1490_cov_5.726096	233	295	6	2	62	0.0322581
NODE_2332_length_1490_cov_5.726096	233	295	7	3	62	0.0483871
NODE_2332_length_1490_cov_5.726096	233	295	8	2	62	0.0322581
NODE_2332_length_1490_cov_5.726096	233	295	9	31	62	0.5000000
NODE_2332_length_1490_cov_5.726096	233	295	10	12	62	0.1935484
NODE_2332_length_1490_cov_5.726096	1065	1149	0	84	84	1.0000000
NODE_2333_length_1490_cov_4.687275	318	399	0	81	81	1.0000000
NODE_2333_length_1490_cov_4.687275	372	452	0	80	80	1.0000000
NODE_2338_length_1488_cov_3.734341	1141	1221	0	15	80	0.1875000
NODE_2338_length_1488_cov_3.734341	1141	1221	4	46	80	0.5750000
NODE_2338_length_1488_cov_3.734341	1141	1221	6	19	80	0.2375000
NODE_2340_length_1487_cov_19.332133	673	753	0	49	80	0.6125000
NODE_2340_length_1487_cov_19.332133	673	753	2	31	80	0.3875000
NODE_2340_length_1487_cov_19.332133	726	806	2	80	80	1.0000000
NODE_2348_length_1484_cov_38.342960	706	786	0	14	80	0.1750000
NODE_2348_length_1484_cov_38.342960	706	786	2	66	80	0.8250000
NODE_2348_length_1484_cov_38.342960	759	839	0	27	80	0.3375000
NODE_2348_length_1484_cov_38.342960	759	839	2	53	80	0.6625000
NODE_2349_length_1484_cov_21.260650	348	428	3	3	80	0.0375000
NODE_2349_length_1484_cov_21.260650	348	428	4	32	80	0.4000000
NODE_2349_length_1484_cov_21.260650	348	428	8	45	80	0.5625000
NODE_2349_length_1484_cov_21.260650	401	481	2	4	80	0.0500000
NODE_2349_length_1484_cov_21.260650	401	481	6	49	80	0.6125000
NODE_2349_length_1484_cov_21.260650	401	481	8	27	80	0.3375000
NODE_2349_length_1484_cov_21.260650	978	1058	0	80	80	1.0000000
NODE_2349_length_1484_cov_21.260650	1031	1111	0	80	80	1.0000000
NODE_2350_length_1484_cov_19.243321	952	1032	0	5	80	0.0625000
NODE_2350_length_1484_cov_19.243321	952	1032	1	25	80	0.3125000
NODE_2350_length_1484_cov_19.243321	952	1032	3	10	80	0.1250000
NODE_2350_length_1484_cov_19.243321	952	1032	4	40	80	0.5000000
NODE_2350_length_1484_cov_19.243321	1005	1085	0	58	80	0.7250000
NODE_2350_length_1484_cov_19.243321	1005	1085	1	22	80	0.2750000
NODE_2351_length_1484_cov_9.085199	314	394	0	80	80	1.0000000
NODE_2351_length_1484_cov_9.085199	367	447	0	80	80	1.0000000
NODE_2353_length_1483_cov_21.207370	555	635	4	6	80	0.0750000
NODE_2353_length_1483_cov_21.207370	555	635	6	7	80	0.0875000
NODE_2353_length_1483_cov_21.207370	555	635	8	28	80	0.3500000
NODE_2353_length_1483_cov_21.207370	555	635	10	39	80	0.4875000
NODE_2353_length_1483_cov_21.207370	608	688	2	37	80	0.4625000
NODE_2353_length_1483_cov_21.207370	608	688	6	7	80	0.0875000
NODE_2353_length_1483_cov_21.207370	608	688	8	36	80	0.4500000
NODE_2359_length_1482_cov_20.177874	430	510	2	17	80	0.2125000
NODE_2359_length_1482_cov_20.177874	430	510	4	60	80	0.7500000
NODE_2359_length_1482_cov_20.177874	430	510	6	3	80	0.0375000
NODE_2359_length_1482_cov_20.177874	483	563	0	29	80	0.3625000
NODE_2359_length_1482_cov_20.177874	483	563	4	51	80	0.6375000
NODE_2359_length_1482_cov_20.177874	559	639	0	80	80	1.0000000
NODE_2359_length_1482_cov_20.177874	612	692	0	80	80	1.0000000
NODE_2360_length_1482_cov_13.644252	1000	1080	0	80	80	1.0000000
NODE_2360_length_1482_cov_13.644252	1053	1133	0	80	80	1.0000000
NODE_2361_length_1482_cov_6.157628	525	605	8	37	80	0.4625000
NODE_2361_length_1482_cov_6.157628	525	605	10	18	80	0.2250000
NODE_2361_length_1482_cov_6.157628	525	605	12	25	80	0.3125000
NODE_2361_length_1482_cov_6.157628	578	658	4	7	80	0.0875000
NODE_2361_length_1482_cov_6.157628	578	658	6	32	80	0.4000000
NODE_2361_length_1482_cov_6.157628	578	658	8	2	80	0.0250000
NODE_2361_length_1482_cov_6.157628	578	658	10	2	80	0.0250000
NODE_2361_length_1482_cov_6.157628	578	658	11	1	80	0.0125000
NODE_2361_length_1482_cov_6.157628	578	658	12	36	80	0.4500000
NODE_2361_length_1482_cov_6.157628	1306	1388	6	12	82	0.1463415
NODE_2361_length_1482_cov_6.157628	1306	1388	10	3	82	0.0365854
NODE_2361_length_1482_cov_6.157628	1306	1388	12	1	82	0.0121951
NODE_2361_length_1482_cov_6.157628	1306	1388	14	3	82	0.0365854
NODE_2361_length_1482_cov_6.157628	1306	1388	18	12	82	0.1463415
NODE_2361_length_1482_cov_6.157628	1306	1388	20	1	82	0.0121951
NODE_2361_length_1482_cov_6.157628	1306	1388	22	5	82	0.0609756
NODE_2361_length_1482_cov_6.157628	1306	1388	24	26	82	0.3170732
NODE_2361_length_1482_cov_6.157628	1306	1388	28	19	82	0.2317073
NODE_2364_length_1481_cov_19.238784	480	560	6	30	80	0.3750000
NODE_2364_length_1481_cov_19.238784	480	560	8	50	80	0.6250000
NODE_2364_length_1481_cov_19.238784	533	613	0	22	80	0.2750000
NODE_2364_length_1481_cov_19.238784	533	613	5	2	80	0.0250000
NODE_2364_length_1481_cov_19.238784	533	613	6	56	80	0.7000000
NODE_2365_length_1481_cov_18.139653	706	786	0	80	80	1.0000000
NODE_2365_length_1481_cov_18.139653	759	839	0	80	80	1.0000000
NODE_2367_length_1480_cov_27.552498	762	842	0	80	80	1.0000000
NODE_2367_length_1480_cov_27.552498	815	895	0	80	80	1.0000000
NODE_2367_length_1480_cov_27.552498	891	971	0	80	80	1.0000000
NODE_2367_length_1480_cov_27.552498	944	1024	0	80	80	1.0000000
NODE_2367_length_1480_cov_27.552498	1171	1222	15	12	51	0.2352941
NODE_2367_length_1480_cov_27.552498	1171	1222	17	1	51	0.0196078
NODE_2367_length_1480_cov_27.552498	1171	1222	19	4	51	0.0784314
NODE_2367_length_1480_cov_27.552498	1171	1222	36	1	51	0.0196078
NODE_2367_length_1480_cov_27.552498	1171	1222	45	1	51	0.0196078
NODE_2367_length_1480_cov_27.552498	1171	1222	47	1	51	0.0196078
NODE_2367_length_1480_cov_27.552498	1171	1222	49	1	51	0.0196078
NODE_2367_length_1480_cov_27.552498	1171	1222	53	2	51	0.0392157
NODE_2367_length_1480_cov_27.552498	1171	1222	55	5	51	0.0980392
NODE_2367_length_1480_cov_27.552498	1171	1222	57	2	51	0.0392157
NODE_2367_length_1480_cov_27.552498	1171	1222	61	1	51	0.0196078
NODE_2367_length_1480_cov_27.552498	1171	1222	73	2	51	0.0392157
NODE_2367_length_1480_cov_27.552498	1171	1222	75	3	51	0.0588235
NODE_2367_length_1480_cov_27.552498	1171	1222	77	1	51	0.0196078
NODE_2367_length_1480_cov_27.552498	1171	1222	79	5	51	0.0980392
NODE_2367_length_1480_cov_27.552498	1171	1222	83	7	51	0.1372549
NODE_2367_length_1480_cov_27.552498	1171	1222	85	2	51	0.0392157
NODE_2369_length_1480_cov_12.535844	466	546	6	40	80	0.5000000
NODE_2369_length_1480_cov_12.535844	466	546	10	2	80	0.0250000
NODE_2369_length_1480_cov_12.535844	466	546	11	1	80	0.0125000
NODE_2369_length_1480_cov_12.535844	466	546	12	37	80	0.4625000
NODE_2369_length_1480_cov_12.535844	519	599	4	24	80	0.3000000
NODE_2369_length_1480_cov_12.535844	519	599	6	19	80	0.2375000
NODE_2369_length_1480_cov_12.535844	519	599	12	37	80	0.4625000
NODE_2373_length_1479_cov_17.035507	708	788	0	80	80	1.0000000
NODE_2373_length_1479_cov_17.035507	761	841	0	80	80	1.0000000
NODE_2373_length_1479_cov_17.035507	837	917	0	7	80	0.0875000
NODE_2373_length_1479_cov_17.035507	837	917	4	17	80	0.2125000
NODE_2373_length_1479_cov_17.035507	837	917	10	56	80	0.7000000
NODE_2373_length_1479_cov_17.035507	890	970	6	36	80	0.4500000
NODE_2373_length_1479_cov_17.035507	890	970	10	44	80	0.5500000
NODE_2374_length_1479_cov_16.448551	908	988	4	80	80	1.0000000
NODE_2374_length_1479_cov_16.448551	961	1041	0	36	80	0.4500000
NODE_2374_length_1479_cov_16.448551	961	1041	4	44	80	0.5500000
NODE_2375_length_1479_cov_5.285507	123	185	0	43	62	0.6935484
NODE_2375_length_1479_cov_5.285507	123	185	4	1	62	0.0161290
NODE_2375_length_1479_cov_5.285507	123	185	6	18	62	0.2903226
NODE_2376_length_1479_cov_2.018841	881	967	4	34	86	0.3953488
NODE_2376_length_1479_cov_2.018841	881	967	6	23	86	0.2674419
NODE_2376_length_1479_cov_2.018841	881	967	10	29	86	0.3372093
NODE_2377_length_1478_cov_32.050761	411	491	0	80	80	1.0000000
NODE_2377_length_1478_cov_32.050761	464	544	0	80	80	1.0000000
NODE_2377_length_1478_cov_32.050761	540	620	0	80	80	1.0000000
NODE_2377_length_1478_cov_32.050761	593	673	0	75	80	0.9375000
NODE_2377_length_1478_cov_32.050761	593	673	2	5	80	0.0625000
NODE_2378_length_1478_cov_27.414793	817	897	0	6	80	0.0750000
NODE_2378_length_1478_cov_27.414793	817	897	1	51	80	0.6375000
NODE_2378_length_1478_cov_27.414793	817	897	2	23	80	0.2875000
NODE_2378_length_1478_cov_27.414793	870	950	1	4	80	0.0500000
NODE_2378_length_1478_cov_27.414793	870	950	2	76	80	0.9500000
NODE_2379_length_1478_cov_23.472081	1212	1241	23	1	29	0.0344828
NODE_2379_length_1478_cov_23.472081	1212	1241	25	5	29	0.1724138
NODE_2379_length_1478_cov_23.472081	1212	1241	32	1	29	0.0344828
NODE_2379_length_1478_cov_23.472081	1212	1241	33	1	29	0.0344828
NODE_2379_length_1478_cov_23.472081	1212	1241	35	1	29	0.0344828
NODE_2379_length_1478_cov_23.472081	1212	1241	37	2	29	0.0689655
NODE_2379_length_1478_cov_23.472081	1212	1241	41	3	29	0.1034483
NODE_2379_length_1478_cov_23.472081	1212	1241	43	1	29	0.0344828
NODE_2379_length_1478_cov_23.472081	1212	1241	44	2	29	0.0689655
NODE_2379_length_1478_cov_23.472081	1212	1241	46	2	29	0.0689655
NODE_2379_length_1478_cov_23.472081	1212	1241	52	1	29	0.0344828
NODE_2379_length_1478_cov_23.472081	1212	1241	54	4	29	0.1379310
NODE_2379_length_1478_cov_23.472081	1212	1241	60	5	29	0.1724138
NODE_2380_length_1478_cov_10.746193	678	758	0	35	80	0.4375000
NODE_2380_length_1478_cov_10.746193	678	758	2	30	80	0.3750000
NODE_2380_length_1478_cov_10.746193	678	758	4	15	80	0.1875000
NODE_2380_length_1478_cov_10.746193	731	811	0	2	80	0.0250000
NODE_2380_length_1478_cov_10.746193	731	811	2	40	80	0.5000000
NODE_2380_length_1478_cov_10.746193	731	811	4	38	80	0.4750000
NODE_2380_length_1478_cov_10.746193	807	892	0	52	85	0.6117647
NODE_2380_length_1478_cov_10.746193	807	892	2	33	85	0.3882353
NODE_2380_length_1478_cov_10.746193	860	945	0	1	85	0.0117647
NODE_2380_length_1478_cov_10.746193	860	945	2	84	85	0.9882353
NODE_2384_length_1476_cov_6.522150	791	871	0	57	80	0.7125000
NODE_2384_length_1476_cov_6.522150	791	871	4	23	80	0.2875000
NODE_2384_length_1476_cov_6.522150	844	924	0	8	80	0.1000000
NODE_2384_length_1476_cov_6.522150	844	924	4	72	80	0.9000000
NODE_2392_length_1474_cov_11.209455	515	595	0	51	80	0.6375000
NODE_2392_length_1474_cov_11.209455	515	595	2	29	80	0.3625000
NODE_2392_length_1474_cov_11.209455	568	648	2	80	80	1.0000000
NODE_2397_length_1472_cov_22.159505	428	508	6	40	80	0.5000000
NODE_2397_length_1472_cov_22.159505	428	508	10	40	80	0.5000000
NODE_2397_length_1472_cov_22.159505	428	508	6	40	80	0.5000000
NODE_2397_length_1472_cov_22.159505	428	508	10	40	80	0.5000000
NODE_2397_length_1472_cov_22.159505	481	561	0	31	80	0.3875000
NODE_2397_length_1472_cov_22.159505	481	561	2	2	80	0.0250000
NODE_2397_length_1472_cov_22.159505	481	561	4	2	80	0.0250000
NODE_2397_length_1472_cov_22.159505	481	561	6	29	80	0.3625000
NODE_2397_length_1472_cov_22.159505	481	561	20	4	80	0.0500000
NODE_2397_length_1472_cov_22.159505	481	561	25	1	80	0.0125000
NODE_2397_length_1472_cov_22.159505	481	561	26	4	80	0.0500000
NODE_2397_length_1472_cov_22.159505	481	561	28	3	80	0.0375000
NODE_2397_length_1472_cov_22.159505	481	561	29	1	80	0.0125000
NODE_2397_length_1472_cov_22.159505	481	561	31	1	80	0.0125000
NODE_2397_length_1472_cov_22.159505	481	561	33	1	80	0.0125000
NODE_2397_length_1472_cov_22.159505	481	561	34	1	80	0.0125000
NODE_2397_length_1472_cov_22.159505	913	993	2	48	80	0.6000000
NODE_2397_length_1472_cov_22.159505	913	993	6	32	80	0.4000000
NODE_2397_length_1472_cov_22.159505	966	1046	4	4	80	0.0500000
NODE_2397_length_1472_cov_22.159505	966	1046	6	76	80	0.9500000
NODE_2397_length_1472_cov_22.159505	1042	1122	0	57	80	0.7125000
NODE_2397_length_1472_cov_22.159505	1042	1122	4	23	80	0.2875000
NODE_2397_length_1472_cov_22.159505	1095	1175	0	80	80	1.0000000
NODE_2398_length_1472_cov_22.018208	523	590	0	67	67	1.0000000
NODE_2398_length_1472_cov_22.018208	563	643	0	80	80	1.0000000
NODE_2398_length_1472_cov_22.018208	639	719	0	80	80	1.0000000
NODE_2398_length_1472_cov_22.018208	692	772	0	80	80	1.0000000
NODE_2404_length_1470_cov_7.042305	5	57	65	1	52	0.0192308
NODE_2404_length_1470_cov_7.042305	5	57	74	1	52	0.0192308
NODE_2404_length_1470_cov_7.042305	5	57	78	2	52	0.0384615
NODE_2404_length_1470_cov_7.042305	5	57	88	1	52	0.0192308
NODE_2404_length_1470_cov_7.042305	5	57	92	2	52	0.0384615
NODE_2404_length_1470_cov_7.042305	5	57	94	1	52	0.0192308
NODE_2404_length_1470_cov_7.042305	5	57	101	1	52	0.0192308
NODE_2404_length_1470_cov_7.042305	5	57	107	1	52	0.0192308
NODE_2404_length_1470_cov_7.042305	5	57	109	1	52	0.0192308
NODE_2404_length_1470_cov_7.042305	5	57	115	1	52	0.0192308
NODE_2404_length_1470_cov_7.042305	5	57	121	2	52	0.0384615
NODE_2404_length_1470_cov_7.042305	5	57	123	1	52	0.0192308
NODE_2404_length_1470_cov_7.042305	5	57	153	3	52	0.0576923
NODE_2404_length_1470_cov_7.042305	5	57	157	1	52	0.0192308
NODE_2404_length_1470_cov_7.042305	5	57	159	1	52	0.0192308
NODE_2404_length_1470_cov_7.042305	5	57	161	1	52	0.0192308
NODE_2404_length_1470_cov_7.042305	5	57	165	7	52	0.1346154
NODE_2404_length_1470_cov_7.042305	5	57	166	1	52	0.0192308
NODE_2404_length_1470_cov_7.042305	5	57	168	5	52	0.0961538
NODE_2404_length_1470_cov_7.042305	5	57	170	18	52	0.3461539
NODE_2405_length_1470_cov_2.185266	199	245	2	14	46	0.3043478
NODE_2405_length_1470_cov_2.185266	199	245	4	32	46	0.6956522
NODE_2407_length_1469_cov_5.683942	834	914	0	23	80	0.2875000
NODE_2407_length_1469_cov_5.683942	834	914	2	57	80	0.7125000
NODE_2407_length_1469_cov_5.683942	887	967	0	76	80	0.9500000
NODE_2407_length_1469_cov_5.683942	887	967	2	4	80	0.0500000
NODE_2410_length_1467_cov_31.231725	1048	1131	0	83	83	1.0000000
NODE_2411_length_1467_cov_19.731725	485	565	4	24	80	0.3000000
NODE_2411_length_1467_cov_19.731725	485	565	6	1	80	0.0125000
NODE_2411_length_1467_cov_19.731725	485	565	11	5	80	0.0625000
NODE_2411_length_1467_cov_19.731725	485	565	12	4	80	0.0500000
NODE_2411_length_1467_cov_19.731725	485	565	14	19	80	0.2375000
NODE_2411_length_1467_cov_19.731725	485	565	15	27	80	0.3375000
NODE_2411_length_1467_cov_19.731725	538	618	2	16	80	0.2000000
NODE_2411_length_1467_cov_19.731725	538	618	4	24	80	0.3000000
NODE_2411_length_1467_cov_19.731725	538	618	6	38	80	0.4750000
NODE_2411_length_1467_cov_19.731725	538	618	14	2	80	0.0250000
NODE_2412_length_1467_cov_11.807749	180	242	12	15	62	0.2419355
NODE_2412_length_1467_cov_11.807749	180	242	14	1	62	0.0161290
NODE_2412_length_1467_cov_11.807749	180	242	16	2	62	0.0322581
NODE_2412_length_1467_cov_11.807749	180	242	18	7	62	0.1129032
NODE_2412_length_1467_cov_11.807749	180	242	22	1	62	0.0161290
NODE_2412_length_1467_cov_11.807749	180	242	24	5	62	0.0806452
NODE_2412_length_1467_cov_11.807749	180	242	26	31	62	0.5000000
NODE_2412_length_1467_cov_11.807749	264	293	8	4	29	0.1379310
NODE_2412_length_1467_cov_11.807749	264	293	12	7	29	0.2413793
NODE_2412_length_1467_cov_11.807749	264	293	14	3	29	0.1034483
NODE_2412_length_1467_cov_11.807749	264	293	18	9	29	0.3103448
NODE_2412_length_1467_cov_11.807749	264	293	20	2	29	0.0689655
NODE_2412_length_1467_cov_11.807749	264	293	22	3	29	0.1034483
NODE_2412_length_1467_cov_11.807749	264	293	24	1	29	0.0344828
NODE_2412_length_1467_cov_11.807749	930	1010	1	7	80	0.0875000
NODE_2412_length_1467_cov_11.807749	930	1010	2	31	80	0.3875000
NODE_2412_length_1467_cov_11.807749	930	1010	3	42	80	0.5250000
NODE_2412_length_1467_cov_11.807749	983	1063	1	31	80	0.3875000
NODE_2412_length_1467_cov_11.807749	983	1063	2	10	80	0.1250000
NODE_2412_length_1467_cov_11.807749	983	1063	3	39	80	0.4875000
NODE_2414_length_1466_cov_41.326993	664	744	6	38	80	0.4750000
NODE_2414_length_1466_cov_41.326993	664	744	8	27	80	0.3375000
NODE_2414_length_1466_cov_41.326993	664	744	9	12	80	0.1500000
NODE_2414_length_1466_cov_41.326993	664	744	10	3	80	0.0375000
NODE_2414_length_1466_cov_41.326993	717	797	6	4	80	0.0500000
NODE_2414_length_1466_cov_41.326993	717	797	7	20	80	0.2500000
NODE_2414_length_1466_cov_41.326993	717	797	8	16	80	0.2000000
NODE_2414_length_1466_cov_41.326993	717	797	9	16	80	0.2000000
NODE_2414_length_1466_cov_41.326993	717	797	10	10	80	0.1250000
NODE_2414_length_1466_cov_41.326993	717	797	11	14	80	0.1750000
NODE_2414_length_1466_cov_41.326993	793	873	8	11	80	0.1375000
NODE_2414_length_1466_cov_41.326993	793	873	10	15	80	0.1875000
NODE_2414_length_1466_cov_41.326993	793	873	14	2	80	0.0250000
NODE_2414_length_1466_cov_41.326993	793	873	18	23	80	0.2875000
NODE_2414_length_1466_cov_41.326993	793	873	19	4	80	0.0500000
NODE_2414_length_1466_cov_41.326993	793	873	20	15	80	0.1875000
NODE_2414_length_1466_cov_41.326993	793	873	23	10	80	0.1250000
NODE_2414_length_1466_cov_41.326993	846	926	14	21	80	0.2625000
NODE_2414_length_1466_cov_41.326993	846	926	17	1	80	0.0125000
NODE_2414_length_1466_cov_41.326993	846	926	19	14	80	0.1750000
NODE_2414_length_1466_cov_41.326993	846	926	20	28	80	0.3500000
NODE_2414_length_1466_cov_41.326993	846	926	21	3	80	0.0375000
NODE_2414_length_1466_cov_41.326993	846	926	22	3	80	0.0375000
NODE_2414_length_1466_cov_41.326993	846	926	23	10	80	0.1250000
NODE_2420_length_1464_cov_6.726740	137	204	8	14	67	0.2089552
NODE_2420_length_1464_cov_6.726740	137	204	12	4	67	0.0597015
NODE_2420_length_1464_cov_6.726740	137	204	14	8	67	0.1194030
NODE_2420_length_1464_cov_6.726740	137	204	16	3	67	0.0447761
NODE_2420_length_1464_cov_6.726740	137	204	21	1	67	0.0149254
NODE_2420_length_1464_cov_6.726740	137	204	22	26	67	0.3880597
NODE_2420_length_1464_cov_6.726740	137	204	24	11	67	0.1641791
NODE_2422_length_1464_cov_2.198535	1301	1363	28	1	62	0.0161290
NODE_2422_length_1464_cov_2.198535	1301	1363	31	1	62	0.0161290
NODE_2422_length_1464_cov_2.198535	1301	1363	32	1	62	0.0161290
NODE_2422_length_1464_cov_2.198535	1301	1363	36	3	62	0.0483871
NODE_2422_length_1464_cov_2.198535	1301	1363	39	1	62	0.0161290
NODE_2422_length_1464_cov_2.198535	1301	1363	40	1	62	0.0161290
NODE_2422_length_1464_cov_2.198535	1301	1363	44	1	62	0.0161290
NODE_2422_length_1464_cov_2.198535	1301	1363	46	2	62	0.0322581
NODE_2422_length_1464_cov_2.198535	1301	1363	49	2	62	0.0322581
NODE_2422_length_1464_cov_2.198535	1301	1363	58	1	62	0.0161290
NODE_2422_length_1464_cov_2.198535	1301	1363	66	1	62	0.0161290
NODE_2422_length_1464_cov_2.198535	1301	1363	68	1	62	0.0161290
NODE_2422_length_1464_cov_2.198535	1301	1363	72	1	62	0.0161290
NODE_2422_length_1464_cov_2.198535	1301	1363	74	1	62	0.0161290
NODE_2422_length_1464_cov_2.198535	1301	1363	75	1	62	0.0161290
NODE_2422_length_1464_cov_2.198535	1301	1363	78	1	62	0.0161290
NODE_2422_length_1464_cov_2.198535	1301	1363	80	1	62	0.0161290
NODE_2422_length_1464_cov_2.198535	1301	1363	82	1	62	0.0161290
NODE_2422_length_1464_cov_2.198535	1301	1363	83	1	62	0.0161290
NODE_2422_length_1464_cov_2.198535	1301	1363	85	1	62	0.0161290
NODE_2422_length_1464_cov_2.198535	1301	1363	91	3	62	0.0483871
NODE_2422_length_1464_cov_2.198535	1301	1363	96	1	62	0.0161290
NODE_2422_length_1464_cov_2.198535	1301	1363	100	1	62	0.0161290
NODE_2422_length_1464_cov_2.198535	1301	1363	113	2	62	0.0322581
NODE_2422_length_1464_cov_2.198535	1301	1363	115	1	62	0.0161290
NODE_2422_length_1464_cov_2.198535	1301	1363	117	2	62	0.0322581
NODE_2422_length_1464_cov_2.198535	1301	1363	123	2	62	0.0322581
NODE_2422_length_1464_cov_2.198535	1301	1363	129	1	62	0.0161290
NODE_2422_length_1464_cov_2.198535	1301	1363	131	1	62	0.0161290
NODE_2422_length_1464_cov_2.198535	1301	1363	136	1	62	0.0161290
NODE_2422_length_1464_cov_2.198535	1301	1363	138	1	62	0.0161290
NODE_2422_length_1464_cov_2.198535	1301	1363	140	3	62	0.0483871
NODE_2422_length_1464_cov_2.198535	1301	1363	142	3	62	0.0483871
NODE_2422_length_1464_cov_2.198535	1301	1363	146	1	62	0.0161290
NODE_2422_length_1464_cov_2.198535	1301	1363	148	1	62	0.0161290
NODE_2422_length_1464_cov_2.198535	1301	1363	151	1	62	0.0161290
NODE_2422_length_1464_cov_2.198535	1301	1363	152	5	62	0.0806452
NODE_2422_length_1464_cov_2.198535	1301	1363	154	1	62	0.0161290
NODE_2422_length_1464_cov_2.198535	1301	1363	156	4	62	0.0645161
NODE_2422_length_1464_cov_2.198535	1301	1363	158	3	62	0.0483871
NODE_2425_length_1463_cov_15.345308	314	394	0	46	80	0.5750000
NODE_2425_length_1463_cov_15.345308	314	394	4	34	80	0.4250000
NODE_2425_length_1463_cov_15.345308	367	447	0	33	80	0.4125000
NODE_2425_length_1463_cov_15.345308	367	447	2	47	80	0.5875000
NODE_2427_length_1462_cov_18.082172	418	498	2	24	80	0.3000000
NODE_2427_length_1462_cov_18.082172	418	498	14	15	80	0.1875000
NODE_2427_length_1462_cov_18.082172	418	498	16	41	80	0.5125000
NODE_2427_length_1462_cov_18.082172	471	551	6	15	80	0.1875000
NODE_2427_length_1462_cov_18.082172	471	551	8	2	80	0.0250000
NODE_2427_length_1462_cov_18.082172	471	551	14	3	80	0.0375000
NODE_2427_length_1462_cov_18.082172	471	551	16	24	80	0.3000000
NODE_2427_length_1462_cov_18.082172	471	551	18	20	80	0.2500000
NODE_2427_length_1462_cov_18.082172	471	551	19	1	80	0.0125000
NODE_2427_length_1462_cov_18.082172	471	551	20	15	80	0.1875000
NODE_2427_length_1462_cov_18.082172	1036	1116	12	8	80	0.1000000
NODE_2427_length_1462_cov_18.082172	1036	1116	13	31	80	0.3875000
NODE_2427_length_1462_cov_18.082172	1036	1116	14	4	80	0.0500000
NODE_2427_length_1462_cov_18.082172	1036	1116	15	10	80	0.1250000
NODE_2427_length_1462_cov_18.082172	1036	1116	16	5	80	0.0625000
NODE_2427_length_1462_cov_18.082172	1036	1116	17	22	80	0.2750000
NODE_2427_length_1462_cov_18.082172	1089	1169	6	13	80	0.1625000
NODE_2427_length_1462_cov_18.082172	1089	1169	8	18	80	0.2250000
NODE_2427_length_1462_cov_18.082172	1089	1169	10	11	80	0.1375000
NODE_2427_length_1462_cov_18.082172	1089	1169	12	19	80	0.2375000
NODE_2427_length_1462_cov_18.082172	1089	1169	14	4	80	0.0500000
NODE_2427_length_1462_cov_18.082172	1089	1169	15	8	80	0.1000000
NODE_2427_length_1462_cov_18.082172	1089	1169	16	5	80	0.0625000
NODE_2427_length_1462_cov_18.082172	1089	1169	17	2	80	0.0250000
NODE_2428_length_1462_cov_1.792370	1247	1319	0	72	72	1.0000000
NODE_2428_length_1462_cov_1.792370	1305	1374	0	69	69	1.0000000
NODE_2433_length_1460_cov_23.927994	852	932	2	7	80	0.0875000
NODE_2433_length_1460_cov_23.927994	852	932	7	1	80	0.0125000
NODE_2433_length_1460_cov_23.927994	852	932	8	72	80	0.9000000
NODE_2433_length_1460_cov_23.927994	905	985	2	13	80	0.1625000
NODE_2433_length_1460_cov_23.927994	905	985	8	67	80	0.8375000
NODE_2436_length_1459_cov_43.600000	535	615	0	11	80	0.1375000
NODE_2436_length_1459_cov_43.600000	535	615	1	57	80	0.7125000
NODE_2436_length_1459_cov_43.600000	535	615	4	12	80	0.1500000
NODE_2436_length_1459_cov_43.600000	588	668	0	11	80	0.1375000
NODE_2436_length_1459_cov_43.600000	588	668	1	4	80	0.0500000
NODE_2436_length_1459_cov_43.600000	588	668	4	35	80	0.4375000
NODE_2436_length_1459_cov_43.600000	588	668	8	6	80	0.0750000
NODE_2436_length_1459_cov_43.600000	588	668	26	24	80	0.3000000
NODE_2436_length_1459_cov_43.600000	664	744	18	32	80	0.4000000
NODE_2436_length_1459_cov_43.600000	664	744	21	3	80	0.0375000
NODE_2436_length_1459_cov_43.600000	664	744	22	14	80	0.1750000
NODE_2436_length_1459_cov_43.600000	664	744	26	31	80	0.3875000
NODE_2436_length_1459_cov_43.600000	717	797	0	4	80	0.0500000
NODE_2436_length_1459_cov_43.600000	717	797	18	76	80	0.9500000
NODE_2437_length_1459_cov_32.276471	865	945	0	80	80	1.0000000
NODE_2437_length_1459_cov_32.276471	918	998	0	80	80	1.0000000
NODE_2437_length_1459_cov_32.276471	994	1074	0	80	80	1.0000000
NODE_2437_length_1459_cov_32.276471	1047	1127	0	80	80	1.0000000
NODE_2441_length_1458_cov_2.184695	1361	1441	0	12	80	0.1500000
NODE_2441_length_1458_cov_2.184695	1361	1441	2	41	80	0.5125000
NODE_2441_length_1458_cov_2.184695	1361	1441	4	6	80	0.0750000
NODE_2441_length_1458_cov_2.184695	1361	1441	6	21	80	0.2625000
NODE_2442_length_1457_cov_19.687040	834	914	0	80	80	1.0000000
NODE_2442_length_1457_cov_19.687040	887	967	0	80	80	1.0000000
NODE_2442_length_1457_cov_19.687040	963	1043	0	80	80	1.0000000
NODE_2442_length_1457_cov_19.687040	1016	1096	0	80	80	1.0000000
NODE_2444_length_1457_cov_14.944772	754	834	0	35	80	0.4375000
NODE_2444_length_1457_cov_14.944772	754	834	2	45	80	0.5625000
NODE_2444_length_1457_cov_14.944772	807	887	0	18	80	0.2250000
NODE_2444_length_1457_cov_14.944772	807	887	2	62	80	0.7750000
NODE_2445_length_1457_cov_10.168630	827	907	1	69	80	0.8625000
NODE_2445_length_1457_cov_10.168630	827	907	2	11	80	0.1375000
NODE_2445_length_1457_cov_10.168630	880	960	1	69	80	0.8625000
NODE_2445_length_1457_cov_10.168630	880	960	2	11	80	0.1375000
NODE_2445_length_1457_cov_10.168630	956	1036	1	80	80	1.0000000
NODE_2445_length_1457_cov_10.168630	1009	1089	0	46	80	0.5750000
NODE_2445_length_1457_cov_10.168630	1009	1089	1	34	80	0.4250000
NODE_2448_length_1456_cov_13.675755	557	637	0	12	80	0.1500000
NODE_2448_length_1456_cov_13.675755	557	637	4	31	80	0.3875000
NODE_2448_length_1456_cov_13.675755	557	637	6	6	80	0.0750000
NODE_2448_length_1456_cov_13.675755	557	637	8	31	80	0.3875000
NODE_2448_length_1456_cov_13.675755	610	690	4	18	80	0.2250000
NODE_2448_length_1456_cov_13.675755	610	690	6	2	80	0.0250000
NODE_2448_length_1456_cov_13.675755	610	690	7	1	80	0.0125000
NODE_2448_length_1456_cov_13.675755	610	690	8	43	80	0.5375000
NODE_2448_length_1456_cov_13.675755	610	690	10	16	80	0.2000000
NODE_2449_length_1456_cov_11.109064	951	1031	0	42	80	0.5250000
NODE_2449_length_1456_cov_11.109064	951	1031	1	24	80	0.3000000
NODE_2449_length_1456_cov_11.109064	951	1031	2	14	80	0.1750000
NODE_2449_length_1456_cov_11.109064	1004	1084	0	80	80	1.0000000
NODE_2452_length_1456_cov_3.137067	374	410	7	2	36	0.0555556
NODE_2452_length_1456_cov_3.137067	374	410	11	1	36	0.0277778
NODE_2452_length_1456_cov_3.137067	374	410	13	13	36	0.3611111
NODE_2452_length_1456_cov_3.137067	374	410	17	3	36	0.0833333
NODE_2452_length_1456_cov_3.137067	374	410	19	5	36	0.1388889
NODE_2452_length_1456_cov_3.137067	374	410	23	3	36	0.0833333
NODE_2452_length_1456_cov_3.137067	374	410	25	8	36	0.2222222
NODE_2452_length_1456_cov_3.137067	374	410	26	1	36	0.0277778
NODE_2454_length_1456_cov_1.889462	35	99	2	64	64	1.0000000
NODE_2456_length_1455_cov_60.874631	369	449	0	54	80	0.6750000
NODE_2456_length_1455_cov_60.874631	369	449	4	26	80	0.3250000
NODE_2456_length_1455_cov_60.874631	422	502	0	1	80	0.0125000
NODE_2456_length_1455_cov_60.874631	422	502	4	68	80	0.8500000
NODE_2456_length_1455_cov_60.874631	422	502	14	11	80	0.1375000
NODE_2456_length_1455_cov_60.874631	498	578	10	15	80	0.1875000
NODE_2456_length_1455_cov_60.874631	498	578	14	58	80	0.7250000
NODE_2456_length_1455_cov_60.874631	498	578	17	7	80	0.0875000
NODE_2456_length_1455_cov_60.874631	551	631	6	24	80	0.3000000
NODE_2456_length_1455_cov_60.874631	551	631	10	7	80	0.0875000
NODE_2456_length_1455_cov_60.874631	551	631	14	20	80	0.2500000
NODE_2456_length_1455_cov_60.874631	551	631	17	13	80	0.1625000
NODE_2456_length_1455_cov_60.874631	551	631	20	16	80	0.2000000
NODE_2458_length_1455_cov_35.253687	615	695	12	8	80	0.1000000
NODE_2458_length_1455_cov_35.253687	615	695	13	17	80	0.2125000
NODE_2458_length_1455_cov_35.253687	615	695	14	7	80	0.0875000
NODE_2458_length_1455_cov_35.253687	615	695	15	36	80	0.4500000
NODE_2458_length_1455_cov_35.253687	615	695	19	12	80	0.1500000
NODE_2458_length_1455_cov_35.253687	668	748	10	4	80	0.0500000
NODE_2458_length_1455_cov_35.253687	668	748	12	12	80	0.1500000
NODE_2458_length_1455_cov_35.253687	668	748	13	35	80	0.4375000
NODE_2458_length_1455_cov_35.253687	668	748	15	15	80	0.1875000
NODE_2458_length_1455_cov_35.253687	668	748	16	1	80	0.0125000
NODE_2458_length_1455_cov_35.253687	668	748	17	3	80	0.0375000
NODE_2458_length_1455_cov_35.253687	668	748	18	4	80	0.0500000
NODE_2458_length_1455_cov_35.253687	668	748	19	6	80	0.0750000
NODE_2458_length_1455_cov_35.253687	744	824	10	11	80	0.1375000
NODE_2458_length_1455_cov_35.253687	744	824	11	61	80	0.7625000
NODE_2458_length_1455_cov_35.253687	744	824	12	8	80	0.1000000
NODE_2458_length_1455_cov_35.253687	797	877	5	14	80	0.1750000
NODE_2458_length_1455_cov_35.253687	797	877	9	36	80	0.4500000
NODE_2458_length_1455_cov_35.253687	797	877	11	30	80	0.3750000
NODE_2465_length_1452_cov_7.101256	976	1056	0	80	80	1.0000000
NODE_2465_length_1452_cov_7.101256	1029	1109	0	80	80	1.0000000
NODE_2465_length_1452_cov_7.101256	1105	1185	0	80	80	1.0000000
NODE_2465_length_1452_cov_7.101256	1158	1238	0	80	80	1.0000000
NODE_2470_length_1451_cov_23.880178	439	520	14	24	81	0.2962963
NODE_2470_length_1451_cov_23.880178	439	520	16	18	81	0.2222222
NODE_2470_length_1451_cov_23.880178	439	520	20	39	81	0.4814815
NODE_2470_length_1451_cov_23.880178	493	573	6	4	80	0.0500000
NODE_2470_length_1451_cov_23.880178	493	573	10	13	80	0.1625000
NODE_2470_length_1451_cov_23.880178	493	573	12	28	80	0.3500000
NODE_2470_length_1451_cov_23.880178	493	573	18	7	80	0.0875000
NODE_2470_length_1451_cov_23.880178	493	573	20	27	80	0.3375000
NODE_2470_length_1451_cov_23.880178	493	573	24	1	80	0.0125000
NODE_2471_length_1451_cov_16.249260	422	502	8	80	80	1.0000000
NODE_2471_length_1451_cov_16.249260	475	555	0	44	80	0.5500000
NODE_2471_length_1451_cov_16.249260	475	555	2	8	80	0.1000000
NODE_2471_length_1451_cov_16.249260	475	555	8	28	80	0.3500000
NODE_2472_length_1451_cov_8.663462	908	988	2	80	80	1.0000000
NODE_2472_length_1451_cov_8.663462	961	1040	0	50	79	0.6329114
NODE_2472_length_1451_cov_8.663462	961	1040	2	29	79	0.3670886
NODE_2474_length_1451_cov_5.219675	897	977	0	80	80	1.0000000
NODE_2474_length_1451_cov_5.219675	950	1030	0	80	80	1.0000000
NODE_2477_length_1450_cov_20.371577	611	691	0	73	80	0.9125000
NODE_2477_length_1450_cov_20.371577	611	691	6	7	80	0.0875000
NODE_2477_length_1450_cov_20.371577	664	744	0	20	80	0.2500000
NODE_2477_length_1450_cov_20.371577	664	744	6	60	80	0.7500000
NODE_2482_length_1449_cov_24.665926	432	512	0	49	80	0.6125000
NODE_2482_length_1449_cov_24.665926	432	512	2	31	80	0.3875000
NODE_2482_length_1449_cov_24.665926	485	565	0	80	80	1.0000000
NODE_2482_length_1449_cov_24.665926	561	643	0	82	82	1.0000000
NODE_2482_length_1449_cov_24.665926	616	696	0	80	80	1.0000000
NODE_2485_length_1448_cov_20.587102	904	984	0	75	80	0.9375000
NODE_2485_length_1448_cov_20.587102	904	984	4	5	80	0.0625000
NODE_2485_length_1448_cov_20.587102	957	1037	0	80	80	1.0000000
NODE_2487_length_1448_cov_8.693847	537	617	0	63	80	0.7875000
NODE_2487_length_1448_cov_8.693847	537	617	4	17	80	0.2125000
NODE_2487_length_1448_cov_8.693847	590	670	0	10	80	0.1250000
NODE_2487_length_1448_cov_8.693847	590	670	4	70	80	0.8750000
NODE_2488_length_1447_cov_21.391691	519	599	0	18	80	0.2250000
NODE_2488_length_1447_cov_21.391691	519	599	2	62	80	0.7750000
NODE_2488_length_1447_cov_21.391691	572	652	0	35	80	0.4375000
NODE_2488_length_1447_cov_21.391691	572	652	2	45	80	0.5625000
NODE_2488_length_1447_cov_21.391691	648	728	0	80	80	1.0000000
NODE_2488_length_1447_cov_21.391691	701	781	0	80	80	1.0000000
NODE_2491_length_1447_cov_2.262611	1268	1325	11	1	57	0.0175439
NODE_2491_length_1447_cov_2.262611	1268	1325	12	1	57	0.0175439
NODE_2491_length_1447_cov_2.262611	1268	1325	14	3	57	0.0526316
NODE_2491_length_1447_cov_2.262611	1268	1325	18	2	57	0.0350877
NODE_2491_length_1447_cov_2.262611	1268	1325	30	10	57	0.1754386
NODE_2491_length_1447_cov_2.262611	1268	1325	31	1	57	0.0175439
NODE_2491_length_1447_cov_2.262611	1268	1325	33	2	57	0.0350877
NODE_2491_length_1447_cov_2.262611	1268	1325	36	2	57	0.0350877
NODE_2491_length_1447_cov_2.262611	1268	1325	40	3	57	0.0526316
NODE_2491_length_1447_cov_2.262611	1268	1325	55	1	57	0.0175439
NODE_2491_length_1447_cov_2.262611	1268	1325	56	3	57	0.0526316
NODE_2491_length_1447_cov_2.262611	1268	1325	58	2	57	0.0350877
NODE_2491_length_1447_cov_2.262611	1268	1325	62	1	57	0.0175439
NODE_2491_length_1447_cov_2.262611	1268	1325	64	2	57	0.0350877
NODE_2491_length_1447_cov_2.262611	1268	1325	66	3	57	0.0526316
NODE_2491_length_1447_cov_2.262611	1268	1325	68	5	57	0.0877193
NODE_2491_length_1447_cov_2.262611	1268	1325	70	1	57	0.0175439
NODE_2491_length_1447_cov_2.262611	1268	1325	72	4	57	0.0701754
NODE_2491_length_1447_cov_2.262611	1268	1325	78	10	57	0.1754386
NODE_2491_length_1447_cov_2.262611	1321	1378	72	1	57	0.0175439
NODE_2491_length_1447_cov_2.262611	1321	1378	74	9	57	0.1578947
NODE_2491_length_1447_cov_2.262611	1321	1378	76	4	57	0.0701754
NODE_2491_length_1447_cov_2.262611	1321	1378	78	41	57	0.7192982
NODE_2491_length_1447_cov_2.262611	1321	1378	80	2	57	0.0350877
NODE_2494_length_1445_cov_22.052006	759	839	0	22	80	0.2750000
NODE_2494_length_1445_cov_22.052006	759	839	4	58	80	0.7250000
NODE_2494_length_1445_cov_22.052006	812	892	0	75	80	0.9375000
NODE_2494_length_1445_cov_22.052006	812	892	4	5	80	0.0625000
NODE_2494_length_1445_cov_22.052006	888	968	0	5	80	0.0625000
NODE_2494_length_1445_cov_22.052006	888	968	4	26	80	0.3250000
NODE_2494_length_1445_cov_22.052006	888	968	6	1	80	0.0125000
NODE_2494_length_1445_cov_22.052006	888	968	8	48	80	0.6000000
NODE_2494_length_1445_cov_22.052006	941	1021	2	5	80	0.0625000
NODE_2494_length_1445_cov_22.052006	941	1021	4	5	80	0.0625000
NODE_2494_length_1445_cov_22.052006	941	1021	8	70	80	0.8750000
NODE_2495_length_1445_cov_13.378900	584	664	0	80	80	1.0000000
NODE_2495_length_1445_cov_13.378900	637	717	0	80	80	1.0000000
NODE_2501_length_1443_cov_7.628720	480	560	0	80	80	1.0000000
NODE_2501_length_1443_cov_7.628720	533	613	0	80	80	1.0000000
NODE_2501_length_1443_cov_7.628720	609	689	0	39	80	0.4875000
NODE_2501_length_1443_cov_7.628720	609	689	2	41	80	0.5125000
NODE_2501_length_1443_cov_7.628720	662	742	2	80	80	1.0000000
NODE_2502_length_1443_cov_4.843006	924	1004	0	80	80	1.0000000
NODE_2502_length_1443_cov_4.843006	977	1057	0	80	80	1.0000000
NODE_2508_length_1442_cov_24.551750	427	507	0	80	80	1.0000000
NODE_2508_length_1442_cov_24.551750	480	560	0	80	80	1.0000000
NODE_2508_length_1442_cov_24.551750	556	636	0	55	80	0.6875000
NODE_2508_length_1442_cov_24.551750	556	636	2	19	80	0.2375000
NODE_2508_length_1442_cov_24.551750	556	636	4	6	80	0.0750000
NODE_2508_length_1442_cov_24.551750	609	689	0	2	80	0.0250000
NODE_2508_length_1442_cov_24.551750	609	689	2	19	80	0.2375000
NODE_2508_length_1442_cov_24.551750	609	689	4	48	80	0.6000000
NODE_2508_length_1442_cov_24.551750	609	689	5	11	80	0.1375000
NODE_2509_length_1442_cov_24.032762	424	504	0	64	80	0.8000000
NODE_2509_length_1442_cov_24.032762	424	504	2	16	80	0.2000000
NODE_2509_length_1442_cov_24.032762	477	557	0	11	80	0.1375000
NODE_2509_length_1442_cov_24.032762	477	557	2	69	80	0.8625000
NODE_2511_length_1441_cov_16.528316	963	1043	2	28	80	0.3500000
NODE_2511_length_1441_cov_16.528316	963	1043	6	23	80	0.2875000
NODE_2511_length_1441_cov_16.528316	963	1043	8	1	80	0.0125000
NODE_2511_length_1441_cov_16.528316	963	1043	10	28	80	0.3500000
NODE_2511_length_1441_cov_16.528316	1016	1096	2	21	80	0.2625000
NODE_2511_length_1441_cov_16.528316	1016	1096	4	6	80	0.0750000
NODE_2511_length_1441_cov_16.528316	1016	1096	6	3	80	0.0375000
NODE_2511_length_1441_cov_16.528316	1016	1096	10	50	80	0.6250000
NODE_2512_length_1441_cov_3.781669	80	156	0	19	76	0.2500000
NODE_2512_length_1441_cov_3.781669	80	156	2	57	76	0.7500000
NODE_2512_length_1441_cov_3.781669	129	209	0	20	80	0.2500000
NODE_2512_length_1441_cov_3.781669	129	209	2	60	80	0.7500000
NODE_2515_length_1440_cov_34.523490	446	526	0	80	80	1.0000000
NODE_2515_length_1440_cov_34.523490	499	576	0	32	77	0.4155844
NODE_2515_length_1440_cov_34.523490	499	576	2	30	77	0.3896104
NODE_2515_length_1440_cov_34.523490	499	576	4	15	77	0.1948052
NODE_2515_length_1440_cov_34.523490	576	654	4	52	78	0.6666667
NODE_2515_length_1440_cov_34.523490	576	654	6	16	78	0.2051282
NODE_2515_length_1440_cov_34.523490	576	654	8	8	78	0.1025641
NODE_2515_length_1440_cov_34.523490	576	654	10	2	78	0.0256410
NODE_2515_length_1440_cov_34.523490	627	707	4	1	80	0.0125000
NODE_2515_length_1440_cov_34.523490	627	707	6	39	80	0.4875000
NODE_2515_length_1440_cov_34.523490	627	707	8	19	80	0.2375000
NODE_2515_length_1440_cov_34.523490	627	707	10	21	80	0.2625000
NODE_2516_length_1440_cov_20.372110	776	856	0	43	80	0.5375000
NODE_2516_length_1440_cov_20.372110	776	856	1	14	80	0.1750000
NODE_2516_length_1440_cov_20.372110	776	856	2	23	80	0.2875000
NODE_2516_length_1440_cov_20.372110	829	909	0	80	80	1.0000000
NODE_2516_length_1440_cov_20.372110	905	985	0	80	80	1.0000000
NODE_2516_length_1440_cov_20.372110	958	1038	0	80	80	1.0000000
NODE_2517_length_1440_cov_14.476510	586	615	0	29	29	1.0000000
NODE_2517_length_1440_cov_14.476510	666	695	0	29	29	1.0000000
NODE_2517_length_1440_cov_14.476510	1295	1359	311	1	64	0.0156250
NODE_2517_length_1440_cov_14.476510	1295	1359	323	2	64	0.0312500
NODE_2517_length_1440_cov_14.476510	1295	1359	325	1	64	0.0156250
NODE_2517_length_1440_cov_14.476510	1295	1359	327	2	64	0.0312500
NODE_2517_length_1440_cov_14.476510	1295	1359	329	1	64	0.0156250
NODE_2517_length_1440_cov_14.476510	1295	1359	333	1	64	0.0156250
NODE_2517_length_1440_cov_14.476510	1295	1359	335	4	64	0.0625000
NODE_2517_length_1440_cov_14.476510	1295	1359	340	1	64	0.0156250
NODE_2517_length_1440_cov_14.476510	1295	1359	346	1	64	0.0156250
NODE_2517_length_1440_cov_14.476510	1295	1359	352	3	64	0.0468750
NODE_2517_length_1440_cov_14.476510	1295	1359	353	1	64	0.0156250
NODE_2517_length_1440_cov_14.476510	1295	1359	355	2	64	0.0312500
NODE_2517_length_1440_cov_14.476510	1295	1359	357	2	64	0.0312500
NODE_2517_length_1440_cov_14.476510	1295	1359	359	3	64	0.0468750
NODE_2517_length_1440_cov_14.476510	1295	1359	361	1	64	0.0156250
NODE_2517_length_1440_cov_14.476510	1295	1359	362	6	64	0.0937500
NODE_2517_length_1440_cov_14.476510	1295	1359	364	3	64	0.0468750
NODE_2517_length_1440_cov_14.476510	1295	1359	367	2	64	0.0312500
NODE_2517_length_1440_cov_14.476510	1295	1359	369	2	64	0.0312500
NODE_2517_length_1440_cov_14.476510	1295	1359	372	2	64	0.0312500
NODE_2517_length_1440_cov_14.476510	1295	1359	373	1	64	0.0156250
NODE_2517_length_1440_cov_14.476510	1295	1359	375	1	64	0.0156250
NODE_2517_length_1440_cov_14.476510	1295	1359	376	8	64	0.1250000
NODE_2517_length_1440_cov_14.476510	1295	1359	378	3	64	0.0468750
NODE_2517_length_1440_cov_14.476510	1295	1359	379	10	64	0.1562500
NODE_2518_length_1440_cov_9.049217	384	464	2	80	80	1.0000000
NODE_2518_length_1440_cov_9.049217	437	517	0	48	80	0.6000000
NODE_2518_length_1440_cov_9.049217	437	517	2	32	80	0.4000000
NODE_2520_length_1439_cov_11.784328	898	978	0	80	80	1.0000000
NODE_2520_length_1439_cov_11.784328	951	1031	0	80	80	1.0000000
NODE_2525_length_1438_cov_41.481703	671	751	0	80	80	1.0000000
NODE_2525_length_1438_cov_41.481703	724	804	0	30	80	0.3750000
NODE_2525_length_1438_cov_41.481703	724	804	2	50	80	0.6250000
NODE_2529_length_1437_cov_14.449178	815	895	0	80	80	1.0000000
NODE_2529_length_1437_cov_14.449178	868	948	0	80	80	1.0000000
NODE_2529_length_1437_cov_14.449178	944	1024	0	80	80	1.0000000
NODE_2529_length_1437_cov_14.449178	997	1077	0	80	80	1.0000000
NODE_2532_length_1436_cov_96.256545	1145	1225	0	80	80	1.0000000
NODE_2532_length_1436_cov_96.256545	1198	1278	0	80	80	1.0000000
NODE_2532_length_1436_cov_96.256545	1274	1354	0	80	80	1.0000000
NODE_2532_length_1436_cov_96.256545	1327	1407	0	80	80	1.0000000
NODE_2536_length_1435_cov_21.468563	783	863	0	80	80	1.0000000
NODE_2536_length_1435_cov_21.468563	836	916	0	80	80	1.0000000
NODE_2536_length_1435_cov_21.468563	912	992	0	80	80	1.0000000
NODE_2536_length_1435_cov_21.468563	965	1045	0	80	80	1.0000000
NODE_2537_length_1435_cov_18.593563	1123	1203	2	18	80	0.2250000
NODE_2537_length_1435_cov_18.593563	1123	1203	4	15	80	0.1875000
NODE_2537_length_1435_cov_18.593563	1123	1203	6	9	80	0.1125000
NODE_2537_length_1435_cov_18.593563	1123	1203	8	4	80	0.0500000
NODE_2537_length_1435_cov_18.593563	1123	1203	10	1	80	0.0125000
NODE_2537_length_1435_cov_18.593563	1123	1203	14	4	80	0.0500000
NODE_2537_length_1435_cov_18.593563	1123	1203	16	10	80	0.1250000
NODE_2537_length_1435_cov_18.593563	1123	1203	18	2	80	0.0250000
NODE_2537_length_1435_cov_18.593563	1123	1203	20	2	80	0.0250000
NODE_2537_length_1435_cov_18.593563	1123	1203	22	4	80	0.0500000
NODE_2537_length_1435_cov_18.593563	1123	1203	24	2	80	0.0250000
NODE_2537_length_1435_cov_18.593563	1123	1203	28	5	80	0.0625000
NODE_2537_length_1435_cov_18.593563	1123	1203	30	2	80	0.0250000
NODE_2537_length_1435_cov_18.593563	1123	1203	32	2	80	0.0250000
NODE_2537_length_1435_cov_18.593563	1176	1256	2	58	80	0.7250000
NODE_2537_length_1435_cov_18.593563	1176	1256	4	11	80	0.1375000
NODE_2537_length_1435_cov_18.593563	1176	1256	6	11	80	0.1375000
NODE_2538_length_1435_cov_5.828593	299	379	0	80	80	1.0000000
NODE_2538_length_1435_cov_5.828593	352	432	0	80	80	1.0000000
NODE_2540_length_1434_cov_17.610487	1023	1103	0	80	80	1.0000000
NODE_2540_length_1434_cov_17.610487	1076	1156	0	80	80	1.0000000
NODE_2540_length_1434_cov_17.610487	1152	1232	0	80	80	1.0000000
NODE_2540_length_1434_cov_17.610487	1205	1285	0	80	80	1.0000000
NODE_2541_length_1434_cov_9.845693	846	926	0	22	80	0.2750000
NODE_2541_length_1434_cov_9.845693	846	926	2	33	80	0.4125000
NODE_2541_length_1434_cov_9.845693	846	926	4	1	80	0.0125000
NODE_2541_length_1434_cov_9.845693	846	926	6	24	80	0.3000000
NODE_2541_length_1434_cov_9.845693	899	978	2	10	79	0.1265823
NODE_2541_length_1434_cov_9.845693	899	978	4	12	79	0.1518987
NODE_2541_length_1434_cov_9.845693	899	978	6	57	79	0.7215190
NODE_2544_length_1433_cov_36.452774	538	618	0	52	80	0.6500000
NODE_2544_length_1433_cov_36.452774	538	618	2	22	80	0.2750000
NODE_2544_length_1433_cov_36.452774	538	618	4	6	80	0.0750000
NODE_2544_length_1433_cov_36.452774	591	671	0	18	80	0.2250000
NODE_2544_length_1433_cov_36.452774	591	671	2	62	80	0.7750000
NODE_2544_length_1433_cov_36.452774	667	747	0	5	80	0.0625000
NODE_2544_length_1433_cov_36.452774	667	747	6	51	80	0.6375000
NODE_2544_length_1433_cov_36.452774	667	747	8	24	80	0.3000000
NODE_2544_length_1433_cov_36.452774	720	800	2	52	80	0.6500000
NODE_2544_length_1433_cov_36.452774	720	800	6	3	80	0.0375000
NODE_2544_length_1433_cov_36.452774	720	800	8	25	80	0.3125000
NODE_2550_length_1431_cov_7.409159	513	593	0	80	80	1.0000000
NODE_2550_length_1431_cov_7.409159	566	646	0	80	80	1.0000000
NODE_2551_length_1431_cov_6.721471	1074	1154	0	42	80	0.5250000
NODE_2551_length_1431_cov_6.721471	1074	1154	2	38	80	0.4750000
NODE_2551_length_1431_cov_6.721471	1127	1207	0	12	80	0.1500000
NODE_2551_length_1431_cov_6.721471	1127	1207	2	68	80	0.8500000
NODE_2552_length_1430_cov_32.643877	753	833	0	42	80	0.5250000
NODE_2552_length_1430_cov_32.643877	753	833	1	38	80	0.4750000
NODE_2552_length_1430_cov_32.643877	806	886	1	80	80	1.0000000
NODE_2552_length_1430_cov_32.643877	882	962	0	17	80	0.2125000
NODE_2552_length_1430_cov_32.643877	882	962	1	63	80	0.7875000
NODE_2552_length_1430_cov_32.643877	935	1016	0	30	81	0.3703704
NODE_2552_length_1430_cov_32.643877	935	1016	1	10	81	0.1234568
NODE_2552_length_1430_cov_32.643877	935	1016	2	41	81	0.5061728
NODE_2557_length_1428_cov_5.895410	340	416	0	76	76	1.0000000
NODE_2557_length_1428_cov_5.895410	393	476	0	83	83	1.0000000
NODE_2560_length_1427_cov_38.919428	707	787	0	33	80	0.4125000
NODE_2560_length_1427_cov_38.919428	707	787	2	47	80	0.5875000
NODE_2560_length_1427_cov_38.919428	760	840	0	80	80	1.0000000
NODE_2560_length_1427_cov_38.919428	836	916	0	61	80	0.7625000
NODE_2560_length_1427_cov_38.919428	836	916	2	6	80	0.0750000
NODE_2560_length_1427_cov_38.919428	836	916	4	13	80	0.1625000
NODE_2560_length_1427_cov_38.919428	889	969	0	8	80	0.1000000
NODE_2560_length_1427_cov_38.919428	889	969	2	6	80	0.0750000
NODE_2560_length_1427_cov_38.919428	889	969	4	66	80	0.8250000
NODE_2561_length_1427_cov_19.442771	808	888	0	64	80	0.8000000
NODE_2561_length_1427_cov_19.442771	808	888	2	16	80	0.2000000
NODE_2561_length_1427_cov_19.442771	861	941	0	80	80	1.0000000
NODE_2561_length_1427_cov_19.442771	937	1017	0	80	80	1.0000000
NODE_2561_length_1427_cov_19.442771	990	1070	0	80	80	1.0000000
NODE_2562_length_1427_cov_10.490964	728	808	0	80	80	1.0000000
NODE_2562_length_1427_cov_10.490964	781	861	0	80	80	1.0000000
NODE_2562_length_1427_cov_10.490964	857	937	0	80	80	1.0000000
NODE_2562_length_1427_cov_10.490964	910	990	0	80	80	1.0000000
NODE_2563_length_1427_cov_9.929217	646	726	4	80	80	1.0000000
NODE_2563_length_1427_cov_9.929217	699	779	0	51	80	0.6375000
NODE_2563_length_1427_cov_9.929217	699	779	4	29	80	0.3625000
NODE_2563_length_1427_cov_9.929217	775	855	0	80	80	1.0000000
NODE_2563_length_1427_cov_9.929217	828	908	0	80	80	1.0000000
NODE_2563_length_1427_cov_9.929217	1248	1324	0	76	76	1.0000000
NODE_2563_length_1427_cov_9.929217	1301	1376	0	75	75	1.0000000
NODE_2564_length_1427_cov_3.122741	1336	1399	2	63	63	1.0000000
NODE_2570_length_1426_cov_36.580256	422	502	0	80	80	1.0000000
NODE_2570_length_1426_cov_36.580256	475	555	0	74	80	0.9250000
NODE_2570_length_1426_cov_36.580256	475	555	1	6	80	0.0750000
NODE_2570_length_1426_cov_36.580256	551	631	1	19	80	0.2375000
NODE_2570_length_1426_cov_36.580256	551	631	2	61	80	0.7625000
NODE_2570_length_1426_cov_36.580256	604	684	2	80	80	1.0000000
NODE_2574_length_1425_cov_25.524133	561	641	0	18	80	0.2250000
NODE_2574_length_1425_cov_25.524133	561	641	4	62	80	0.7750000
NODE_2574_length_1425_cov_25.524133	614	694	0	71	80	0.8875000
NODE_2574_length_1425_cov_25.524133	614	694	4	9	80	0.1125000
NODE_2575_length_1425_cov_10.175716	361	441	0	44	80	0.5500000
NODE_2575_length_1425_cov_10.175716	361	441	6	22	80	0.2750000
NODE_2575_length_1425_cov_10.175716	361	441	7	1	80	0.0125000
NODE_2575_length_1425_cov_10.175716	361	441	11	1	80	0.0125000
NODE_2575_length_1425_cov_10.175716	361	441	12	3	80	0.0375000
NODE_2575_length_1425_cov_10.175716	361	441	14	9	80	0.1125000
NODE_2575_length_1425_cov_10.175716	414	494	6	13	80	0.1625000
NODE_2575_length_1425_cov_10.175716	414	494	7	1	80	0.0125000
NODE_2575_length_1425_cov_10.175716	414	494	11	1	80	0.0125000
NODE_2575_length_1425_cov_10.175716	414	494	12	3	80	0.0375000
NODE_2575_length_1425_cov_10.175716	414	494	14	31	80	0.3875000
NODE_2575_length_1425_cov_10.175716	414	494	16	21	80	0.2625000
NODE_2575_length_1425_cov_10.175716	414	494	18	10	80	0.1250000
NODE_2587_length_1423_cov_31.158610	862	942	14	27	80	0.3375000
NODE_2587_length_1423_cov_31.158610	862	942	16	53	80	0.6625000
NODE_2587_length_1423_cov_31.158610	915	995	0	22	80	0.2750000
NODE_2587_length_1423_cov_31.158610	915	995	13	1	80	0.0125000
NODE_2587_length_1423_cov_31.158610	915	995	14	57	80	0.7125000
NODE_2588_length_1423_cov_30.731873	764	844	0	5	80	0.0625000
NODE_2588_length_1423_cov_30.731873	764	844	7	29	80	0.3625000
NODE_2588_length_1423_cov_30.731873	764	844	8	46	80	0.5750000
NODE_2588_length_1423_cov_30.731873	817	897	0	33	80	0.4125000
NODE_2588_length_1423_cov_30.731873	817	897	7	2	80	0.0250000
NODE_2588_length_1423_cov_30.731873	817	897	8	45	80	0.5625000
NODE_2596_length_1421_cov_8.285930	136	212	104	1	76	0.0131579
NODE_2596_length_1421_cov_8.285930	136	212	105	1	76	0.0131579
NODE_2596_length_1421_cov_8.285930	136	212	106	4	76	0.0526316
NODE_2596_length_1421_cov_8.285930	136	212	107	1	76	0.0131579
NODE_2596_length_1421_cov_8.285930	136	212	108	1	76	0.0131579
NODE_2596_length_1421_cov_8.285930	136	212	109	1	76	0.0131579
NODE_2596_length_1421_cov_8.285930	136	212	113	3	76	0.0394737
NODE_2596_length_1421_cov_8.285930	136	212	114	3	76	0.0394737
NODE_2596_length_1421_cov_8.285930	136	212	115	1	76	0.0131579
NODE_2596_length_1421_cov_8.285930	136	212	117	3	76	0.0394737
NODE_2596_length_1421_cov_8.285930	136	212	119	3	76	0.0394737
NODE_2596_length_1421_cov_8.285930	136	212	125	5	76	0.0657895
NODE_2596_length_1421_cov_8.285930	136	212	126	2	76	0.0263158
NODE_2596_length_1421_cov_8.285930	136	212	127	2	76	0.0263158
NODE_2596_length_1421_cov_8.285930	136	212	135	1	76	0.0131579
NODE_2596_length_1421_cov_8.285930	136	212	145	1	76	0.0131579
NODE_2596_length_1421_cov_8.285930	136	212	148	1	76	0.0131579
NODE_2596_length_1421_cov_8.285930	136	212	159	1	76	0.0131579
NODE_2596_length_1421_cov_8.285930	136	212	169	1	76	0.0131579
NODE_2596_length_1421_cov_8.285930	136	212	172	1	76	0.0131579
NODE_2596_length_1421_cov_8.285930	136	212	175	1	76	0.0131579
NODE_2596_length_1421_cov_8.285930	136	212	176	2	76	0.0263158
NODE_2596_length_1421_cov_8.285930	136	212	180	2	76	0.0263158
NODE_2596_length_1421_cov_8.285930	136	212	188	2	76	0.0263158
NODE_2596_length_1421_cov_8.285930	136	212	190	1	76	0.0131579
NODE_2596_length_1421_cov_8.285930	136	212	198	2	76	0.0263158
NODE_2596_length_1421_cov_8.285930	136	212	200	1	76	0.0131579
NODE_2596_length_1421_cov_8.285930	136	212	202	2	76	0.0263158
NODE_2596_length_1421_cov_8.285930	136	212	204	3	76	0.0394737
NODE_2596_length_1421_cov_8.285930	136	212	210	1	76	0.0131579
NODE_2596_length_1421_cov_8.285930	136	212	212	2	76	0.0263158
NODE_2596_length_1421_cov_8.285930	136	212	214	1	76	0.0131579
NODE_2596_length_1421_cov_8.285930	136	212	217	1	76	0.0131579
NODE_2596_length_1421_cov_8.285930	136	212	218	2	76	0.0263158
NODE_2596_length_1421_cov_8.285930	136	212	219	2	76	0.0263158
NODE_2596_length_1421_cov_8.285930	136	212	224	3	76	0.0394737
NODE_2596_length_1421_cov_8.285930	136	212	226	1	76	0.0131579
NODE_2596_length_1421_cov_8.285930	136	212	236	1	76	0.0131579
NODE_2596_length_1421_cov_8.285930	136	212	238	2	76	0.0263158
NODE_2596_length_1421_cov_8.285930	136	212	248	1	76	0.0131579
NODE_2596_length_1421_cov_8.285930	136	212	249	1	76	0.0131579
NODE_2596_length_1421_cov_8.285930	136	212	250	1	76	0.0131579
NODE_2596_length_1421_cov_8.285930	136	212	254	2	76	0.0263158
NODE_2596_length_1421_cov_8.285930	136	212	255	1	76	0.0131579
NODE_2596_length_1421_cov_8.285930	136	212	256	1	76	0.0131579
NODE_2598_length_1421_cov_2.574130	22	102	10	9	80	0.1125000
NODE_2598_length_1421_cov_2.574130	22	102	14	2	80	0.0250000
NODE_2598_length_1421_cov_2.574130	22	102	16	69	80	0.8625000
NODE_2598_length_1421_cov_2.574130	75	132	2	20	57	0.3508772
NODE_2598_length_1421_cov_2.574130	75	132	8	5	57	0.0877193
NODE_2598_length_1421_cov_2.574130	75	132	10	3	57	0.0526316
NODE_2598_length_1421_cov_2.574130	75	132	12	1	57	0.0175439
NODE_2598_length_1421_cov_2.574130	75	132	16	28	57	0.4912281
NODE_2599_length_1420_cov_256.442846	60	140	16	12	80	0.1500000
NODE_2599_length_1420_cov_256.442846	60	140	17	44	80	0.5500000
NODE_2599_length_1420_cov_256.442846	60	140	19	18	80	0.2250000
NODE_2599_length_1420_cov_256.442846	60	140	21	6	80	0.0750000
NODE_2599_length_1420_cov_256.442846	1294	1360	2	3	66	0.0454545
NODE_2599_length_1420_cov_256.442846	1294	1360	4	5	66	0.0757576
NODE_2599_length_1420_cov_256.442846	1294	1360	10	2	66	0.0303030
NODE_2599_length_1420_cov_256.442846	1294	1360	12	2	66	0.0303030
NODE_2599_length_1420_cov_256.442846	1294	1360	14	3	66	0.0454545
NODE_2599_length_1420_cov_256.442846	1294	1360	16	1	66	0.0151515
NODE_2599_length_1420_cov_256.442846	1294	1360	18	50	66	0.7575758
NODE_2600_length_1420_cov_7.547313	628	708	0	80	80	1.0000000
NODE_2600_length_1420_cov_7.547313	681	761	0	80	80	1.0000000
NODE_2602_length_1420_cov_2.051476	972	1039	2	3	67	0.0447761
NODE_2602_length_1420_cov_2.051476	972	1039	6	19	67	0.2835821
NODE_2602_length_1420_cov_2.051476	972	1039	8	45	67	0.6716418
NODE_2604_length_1419_cov_46.997727	1230	1305	0	6	75	0.0800000
NODE_2604_length_1419_cov_46.997727	1230	1305	2	69	75	0.9200000
NODE_2604_length_1419_cov_46.997727	1278	1332	0	19	54	0.3518519
NODE_2604_length_1419_cov_46.997727	1278	1332	2	35	54	0.6481481
NODE_2609_length_1418_cov_11.373010	432	512	0	80	80	1.0000000
NODE_2609_length_1418_cov_11.373010	485	556	0	71	71	1.0000000
NODE_2615_length_1417_cov_12.477997	354	399	0	45	45	1.0000000
NODE_2616_length_1417_cov_11.120637	794	874	0	41	80	0.5125000
NODE_2616_length_1417_cov_11.120637	794	874	4	39	80	0.4875000
NODE_2616_length_1417_cov_11.120637	847	927	4	80	80	1.0000000
NODE_2625_length_1415_cov_51.375380	423	503	0	32	80	0.4000000
NODE_2625_length_1415_cov_51.375380	423	503	5	1	80	0.0125000
NODE_2625_length_1415_cov_51.375380	423	503	6	47	80	0.5875000
NODE_2625_length_1415_cov_51.375380	476	556	0	5	80	0.0625000
NODE_2625_length_1415_cov_51.375380	476	556	5	1	80	0.0125000
NODE_2625_length_1415_cov_51.375380	476	556	6	74	80	0.9250000
NODE_2625_length_1415_cov_51.375380	552	632	0	80	80	1.0000000
NODE_2625_length_1415_cov_51.375380	605	683	0	78	78	1.0000000
NODE_2626_length_1415_cov_38.272036	513	593	12	64	80	0.8000000
NODE_2626_length_1415_cov_38.272036	513	593	14	16	80	0.2000000
NODE_2626_length_1415_cov_38.272036	566	646	0	26	80	0.3250000
NODE_2626_length_1415_cov_38.272036	566	646	2	16	80	0.2000000
NODE_2626_length_1415_cov_38.272036	566	646	10	1	80	0.0125000
NODE_2626_length_1415_cov_38.272036	566	646	12	32	80	0.4000000
NODE_2626_length_1415_cov_38.272036	566	646	14	5	80	0.0625000
NODE_2627_length_1415_cov_17.232523	642	722	0	80	80	1.0000000
NODE_2627_length_1415_cov_17.232523	695	775	0	80	80	1.0000000
NODE_2629_length_1414_cov_5.307985	1026	1106	0	80	80	1.0000000
NODE_2629_length_1414_cov_5.307985	1079	1159	0	80	80	1.0000000
NODE_2637_length_1412_cov_17.723534	875	955	2	2	80	0.0250000
NODE_2637_length_1412_cov_17.723534	875	955	4	11	80	0.1375000
NODE_2637_length_1412_cov_17.723534	875	955	10	10	80	0.1250000
NODE_2637_length_1412_cov_17.723534	875	955	11	2	80	0.0250000
NODE_2637_length_1412_cov_17.723534	875	955	12	55	80	0.6875000
NODE_2637_length_1412_cov_17.723534	928	1008	0	9	80	0.1125000
NODE_2637_length_1412_cov_17.723534	928	1008	2	7	80	0.0875000
NODE_2637_length_1412_cov_17.723534	928	1008	10	32	80	0.4000000
NODE_2637_length_1412_cov_17.723534	928	1008	12	32	80	0.4000000
NODE_2641_length_1411_cov_34.004573	516	596	0	80	80	1.0000000
NODE_2641_length_1411_cov_34.004573	569	649	0	80	80	1.0000000
NODE_2641_length_1411_cov_34.004573	645	725	0	16	80	0.2000000
NODE_2641_length_1411_cov_34.004573	645	725	2	64	80	0.8000000
NODE_2641_length_1411_cov_34.004573	698	778	0	21	80	0.2625000
NODE_2641_length_1411_cov_34.004573	698	778	2	59	80	0.7375000
NODE_2643_length_1409_cov_25.380153	828	908	2	27	80	0.3375000
NODE_2643_length_1409_cov_25.380153	828	908	4	4	80	0.0500000
NODE_2643_length_1409_cov_25.380153	828	908	6	11	80	0.1375000
NODE_2643_length_1409_cov_25.380153	828	908	8	38	80	0.4750000
NODE_2643_length_1409_cov_25.380153	881	961	2	19	80	0.2375000
NODE_2643_length_1409_cov_25.380153	881	961	4	2	80	0.0250000
NODE_2643_length_1409_cov_25.380153	881	961	6	43	80	0.5375000
NODE_2643_length_1409_cov_25.380153	881	961	8	16	80	0.2000000
NODE_2644_length_1409_cov_13.028244	349	405	51	4	56	0.0714286
NODE_2644_length_1409_cov_13.028244	349	405	52	2	56	0.0357143
NODE_2644_length_1409_cov_13.028244	349	405	53	9	56	0.1607143
NODE_2644_length_1409_cov_13.028244	349	405	54	1	56	0.0178571
NODE_2644_length_1409_cov_13.028244	349	405	56	5	56	0.0892857
NODE_2644_length_1409_cov_13.028244	349	405	57	2	56	0.0357143
NODE_2644_length_1409_cov_13.028244	349	405	58	7	56	0.1250000
NODE_2644_length_1409_cov_13.028244	349	405	59	1	56	0.0178571
NODE_2644_length_1409_cov_13.028244	349	405	63	12	56	0.2142857
NODE_2644_length_1409_cov_13.028244	349	405	64	13	56	0.2321429
NODE_2644_length_1409_cov_13.028244	416	482	18	12	66	0.1818182
NODE_2644_length_1409_cov_13.028244	416	482	19	4	66	0.0606061
NODE_2644_length_1409_cov_13.028244	416	482	20	1	66	0.0151515
NODE_2644_length_1409_cov_13.028244	416	482	21	2	66	0.0303030
NODE_2644_length_1409_cov_13.028244	416	482	22	4	66	0.0606061
NODE_2644_length_1409_cov_13.028244	416	482	27	1	66	0.0151515
NODE_2644_length_1409_cov_13.028244	416	482	33	1	66	0.0151515
NODE_2644_length_1409_cov_13.028244	416	482	34	4	66	0.0606061
NODE_2644_length_1409_cov_13.028244	416	482	40	13	66	0.1969697
NODE_2644_length_1409_cov_13.028244	416	482	42	22	66	0.3333333
NODE_2644_length_1409_cov_13.028244	416	482	44	1	66	0.0151515
NODE_2644_length_1409_cov_13.028244	416	482	46	1	66	0.0151515
NODE_2648_length_1408_cov_6.261268	492	572	0	80	80	1.0000000
NODE_2648_length_1408_cov_6.261268	545	625	0	80	80	1.0000000
NODE_2652_length_1407_cov_27.711009	772	852	0	4	80	0.0500000
NODE_2652_length_1407_cov_27.711009	772	852	1	76	80	0.9500000
NODE_2652_length_1407_cov_27.711009	825	905	1	80	80	1.0000000
NODE_2653_length_1407_cov_24.387615	586	666	0	27	80	0.3375000
NODE_2653_length_1407_cov_24.387615	586	666	10	30	80	0.3750000
NODE_2653_length_1407_cov_24.387615	586	666	14	23	80	0.2875000
NODE_2653_length_1407_cov_24.387615	639	719	10	4	80	0.0500000
NODE_2653_length_1407_cov_24.387615	639	719	14	23	80	0.2875000
NODE_2653_length_1407_cov_24.387615	639	719	18	53	80	0.6625000
NODE_2653_length_1407_cov_24.387615	715	795	0	22	80	0.2750000
NODE_2653_length_1407_cov_24.387615	715	795	4	9	80	0.1125000
NODE_2653_length_1407_cov_24.387615	715	795	14	10	80	0.1250000
NODE_2653_length_1407_cov_24.387615	715	795	18	39	80	0.4875000
NODE_2653_length_1407_cov_24.387615	768	848	0	75	80	0.9375000
NODE_2653_length_1407_cov_24.387615	768	848	4	5	80	0.0625000
NODE_2654_length_1407_cov_19.022936	551	629	8	24	78	0.3076923
NODE_2654_length_1407_cov_19.022936	551	629	10	35	78	0.4487180
NODE_2654_length_1407_cov_19.022936	551	629	12	19	78	0.2435897
NODE_2654_length_1407_cov_19.022936	602	665	0	4	63	0.0634921
NODE_2654_length_1407_cov_19.022936	602	665	2	18	63	0.2857143
NODE_2654_length_1407_cov_19.022936	602	665	8	38	63	0.6031746
NODE_2654_length_1407_cov_19.022936	602	665	12	3	63	0.0476190
NODE_2655_length_1407_cov_11.266820	813	893	0	80	80	1.0000000
NODE_2655_length_1407_cov_11.266820	866	946	0	80	80	1.0000000
NODE_2655_length_1407_cov_11.266820	942	1022	0	80	80	1.0000000
NODE_2655_length_1407_cov_11.266820	995	1075	0	80	80	1.0000000
NODE_2657_length_1406_cov_7.247896	761	841	0	80	80	1.0000000
NODE_2657_length_1406_cov_7.247896	814	894	0	80	80	1.0000000
NODE_2659_length_1404_cov_23.406130	826	906	0	15	80	0.1875000
NODE_2659_length_1404_cov_23.406130	826	906	6	65	80	0.8125000
NODE_2659_length_1404_cov_23.406130	879	959	0	14	80	0.1750000
NODE_2659_length_1404_cov_23.406130	879	959	6	66	80	0.8250000
NODE_2659_length_1404_cov_23.406130	955	1035	0	80	80	1.0000000
NODE_2659_length_1404_cov_23.406130	1008	1088	0	80	80	1.0000000
NODE_2666_length_1403_cov_14.331288	325	405	0	80	80	1.0000000
NODE_2666_length_1403_cov_14.331288	378	458	0	80	80	1.0000000
NODE_2666_length_1403_cov_14.331288	454	534	0	80	80	1.0000000
NODE_2666_length_1403_cov_14.331288	454	534	0	80	80	1.0000000
NODE_2666_length_1403_cov_14.331288	454	524	0	70	70	1.0000000
NODE_2666_length_1403_cov_14.331288	507	587	0	80	80	1.0000000
NODE_2666_length_1403_cov_14.331288	507	579	0	72	72	1.0000000
NODE_2668_length_1402_cov_29.095165	610	690	0	38	80	0.4750000
NODE_2668_length_1402_cov_29.095165	610	690	4	42	80	0.5250000
NODE_2668_length_1402_cov_29.095165	663	743	0	8	80	0.1000000
NODE_2668_length_1402_cov_29.095165	663	743	4	72	80	0.9000000
NODE_2669_length_1402_cov_23.411358	528	608	0	80	80	1.0000000
NODE_2669_length_1402_cov_23.411358	581	661	0	80	80	1.0000000
NODE_2669_length_1402_cov_23.411358	657	737	0	80	80	1.0000000
NODE_2669_length_1402_cov_23.411358	710	790	0	80	80	1.0000000
NODE_2670_length_1402_cov_11.732924	661	741	0	80	80	1.0000000
NODE_2670_length_1402_cov_11.732924	714	794	0	80	80	1.0000000
NODE_2671_length_1402_cov_9.929394	766	846	2	23	80	0.2875000
NODE_2671_length_1402_cov_9.929394	766	846	4	57	80	0.7125000
NODE_2671_length_1402_cov_9.929394	819	899	0	30	80	0.3750000
NODE_2671_length_1402_cov_9.929394	819	899	2	38	80	0.4750000
NODE_2671_length_1402_cov_9.929394	819	899	4	12	80	0.1500000
NODE_2677_length_1401_cov_35.754992	825	905	0	34	80	0.4250000
NODE_2677_length_1401_cov_35.754992	825	905	2	46	80	0.5750000
NODE_2677_length_1401_cov_35.754992	878	958	0	49	80	0.6125000
NODE_2677_length_1401_cov_35.754992	878	958	2	31	80	0.3875000
NODE_2678_length_1401_cov_10.811828	539	619	0	80	80	1.0000000
NODE_2678_length_1401_cov_10.811828	592	672	0	31	80	0.3875000
NODE_2678_length_1401_cov_10.811828	592	672	2	49	80	0.6125000
NODE_2679_length_1401_cov_5.438556	241	321	0	41	80	0.5125000
NODE_2679_length_1401_cov_5.438556	241	321	2	39	80	0.4875000
NODE_2679_length_1401_cov_5.438556	294	374	2	80	80	1.0000000
NODE_2683_length_1400_cov_16.680246	813	893	0	7	80	0.0875000
NODE_2683_length_1400_cov_16.680246	813	893	4	73	80	0.9125000
NODE_2683_length_1400_cov_16.680246	866	946	0	37	80	0.4625000
NODE_2683_length_1400_cov_16.680246	866	946	4	43	80	0.5375000
NODE_2684_length_1400_cov_8.166795	53	133	10	33	80	0.4125000
NODE_2684_length_1400_cov_8.166795	53	133	11	3	80	0.0375000
NODE_2684_length_1400_cov_8.166795	53	133	12	12	80	0.1500000
NODE_2684_length_1400_cov_8.166795	53	133	14	3	80	0.0375000
NODE_2684_length_1400_cov_8.166795	53	133	16	29	80	0.3625000
NODE_2684_length_1400_cov_8.166795	106	186	0	7	80	0.0875000
NODE_2684_length_1400_cov_8.166795	106	186	2	3	80	0.0375000
NODE_2684_length_1400_cov_8.166795	106	186	3	4	80	0.0500000
NODE_2684_length_1400_cov_8.166795	106	186	4	3	80	0.0375000
NODE_2684_length_1400_cov_8.166795	106	186	11	39	80	0.4875000
NODE_2684_length_1400_cov_8.166795	106	186	16	24	80	0.3000000
NODE_2694_length_1397_cov_25.549307	869	918	4	9	49	0.1836735
NODE_2694_length_1397_cov_25.549307	869	918	6	9	49	0.1836735
NODE_2694_length_1397_cov_25.549307	869	918	9	1	49	0.0204082
NODE_2694_length_1397_cov_25.549307	869	918	10	2	49	0.0408163
NODE_2694_length_1397_cov_25.549307	869	918	14	4	49	0.0816327
NODE_2694_length_1397_cov_25.549307	869	918	18	8	49	0.1632653
NODE_2694_length_1397_cov_25.549307	869	918	19	1	49	0.0204082
NODE_2694_length_1397_cov_25.549307	869	918	20	15	49	0.3061225
NODE_2694_length_1397_cov_25.549307	891	971	6	3	80	0.0375000
NODE_2694_length_1397_cov_25.549307	891	971	10	3	80	0.0375000
NODE_2694_length_1397_cov_25.549307	891	971	14	3	80	0.0375000
NODE_2694_length_1397_cov_25.549307	891	971	15	1	80	0.0125000
NODE_2694_length_1397_cov_25.549307	891	971	17	43	80	0.5375000
NODE_2694_length_1397_cov_25.549307	891	971	18	11	80	0.1375000
NODE_2694_length_1397_cov_25.549307	891	971	19	1	80	0.0125000
NODE_2694_length_1397_cov_25.549307	891	971	20	15	80	0.1875000
NODE_2695_length_1397_cov_14.395223	672	752	0	80	80	1.0000000
NODE_2695_length_1397_cov_14.395223	725	805	0	80	80	1.0000000
NODE_2695_length_1397_cov_14.395223	801	881	0	33	80	0.4125000
NODE_2695_length_1397_cov_14.395223	801	881	1	47	80	0.5875000
NODE_2695_length_1397_cov_14.395223	854	934	1	80	80	1.0000000
NODE_2699_length_1396_cov_21.656130	825	905	0	19	80	0.2375000
NODE_2699_length_1396_cov_21.656130	825	905	2	9	80	0.1125000
NODE_2699_length_1396_cov_21.656130	825	905	3	5	80	0.0625000
NODE_2699_length_1396_cov_21.656130	825	905	10	47	80	0.5875000
NODE_2699_length_1396_cov_21.656130	878	958	0	72	80	0.9000000
NODE_2699_length_1396_cov_21.656130	878	958	2	8	80	0.1000000
NODE_2700_length_1396_cov_18.108712	560	640	0	62	80	0.7750000
NODE_2700_length_1396_cov_18.108712	560	640	2	18	80	0.2250000
NODE_2700_length_1396_cov_18.108712	613	693	0	9	80	0.1125000
NODE_2700_length_1396_cov_18.108712	613	693	2	71	80	0.8875000
NODE_2701_length_1396_cov_16.208944	136	198	52	1	62	0.0161290
NODE_2701_length_1396_cov_16.208944	136	198	54	1	62	0.0161290
NODE_2701_length_1396_cov_16.208944	136	198	55	2	62	0.0322581
NODE_2701_length_1396_cov_16.208944	136	198	57	1	62	0.0161290
NODE_2701_length_1396_cov_16.208944	136	198	59	1	62	0.0161290
NODE_2701_length_1396_cov_16.208944	136	198	61	1	62	0.0161290
NODE_2701_length_1396_cov_16.208944	136	198	65	2	62	0.0322581
NODE_2701_length_1396_cov_16.208944	136	198	69	2	62	0.0322581
NODE_2701_length_1396_cov_16.208944	136	198	78	2	62	0.0322581
NODE_2701_length_1396_cov_16.208944	136	198	79	1	62	0.0161290
NODE_2701_length_1396_cov_16.208944	136	198	83	1	62	0.0161290
NODE_2701_length_1396_cov_16.208944	136	198	84	4	62	0.0645161
NODE_2701_length_1396_cov_16.208944	136	198	86	1	62	0.0161290
NODE_2701_length_1396_cov_16.208944	136	198	87	1	62	0.0161290
NODE_2701_length_1396_cov_16.208944	136	198	88	1	62	0.0161290
NODE_2701_length_1396_cov_16.208944	136	198	89	2	62	0.0322581
NODE_2701_length_1396_cov_16.208944	136	198	93	2	62	0.0322581
NODE_2701_length_1396_cov_16.208944	136	198	95	3	62	0.0483871
NODE_2701_length_1396_cov_16.208944	136	198	108	1	62	0.0161290
NODE_2701_length_1396_cov_16.208944	136	198	110	1	62	0.0161290
NODE_2701_length_1396_cov_16.208944	136	198	111	1	62	0.0161290
NODE_2701_length_1396_cov_16.208944	136	198	115	1	62	0.0161290
NODE_2701_length_1396_cov_16.208944	136	198	118	1	62	0.0161290
NODE_2701_length_1396_cov_16.208944	136	198	124	1	62	0.0161290
NODE_2701_length_1396_cov_16.208944	136	198	128	1	62	0.0161290
NODE_2701_length_1396_cov_16.208944	136	198	135	1	62	0.0161290
NODE_2701_length_1396_cov_16.208944	136	198	141	1	62	0.0161290
NODE_2701_length_1396_cov_16.208944	136	198	146	1	62	0.0161290
NODE_2701_length_1396_cov_16.208944	136	198	151	1	62	0.0161290
NODE_2701_length_1396_cov_16.208944	136	198	157	4	62	0.0645161
NODE_2701_length_1396_cov_16.208944	136	198	160	3	62	0.0483871
NODE_2701_length_1396_cov_16.208944	136	198	162	1	62	0.0161290
NODE_2701_length_1396_cov_16.208944	136	198	173	1	62	0.0161290
NODE_2701_length_1396_cov_16.208944	136	198	175	1	62	0.0161290
NODE_2701_length_1396_cov_16.208944	136	198	179	1	62	0.0161290
NODE_2701_length_1396_cov_16.208944	136	198	181	3	62	0.0483871
NODE_2701_length_1396_cov_16.208944	136	198	183	3	62	0.0483871
NODE_2701_length_1396_cov_16.208944	136	198	187	3	62	0.0483871
NODE_2701_length_1396_cov_16.208944	136	198	190	1	62	0.0161290
NODE_2701_length_1396_cov_16.208944	136	198	194	1	62	0.0161290
NODE_2701_length_1396_cov_16.208944	848	928	0	6	80	0.0750000
NODE_2701_length_1396_cov_16.208944	848	928	2	74	80	0.9250000
NODE_2701_length_1396_cov_16.208944	901	981	2	73	80	0.9125000
NODE_2701_length_1396_cov_16.208944	901	981	12	7	80	0.0875000
NODE_2701_length_1396_cov_16.208944	977	1057	10	60	80	0.7500000
NODE_2701_length_1396_cov_16.208944	977	1057	12	20	80	0.2500000
NODE_2701_length_1396_cov_16.208944	1030	1110	0	30	80	0.3750000
NODE_2701_length_1396_cov_16.208944	1030	1110	10	50	80	0.6250000
NODE_2702_length_1396_cov_9.196608	428	508	0	80	80	1.0000000
NODE_2702_length_1396_cov_9.196608	481	561	0	80	80	1.0000000
NODE_2712_length_1394_cov_29.602317	349	415	0	16	66	0.2424242
NODE_2712_length_1394_cov_29.602317	349	415	4	50	66	0.7575758
NODE_2712_length_1394_cov_29.602317	349	416	0	17	67	0.2537313
NODE_2712_length_1394_cov_29.602317	349	416	4	50	67	0.7462686
NODE_2712_length_1394_cov_29.602317	1117	1197	0	7	80	0.0875000
NODE_2712_length_1394_cov_29.602317	1117	1197	2	73	80	0.9125000
NODE_2712_length_1394_cov_29.602317	1170	1250	0	28	80	0.3500000
NODE_2712_length_1394_cov_29.602317	1170	1250	2	34	80	0.4250000
NODE_2712_length_1394_cov_29.602317	1170	1250	4	18	80	0.2250000
NODE_2713_length_1394_cov_6.291892	313	393	0	80	80	1.0000000
NODE_2713_length_1394_cov_6.291892	366	446	0	80	80	1.0000000
NODE_2716_length_1393_cov_14.635240	1286	1339	14	3	53	0.0566038
NODE_2716_length_1393_cov_14.635240	1286	1339	16	1	53	0.0188679
NODE_2716_length_1393_cov_14.635240	1286	1339	18	49	53	0.9245283
NODE_2717_length_1393_cov_12.032457	737	817	0	44	80	0.5500000
NODE_2717_length_1393_cov_12.032457	737	817	1	27	80	0.3375000
NODE_2717_length_1393_cov_12.032457	737	817	2	2	80	0.0250000
NODE_2717_length_1393_cov_12.032457	737	817	6	7	80	0.0875000
NODE_2717_length_1393_cov_12.032457	790	870	1	18	80	0.2250000
NODE_2717_length_1393_cov_12.032457	790	870	2	2	80	0.0250000
NODE_2717_length_1393_cov_12.032457	790	870	6	60	80	0.7500000
NODE_2720_length_1392_cov_5.898685	270	350	0	35	80	0.4375000
NODE_2720_length_1392_cov_5.898685	270	350	4	28	80	0.3500000
NODE_2720_length_1392_cov_5.898685	270	350	6	17	80	0.2125000
NODE_2720_length_1392_cov_5.898685	323	399	2	1	76	0.0131579
NODE_2720_length_1392_cov_5.898685	323	399	4	18	76	0.2368421
NODE_2720_length_1392_cov_5.898685	323	399	6	23	76	0.3026316
NODE_2720_length_1392_cov_5.898685	323	399	8	34	76	0.4473684
NODE_2723_length_1391_cov_35.921827	415	495	7	37	80	0.4625000
NODE_2723_length_1391_cov_35.921827	415	495	8	2	80	0.0250000
NODE_2723_length_1391_cov_35.921827	415	495	9	37	80	0.4625000
NODE_2723_length_1391_cov_35.921827	415	495	10	4	80	0.0500000
NODE_2723_length_1391_cov_35.921827	468	548	3	4	80	0.0500000
NODE_2723_length_1391_cov_35.921827	468	548	4	42	80	0.5250000
NODE_2723_length_1391_cov_35.921827	468	548	7	26	80	0.3250000
NODE_2723_length_1391_cov_35.921827	468	548	8	8	80	0.1000000
NODE_2723_length_1391_cov_35.921827	544	624	0	25	80	0.3125000
NODE_2723_length_1391_cov_35.921827	544	624	2	43	80	0.5375000
NODE_2723_length_1391_cov_35.921827	544	624	3	12	80	0.1500000
NODE_2723_length_1391_cov_35.921827	597	677	0	35	80	0.4375000
NODE_2723_length_1391_cov_35.921827	597	677	2	45	80	0.5625000
NODE_2729_length_1390_cov_16.326878	550	630	0	80	80	1.0000000
NODE_2729_length_1390_cov_16.326878	603	683	0	80	80	1.0000000
NODE_2731_length_1389_cov_29.772093	780	860	1	65	80	0.8125000
NODE_2731_length_1389_cov_29.772093	780	860	2	15	80	0.1875000
NODE_2731_length_1389_cov_29.772093	833	913	1	12	80	0.1500000
NODE_2731_length_1389_cov_29.772093	833	913	2	68	80	0.8500000
NODE_2732_length_1389_cov_12.858140	821	901	0	10	80	0.1250000
NODE_2732_length_1389_cov_12.858140	821	901	4	70	80	0.8750000
NODE_2732_length_1389_cov_12.858140	874	954	0	34	80	0.4250000
NODE_2732_length_1389_cov_12.858140	874	954	4	46	80	0.5750000
NODE_2735_length_1388_cov_14.641583	529	610	0	17	81	0.2098765
NODE_2735_length_1388_cov_14.641583	529	610	2	64	81	0.7901235
NODE_2735_length_1388_cov_14.641583	583	660	0	67	77	0.8701299
NODE_2735_length_1388_cov_14.641583	583	660	2	10	77	0.1298701
NODE_2736_length_1388_cov_5.168348	427	499	34	3	72	0.0416667
NODE_2736_length_1388_cov_5.168348	427	499	36	9	72	0.1250000
NODE_2736_length_1388_cov_5.168348	427	499	38	20	72	0.2777778
NODE_2736_length_1388_cov_5.168348	427	499	40	5	72	0.0694444
NODE_2736_length_1388_cov_5.168348	427	499	42	11	72	0.1527778
NODE_2736_length_1388_cov_5.168348	427	499	43	3	72	0.0416667
NODE_2736_length_1388_cov_5.168348	427	499	44	8	72	0.1111111
NODE_2736_length_1388_cov_5.168348	427	499	46	13	72	0.1805556
NODE_2742_length_1386_cov_55.384615	559	639	0	80	80	1.0000000
NODE_2742_length_1386_cov_55.384615	612	692	0	80	80	1.0000000
NODE_2742_length_1386_cov_55.384615	688	768	0	80	80	1.0000000
NODE_2742_length_1386_cov_55.384615	741	821	0	80	80	1.0000000
NODE_2744_length_1386_cov_13.181041	549	629	0	64	80	0.8000000
NODE_2744_length_1386_cov_13.181041	549	629	2	16	80	0.2000000
NODE_2744_length_1386_cov_13.181041	602	682	0	11	80	0.1375000
NODE_2744_length_1386_cov_13.181041	602	682	2	69	80	0.8625000
NODE_2748_length_1385_cov_41.636081	968	1048	0	80	80	1.0000000
NODE_2748_length_1385_cov_41.636081	1021	1101	0	80	80	1.0000000
NODE_2749_length_1385_cov_38.877138	707	787	4	5	80	0.0625000
NODE_2749_length_1385_cov_38.877138	707	787	6	5	80	0.0625000
NODE_2749_length_1385_cov_38.877138	707	787	9	7	80	0.0875000
NODE_2749_length_1385_cov_38.877138	707	787	10	12	80	0.1500000
NODE_2749_length_1385_cov_38.877138	707	787	11	33	80	0.4125000
NODE_2749_length_1385_cov_38.877138	707	787	12	18	80	0.2250000
NODE_2749_length_1385_cov_38.877138	760	840	4	5	80	0.0625000
NODE_2749_length_1385_cov_38.877138	760	840	6	29	80	0.3625000
NODE_2749_length_1385_cov_38.877138	760	840	8	29	80	0.3625000
NODE_2749_length_1385_cov_38.877138	760	840	12	17	80	0.2125000
NODE_2749_length_1385_cov_38.877138	836	916	5	10	80	0.1250000
NODE_2749_length_1385_cov_38.877138	836	916	6	31	80	0.3875000
NODE_2749_length_1385_cov_38.877138	836	916	8	2	80	0.0250000
NODE_2749_length_1385_cov_38.877138	836	916	9	7	80	0.0875000
NODE_2749_length_1385_cov_38.877138	836	916	10	27	80	0.3375000
NODE_2749_length_1385_cov_38.877138	836	916	12	3	80	0.0375000
NODE_2749_length_1385_cov_38.877138	889	969	7	32	80	0.4000000
NODE_2749_length_1385_cov_38.877138	889	969	9	28	80	0.3500000
NODE_2749_length_1385_cov_38.877138	889	969	10	20	80	0.2500000
NODE_2751_length_1385_cov_4.608865	844	904	0	60	60	1.0000000
NODE_2758_length_1384_cov_10.574319	865	922	0	8	57	0.1403509
NODE_2758_length_1384_cov_10.574319	865	922	4	49	57	0.8596491
NODE_2758_length_1384_cov_10.574319	933	1013	0	21	80	0.2625000
NODE_2758_length_1384_cov_10.574319	933	1013	2	19	80	0.2375000
NODE_2758_length_1384_cov_10.574319	933	1013	4	40	80	0.5000000
NODE_2758_length_1384_cov_10.574319	986	1066	0	15	80	0.1875000
NODE_2758_length_1384_cov_10.574319	986	1066	2	23	80	0.2875000
NODE_2758_length_1384_cov_10.574319	986	1066	4	42	80	0.5250000
NODE_2759_length_1383_cov_10.710280	414	493	0	79	79	1.0000000
NODE_2759_length_1383_cov_10.710280	466	546	0	80	80	1.0000000
NODE_2763_length_1382_cov_12.521434	837	917	2	12	80	0.1500000
NODE_2763_length_1382_cov_12.521434	837	917	6	68	80	0.8500000
NODE_2763_length_1382_cov_12.521434	890	970	0	45	80	0.5625000
NODE_2763_length_1382_cov_12.521434	890	970	2	7	80	0.0875000
NODE_2763_length_1382_cov_12.521434	890	970	6	28	80	0.3500000
NODE_2764_length_1382_cov_5.074045	1028	1108	0	10	80	0.1250000
NODE_2764_length_1382_cov_5.074045	1028	1108	2	32	80	0.4000000
NODE_2764_length_1382_cov_5.074045	1028	1108	4	38	80	0.4750000
NODE_2764_length_1382_cov_5.074045	1081	1161	4	36	80	0.4500000
NODE_2764_length_1382_cov_5.074045	1081	1161	8	44	80	0.5500000
NODE_2771_length_1381_cov_7.796412	307	387	0	35	80	0.4375000
NODE_2771_length_1381_cov_7.796412	307	387	2	4	80	0.0500000
NODE_2771_length_1381_cov_7.796412	307	387	4	41	80	0.5125000
NODE_2771_length_1381_cov_7.796412	360	440	4	60	80	0.7500000
NODE_2771_length_1381_cov_7.796412	360	440	6	20	80	0.2500000
NODE_2775_length_1380_cov_12.804059	835	915	0	80	80	1.0000000
NODE_2775_length_1380_cov_12.804059	888	968	0	80	80	1.0000000
NODE_2782_length_1378_cov_25.362002	368	448	0	80	80	1.0000000
NODE_2782_length_1378_cov_25.362002	421	501	0	47	80	0.5875000
NODE_2782_length_1378_cov_25.362002	421	501	2	33	80	0.4125000
NODE_2782_length_1378_cov_25.362002	497	577	0	28	80	0.3500000
NODE_2782_length_1378_cov_25.362002	497	577	2	52	80	0.6500000
NODE_2782_length_1378_cov_25.362002	550	630	0	80	80	1.0000000
NODE_2783_length_1378_cov_20.508210	318	338	14	3	20	0.1500000
NODE_2783_length_1378_cov_20.508210	318	338	16	3	20	0.1500000
NODE_2783_length_1378_cov_20.508210	318	338	18	4	20	0.2000000
NODE_2783_length_1378_cov_20.508210	318	338	19	2	20	0.1000000
NODE_2783_length_1378_cov_20.508210	318	338	22	8	20	0.4000000
NODE_2783_length_1378_cov_20.508210	318	391	14	3	73	0.0410959
NODE_2783_length_1378_cov_20.508210	318	391	16	3	73	0.0410959
NODE_2783_length_1378_cov_20.508210	318	391	18	4	73	0.0547945
NODE_2783_length_1378_cov_20.508210	318	391	19	2	73	0.0273973
NODE_2783_length_1378_cov_20.508210	318	391	22	15	73	0.2054795
NODE_2783_length_1378_cov_20.508210	318	391	24	13	73	0.1780822
NODE_2783_length_1378_cov_20.508210	318	391	25	5	73	0.0684932
NODE_2783_length_1378_cov_20.508210	318	391	26	5	73	0.0684932
NODE_2783_length_1378_cov_20.508210	318	391	28	1	73	0.0136986
NODE_2783_length_1378_cov_20.508210	318	391	30	2	73	0.0273973
NODE_2783_length_1378_cov_20.508210	318	391	32	1	73	0.0136986
NODE_2783_length_1378_cov_20.508210	318	391	33	9	73	0.1232877
NODE_2783_length_1378_cov_20.508210	318	391	34	1	73	0.0136986
NODE_2783_length_1378_cov_20.508210	318	391	35	9	73	0.1232877
NODE_2785_length_1377_cov_103.832551	1259	1299	45	1	40	0.0250000
NODE_2785_length_1377_cov_103.832551	1259	1299	46	4	40	0.1000000
NODE_2785_length_1377_cov_103.832551	1259	1299	50	2	40	0.0500000
NODE_2785_length_1377_cov_103.832551	1259	1299	51	1	40	0.0250000
NODE_2785_length_1377_cov_103.832551	1259	1299	52	3	40	0.0750000
NODE_2785_length_1377_cov_103.832551	1259	1299	54	1	40	0.0250000
NODE_2785_length_1377_cov_103.832551	1259	1299	55	1	40	0.0250000
NODE_2785_length_1377_cov_103.832551	1259	1299	56	3	40	0.0750000
NODE_2785_length_1377_cov_103.832551	1259	1299	57	7	40	0.1750000
NODE_2785_length_1377_cov_103.832551	1259	1299	58	2	40	0.0500000
NODE_2785_length_1377_cov_103.832551	1259	1299	60	8	40	0.2000000
NODE_2785_length_1377_cov_103.832551	1259	1299	61	7	40	0.1750000
NODE_2788_length_1376_cov_7.967110	904	984	0	20	80	0.2500000
NODE_2788_length_1376_cov_7.967110	904	984	4	60	80	0.7500000
NODE_2788_length_1376_cov_7.967110	957	1037	0	73	80	0.9125000
NODE_2788_length_1376_cov_7.967110	957	1037	4	7	80	0.0875000
NODE_2798_length_1373_cov_52.691523	524	606	1	11	82	0.1341463
NODE_2798_length_1373_cov_52.691523	524	606	2	14	82	0.1707317
NODE_2798_length_1373_cov_52.691523	524	606	3	57	82	0.6951219
NODE_2798_length_1373_cov_52.691523	579	659	0	33	80	0.4125000
NODE_2798_length_1373_cov_52.691523	579	659	1	2	80	0.0250000
NODE_2798_length_1373_cov_52.691523	579	659	3	45	80	0.5625000
NODE_2799_length_1373_cov_20.880691	987	1067	8	9	80	0.1125000
NODE_2799_length_1373_cov_20.880691	987	1067	10	7	80	0.0875000
NODE_2799_length_1373_cov_20.880691	987	1067	16	8	80	0.1000000
NODE_2799_length_1373_cov_20.880691	987	1067	22	3	80	0.0375000
NODE_2799_length_1373_cov_20.880691	987	1067	24	23	80	0.2875000
NODE_2799_length_1373_cov_20.880691	987	1067	26	20	80	0.2500000
NODE_2799_length_1373_cov_20.880691	987	1067	28	10	80	0.1250000
NODE_2799_length_1373_cov_20.880691	1116	1195	10	7	79	0.0886076
NODE_2799_length_1373_cov_20.880691	1116	1195	12	30	79	0.3797468
NODE_2799_length_1373_cov_20.880691	1116	1195	14	42	79	0.5316456
NODE_2799_length_1373_cov_20.880691	1168	1248	2	11	80	0.1375000
NODE_2799_length_1373_cov_20.880691	1168	1248	4	18	80	0.2250000
NODE_2799_length_1373_cov_20.880691	1168	1248	5	2	80	0.0250000
NODE_2799_length_1373_cov_20.880691	1168	1248	6	3	80	0.0375000
NODE_2799_length_1373_cov_20.880691	1168	1248	8	3	80	0.0375000
NODE_2799_length_1373_cov_20.880691	1168	1248	10	19	80	0.2375000
NODE_2799_length_1373_cov_20.880691	1168	1248	12	13	80	0.1625000
NODE_2799_length_1373_cov_20.880691	1168	1248	14	11	80	0.1375000
NODE_2800_length_1373_cov_12.694662	94	167	19	1	73	0.0136986
NODE_2800_length_1373_cov_12.694662	94	167	21	17	73	0.2328767
NODE_2800_length_1373_cov_12.694662	94	167	22	2	73	0.0273973
NODE_2800_length_1373_cov_12.694662	94	167	23	2	73	0.0273973
NODE_2800_length_1373_cov_12.694662	94	167	24	2	73	0.0273973
NODE_2800_length_1373_cov_12.694662	94	167	25	8	73	0.1095890
NODE_2800_length_1373_cov_12.694662	94	167	27	1	73	0.0136986
NODE_2800_length_1373_cov_12.694662	94	167	28	1	73	0.0136986
NODE_2800_length_1373_cov_12.694662	94	167	29	2	73	0.0273973
NODE_2800_length_1373_cov_12.694662	94	167	31	1	73	0.0136986
NODE_2800_length_1373_cov_12.694662	94	167	35	2	73	0.0273973
NODE_2800_length_1373_cov_12.694662	94	167	37	2	73	0.0273973
NODE_2800_length_1373_cov_12.694662	94	167	40	1	73	0.0136986
NODE_2800_length_1373_cov_12.694662	94	167	44	4	73	0.0547945
NODE_2800_length_1373_cov_12.694662	94	167	46	1	73	0.0136986
NODE_2800_length_1373_cov_12.694662	94	167	50	4	73	0.0547945
NODE_2800_length_1373_cov_12.694662	94	167	52	1	73	0.0136986
NODE_2800_length_1373_cov_12.694662	94	167	58	5	73	0.0684932
NODE_2800_length_1373_cov_12.694662	94	167	62	1	73	0.0136986
NODE_2800_length_1373_cov_12.694662	94	167	68	1	73	0.0136986
NODE_2800_length_1373_cov_12.694662	94	167	69	1	73	0.0136986
NODE_2800_length_1373_cov_12.694662	94	167	73	2	73	0.0273973
NODE_2800_length_1373_cov_12.694662	94	167	78	1	73	0.0136986
NODE_2800_length_1373_cov_12.694662	94	167	82	1	73	0.0136986
NODE_2800_length_1373_cov_12.694662	94	167	88	2	73	0.0273973
NODE_2800_length_1373_cov_12.694662	94	167	89	1	73	0.0136986
NODE_2800_length_1373_cov_12.694662	94	167	90	1	73	0.0136986
NODE_2800_length_1373_cov_12.694662	94	167	91	2	73	0.0273973
NODE_2800_length_1373_cov_12.694662	94	167	93	3	73	0.0410959
NODE_2800_length_1373_cov_12.694662	140	224	46	1	84	0.0119048
NODE_2800_length_1373_cov_12.694662	140	224	50	4	84	0.0476190
NODE_2800_length_1373_cov_12.694662	140	224	52	1	84	0.0119048
NODE_2800_length_1373_cov_12.694662	140	224	58	5	84	0.0595238
NODE_2800_length_1373_cov_12.694662	140	224	62	1	84	0.0119048
NODE_2800_length_1373_cov_12.694662	140	224	68	1	84	0.0119048
NODE_2800_length_1373_cov_12.694662	140	224	69	1	84	0.0119048
NODE_2800_length_1373_cov_12.694662	140	224	73	2	84	0.0238095
NODE_2800_length_1373_cov_12.694662	140	224	78	1	84	0.0119048
NODE_2800_length_1373_cov_12.694662	140	224	82	1	84	0.0119048
NODE_2800_length_1373_cov_12.694662	140	224	88	2	84	0.0238095
NODE_2800_length_1373_cov_12.694662	140	224	89	1	84	0.0119048
NODE_2800_length_1373_cov_12.694662	140	224	90	1	84	0.0119048
NODE_2800_length_1373_cov_12.694662	140	224	91	2	84	0.0238095
NODE_2800_length_1373_cov_12.694662	140	224	93	3	84	0.0357143
NODE_2800_length_1373_cov_12.694662	140	224	94	4	84	0.0476190
NODE_2800_length_1373_cov_12.694662	140	224	98	1	84	0.0119048
NODE_2800_length_1373_cov_12.694662	140	224	100	2	84	0.0238095
NODE_2800_length_1373_cov_12.694662	140	224	102	1	84	0.0119048
NODE_2800_length_1373_cov_12.694662	140	224	103	3	84	0.0357143
NODE_2800_length_1373_cov_12.694662	140	224	105	1	84	0.0119048
NODE_2800_length_1373_cov_12.694662	140	224	111	2	84	0.0238095
NODE_2800_length_1373_cov_12.694662	140	224	113	2	84	0.0238095
NODE_2800_length_1373_cov_12.694662	140	224	115	2	84	0.0238095
NODE_2800_length_1373_cov_12.694662	140	224	117	1	84	0.0119048
NODE_2800_length_1373_cov_12.694662	140	224	119	2	84	0.0238095
NODE_2800_length_1373_cov_12.694662	140	224	121	2	84	0.0238095
NODE_2800_length_1373_cov_12.694662	140	224	123	5	84	0.0595238
NODE_2800_length_1373_cov_12.694662	140	224	125	1	84	0.0119048
NODE_2800_length_1373_cov_12.694662	140	224	127	1	84	0.0119048
NODE_2800_length_1373_cov_12.694662	140	224	135	1	84	0.0119048
NODE_2800_length_1373_cov_12.694662	140	224	138	6	84	0.0714286
NODE_2800_length_1373_cov_12.694662	140	224	140	1	84	0.0119048
NODE_2800_length_1373_cov_12.694662	140	224	141	6	84	0.0714286
NODE_2800_length_1373_cov_12.694662	140	224	143	2	84	0.0238095
NODE_2800_length_1373_cov_12.694662	140	224	145	3	84	0.0357143
NODE_2800_length_1373_cov_12.694662	140	224	147	1	84	0.0119048
NODE_2800_length_1373_cov_12.694662	140	224	148	4	84	0.0476190
NODE_2800_length_1373_cov_12.694662	140	224	149	1	84	0.0119048
NODE_2800_length_1373_cov_12.694662	140	224	150	1	84	0.0119048
NODE_2800_length_1373_cov_12.694662	140	224	152	1	84	0.0119048
NODE_2800_length_1373_cov_12.694662	1214	1286	15	20	72	0.2777778
NODE_2800_length_1373_cov_12.694662	1214	1286	17	6	72	0.0833333
NODE_2800_length_1373_cov_12.694662	1214	1286	18	3	72	0.0416667
NODE_2800_length_1373_cov_12.694662	1214	1286	21	16	72	0.2222222
NODE_2800_length_1373_cov_12.694662	1214	1286	22	6	72	0.0833333
NODE_2800_length_1373_cov_12.694662	1214	1286	23	21	72	0.2916667
NODE_2800_length_1373_cov_12.694662	1267	1339	8	3	72	0.0416667
NODE_2800_length_1373_cov_12.694662	1267	1339	12	43	72	0.5972222
NODE_2800_length_1373_cov_12.694662	1267	1339	14	5	72	0.0694444
NODE_2800_length_1373_cov_12.694662	1267	1339	15	15	72	0.2083333
NODE_2800_length_1373_cov_12.694662	1267	1339	17	6	72	0.0833333
NODE_2801_length_1372_cov_25.408484	665	745	0	5	80	0.0625000
NODE_2801_length_1372_cov_25.408484	665	745	2	50	80	0.6250000
NODE_2801_length_1372_cov_25.408484	665	745	4	25	80	0.3125000
NODE_2801_length_1372_cov_25.408484	718	798	0	2	80	0.0250000
NODE_2801_length_1372_cov_25.408484	718	798	4	49	80	0.6125000
NODE_2801_length_1372_cov_25.408484	718	798	6	29	80	0.3625000
NODE_2802_length_1372_cov_17.123331	647	727	0	80	80	1.0000000
NODE_2802_length_1372_cov_17.123331	700	780	0	80	80	1.0000000
NODE_2802_length_1372_cov_17.123331	776	856	0	80	80	1.0000000
NODE_2802_length_1372_cov_17.123331	829	909	0	80	80	1.0000000
NODE_2803_length_1372_cov_14.418696	211	291	0	38	80	0.4750000
NODE_2803_length_1372_cov_14.418696	211	291	2	42	80	0.5250000
NODE_2803_length_1372_cov_14.418696	264	344	0	22	80	0.2750000
NODE_2803_length_1372_cov_14.418696	264	344	2	58	80	0.7250000
NODE_2806_length_1371_cov_39.366352	715	795	3	5	80	0.0625000
NODE_2806_length_1371_cov_39.366352	715	795	7	45	80	0.5625000
NODE_2806_length_1371_cov_39.366352	715	795	9	6	80	0.0750000
NODE_2806_length_1371_cov_39.366352	715	795	12	1	80	0.0125000
NODE_2806_length_1371_cov_39.366352	715	795	13	23	80	0.2875000
NODE_2806_length_1371_cov_39.366352	768	848	4	1	80	0.0125000
NODE_2806_length_1371_cov_39.366352	768	848	6	9	80	0.1125000
NODE_2806_length_1371_cov_39.366352	768	848	7	10	80	0.1250000
NODE_2806_length_1371_cov_39.366352	768	848	9	3	80	0.0375000
NODE_2806_length_1371_cov_39.366352	768	848	11	8	80	0.1000000
NODE_2806_length_1371_cov_39.366352	768	848	12	1	80	0.0125000
NODE_2806_length_1371_cov_39.366352	768	848	13	48	80	0.6000000
NODE_2807_length_1371_cov_36.961478	371	455	0	84	84	1.0000000
NODE_2807_length_1371_cov_36.961478	424	508	0	84	84	1.0000000
NODE_2807_length_1371_cov_36.961478	504	584	0	80	80	1.0000000
NODE_2807_length_1371_cov_36.961478	557	637	0	80	80	1.0000000
NODE_2808_length_1371_cov_16.944182	459	539	0	80	80	1.0000000
NODE_2808_length_1371_cov_16.944182	512	592	0	80	80	1.0000000
NODE_2808_length_1371_cov_16.944182	588	668	0	77	80	0.9625000
NODE_2808_length_1371_cov_16.944182	588	668	4	3	80	0.0375000
NODE_2808_length_1371_cov_16.944182	641	721	0	24	80	0.3000000
NODE_2808_length_1371_cov_16.944182	641	721	4	56	80	0.7000000
NODE_2812_length_1370_cov_11.627065	502	582	0	80	80	1.0000000
NODE_2812_length_1370_cov_11.627065	555	635	0	80	80	1.0000000
NODE_2812_length_1370_cov_11.627065	631	711	0	54	80	0.6750000
NODE_2812_length_1370_cov_11.627065	631	711	4	26	80	0.3250000
NODE_2812_length_1370_cov_11.627065	684	764	0	1	80	0.0125000
NODE_2812_length_1370_cov_11.627065	684	764	4	79	80	0.9875000
NODE_2813_length_1369_cov_27.937795	597	677	3	12	80	0.1500000
NODE_2813_length_1369_cov_27.937795	597	677	4	16	80	0.2000000
NODE_2813_length_1369_cov_27.937795	597	677	8	18	80	0.2250000
NODE_2813_length_1369_cov_27.937795	597	677	9	4	80	0.0500000
NODE_2813_length_1369_cov_27.937795	597	677	10	30	80	0.3750000
NODE_2813_length_1369_cov_27.937795	650	730	3	7	80	0.0875000
NODE_2813_length_1369_cov_27.937795	650	730	4	5	80	0.0625000
NODE_2813_length_1369_cov_27.937795	650	730	6	4	80	0.0500000
NODE_2813_length_1369_cov_27.937795	650	730	10	64	80	0.8000000
NODE_2820_length_1368_cov_35.148148	546	626	0	58	80	0.7250000
NODE_2820_length_1368_cov_35.148148	546	626	2	22	80	0.2750000
NODE_2820_length_1368_cov_35.148148	599	679	0	80	80	1.0000000
NODE_2821_length_1368_cov_27.847912	486	559	0	73	73	1.0000000
NODE_2821_length_1368_cov_27.847912	532	612	0	80	80	1.0000000
NODE_2821_length_1368_cov_27.847912	608	688	0	80	80	1.0000000
NODE_2821_length_1368_cov_27.847912	661	741	0	80	80	1.0000000
NODE_2822_length_1368_cov_26.832151	458	538	2	37	80	0.4625000
NODE_2822_length_1368_cov_26.832151	458	538	4	43	80	0.5375000
NODE_2822_length_1368_cov_26.832151	511	591	0	2	80	0.0250000
NODE_2822_length_1368_cov_26.832151	511	591	1	9	80	0.1125000
NODE_2822_length_1368_cov_26.832151	511	591	2	69	80	0.8625000
NODE_2822_length_1368_cov_26.832151	587	667	0	18	80	0.2250000
NODE_2822_length_1368_cov_26.832151	587	667	2	62	80	0.7750000
NODE_2822_length_1368_cov_26.832151	640	720	0	71	80	0.8875000
NODE_2822_length_1368_cov_26.832151	640	720	2	9	80	0.1125000
NODE_2823_length_1368_cov_18.205674	603	683	0	80	80	1.0000000
NODE_2823_length_1368_cov_18.205674	656	736	0	80	80	1.0000000
NODE_2826_length_1367_cov_576.769716	799	879	459	1	80	0.0125000
NODE_2826_length_1367_cov_576.769716	799	879	465	1	80	0.0125000
NODE_2826_length_1367_cov_576.769716	799	879	469	1	80	0.0125000
NODE_2826_length_1367_cov_576.769716	799	879	474	1	80	0.0125000
NODE_2826_length_1367_cov_576.769716	799	879	477	1	80	0.0125000
NODE_2826_length_1367_cov_576.769716	799	879	500	2	80	0.0250000
NODE_2826_length_1367_cov_576.769716	799	879	518	1	80	0.0125000
NODE_2826_length_1367_cov_576.769716	799	879	521	1	80	0.0125000
NODE_2826_length_1367_cov_576.769716	799	879	530	1	80	0.0125000
NODE_2826_length_1367_cov_576.769716	799	879	548	1	80	0.0125000
NODE_2826_length_1367_cov_576.769716	799	879	551	1	80	0.0125000
NODE_2826_length_1367_cov_576.769716	799	879	568	2	80	0.0250000
NODE_2826_length_1367_cov_576.769716	799	879	573	1	80	0.0125000
NODE_2826_length_1367_cov_576.769716	799	879	575	1	80	0.0125000
NODE_2826_length_1367_cov_576.769716	799	879	576	1	80	0.0125000
NODE_2826_length_1367_cov_576.769716	799	879	578	2	80	0.0250000
NODE_2826_length_1367_cov_576.769716	799	879	583	1	80	0.0125000
NODE_2826_length_1367_cov_576.769716	799	879	584	1	80	0.0125000
NODE_2826_length_1367_cov_576.769716	799	879	588	1	80	0.0125000
NODE_2826_length_1367_cov_576.769716	799	879	592	1	80	0.0125000
NODE_2826_length_1367_cov_576.769716	799	879	602	1	80	0.0125000
NODE_2826_length_1367_cov_576.769716	799	879	603	1	80	0.0125000
NODE_2826_length_1367_cov_576.769716	799	879	612	1	80	0.0125000
NODE_2826_length_1367_cov_576.769716	799	879	616	1	80	0.0125000
NODE_2826_length_1367_cov_576.769716	799	879	619	1	80	0.0125000
NODE_2826_length_1367_cov_576.769716	799	879	621	1	80	0.0125000
NODE_2826_length_1367_cov_576.769716	799	879	622	1	80	0.0125000
NODE_2826_length_1367_cov_576.769716	799	879	631	1	80	0.0125000
NODE_2826_length_1367_cov_576.769716	799	879	632	1	80	0.0125000
NODE_2826_length_1367_cov_576.769716	799	879	633	1	80	0.0125000
NODE_2826_length_1367_cov_576.769716	799	879	638	1	80	0.0125000
NODE_2826_length_1367_cov_576.769716	799	879	639	1	80	0.0125000
NODE_2826_length_1367_cov_576.769716	799	879	640	1	80	0.0125000
NODE_2826_length_1367_cov_576.769716	799	879	642	1	80	0.0125000
NODE_2826_length_1367_cov_576.769716	799	879	643	1	80	0.0125000
NODE_2826_length_1367_cov_576.769716	799	879	645	1	80	0.0125000
NODE_2826_length_1367_cov_576.769716	799	879	654	2	80	0.0250000
NODE_2826_length_1367_cov_576.769716	799	879	655	1	80	0.0125000
NODE_2826_length_1367_cov_576.769716	799	879	662	1	80	0.0125000
NODE_2826_length_1367_cov_576.769716	799	879	697	1	80	0.0125000
NODE_2826_length_1367_cov_576.769716	799	879	706	1	80	0.0125000
NODE_2826_length_1367_cov_576.769716	799	879	707	1	80	0.0125000
NODE_2826_length_1367_cov_576.769716	799	879	708	1	80	0.0125000
NODE_2826_length_1367_cov_576.769716	799	879	711	1	80	0.0125000
NODE_2826_length_1367_cov_576.769716	799	879	713	1	80	0.0125000
NODE_2826_length_1367_cov_576.769716	799	879	769	1	80	0.0125000
NODE_2826_length_1367_cov_576.769716	799	879	773	1	80	0.0125000
NODE_2826_length_1367_cov_576.769716	799	879	787	1	80	0.0125000
NODE_2826_length_1367_cov_576.769716	799	879	792	1	80	0.0125000
NODE_2826_length_1367_cov_576.769716	799	879	810	1	80	0.0125000
NODE_2826_length_1367_cov_576.769716	799	879	828	1	80	0.0125000
NODE_2826_length_1367_cov_576.769716	799	879	849	1	80	0.0125000
NODE_2826_length_1367_cov_576.769716	799	879	890	1	80	0.0125000
NODE_2826_length_1367_cov_576.769716	799	879	895	1	80	0.0125000
NODE_2826_length_1367_cov_576.769716	799	879	931	1	80	0.0125000
NODE_2826_length_1367_cov_576.769716	799	879	1015	1	80	0.0125000
NODE_2826_length_1367_cov_576.769716	799	879	1065	1	80	0.0125000
NODE_2826_length_1367_cov_576.769716	799	879	1084	1	80	0.0125000
NODE_2826_length_1367_cov_576.769716	799	879	1131	1	80	0.0125000
NODE_2826_length_1367_cov_576.769716	799	879	1154	1	80	0.0125000
NODE_2826_length_1367_cov_576.769716	799	879	1158	1	80	0.0125000
NODE_2826_length_1367_cov_576.769716	799	879	1295	1	80	0.0125000
NODE_2826_length_1367_cov_576.769716	799	879	1310	1	80	0.0125000
NODE_2826_length_1367_cov_576.769716	799	879	1311	1	80	0.0125000
NODE_2826_length_1367_cov_576.769716	799	879	1425	1	80	0.0125000
NODE_2826_length_1367_cov_576.769716	799	879	1442	1	80	0.0125000
NODE_2826_length_1367_cov_576.769716	799	879	1477	1	80	0.0125000
NODE_2826_length_1367_cov_576.769716	799	879	1487	1	80	0.0125000
NODE_2826_length_1367_cov_576.769716	799	879	1551	1	80	0.0125000
NODE_2826_length_1367_cov_576.769716	799	879	1580	1	80	0.0125000
NODE_2826_length_1367_cov_576.769716	799	879	1618	1	80	0.0125000
NODE_2826_length_1367_cov_576.769716	799	879	1641	2	80	0.0250000
NODE_2826_length_1367_cov_576.769716	799	879	1650	2	80	0.0250000
NODE_2826_length_1367_cov_576.769716	799	879	1669	1	80	0.0125000
NODE_2826_length_1367_cov_576.769716	852	932	810	1	80	0.0125000
NODE_2826_length_1367_cov_576.769716	852	932	828	1	80	0.0125000
NODE_2826_length_1367_cov_576.769716	852	932	849	1	80	0.0125000
NODE_2826_length_1367_cov_576.769716	852	932	890	1	80	0.0125000
NODE_2826_length_1367_cov_576.769716	852	932	895	1	80	0.0125000
NODE_2826_length_1367_cov_576.769716	852	932	931	1	80	0.0125000
NODE_2826_length_1367_cov_576.769716	852	932	1015	1	80	0.0125000
NODE_2826_length_1367_cov_576.769716	852	932	1065	1	80	0.0125000
NODE_2826_length_1367_cov_576.769716	852	932	1084	1	80	0.0125000
NODE_2826_length_1367_cov_576.769716	852	932	1131	1	80	0.0125000
NODE_2826_length_1367_cov_576.769716	852	932	1154	1	80	0.0125000
NODE_2826_length_1367_cov_576.769716	852	932	1158	1	80	0.0125000
NODE_2826_length_1367_cov_576.769716	852	932	1295	1	80	0.0125000
NODE_2826_length_1367_cov_576.769716	852	932	1310	1	80	0.0125000
NODE_2826_length_1367_cov_576.769716	852	932	1311	1	80	0.0125000
NODE_2826_length_1367_cov_576.769716	852	932	1425	1	80	0.0125000
NODE_2826_length_1367_cov_576.769716	852	932	1442	1	80	0.0125000
NODE_2826_length_1367_cov_576.769716	852	932	1477	1	80	0.0125000
NODE_2826_length_1367_cov_576.769716	852	932	1487	1	80	0.0125000
NODE_2826_length_1367_cov_576.769716	852	932	1551	1	80	0.0125000
NODE_2826_length_1367_cov_576.769716	852	932	1580	1	80	0.0125000
NODE_2826_length_1367_cov_576.769716	852	932	1618	1	80	0.0125000
NODE_2826_length_1367_cov_576.769716	852	932	1641	2	80	0.0250000
NODE_2826_length_1367_cov_576.769716	852	932	1650	2	80	0.0250000
NODE_2826_length_1367_cov_576.769716	852	932	1669	2	80	0.0250000
NODE_2826_length_1367_cov_576.769716	852	932	1670	1	80	0.0125000
NODE_2826_length_1367_cov_576.769716	852	932	1673	1	80	0.0125000
NODE_2826_length_1367_cov_576.769716	852	932	1725	1	80	0.0125000
NODE_2826_length_1367_cov_576.769716	852	932	1770	1	80	0.0125000
NODE_2826_length_1367_cov_576.769716	852	932	1773	1	80	0.0125000
NODE_2826_length_1367_cov_576.769716	852	932	1834	1	80	0.0125000
NODE_2826_length_1367_cov_576.769716	852	932	1892	1	80	0.0125000
NODE_2826_length_1367_cov_576.769716	852	932	1898	1	80	0.0125000
NODE_2826_length_1367_cov_576.769716	852	932	1919	1	80	0.0125000
NODE_2826_length_1367_cov_576.769716	852	932	1935	1	80	0.0125000
NODE_2826_length_1367_cov_576.769716	852	932	1959	1	80	0.0125000
NODE_2826_length_1367_cov_576.769716	852	932	2016	1	80	0.0125000
NODE_2826_length_1367_cov_576.769716	852	932	2049	1	80	0.0125000
NODE_2826_length_1367_cov_576.769716	852	932	2051	2	80	0.0250000
NODE_2826_length_1367_cov_576.769716	852	932	2052	1	80	0.0125000
NODE_2826_length_1367_cov_576.769716	852	932	2055	2	80	0.0250000
NODE_2826_length_1367_cov_576.769716	852	932	2056	1	80	0.0125000
NODE_2826_length_1367_cov_576.769716	852	932	2060	1	80	0.0125000
NODE_2826_length_1367_cov_576.769716	852	932	2063	1	80	0.0125000
NODE_2826_length_1367_cov_576.769716	852	932	2064	4	80	0.0500000
NODE_2826_length_1367_cov_576.769716	852	932	2065	2	80	0.0250000
NODE_2826_length_1367_cov_576.769716	852	932	2066	1	80	0.0125000
NODE_2826_length_1367_cov_576.769716	852	932	2069	1	80	0.0125000
NODE_2826_length_1367_cov_576.769716	852	932	2070	2	80	0.0250000
NODE_2826_length_1367_cov_576.769716	852	932	2072	1	80	0.0125000
NODE_2826_length_1367_cov_576.769716	852	932	2076	2	80	0.0250000
NODE_2826_length_1367_cov_576.769716	852	932	2078	3	80	0.0375000
NODE_2826_length_1367_cov_576.769716	852	932	2083	3	80	0.0375000
NODE_2826_length_1367_cov_576.769716	852	932	2084	6	80	0.0750000
NODE_2826_length_1367_cov_576.769716	852	932	2085	1	80	0.0125000
NODE_2826_length_1367_cov_576.769716	852	932	2086	3	80	0.0375000
NODE_2826_length_1367_cov_576.769716	852	932	2087	2	80	0.0250000
NODE_2826_length_1367_cov_576.769716	900	980	1491	1	80	0.0125000
NODE_2826_length_1367_cov_576.769716	900	980	1566	1	80	0.0125000
NODE_2826_length_1367_cov_576.769716	900	980	1621	1	80	0.0125000
NODE_2826_length_1367_cov_576.769716	900	980	1702	1	80	0.0125000
NODE_2826_length_1367_cov_576.769716	900	980	1733	1	80	0.0125000
NODE_2826_length_1367_cov_576.769716	900	980	1780	1	80	0.0125000
NODE_2826_length_1367_cov_576.769716	900	980	1808	1	80	0.0125000
NODE_2826_length_1367_cov_576.769716	900	980	1818	1	80	0.0125000
NODE_2826_length_1367_cov_576.769716	900	980	1826	1	80	0.0125000
NODE_2826_length_1367_cov_576.769716	900	980	1838	1	80	0.0125000
NODE_2826_length_1367_cov_576.769716	900	980	1842	1	80	0.0125000
NODE_2826_length_1367_cov_576.769716	900	980	1843	1	80	0.0125000
NODE_2826_length_1367_cov_576.769716	900	980	1851	1	80	0.0125000
NODE_2826_length_1367_cov_576.769716	900	980	1855	1	80	0.0125000
NODE_2826_length_1367_cov_576.769716	900	980	1860	1	80	0.0125000
NODE_2826_length_1367_cov_576.769716	900	980	1864	1	80	0.0125000
NODE_2826_length_1367_cov_576.769716	900	980	1866	2	80	0.0250000
NODE_2826_length_1367_cov_576.769716	900	980	1869	1	80	0.0125000
NODE_2826_length_1367_cov_576.769716	900	980	1870	1	80	0.0125000
NODE_2826_length_1367_cov_576.769716	900	980	1882	1	80	0.0125000
NODE_2826_length_1367_cov_576.769716	900	980	1889	1	80	0.0125000
NODE_2826_length_1367_cov_576.769716	900	980	1909	1	80	0.0125000
NODE_2826_length_1367_cov_576.769716	900	980	1913	1	80	0.0125000
NODE_2826_length_1367_cov_576.769716	900	980	1921	1	80	0.0125000
NODE_2826_length_1367_cov_576.769716	900	980	1923	1	80	0.0125000
NODE_2826_length_1367_cov_576.769716	900	980	1935	1	80	0.0125000
NODE_2826_length_1367_cov_576.769716	900	980	1941	2	80	0.0250000
NODE_2826_length_1367_cov_576.769716	900	980	1956	1	80	0.0125000
NODE_2826_length_1367_cov_576.769716	900	980	1957	1	80	0.0125000
NODE_2826_length_1367_cov_576.769716	900	980	1961	1	80	0.0125000
NODE_2826_length_1367_cov_576.769716	900	980	1966	1	80	0.0125000
NODE_2826_length_1367_cov_576.769716	900	980	1970	1	80	0.0125000
NODE_2826_length_1367_cov_576.769716	900	980	1982	1	80	0.0125000
NODE_2826_length_1367_cov_576.769716	900	980	1988	1	80	0.0125000
NODE_2826_length_1367_cov_576.769716	900	980	2014	1	80	0.0125000
NODE_2826_length_1367_cov_576.769716	900	980	2023	1	80	0.0125000
NODE_2826_length_1367_cov_576.769716	900	980	2024	1	80	0.0125000
NODE_2826_length_1367_cov_576.769716	900	980	2034	1	80	0.0125000
NODE_2826_length_1367_cov_576.769716	900	980	2036	1	80	0.0125000
NODE_2826_length_1367_cov_576.769716	900	980	2039	2	80	0.0250000
NODE_2826_length_1367_cov_576.769716	900	980	2040	2	80	0.0250000
NODE_2826_length_1367_cov_576.769716	900	980	2044	1	80	0.0125000
NODE_2826_length_1367_cov_576.769716	900	980	2047	1	80	0.0125000
NODE_2826_length_1367_cov_576.769716	900	980	2048	1	80	0.0125000
NODE_2826_length_1367_cov_576.769716	900	980	2049	1	80	0.0125000
NODE_2826_length_1367_cov_576.769716	900	980	2051	2	80	0.0250000
NODE_2826_length_1367_cov_576.769716	900	980	2052	1	80	0.0125000
NODE_2826_length_1367_cov_576.769716	900	980	2055	2	80	0.0250000
NODE_2826_length_1367_cov_576.769716	900	980	2060	1	80	0.0125000
NODE_2826_length_1367_cov_576.769716	900	980	2063	1	80	0.0125000
NODE_2826_length_1367_cov_576.769716	900	980	2064	4	80	0.0500000
NODE_2826_length_1367_cov_576.769716	900	980	2065	2	80	0.0250000
NODE_2826_length_1367_cov_576.769716	900	980	2066	1	80	0.0125000
NODE_2826_length_1367_cov_576.769716	900	980	2069	1	80	0.0125000
NODE_2826_length_1367_cov_576.769716	900	980	2070	2	80	0.0250000
NODE_2826_length_1367_cov_576.769716	900	980	2072	1	80	0.0125000
NODE_2826_length_1367_cov_576.769716	900	980	2076	2	80	0.0250000
NODE_2826_length_1367_cov_576.769716	900	980	2078	3	80	0.0375000
NODE_2826_length_1367_cov_576.769716	900	980	2083	1	80	0.0125000
NODE_2826_length_1367_cov_576.769716	900	980	2084	2	80	0.0250000
NODE_2826_length_1367_cov_576.769716	900	980	2085	1	80	0.0125000
NODE_2826_length_1367_cov_576.769716	900	980	2086	2	80	0.0250000
NODE_2826_length_1367_cov_576.769716	900	980	2087	2	80	0.0250000
NODE_2826_length_1367_cov_576.769716	905	927	2055	1	22	0.0454545
NODE_2826_length_1367_cov_576.769716	905	927	2060	1	22	0.0454545
NODE_2826_length_1367_cov_576.769716	905	927	2063	1	22	0.0454545
NODE_2826_length_1367_cov_576.769716	905	927	2064	4	22	0.1818182
NODE_2826_length_1367_cov_576.769716	905	927	2065	2	22	0.0909091
NODE_2826_length_1367_cov_576.769716	905	927	2066	1	22	0.0454545
NODE_2826_length_1367_cov_576.769716	905	927	2069	1	22	0.0454545
NODE_2826_length_1367_cov_576.769716	905	927	2070	2	22	0.0909091
NODE_2826_length_1367_cov_576.769716	905	927	2072	1	22	0.0454545
NODE_2826_length_1367_cov_576.769716	905	927	2076	2	22	0.0909091
NODE_2826_length_1367_cov_576.769716	905	927	2078	1	22	0.0454545
NODE_2826_length_1367_cov_576.769716	905	927	2085	1	22	0.0454545
NODE_2826_length_1367_cov_576.769716	905	927	2086	2	22	0.0909091
NODE_2826_length_1367_cov_576.769716	905	927	2087	2	22	0.0909091
NODE_2826_length_1367_cov_576.769716	1051	1131	63	2	80	0.0250000
NODE_2826_length_1367_cov_576.769716	1051	1131	64	1	80	0.0125000
NODE_2826_length_1367_cov_576.769716	1051	1131	68	3	80	0.0375000
NODE_2826_length_1367_cov_576.769716	1051	1131	72	1	80	0.0125000
NODE_2826_length_1367_cov_576.769716	1051	1131	76	1	80	0.0125000
NODE_2826_length_1367_cov_576.769716	1051	1131	80	2	80	0.0250000
NODE_2826_length_1367_cov_576.769716	1051	1131	81	9	80	0.1125000
NODE_2826_length_1367_cov_576.769716	1051	1131	83	1	80	0.0125000
NODE_2826_length_1367_cov_576.769716	1051	1131	85	5	80	0.0625000
NODE_2826_length_1367_cov_576.769716	1051	1131	86	3	80	0.0375000
NODE_2826_length_1367_cov_576.769716	1051	1131	88	2	80	0.0250000
NODE_2826_length_1367_cov_576.769716	1051	1131	92	1	80	0.0125000
NODE_2826_length_1367_cov_576.769716	1051	1131	98	1	80	0.0125000
NODE_2826_length_1367_cov_576.769716	1051	1131	100	1	80	0.0125000
NODE_2826_length_1367_cov_576.769716	1051	1131	108	1	80	0.0125000
NODE_2826_length_1367_cov_576.769716	1051	1131	114	1	80	0.0125000
NODE_2826_length_1367_cov_576.769716	1051	1131	115	5	80	0.0625000
NODE_2826_length_1367_cov_576.769716	1051	1131	127	1	80	0.0125000
NODE_2826_length_1367_cov_576.769716	1051	1131	134	1	80	0.0125000
NODE_2826_length_1367_cov_576.769716	1051	1131	155	1	80	0.0125000
NODE_2826_length_1367_cov_576.769716	1051	1131	160	1	80	0.0125000
NODE_2826_length_1367_cov_576.769716	1051	1131	169	2	80	0.0250000
NODE_2826_length_1367_cov_576.769716	1051	1131	170	1	80	0.0125000
NODE_2826_length_1367_cov_576.769716	1051	1131	172	2	80	0.0250000
NODE_2826_length_1367_cov_576.769716	1051	1131	179	2	80	0.0250000
NODE_2826_length_1367_cov_576.769716	1051	1131	189	1	80	0.0125000
NODE_2826_length_1367_cov_576.769716	1051	1131	190	1	80	0.0125000
NODE_2826_length_1367_cov_576.769716	1051	1131	193	3	80	0.0375000
NODE_2826_length_1367_cov_576.769716	1051	1131	200	1	80	0.0125000
NODE_2826_length_1367_cov_576.769716	1051	1131	201	2	80	0.0250000
NODE_2826_length_1367_cov_576.769716	1051	1131	203	1	80	0.0125000
NODE_2826_length_1367_cov_576.769716	1051	1131	204	1	80	0.0125000
NODE_2826_length_1367_cov_576.769716	1051	1131	208	1	80	0.0125000
NODE_2826_length_1367_cov_576.769716	1051	1131	213	4	80	0.0500000
NODE_2826_length_1367_cov_576.769716	1051	1131	216	1	80	0.0125000
NODE_2826_length_1367_cov_576.769716	1051	1131	218	1	80	0.0125000
NODE_2826_length_1367_cov_576.769716	1051	1131	220	2	80	0.0250000
NODE_2826_length_1367_cov_576.769716	1051	1131	223	3	80	0.0375000
NODE_2826_length_1367_cov_576.769716	1051	1131	230	1	80	0.0125000
NODE_2826_length_1367_cov_576.769716	1051	1131	234	2	80	0.0250000
NODE_2826_length_1367_cov_576.769716	1051	1131	235	1	80	0.0125000
NODE_2826_length_1367_cov_576.769716	1051	1131	242	1	80	0.0125000
NODE_2826_length_1367_cov_576.769716	1051	1131	244	1	80	0.0125000
NODE_2826_length_1367_cov_576.769716	1051	1131	247	1	80	0.0125000
NODE_2826_length_1367_cov_576.769716	1104	1184	193	3	80	0.0375000
NODE_2826_length_1367_cov_576.769716	1104	1184	200	1	80	0.0125000
NODE_2826_length_1367_cov_576.769716	1104	1184	201	2	80	0.0250000
NODE_2826_length_1367_cov_576.769716	1104	1184	203	1	80	0.0125000
NODE_2826_length_1367_cov_576.769716	1104	1184	204	1	80	0.0125000
NODE_2826_length_1367_cov_576.769716	1104	1184	208	1	80	0.0125000
NODE_2826_length_1367_cov_576.769716	1104	1184	213	4	80	0.0500000
NODE_2826_length_1367_cov_576.769716	1104	1184	216	1	80	0.0125000
NODE_2826_length_1367_cov_576.769716	1104	1184	218	1	80	0.0125000
NODE_2826_length_1367_cov_576.769716	1104	1184	220	2	80	0.0250000
NODE_2826_length_1367_cov_576.769716	1104	1184	223	3	80	0.0375000
NODE_2826_length_1367_cov_576.769716	1104	1184	230	1	80	0.0125000
NODE_2826_length_1367_cov_576.769716	1104	1184	234	2	80	0.0250000
NODE_2826_length_1367_cov_576.769716	1104	1184	235	1	80	0.0125000
NODE_2826_length_1367_cov_576.769716	1104	1184	242	1	80	0.0125000
NODE_2826_length_1367_cov_576.769716	1104	1184	244	1	80	0.0125000
NODE_2826_length_1367_cov_576.769716	1104	1184	247	4	80	0.0500000
NODE_2826_length_1367_cov_576.769716	1104	1184	252	1	80	0.0125000
NODE_2826_length_1367_cov_576.769716	1104	1184	255	1	80	0.0125000
NODE_2826_length_1367_cov_576.769716	1104	1184	258	1	80	0.0125000
NODE_2826_length_1367_cov_576.769716	1104	1184	266	2	80	0.0250000
NODE_2826_length_1367_cov_576.769716	1104	1184	269	1	80	0.0125000
NODE_2826_length_1367_cov_576.769716	1104	1184	270	1	80	0.0125000
NODE_2826_length_1367_cov_576.769716	1104	1184	271	1	80	0.0125000
NODE_2826_length_1367_cov_576.769716	1104	1184	272	1	80	0.0125000
NODE_2826_length_1367_cov_576.769716	1104	1184	274	1	80	0.0125000
NODE_2826_length_1367_cov_576.769716	1104	1184	276	1	80	0.0125000
NODE_2826_length_1367_cov_576.769716	1104	1184	284	1	80	0.0125000
NODE_2826_length_1367_cov_576.769716	1104	1184	285	1	80	0.0125000
NODE_2826_length_1367_cov_576.769716	1104	1184	299	1	80	0.0125000
NODE_2826_length_1367_cov_576.769716	1104	1184	304	1	80	0.0125000
NODE_2826_length_1367_cov_576.769716	1104	1184	313	1	80	0.0125000
NODE_2826_length_1367_cov_576.769716	1104	1184	321	1	80	0.0125000
NODE_2826_length_1367_cov_576.769716	1104	1184	332	1	80	0.0125000
NODE_2826_length_1367_cov_576.769716	1104	1184	334	1	80	0.0125000
NODE_2826_length_1367_cov_576.769716	1104	1184	341	1	80	0.0125000
NODE_2826_length_1367_cov_576.769716	1104	1184	342	1	80	0.0125000
NODE_2826_length_1367_cov_576.769716	1104	1184	346	2	80	0.0250000
NODE_2826_length_1367_cov_576.769716	1104	1184	349	1	80	0.0125000
NODE_2826_length_1367_cov_576.769716	1104	1184	351	1	80	0.0125000
NODE_2826_length_1367_cov_576.769716	1104	1184	352	1	80	0.0125000
NODE_2826_length_1367_cov_576.769716	1104	1184	353	1	80	0.0125000
NODE_2826_length_1367_cov_576.769716	1104	1184	355	2	80	0.0250000
NODE_2826_length_1367_cov_576.769716	1104	1184	367	1	80	0.0125000
NODE_2826_length_1367_cov_576.769716	1104	1184	373	1	80	0.0125000
NODE_2826_length_1367_cov_576.769716	1104	1184	380	1	80	0.0125000
NODE_2826_length_1367_cov_576.769716	1104	1184	381	1	80	0.0125000
NODE_2826_length_1367_cov_576.769716	1104	1184	386	1	80	0.0125000
NODE_2826_length_1367_cov_576.769716	1104	1184	388	2	80	0.0250000
NODE_2826_length_1367_cov_576.769716	1104	1184	392	1	80	0.0125000
NODE_2826_length_1367_cov_576.769716	1104	1184	394	1	80	0.0125000
NODE_2826_length_1367_cov_576.769716	1104	1184	395	2	80	0.0250000
NODE_2826_length_1367_cov_576.769716	1104	1184	399	1	80	0.0125000
NODE_2826_length_1367_cov_576.769716	1104	1184	410	1	80	0.0125000
NODE_2826_length_1367_cov_576.769716	1104	1184	427	1	80	0.0125000
NODE_2826_length_1367_cov_576.769716	1104	1184	435	1	80	0.0125000
NODE_2826_length_1367_cov_576.769716	1104	1184	436	1	80	0.0125000
NODE_2826_length_1367_cov_576.769716	1104	1184	438	1	80	0.0125000
NODE_2826_length_1367_cov_576.769716	1104	1184	442	1	80	0.0125000
NODE_2826_length_1367_cov_576.769716	1104	1184	450	1	80	0.0125000
NODE_2826_length_1367_cov_576.769716	1104	1184	455	1	80	0.0125000
NODE_2826_length_1367_cov_576.769716	1104	1184	457	1	80	0.0125000
NODE_2827_length_1367_cov_152.824921	513	593	0	80	80	1.0000000
NODE_2827_length_1367_cov_152.824921	566	646	0	80	80	1.0000000
NODE_2827_length_1367_cov_152.824921	642	722	0	80	80	1.0000000
NODE_2827_length_1367_cov_152.824921	695	775	0	80	80	1.0000000
NODE_2829_length_1367_cov_2.947161	250	326	15	8	76	0.1052632
NODE_2829_length_1367_cov_2.947161	250	326	17	9	76	0.1184211
NODE_2829_length_1367_cov_2.947161	250	326	18	9	76	0.1184211
NODE_2829_length_1367_cov_2.947161	250	326	19	7	76	0.0921053
NODE_2829_length_1367_cov_2.947161	250	326	20	23	76	0.3026316
NODE_2829_length_1367_cov_2.947161	250	326	22	20	76	0.2631579
NODE_2831_length_1366_cov_82.742699	198	278	0	80	80	1.0000000
NODE_2831_length_1366_cov_82.742699	251	331	0	80	80	1.0000000
NODE_2832_length_1366_cov_36.659037	577	657	0	80	80	1.0000000
NODE_2832_length_1366_cov_36.659037	630	710	0	80	80	1.0000000
NODE_2834_length_1366_cov_2.320442	47	116	5	1	69	0.0144928
NODE_2834_length_1366_cov_2.320442	47	116	6	68	69	0.9855072
NODE_2834_length_1366_cov_2.320442	1122	1202	2	7	80	0.0875000
NODE_2834_length_1366_cov_2.320442	1122	1202	3	19	80	0.2375000
NODE_2834_length_1366_cov_2.320442	1122	1202	4	15	80	0.1875000
NODE_2834_length_1366_cov_2.320442	1122	1202	5	2	80	0.0250000
NODE_2834_length_1366_cov_2.320442	1122	1202	6	1	80	0.0125000
NODE_2834_length_1366_cov_2.320442	1122	1202	8	21	80	0.2625000
NODE_2834_length_1366_cov_2.320442	1122	1202	9	7	80	0.0875000
NODE_2834_length_1366_cov_2.320442	1122	1202	14	8	80	0.1000000
NODE_2834_length_1366_cov_2.320442	1175	1255	3	11	80	0.1375000
NODE_2834_length_1366_cov_2.320442	1175	1255	5	2	80	0.0250000
NODE_2834_length_1366_cov_2.320442	1175	1255	6	1	80	0.0125000
NODE_2834_length_1366_cov_2.320442	1175	1255	8	6	80	0.0750000
NODE_2834_length_1366_cov_2.320442	1175	1255	9	10	80	0.1250000
NODE_2834_length_1366_cov_2.320442	1175	1255	15	2	80	0.0250000
NODE_2834_length_1366_cov_2.320442	1175	1255	21	2	80	0.0250000
NODE_2834_length_1366_cov_2.320442	1175	1255	22	1	80	0.0125000
NODE_2834_length_1366_cov_2.320442	1175	1255	30	1	80	0.0125000
NODE_2834_length_1366_cov_2.320442	1175	1255	34	4	80	0.0500000
NODE_2834_length_1366_cov_2.320442	1175	1255	36	5	80	0.0625000
NODE_2834_length_1366_cov_2.320442	1175	1255	38	6	80	0.0750000
NODE_2834_length_1366_cov_2.320442	1175	1255	40	2	80	0.0250000
NODE_2834_length_1366_cov_2.320442	1175	1255	42	1	80	0.0125000
NODE_2834_length_1366_cov_2.320442	1175	1255	44	6	80	0.0750000
NODE_2834_length_1366_cov_2.320442	1175	1255	46	1	80	0.0125000
NODE_2834_length_1366_cov_2.320442	1175	1255	48	3	80	0.0375000
NODE_2834_length_1366_cov_2.320442	1175	1255	52	3	80	0.0375000
NODE_2834_length_1366_cov_2.320442	1175	1255	54	3	80	0.0375000
NODE_2834_length_1366_cov_2.320442	1175	1255	60	1	80	0.0125000
NODE_2834_length_1366_cov_2.320442	1175	1255	62	2	80	0.0250000
NODE_2834_length_1366_cov_2.320442	1175	1255	64	2	80	0.0250000
NODE_2834_length_1366_cov_2.320442	1175	1255	66	2	80	0.0250000
NODE_2834_length_1366_cov_2.320442	1175	1255	68	2	80	0.0250000
NODE_2834_length_1366_cov_2.320442	1175	1255	70	1	80	0.0125000
NODE_2834_length_1366_cov_2.320442	1251	1331	33	3	80	0.0375000
NODE_2834_length_1366_cov_2.320442	1251	1331	34	1	80	0.0125000
NODE_2834_length_1366_cov_2.320442	1251	1331	40	2	80	0.0250000
NODE_2834_length_1366_cov_2.320442	1251	1331	42	2	80	0.0250000
NODE_2834_length_1366_cov_2.320442	1251	1331	46	3	80	0.0375000
NODE_2834_length_1366_cov_2.320442	1251	1331	52	5	80	0.0625000
NODE_2834_length_1366_cov_2.320442	1251	1331	54	2	80	0.0250000
NODE_2834_length_1366_cov_2.320442	1251	1331	56	1	80	0.0125000
NODE_2834_length_1366_cov_2.320442	1251	1331	58	2	80	0.0250000
NODE_2834_length_1366_cov_2.320442	1251	1331	62	2	80	0.0250000
NODE_2834_length_1366_cov_2.320442	1251	1331	64	4	80	0.0500000
NODE_2834_length_1366_cov_2.320442	1251	1331	66	3	80	0.0375000
NODE_2834_length_1366_cov_2.320442	1251	1331	68	2	80	0.0250000
NODE_2834_length_1366_cov_2.320442	1251	1331	70	19	80	0.2375000
NODE_2834_length_1366_cov_2.320442	1251	1331	72	29	80	0.3625000
NODE_2835_length_1365_cov_25.540284	432	509	0	77	77	1.0000000
NODE_2835_length_1365_cov_25.540284	482	562	0	80	80	1.0000000
NODE_2835_length_1365_cov_25.540284	558	635	0	77	77	1.0000000
NODE_2835_length_1365_cov_25.540284	625	688	0	39	63	0.6190476
NODE_2835_length_1365_cov_25.540284	625	688	2	24	63	0.3809524
NODE_2838_length_1364_cov_15.222134	120	191	15	1	71	0.0140845
NODE_2838_length_1364_cov_15.222134	120	191	17	17	71	0.2394366
NODE_2838_length_1364_cov_15.222134	120	191	19	6	71	0.0845070
NODE_2838_length_1364_cov_15.222134	120	191	20	5	71	0.0704225
NODE_2838_length_1364_cov_15.222134	120	191	24	1	71	0.0140845
NODE_2838_length_1364_cov_15.222134	120	191	31	3	71	0.0422535
NODE_2838_length_1364_cov_15.222134	120	191	36	4	71	0.0563380
NODE_2838_length_1364_cov_15.222134	120	191	37	8	71	0.1126761
NODE_2838_length_1364_cov_15.222134	120	191	38	8	71	0.1126761
NODE_2838_length_1364_cov_15.222134	120	191	43	1	71	0.0140845
NODE_2838_length_1364_cov_15.222134	120	191	44	2	71	0.0281690
NODE_2838_length_1364_cov_15.222134	120	191	46	2	71	0.0281690
NODE_2838_length_1364_cov_15.222134	120	191	50	2	71	0.0281690
NODE_2838_length_1364_cov_15.222134	120	191	53	2	71	0.0281690
NODE_2838_length_1364_cov_15.222134	120	191	55	4	71	0.0563380
NODE_2838_length_1364_cov_15.222134	120	191	57	1	71	0.0140845
NODE_2838_length_1364_cov_15.222134	120	191	59	4	71	0.0563380
NODE_2839_length_1364_cov_7.456917	843	923	0	10	80	0.1250000
NODE_2839_length_1364_cov_7.456917	843	923	2	32	80	0.4000000
NODE_2839_length_1364_cov_7.456917	843	923	4	38	80	0.4750000
NODE_2839_length_1364_cov_7.456917	896	976	2	11	80	0.1375000
NODE_2839_length_1364_cov_7.456917	896	976	4	69	80	0.8625000
NODE_2840_length_1364_cov_5.055336	239	290	2	16	51	0.3137255
NODE_2840_length_1364_cov_5.055336	239	290	12	35	51	0.6862745
NODE_2840_length_1364_cov_5.055336	263	343	10	29	80	0.3625000
NODE_2840_length_1364_cov_5.055336	263	343	12	51	80	0.6375000
NODE_2846_length_1363_cov_19.442247	615	695	8	4	80	0.0500000
NODE_2846_length_1363_cov_19.442247	615	695	11	2	80	0.0250000
NODE_2846_length_1363_cov_19.442247	615	695	12	5	80	0.0625000
NODE_2846_length_1363_cov_19.442247	615	695	14	41	80	0.5125000
NODE_2846_length_1363_cov_19.442247	615	695	16	2	80	0.0250000
NODE_2846_length_1363_cov_19.442247	615	695	18	1	80	0.0125000
NODE_2846_length_1363_cov_19.442247	615	695	20	25	80	0.3125000
NODE_2846_length_1363_cov_19.442247	668	748	14	2	80	0.0250000
NODE_2846_length_1363_cov_19.442247	668	748	18	4	80	0.0500000
NODE_2846_length_1363_cov_19.442247	668	748	20	35	80	0.4375000
NODE_2846_length_1363_cov_19.442247	668	748	22	5	80	0.0625000
NODE_2846_length_1363_cov_19.442247	668	748	24	32	80	0.4000000
NODE_2846_length_1363_cov_19.442247	668	748	25	1	80	0.0125000
NODE_2846_length_1363_cov_19.442247	668	748	26	1	80	0.0125000
NODE_2847_length_1363_cov_13.575949	619	699	0	80	80	1.0000000
NODE_2847_length_1363_cov_13.575949	672	752	0	80	80	1.0000000
NODE_2850_length_1362_cov_15.796516	898	978	0	13	80	0.1625000
NODE_2850_length_1362_cov_15.796516	898	978	4	25	80	0.3125000
NODE_2850_length_1362_cov_15.796516	898	978	6	42	80	0.5250000
NODE_2850_length_1362_cov_15.796516	951	1031	0	32	80	0.4000000
NODE_2850_length_1362_cov_15.796516	951	1031	2	15	80	0.1875000
NODE_2850_length_1362_cov_15.796516	951	1031	6	33	80	0.4125000
NODE_2855_length_1361_cov_24.574485	528	608	0	35	80	0.4375000
NODE_2855_length_1361_cov_24.574485	528	608	6	45	80	0.5625000
NODE_2855_length_1361_cov_24.574485	581	661	0	7	80	0.0875000
NODE_2855_length_1361_cov_24.574485	581	661	5	1	80	0.0125000
NODE_2855_length_1361_cov_24.574485	581	661	6	72	80	0.9000000
NODE_2856_length_1361_cov_20.148970	866	946	0	80	80	1.0000000
NODE_2856_length_1361_cov_20.148970	919	999	0	80	80	1.0000000
NODE_2858_length_1361_cov_10.530903	1139	1219	3	11	80	0.1375000
NODE_2858_length_1361_cov_10.530903	1139	1219	6	30	80	0.3750000
NODE_2858_length_1361_cov_10.530903	1139	1219	7	2	80	0.0250000
NODE_2858_length_1361_cov_10.530903	1139	1219	8	37	80	0.4625000
NODE_2858_length_1361_cov_10.530903	1139	1219	3	11	80	0.1375000
NODE_2858_length_1361_cov_10.530903	1139	1219	6	30	80	0.3750000
NODE_2858_length_1361_cov_10.530903	1139	1219	7	2	80	0.0250000
NODE_2858_length_1361_cov_10.530903	1139	1219	8	37	80	0.4625000
NODE_2858_length_1361_cov_10.530903	1192	1277	0	25	85	0.2941177
NODE_2858_length_1361_cov_10.530903	1192	1277	4	2	85	0.0235294
NODE_2858_length_1361_cov_10.530903	1192	1277	6	43	85	0.5058824
NODE_2858_length_1361_cov_10.530903	1192	1277	8	15	85	0.1764706
NODE_2858_length_1361_cov_10.530903	1273	1353	0	80	80	1.0000000
NODE_2858_length_1361_cov_10.530903	1273	1353	0	80	80	1.0000000
NODE_2858_length_1361_cov_10.530903	1273	1353	0	80	80	1.0000000
NODE_2858_length_1361_cov_10.530903	1273	1353	0	80	80	1.0000000
NODE_2858_length_1361_cov_10.530903	1273	1353	0	80	80	1.0000000
NODE_2858_length_1361_cov_10.530903	1273	1353	0	80	80	1.0000000
NODE_2859_length_1360_cov_42.789056	351	431	0	19	80	0.2375000
NODE_2859_length_1360_cov_42.789056	351	431	7	1	80	0.0125000
NODE_2859_length_1360_cov_42.789056	351	431	8	60	80	0.7500000
NODE_2859_length_1360_cov_42.789056	404	484	0	3	80	0.0375000
NODE_2859_length_1360_cov_42.789056	404	484	8	77	80	0.9625000
NODE_2860_length_1360_cov_26.407613	531	611	14	7	80	0.0875000
NODE_2860_length_1360_cov_26.407613	531	611	15	25	80	0.3125000
NODE_2860_length_1360_cov_26.407613	531	611	20	15	80	0.1875000
NODE_2860_length_1360_cov_26.407613	531	611	22	33	80	0.4125000
NODE_2860_length_1360_cov_26.407613	584	669	0	8	85	0.0941176
NODE_2860_length_1360_cov_26.407613	584	669	6	1	85	0.0117647
NODE_2860_length_1360_cov_26.407613	584	669	7	1	85	0.0117647
NODE_2860_length_1360_cov_26.407613	584	669	20	21	85	0.2470588
NODE_2860_length_1360_cov_26.407613	584	669	21	42	85	0.4941176
NODE_2860_length_1360_cov_26.407613	584	669	22	12	85	0.1411765
NODE_2861_length_1360_cov_16.182395	796	876	5	1	80	0.0125000
NODE_2861_length_1360_cov_16.182395	796	876	6	5	80	0.0625000
NODE_2861_length_1360_cov_16.182395	796	876	8	5	80	0.0625000
NODE_2861_length_1360_cov_16.182395	796	876	11	12	80	0.1500000
NODE_2861_length_1360_cov_16.182395	796	876	12	11	80	0.1375000
NODE_2861_length_1360_cov_16.182395	796	876	14	46	80	0.5750000
NODE_2861_length_1360_cov_16.182395	849	929	0	8	80	0.1000000
NODE_2861_length_1360_cov_16.182395	849	929	2	11	80	0.1375000
NODE_2861_length_1360_cov_16.182395	849	929	4	5	80	0.0625000
NODE_2861_length_1360_cov_16.182395	849	929	6	14	80	0.1750000
NODE_2861_length_1360_cov_16.182395	849	929	10	5	80	0.0625000
NODE_2861_length_1360_cov_16.182395	849	929	14	37	80	0.4625000
NODE_2861_length_1360_cov_16.182395	925	1005	6	80	80	1.0000000
NODE_2861_length_1360_cov_16.182395	978	1058	6	80	80	1.0000000
NODE_2862_length_1360_cov_12.763680	582	662	0	80	80	1.0000000
NODE_2862_length_1360_cov_12.763680	635	715	0	80	80	1.0000000
NODE_2866_length_1359_cov_41.324603	674	754	0	37	80	0.4625000
NODE_2866_length_1359_cov_41.324603	674	754	8	7	80	0.0875000
NODE_2866_length_1359_cov_41.324603	674	754	10	36	80	0.4500000
NODE_2866_length_1359_cov_41.324603	727	807	9	5	80	0.0625000
NODE_2866_length_1359_cov_41.324603	727	807	10	41	80	0.5125000
NODE_2866_length_1359_cov_41.324603	727	807	11	34	80	0.4250000
NODE_2866_length_1359_cov_41.324603	803	883	1	37	80	0.4625000
NODE_2866_length_1359_cov_41.324603	803	883	9	43	80	0.5375000
NODE_2866_length_1359_cov_41.324603	856	936	0	18	80	0.2250000
NODE_2866_length_1359_cov_41.324603	856	936	1	62	80	0.7750000
NODE_2871_length_1358_cov_23.427323	292	372	0	80	80	1.0000000
NODE_2871_length_1358_cov_23.427323	345	425	0	80	80	1.0000000
NODE_2872_length_1358_cov_19.489277	411	491	2	9	80	0.1125000
NODE_2872_length_1358_cov_19.489277	411	491	4	71	80	0.8875000
NODE_2872_length_1358_cov_19.489277	464	544	0	44	80	0.5500000
NODE_2872_length_1358_cov_19.489277	464	544	2	18	80	0.2250000
NODE_2872_length_1358_cov_19.489277	464	544	4	18	80	0.2250000
NODE_2875_length_1357_cov_15.962639	732	812	0	32	80	0.4000000
NODE_2875_length_1357_cov_15.962639	732	812	2	48	80	0.6000000
NODE_2875_length_1357_cov_15.962639	785	865	0	80	80	1.0000000
NODE_2879_length_1354_cov_9.854980	735	815	0	80	80	1.0000000
NODE_2879_length_1354_cov_9.854980	788	868	0	80	80	1.0000000
NODE_2882_length_1353_cov_32.982456	708	788	0	80	80	1.0000000
NODE_2882_length_1353_cov_32.982456	761	841	0	80	80	1.0000000
NODE_2883_length_1353_cov_21.775120	493	573	0	21	80	0.2625000
NODE_2883_length_1353_cov_21.775120	493	573	11	4	80	0.0500000
NODE_2883_length_1353_cov_21.775120	493	573	13	1	80	0.0125000
NODE_2883_length_1353_cov_21.775120	493	573	14	1	80	0.0125000
NODE_2883_length_1353_cov_21.775120	493	573	15	21	80	0.2625000
NODE_2883_length_1353_cov_21.775120	493	573	16	32	80	0.4000000
NODE_2883_length_1353_cov_21.775120	546	626	12	35	80	0.4375000
NODE_2883_length_1353_cov_21.775120	546	626	14	6	80	0.0750000
NODE_2883_length_1353_cov_21.775120	546	626	16	28	80	0.3500000
NODE_2883_length_1353_cov_21.775120	546	626	22	11	80	0.1375000
NODE_2884_length_1353_cov_18.201754	696	776	0	52	80	0.6500000
NODE_2884_length_1353_cov_18.201754	696	776	2	28	80	0.3500000
NODE_2884_length_1353_cov_18.201754	749	829	2	80	80	1.0000000
NODE_2888_length_1352_cov_26.942538	455	535	2	8	80	0.1000000
NODE_2888_length_1352_cov_26.942538	455	535	4	26	80	0.3250000
NODE_2888_length_1352_cov_26.942538	455	535	6	46	80	0.5750000
NODE_2888_length_1352_cov_26.942538	508	588	0	22	80	0.2750000
NODE_2888_length_1352_cov_26.942538	508	588	4	19	80	0.2375000
NODE_2888_length_1352_cov_26.942538	508	588	6	39	80	0.4875000
NODE_2889_length_1352_cov_17.189944	717	797	0	80	80	1.0000000
NODE_2889_length_1352_cov_17.189944	770	850	0	80	80	1.0000000
NODE_2890_length_1352_cov_15.752594	640	720	0	69	80	0.8625000
NODE_2890_length_1352_cov_15.752594	640	720	2	11	80	0.1375000
NODE_2890_length_1352_cov_15.752594	693	773	0	16	80	0.2000000
NODE_2890_length_1352_cov_15.752594	693	773	2	64	80	0.8000000
NODE_2891_length_1352_cov_10.699920	237	317	0	32	80	0.4000000
NODE_2891_length_1352_cov_10.699920	237	317	2	21	80	0.2625000
NODE_2891_length_1352_cov_10.699920	237	317	4	27	80	0.3375000
NODE_2891_length_1352_cov_10.699920	290	370	0	4	80	0.0500000
NODE_2891_length_1352_cov_10.699920	290	370	2	29	80	0.3625000
NODE_2891_length_1352_cov_10.699920	290	370	4	47	80	0.5875000
NODE_2894_length_1351_cov_32.325879	561	641	0	80	80	1.0000000
NODE_2894_length_1351_cov_32.325879	614	694	0	80	80	1.0000000
NODE_2895_length_1351_cov_16.861022	97	162	21	5	65	0.0769231
NODE_2895_length_1351_cov_16.861022	97	162	30	1	65	0.0153846
NODE_2895_length_1351_cov_16.861022	97	162	31	2	65	0.0307692
NODE_2895_length_1351_cov_16.861022	97	162	39	1	65	0.0153846
NODE_2895_length_1351_cov_16.861022	97	162	41	2	65	0.0307692
NODE_2895_length_1351_cov_16.861022	97	162	42	4	65	0.0615385
NODE_2895_length_1351_cov_16.861022	97	162	44	2	65	0.0307692
NODE_2895_length_1351_cov_16.861022	97	162	50	3	65	0.0461538
NODE_2895_length_1351_cov_16.861022	97	162	51	2	65	0.0307692
NODE_2895_length_1351_cov_16.861022	97	162	52	7	65	0.1076923
NODE_2895_length_1351_cov_16.861022	97	162	54	5	65	0.0769231
NODE_2895_length_1351_cov_16.861022	97	162	55	31	65	0.4769231
NODE_2896_length_1351_cov_9.894569	331	411	0	80	80	1.0000000
NODE_2896_length_1351_cov_9.894569	384	464	0	80	80	1.0000000
NODE_2897_length_1351_cov_8.699681	1055	1137	0	75	82	0.9146342
NODE_2897_length_1351_cov_8.699681	1055	1137	8	3	82	0.0365854
NODE_2897_length_1351_cov_8.699681	1055	1137	10	4	82	0.0487805
NODE_2897_length_1351_cov_8.699681	1110	1175	0	65	65	1.0000000
NODE_2898_length_1351_cov_2.931310	68	148	28	6	80	0.0750000
NODE_2898_length_1351_cov_2.931310	68	148	30	6	80	0.0750000
NODE_2898_length_1351_cov_2.931310	68	148	34	1	80	0.0125000
NODE_2898_length_1351_cov_2.931310	68	148	36	4	80	0.0500000
NODE_2898_length_1351_cov_2.931310	68	148	40	3	80	0.0375000
NODE_2898_length_1351_cov_2.931310	68	148	46	2	80	0.0250000
NODE_2898_length_1351_cov_2.931310	68	148	48	1	80	0.0125000
NODE_2898_length_1351_cov_2.931310	68	148	52	1	80	0.0125000
NODE_2898_length_1351_cov_2.931310	68	148	54	4	80	0.0500000
NODE_2898_length_1351_cov_2.931310	68	148	56	6	80	0.0750000
NODE_2898_length_1351_cov_2.931310	68	148	60	11	80	0.1375000
NODE_2898_length_1351_cov_2.931310	68	148	62	7	80	0.0875000
NODE_2898_length_1351_cov_2.931310	68	148	63	7	80	0.0875000
NODE_2898_length_1351_cov_2.931310	68	148	64	5	80	0.0625000
NODE_2898_length_1351_cov_2.931310	68	148	65	1	80	0.0125000
NODE_2898_length_1351_cov_2.931310	68	148	66	11	80	0.1375000
NODE_2898_length_1351_cov_2.931310	68	148	68	4	80	0.0500000
NODE_2898_length_1351_cov_2.931310	495	528	0	33	33	1.0000000
NODE_2899_length_1350_cov_18.274181	424	504	0	11	80	0.1375000
NODE_2899_length_1350_cov_18.274181	424	504	2	69	80	0.8625000
NODE_2899_length_1350_cov_18.274181	477	557	0	11	80	0.1375000
NODE_2899_length_1350_cov_18.274181	477	557	2	69	80	0.8625000
NODE_2899_length_1350_cov_18.274181	553	633	0	80	80	1.0000000
NODE_2899_length_1350_cov_18.274181	606	686	0	80	80	1.0000000
NODE_2900_length_1350_cov_8.053557	737	817	0	80	80	1.0000000
NODE_2900_length_1350_cov_8.053557	790	870	0	80	80	1.0000000
NODE_2903_length_1349_cov_23.782400	839	919	2	35	80	0.4375000
NODE_2903_length_1349_cov_23.782400	839	919	4	5	80	0.0625000
NODE_2903_length_1349_cov_23.782400	839	919	6	40	80	0.5000000
NODE_2903_length_1349_cov_23.782400	892	972	4	58	80	0.7250000
NODE_2903_length_1349_cov_23.782400	892	972	6	22	80	0.2750000
NODE_2903_length_1349_cov_23.782400	968	1048	0	65	80	0.8125000
NODE_2903_length_1349_cov_23.782400	968	1048	4	15	80	0.1875000
NODE_2903_length_1349_cov_23.782400	1021	1101	0	80	80	1.0000000
NODE_2904_length_1349_cov_17.776800	811	891	0	35	80	0.4375000
NODE_2904_length_1349_cov_17.776800	811	891	2	45	80	0.5625000
NODE_2904_length_1349_cov_17.776800	864	944	0	13	80	0.1625000
NODE_2904_length_1349_cov_17.776800	864	944	2	67	80	0.8375000
NODE_2905_length_1349_cov_16.468800	828	908	0	80	80	1.0000000
NODE_2905_length_1349_cov_16.468800	881	961	0	33	80	0.4125000
NODE_2905_length_1349_cov_16.468800	881	961	2	47	80	0.5875000
NODE_2908_length_1348_cov_22.731785	468	548	0	47	80	0.5875000
NODE_2908_length_1348_cov_22.731785	468	548	4	33	80	0.4125000
NODE_2908_length_1348_cov_22.731785	521	601	3	52	80	0.6500000
NODE_2908_length_1348_cov_22.731785	521	601	4	28	80	0.3500000
NODE_2909_length_1348_cov_20.778223	517	597	0	13	80	0.1625000
NODE_2909_length_1348_cov_20.778223	517	597	2	67	80	0.8375000
NODE_2909_length_1348_cov_20.778223	570	650	0	26	80	0.3250000
NODE_2909_length_1348_cov_20.778223	570	650	2	54	80	0.6750000
NODE_2910_length_1348_cov_11.180144	673	753	0	80	80	1.0000000
NODE_2910_length_1348_cov_11.180144	726	806	0	80	80	1.0000000
NODE_2916_length_1347_cov_45.906250	683	763	0	22	80	0.2750000
NODE_2916_length_1347_cov_45.906250	683	763	1	58	80	0.7250000
NODE_2916_length_1347_cov_45.906250	736	816	1	80	80	1.0000000
NODE_2916_length_1347_cov_45.906250	812	892	1	11	80	0.1375000
NODE_2916_length_1347_cov_45.906250	812	892	2	40	80	0.5000000
NODE_2916_length_1347_cov_45.906250	812	892	4	29	80	0.3625000
NODE_2916_length_1347_cov_45.906250	865	945	4	80	80	1.0000000
NODE_2917_length_1347_cov_41.643429	439	519	2	9	80	0.1125000
NODE_2917_length_1347_cov_41.643429	439	519	4	4	80	0.0500000
NODE_2917_length_1347_cov_41.643429	439	519	6	20	80	0.2500000
NODE_2917_length_1347_cov_41.643429	439	519	8	9	80	0.1125000
NODE_2917_length_1347_cov_41.643429	439	519	10	38	80	0.4750000
NODE_2917_length_1347_cov_41.643429	492	572	0	20	80	0.2500000
NODE_2917_length_1347_cov_41.643429	492	572	2	42	80	0.5250000
NODE_2917_length_1347_cov_41.643429	492	572	4	4	80	0.0500000
NODE_2917_length_1347_cov_41.643429	492	572	6	5	80	0.0625000
NODE_2917_length_1347_cov_41.643429	492	572	8	9	80	0.1125000
NODE_2918_length_1347_cov_19.941506	458	538	2	80	80	1.0000000
NODE_2918_length_1347_cov_19.941506	511	591	0	39	80	0.4875000
NODE_2918_length_1347_cov_19.941506	511	591	2	41	80	0.5125000
NODE_2918_length_1347_cov_19.941506	587	667	0	80	80	1.0000000
NODE_2918_length_1347_cov_19.941506	640	720	0	80	80	1.0000000
NODE_2919_length_1347_cov_16.520833	713	793	0	80	80	1.0000000
NODE_2919_length_1347_cov_16.520833	766	846	0	80	80	1.0000000
NODE_2920_length_1347_cov_15.967147	638	718	0	22	80	0.2750000
NODE_2920_length_1347_cov_15.967147	638	718	2	58	80	0.7250000
NODE_2920_length_1347_cov_15.967147	691	771	0	44	80	0.5500000
NODE_2920_length_1347_cov_15.967147	691	771	2	36	80	0.4500000
NODE_2925_length_1346_cov_13.112269	429	509	2	3	80	0.0375000
NODE_2925_length_1346_cov_13.112269	429	509	4	77	80	0.9625000
NODE_2925_length_1346_cov_13.112269	482	562	0	40	80	0.5000000
NODE_2925_length_1346_cov_13.112269	482	562	2	14	80	0.1750000
NODE_2925_length_1346_cov_13.112269	482	562	4	26	80	0.3250000
NODE_2928_length_1345_cov_32.099518	629	709	2	17	80	0.2125000
NODE_2928_length_1345_cov_32.099518	629	709	17	1	80	0.0125000
NODE_2928_length_1345_cov_32.099518	629	709	18	1	80	0.0125000
NODE_2928_length_1345_cov_32.099518	629	709	27	10	80	0.1250000
NODE_2928_length_1345_cov_32.099518	629	709	30	41	80	0.5125000
NODE_2928_length_1345_cov_32.099518	629	709	31	1	80	0.0125000
NODE_2928_length_1345_cov_32.099518	629	709	32	9	80	0.1125000
NODE_2928_length_1345_cov_32.099518	682	762	28	13	80	0.1625000
NODE_2928_length_1345_cov_32.099518	682	762	29	14	80	0.1750000
NODE_2928_length_1345_cov_32.099518	682	762	30	52	80	0.6500000
NODE_2928_length_1345_cov_32.099518	682	762	32	1	80	0.0125000
NODE_2929_length_1345_cov_19.837881	723	803	0	22	80	0.2750000
NODE_2929_length_1345_cov_19.837881	723	803	6	48	80	0.6000000
NODE_2929_length_1345_cov_19.837881	723	803	10	10	80	0.1250000
NODE_2929_length_1345_cov_19.837881	776	856	6	37	80	0.4625000
NODE_2929_length_1345_cov_19.837881	776	856	10	37	80	0.4625000
NODE_2929_length_1345_cov_19.837881	776	856	12	6	80	0.0750000
NODE_2930_length_1345_cov_14.262440	361	441	0	80	80	1.0000000
NODE_2930_length_1345_cov_14.262440	414	494	0	80	80	1.0000000
NODE_2930_length_1345_cov_14.262440	490	570	0	80	80	1.0000000
NODE_2930_length_1345_cov_14.262440	543	623	0	80	80	1.0000000
NODE_2931_length_1345_cov_14.103531	950	1030	0	10	80	0.1250000
NODE_2931_length_1345_cov_14.103531	950	1030	6	6	80	0.0750000
NODE_2931_length_1345_cov_14.103531	950	1030	8	64	80	0.8000000
NODE_2931_length_1345_cov_14.103531	1003	1083	0	32	80	0.4000000
NODE_2931_length_1345_cov_14.103531	1003	1083	4	26	80	0.3250000
NODE_2931_length_1345_cov_14.103531	1003	1083	6	11	80	0.1375000
NODE_2931_length_1345_cov_14.103531	1003	1083	8	11	80	0.1375000
NODE_2934_length_1344_cov_15.013655	345	425	0	59	80	0.7375000
NODE_2934_length_1344_cov_15.013655	345	425	2	9	80	0.1125000
NODE_2934_length_1344_cov_15.013655	345	425	4	12	80	0.1500000
NODE_2934_length_1344_cov_15.013655	398	478	0	80	80	1.0000000
NODE_2935_length_1344_cov_11.383133	519	599	0	16	80	0.2000000
NODE_2935_length_1344_cov_11.383133	519	599	4	64	80	0.8000000
NODE_2935_length_1344_cov_11.383133	572	652	0	69	80	0.8625000
NODE_2935_length_1344_cov_11.383133	572	652	4	11	80	0.1375000
NODE_2935_length_1344_cov_11.383133	648	728	0	67	80	0.8375000
NODE_2935_length_1344_cov_11.383133	648	728	2	13	80	0.1625000
NODE_2935_length_1344_cov_11.383133	701	781	0	14	80	0.1750000
NODE_2935_length_1344_cov_11.383133	701	781	2	28	80	0.3500000
NODE_2935_length_1344_cov_11.383133	701	781	4	38	80	0.4750000
NODE_2936_length_1344_cov_10.924498	529	609	0	38	80	0.4750000
NODE_2936_length_1344_cov_10.924498	529	609	2	42	80	0.5250000
NODE_2936_length_1344_cov_10.924498	582	662	0	35	80	0.4375000
NODE_2936_length_1344_cov_10.924498	582	662	2	45	80	0.5625000
NODE_2937_length_1344_cov_5.531727	920	975	0	8	55	0.1454545
NODE_2937_length_1344_cov_5.531727	920	975	2	47	55	0.8545455
NODE_2942_length_1343_cov_36.005627	150	230	50	1	80	0.0125000
NODE_2942_length_1343_cov_36.005627	150	230	54	1	80	0.0125000
NODE_2942_length_1343_cov_36.005627	150	230	56	4	80	0.0500000
NODE_2942_length_1343_cov_36.005627	150	230	58	3	80	0.0375000
NODE_2942_length_1343_cov_36.005627	150	230	60	1	80	0.0125000
NODE_2942_length_1343_cov_36.005627	150	230	62	1	80	0.0125000
NODE_2942_length_1343_cov_36.005627	150	230	64	1	80	0.0125000
NODE_2942_length_1343_cov_36.005627	150	230	68	1	80	0.0125000
NODE_2942_length_1343_cov_36.005627	150	230	70	14	80	0.1750000
NODE_2942_length_1343_cov_36.005627	150	230	72	14	80	0.1750000
NODE_2942_length_1343_cov_36.005627	150	230	74	17	80	0.2125000
NODE_2942_length_1343_cov_36.005627	150	230	78	14	80	0.1750000
NODE_2942_length_1343_cov_36.005627	150	230	80	8	80	0.1000000
NODE_2942_length_1343_cov_36.005627	286	366	0	55	80	0.6875000
NODE_2942_length_1343_cov_36.005627	286	366	2	5	80	0.0625000
NODE_2942_length_1343_cov_36.005627	286	366	4	20	80	0.2500000
NODE_2942_length_1343_cov_36.005627	339	419	0	60	80	0.7500000
NODE_2942_length_1343_cov_36.005627	339	419	2	20	80	0.2500000
NODE_2942_length_1343_cov_36.005627	415	495	0	15	80	0.1875000
NODE_2942_length_1343_cov_36.005627	415	495	2	65	80	0.8125000
NODE_2942_length_1343_cov_36.005627	468	548	0	68	80	0.8500000
NODE_2942_length_1343_cov_36.005627	468	548	2	12	80	0.1500000
NODE_2943_length_1343_cov_26.826367	782	862	0	80	80	1.0000000
NODE_2943_length_1343_cov_26.826367	835	915	0	80	80	1.0000000
NODE_2944_length_1343_cov_19.353698	799	879	0	52	80	0.6500000
NODE_2944_length_1343_cov_19.353698	799	879	4	28	80	0.3500000
NODE_2944_length_1343_cov_19.353698	852	932	4	80	80	1.0000000
NODE_2944_length_1343_cov_19.353698	928	1008	0	63	80	0.7875000
NODE_2944_length_1343_cov_19.353698	928	1008	4	17	80	0.2125000
NODE_2944_length_1343_cov_19.353698	981	1061	0	80	80	1.0000000
NODE_2945_length_1343_cov_15.717846	745	825	0	47	80	0.5875000
NODE_2945_length_1343_cov_15.717846	745	825	2	33	80	0.4125000
NODE_2945_length_1343_cov_15.717846	798	878	0	29	80	0.3625000
NODE_2945_length_1343_cov_15.717846	798	878	2	51	80	0.6375000
NODE_2949_length_1342_cov_30.491553	456	536	0	10	80	0.1250000
NODE_2949_length_1342_cov_30.491553	456	536	4	70	80	0.8750000
NODE_2949_length_1342_cov_30.491553	509	589	0	63	80	0.7875000
NODE_2949_length_1342_cov_30.491553	509	589	4	17	80	0.2125000
NODE_2949_length_1342_cov_30.491553	585	665	0	76	80	0.9500000
NODE_2949_length_1342_cov_30.491553	585	665	2	4	80	0.0500000
NODE_2949_length_1342_cov_30.491553	638	718	0	23	80	0.2875000
NODE_2949_length_1342_cov_30.491553	638	718	2	57	80	0.7125000
NODE_2950_length_1342_cov_26.796460	538	618	0	2	80	0.0250000
NODE_2950_length_1342_cov_26.796460	538	618	2	35	80	0.4375000
NODE_2950_length_1342_cov_26.796460	538	618	6	13	80	0.1625000
NODE_2950_length_1342_cov_26.796460	538	618	8	30	80	0.3750000
NODE_2950_length_1342_cov_26.796460	591	671	6	66	80	0.8250000
NODE_2950_length_1342_cov_26.796460	591	671	8	14	80	0.1750000
NODE_2950_length_1342_cov_26.796460	667	747	0	74	80	0.9250000
NODE_2950_length_1342_cov_26.796460	667	747	6	6	80	0.0750000
NODE_2950_length_1342_cov_26.796460	720	800	0	80	80	1.0000000
NODE_2951_length_1342_cov_22.769912	298	378	2	44	80	0.5500000
NODE_2951_length_1342_cov_22.769912	298	378	4	36	80	0.4500000
NODE_2951_length_1342_cov_22.769912	351	431	2	54	80	0.6750000
NODE_2951_length_1342_cov_22.769912	351	431	4	26	80	0.3250000
NODE_2951_length_1342_cov_22.769912	427	507	0	17	80	0.2125000
NODE_2951_length_1342_cov_22.769912	427	507	2	63	80	0.7875000
NODE_2951_length_1342_cov_22.769912	480	560	0	70	80	0.8750000
NODE_2951_length_1342_cov_22.769912	480	560	2	10	80	0.1250000
NODE_2953_length_1341_cov_22.449275	494	574	1	33	80	0.4125000
NODE_2953_length_1341_cov_22.449275	494	574	3	45	80	0.5625000
NODE_2953_length_1341_cov_22.449275	494	574	4	2	80	0.0250000
NODE_2953_length_1341_cov_22.449275	547	627	2	22	80	0.2750000
NODE_2953_length_1341_cov_22.449275	547	627	3	25	80	0.3125000
NODE_2953_length_1341_cov_22.449275	547	627	4	33	80	0.4125000
NODE_2953_length_1341_cov_22.449275	623	703	1	64	80	0.8000000
NODE_2953_length_1341_cov_22.449275	623	703	2	16	80	0.2000000
NODE_2953_length_1341_cov_22.449275	676	755	0	33	79	0.4177215
NODE_2953_length_1341_cov_22.449275	676	755	1	46	79	0.5822785
NODE_2954_length_1341_cov_14.497585	415	495	0	80	80	1.0000000
NODE_2954_length_1341_cov_14.497585	468	548	0	80	80	1.0000000
NODE_2954_length_1341_cov_14.497585	544	624	0	64	80	0.8000000
NODE_2954_length_1341_cov_14.497585	544	624	2	16	80	0.2000000
NODE_2954_length_1341_cov_14.497585	597	677	0	15	80	0.1875000
NODE_2954_length_1341_cov_14.497585	597	677	2	65	80	0.8125000
NODE_2960_length_1340_cov_9.460113	531	611	0	80	80	1.0000000
NODE_2960_length_1340_cov_9.460113	584	664	0	80	80	1.0000000
NODE_2961_length_1340_cov_6.511684	735	815	0	57	80	0.7125000
NODE_2961_length_1340_cov_6.511684	735	815	2	23	80	0.2875000
NODE_2961_length_1340_cov_6.511684	788	868	0	4	80	0.0500000
NODE_2961_length_1340_cov_6.511684	788	868	2	76	80	0.9500000
NODE_2966_length_1339_cov_22.725000	751	831	0	80	80	1.0000000
NODE_2966_length_1339_cov_22.725000	804	884	0	80	80	1.0000000
NODE_2967_length_1339_cov_9.322581	329	409	0	80	80	1.0000000
NODE_2967_length_1339_cov_9.322581	382	462	0	80	80	1.0000000
NODE_2970_length_1338_cov_31.740920	527	607	2	75	80	0.9375000
NODE_2970_length_1338_cov_31.740920	527	607	4	5	80	0.0625000
NODE_2970_length_1338_cov_31.740920	580	660	0	46	80	0.5750000
NODE_2970_length_1338_cov_31.740920	580	660	2	34	80	0.4250000
NODE_2970_length_1338_cov_31.740920	656	736	0	80	80	1.0000000
NODE_2970_length_1338_cov_31.740920	709	789	0	80	80	1.0000000
NODE_2971_length_1338_cov_21.254237	639	719	0	80	80	1.0000000
NODE_2971_length_1338_cov_21.254237	692	772	0	80	80	1.0000000
NODE_2974_length_1337_cov_32.307754	739	819	14	47	80	0.5875000
NODE_2974_length_1337_cov_32.307754	739	819	16	33	80	0.4125000
NODE_2974_length_1337_cov_32.307754	792	872	6	17	80	0.2125000
NODE_2974_length_1337_cov_32.307754	792	872	8	5	80	0.0625000
NODE_2974_length_1337_cov_32.307754	792	872	10	3	80	0.0375000
NODE_2974_length_1337_cov_32.307754	792	872	11	4	80	0.0500000
NODE_2974_length_1337_cov_32.307754	792	872	12	10	80	0.1250000
NODE_2974_length_1337_cov_32.307754	792	872	14	35	80	0.4375000
NODE_2974_length_1337_cov_32.307754	792	872	17	2	80	0.0250000
NODE_2974_length_1337_cov_32.307754	792	872	18	4	80	0.0500000
NODE_2975_length_1337_cov_30.412763	465	545	8	44	80	0.5500000
NODE_2975_length_1337_cov_30.412763	465	545	10	36	80	0.4500000
NODE_2975_length_1337_cov_30.412763	518	598	6	14	80	0.1750000
NODE_2975_length_1337_cov_30.412763	518	598	8	2	80	0.0250000
NODE_2975_length_1337_cov_30.412763	518	598	10	49	80	0.6125000
NODE_2975_length_1337_cov_30.412763	518	598	17	1	80	0.0125000
NODE_2975_length_1337_cov_30.412763	518	598	28	2	80	0.0250000
NODE_2975_length_1337_cov_30.412763	518	598	30	2	80	0.0250000
NODE_2975_length_1337_cov_30.412763	518	598	32	5	80	0.0625000
NODE_2975_length_1337_cov_30.412763	518	598	33	1	80	0.0125000
NODE_2975_length_1337_cov_30.412763	518	598	35	1	80	0.0125000
NODE_2975_length_1337_cov_30.412763	518	598	37	1	80	0.0125000
NODE_2975_length_1337_cov_30.412763	518	598	39	1	80	0.0125000
NODE_2975_length_1337_cov_30.412763	518	598	40	1	80	0.0125000
NODE_2976_length_1337_cov_12.760905	560	640	0	48	80	0.6000000
NODE_2976_length_1337_cov_12.760905	560	640	2	32	80	0.4000000
NODE_2976_length_1337_cov_12.760905	613	693	2	80	80	1.0000000
NODE_2977_length_1337_cov_9.463651	724	804	0	80	80	1.0000000
NODE_2977_length_1337_cov_9.463651	777	857	0	80	80	1.0000000
NODE_2979_length_1337_cov_4.540388	216	296	0	80	80	1.0000000
NODE_2979_length_1337_cov_4.540388	272	349	0	77	77	1.0000000
NODE_2981_length_1336_cov_28.161681	394	474	8	80	80	1.0000000
NODE_2981_length_1336_cov_28.161681	447	527	0	12	80	0.1500000
NODE_2981_length_1336_cov_28.161681	447	527	3	2	80	0.0250000
NODE_2981_length_1336_cov_28.161681	447	527	4	39	80	0.4875000
NODE_2981_length_1336_cov_28.161681	447	527	8	27	80	0.3375000
NODE_2981_length_1336_cov_28.161681	523	603	0	49	80	0.6125000
NODE_2981_length_1336_cov_28.161681	523	603	2	31	80	0.3875000
NODE_2981_length_1336_cov_28.161681	576	656	0	22	80	0.2750000
NODE_2981_length_1336_cov_28.161681	576	656	2	58	80	0.7250000
NODE_2982_length_1336_cov_7.860954	17	98	0	45	81	0.5555556
NODE_2982_length_1336_cov_7.860954	17	98	2	16	81	0.1975309
NODE_2982_length_1336_cov_7.860954	17	98	4	20	81	0.2469136
NODE_2984_length_1336_cov_1.689572	1229	1289	6	59	60	0.9833333
NODE_2984_length_1336_cov_1.689572	1229	1289	10	1	60	0.0166667
NODE_2984_length_1336_cov_1.689572	1262	1336	4	13	74	0.1756757
NODE_2984_length_1336_cov_1.689572	1262	1336	6	61	74	0.8243243
NODE_2985_length_1335_cov_19.547735	530	607	2	4	77	0.0519481
NODE_2985_length_1335_cov_19.547735	530	607	4	73	77	0.9480519
NODE_2985_length_1335_cov_19.547735	582	660	0	19	78	0.2435897
NODE_2985_length_1335_cov_19.547735	582	660	2	34	78	0.4358974
NODE_2985_length_1335_cov_19.547735	582	660	4	25	78	0.3205128
NODE_2985_length_1335_cov_19.547735	656	736	0	80	80	1.0000000
NODE_2985_length_1335_cov_19.547735	709	789	0	80	80	1.0000000
NODE_2986_length_1335_cov_15.383495	419	499	0	80	80	1.0000000
NODE_2986_length_1335_cov_15.383495	472	552	0	80	80	1.0000000
NODE_2986_length_1335_cov_15.383495	548	628	0	80	80	1.0000000
NODE_2986_length_1335_cov_15.383495	601	681	0	80	80	1.0000000
NODE_2991_length_1333_cov_27.372771	493	573	0	80	80	1.0000000
NODE_2991_length_1333_cov_27.372771	546	626	0	80	80	1.0000000
NODE_2996_length_1332_cov_18.978913	648	728	0	27	80	0.3375000
NODE_2996_length_1332_cov_18.978913	648	728	2	53	80	0.6625000
NODE_2996_length_1332_cov_18.978913	701	781	0	80	80	1.0000000
NODE_2996_length_1332_cov_18.978913	777	857	0	80	80	1.0000000
NODE_2996_length_1332_cov_18.978913	830	910	0	80	80	1.0000000
NODE_2997_length_1332_cov_3.112733	87	151	10	4	64	0.0625000
NODE_2997_length_1332_cov_3.112733	87	151	16	2	64	0.0312500
NODE_2997_length_1332_cov_3.112733	87	151	18	1	64	0.0156250
NODE_2997_length_1332_cov_3.112733	87	151	20	18	64	0.2812500
NODE_2997_length_1332_cov_3.112733	87	151	22	1	64	0.0156250
NODE_2997_length_1332_cov_3.112733	87	151	24	16	64	0.2500000
NODE_2997_length_1332_cov_3.112733	87	151	26	18	64	0.2812500
NODE_2997_length_1332_cov_3.112733	87	151	32	2	64	0.0312500
NODE_2997_length_1332_cov_3.112733	87	151	34	2	64	0.0312500
NODE_3000_length_1331_cov_16.831981	392	472	0	1	80	0.0125000
NODE_3000_length_1331_cov_16.831981	392	472	4	79	80	0.9875000
NODE_3000_length_1331_cov_16.831981	445	525	4	80	80	1.0000000
NODE_3000_length_1331_cov_16.831981	521	601	0	67	80	0.8375000
NODE_3000_length_1331_cov_16.831981	521	601	4	13	80	0.1625000
NODE_3000_length_1331_cov_16.831981	574	654	0	80	80	1.0000000
NODE_3001_length_1331_cov_12.841721	871	951	0	80	80	1.0000000
NODE_3001_length_1331_cov_12.841721	924	1004	0	80	80	1.0000000
NODE_3004_length_1331_cov_2.090097	0	76	0	76	76	1.0000000
NODE_3004_length_1331_cov_2.090097	49	98	0	49	49	1.0000000
NODE_3007_length_1330_cov_48.993501	278	358	0	80	80	1.0000000
NODE_3007_length_1330_cov_48.993501	331	411	0	80	80	1.0000000
NODE_3007_length_1330_cov_48.993501	742	822	0	1	80	0.0125000
NODE_3007_length_1330_cov_48.993501	742	822	4	79	80	0.9875000
NODE_3007_length_1330_cov_48.993501	795	875	0	18	80	0.2250000
NODE_3007_length_1330_cov_48.993501	795	875	4	62	80	0.7750000
NODE_3008_length_1330_cov_11.037368	407	487	6	53	80	0.6625000
NODE_3008_length_1330_cov_11.037368	407	487	10	16	80	0.2000000
NODE_3008_length_1330_cov_11.037368	407	487	14	11	80	0.1375000
NODE_3008_length_1330_cov_11.037368	460	540	8	38	80	0.4750000
NODE_3008_length_1330_cov_11.037368	460	540	10	16	80	0.2000000
NODE_3008_length_1330_cov_11.037368	460	540	13	1	80	0.0125000
NODE_3008_length_1330_cov_11.037368	460	540	14	25	80	0.3125000
NODE_3008_length_1330_cov_11.037368	536	617	4	34	81	0.4197531
NODE_3008_length_1330_cov_11.037368	536	617	8	47	81	0.5802469
NODE_3008_length_1330_cov_11.037368	590	670	0	43	80	0.5375000
NODE_3008_length_1330_cov_11.037368	590	670	4	37	80	0.4625000
NODE_3009_length_1330_cov_9.026807	551	631	0	20	80	0.2500000
NODE_3009_length_1330_cov_9.026807	551	631	2	50	80	0.6250000
NODE_3009_length_1330_cov_9.026807	551	631	4	10	80	0.1250000
NODE_3009_length_1330_cov_9.026807	604	684	0	73	80	0.9125000
NODE_3009_length_1330_cov_9.026807	604	684	2	7	80	0.0875000
NODE_3011_length_1329_cov_17.036585	691	771	0	80	80	1.0000000
NODE_3011_length_1329_cov_17.036585	744	824	0	80	80	1.0000000
NODE_3011_length_1329_cov_17.036585	820	900	0	80	80	1.0000000
NODE_3011_length_1329_cov_17.036585	873	953	0	80	80	1.0000000
NODE_3012_length_1329_cov_16.341463	428	476	17	3	48	0.0625000
NODE_3012_length_1329_cov_16.341463	428	476	21	2	48	0.0416667
NODE_3012_length_1329_cov_16.341463	428	476	27	3	48	0.0625000
NODE_3012_length_1329_cov_16.341463	428	476	30	1	48	0.0208333
NODE_3012_length_1329_cov_16.341463	428	476	32	4	48	0.0833333
NODE_3012_length_1329_cov_16.341463	428	476	33	1	48	0.0208333
NODE_3012_length_1329_cov_16.341463	428	476	35	1	48	0.0208333
NODE_3012_length_1329_cov_16.341463	428	476	38	1	48	0.0208333
NODE_3012_length_1329_cov_16.341463	428	476	44	1	48	0.0208333
NODE_3012_length_1329_cov_16.341463	428	476	46	4	48	0.0833333
NODE_3012_length_1329_cov_16.341463	428	476	52	2	48	0.0416667
NODE_3012_length_1329_cov_16.341463	428	476	54	1	48	0.0208333
NODE_3012_length_1329_cov_16.341463	428	476	56	1	48	0.0208333
NODE_3012_length_1329_cov_16.341463	428	476	58	1	48	0.0208333
NODE_3012_length_1329_cov_16.341463	428	476	60	3	48	0.0625000
NODE_3012_length_1329_cov_16.341463	428	476	64	2	48	0.0416667
NODE_3012_length_1329_cov_16.341463	428	476	70	1	48	0.0208333
NODE_3012_length_1329_cov_16.341463	428	476	74	2	48	0.0416667
NODE_3012_length_1329_cov_16.341463	428	476	76	3	48	0.0625000
NODE_3012_length_1329_cov_16.341463	428	476	82	2	48	0.0416667
NODE_3012_length_1329_cov_16.341463	428	476	88	3	48	0.0625000
NODE_3012_length_1329_cov_16.341463	428	476	94	1	48	0.0208333
NODE_3012_length_1329_cov_16.341463	428	476	97	1	48	0.0208333
NODE_3012_length_1329_cov_16.341463	428	476	103	1	48	0.0208333
NODE_3012_length_1329_cov_16.341463	428	476	107	1	48	0.0208333
NODE_3012_length_1329_cov_16.341463	428	476	109	1	48	0.0208333
NODE_3012_length_1329_cov_16.341463	428	476	113	1	48	0.0208333
NODE_3013_length_1329_cov_5.620325	888	955	13	4	67	0.0597015
NODE_3013_length_1329_cov_5.620325	888	955	14	14	67	0.2089552
NODE_3013_length_1329_cov_5.620325	888	955	20	48	67	0.7164179
NODE_3013_length_1329_cov_5.620325	888	955	23	1	67	0.0149254
NODE_3013_length_1329_cov_5.620325	941	999	14	17	58	0.2931035
NODE_3013_length_1329_cov_5.620325	941	999	20	13	58	0.2241379
NODE_3013_length_1329_cov_5.620325	941	999	23	7	58	0.1206897
NODE_3013_length_1329_cov_5.620325	941	999	25	7	58	0.1206897
NODE_3013_length_1329_cov_5.620325	941	999	28	14	58	0.2413793
NODE_3017_length_1328_cov_12.954434	794	874	0	49	80	0.6125000
NODE_3017_length_1328_cov_12.954434	794	874	2	31	80	0.3875000
NODE_3017_length_1328_cov_12.954434	847	927	0	5	80	0.0625000
NODE_3017_length_1328_cov_12.954434	847	927	2	75	80	0.9375000
NODE_3018_length_1328_cov_8.810415	762	842	0	80	80	1.0000000
NODE_3018_length_1328_cov_8.810415	815	895	0	80	80	1.0000000
NODE_3021_length_1327_cov_15.938925	260	340	0	80	80	1.0000000
NODE_3021_length_1327_cov_15.938925	313	393	0	80	80	1.0000000
NODE_3022_length_1327_cov_7.274430	159	235	2	76	76	1.0000000
NODE_3022_length_1327_cov_7.274430	774	854	4	54	80	0.6750000
NODE_3022_length_1327_cov_7.274430	774	854	6	2	80	0.0250000
NODE_3022_length_1327_cov_7.274430	774	854	8	24	80	0.3000000
NODE_3022_length_1327_cov_7.274430	827	890	2	1	63	0.0158730
NODE_3022_length_1327_cov_7.274430	827	890	4	58	63	0.9206349
NODE_3022_length_1327_cov_7.274430	827	890	8	4	63	0.0634921
NODE_3023_length_1327_cov_6.486156	896	976	0	15	80	0.1875000
NODE_3023_length_1327_cov_6.486156	896	976	4	65	80	0.8125000
NODE_3023_length_1327_cov_6.486156	949	1029	0	68	80	0.8500000
NODE_3023_length_1327_cov_6.486156	949	1029	4	12	80	0.1500000
NODE_3029_length_1326_cov_32.382233	571	651	0	68	80	0.8500000
NODE_3029_length_1326_cov_32.382233	571	651	2	12	80	0.1500000
NODE_3029_length_1326_cov_32.382233	624	704	0	15	80	0.1875000
NODE_3029_length_1326_cov_32.382233	624	704	2	65	80	0.8125000
NODE_3030_length_1326_cov_30.614507	760	840	0	80	80	1.0000000
NODE_3030_length_1326_cov_30.614507	813	893	0	80	80	1.0000000
NODE_3031_length_1326_cov_30.304808	488	568	0	54	80	0.6750000
NODE_3031_length_1326_cov_30.304808	488	568	2	26	80	0.3250000
NODE_3031_length_1326_cov_30.304808	541	621	0	80	80	1.0000000
NODE_3031_length_1326_cov_30.304808	617	697	0	60	80	0.7500000
NODE_3031_length_1326_cov_30.304808	617	697	6	19	80	0.2375000
NODE_3031_length_1326_cov_30.304808	617	697	8	1	80	0.0125000
NODE_3031_length_1326_cov_30.304808	670	750	0	7	80	0.0875000
NODE_3031_length_1326_cov_30.304808	670	750	6	19	80	0.2375000
NODE_3031_length_1326_cov_30.304808	670	750	8	54	80	0.6750000
NODE_3032_length_1326_cov_10.913610	238	318	0	80	80	1.0000000
NODE_3032_length_1326_cov_10.913610	291	371	0	80	80	1.0000000
NODE_3036_length_1325_cov_38.136215	0	46	0	46	46	1.0000000
NODE_3036_length_1325_cov_38.136215	19	99	0	77	80	0.9625000
NODE_3036_length_1325_cov_38.136215	19	99	2	3	80	0.0375000
NODE_3036_length_1325_cov_38.136215	948	1022	14	2	74	0.0270270
NODE_3036_length_1325_cov_38.136215	948	1022	15	15	74	0.2027027
NODE_3036_length_1325_cov_38.136215	948	1022	16	1	74	0.0135135
NODE_3036_length_1325_cov_38.136215	948	1022	17	4	74	0.0540541
NODE_3036_length_1325_cov_38.136215	948	1022	19	1	74	0.0135135
NODE_3036_length_1325_cov_38.136215	948	1022	21	12	74	0.1621622
NODE_3036_length_1325_cov_38.136215	948	1022	23	29	74	0.3918919
NODE_3036_length_1325_cov_38.136215	948	1022	24	2	74	0.0270270
NODE_3036_length_1325_cov_38.136215	948	1022	25	5	74	0.0675676
NODE_3036_length_1325_cov_38.136215	948	1022	27	2	74	0.0270270
NODE_3036_length_1325_cov_38.136215	948	1022	29	1	74	0.0135135
NODE_3036_length_1325_cov_38.136215	1001	1063	21	10	62	0.1612903
NODE_3036_length_1325_cov_38.136215	1001	1063	23	9	62	0.1451613
NODE_3036_length_1325_cov_38.136215	1001	1063	24	2	62	0.0322581
NODE_3036_length_1325_cov_38.136215	1001	1063	25	5	62	0.0806452
NODE_3036_length_1325_cov_38.136215	1001	1063	27	3	62	0.0483871
NODE_3036_length_1325_cov_38.136215	1001	1063	28	2	62	0.0322581
NODE_3036_length_1325_cov_38.136215	1001	1063	29	12	62	0.1935484
NODE_3036_length_1325_cov_38.136215	1001	1063	30	1	62	0.0161290
NODE_3036_length_1325_cov_38.136215	1001	1063	32	2	62	0.0322581
NODE_3036_length_1325_cov_38.136215	1001	1063	36	2	62	0.0322581
NODE_3036_length_1325_cov_38.136215	1001	1063	40	3	62	0.0483871
NODE_3036_length_1325_cov_38.136215	1001	1063	41	1	62	0.0161290
NODE_3036_length_1325_cov_38.136215	1001	1063	42	10	62	0.1612903
NODE_3037_length_1325_cov_29.201468	613	693	0	48	80	0.6000000
NODE_3037_length_1325_cov_29.201468	613	693	2	32	80	0.4000000
NODE_3037_length_1325_cov_29.201468	666	746	0	80	80	1.0000000
NODE_3038_length_1325_cov_11.902121	697	777	0	39	80	0.4875000
NODE_3038_length_1325_cov_11.902121	697	777	2	41	80	0.5125000
NODE_3038_length_1325_cov_11.902121	750	830	0	14	80	0.1750000
NODE_3038_length_1325_cov_11.902121	750	830	2	66	80	0.8250000
NODE_3039_length_1325_cov_7.876835	645	725	0	27	80	0.3375000
NODE_3039_length_1325_cov_7.876835	645	725	4	53	80	0.6625000
NODE_3039_length_1325_cov_7.876835	698	778	0	17	80	0.2125000
NODE_3039_length_1325_cov_7.876835	698	778	4	63	80	0.7875000
NODE_3040_length_1325_cov_3.774062	1157	1218	0	32	61	0.5245901
NODE_3040_length_1325_cov_3.774062	1157	1218	2	28	61	0.4590164
NODE_3040_length_1325_cov_3.774062	1157	1218	7	1	61	0.0163934
NODE_3040_length_1325_cov_3.774062	1191	1271	2	42	80	0.5250000
NODE_3040_length_1325_cov_3.774062	1191	1271	4	38	80	0.4750000
NODE_3041_length_1325_cov_2.896411	0	58	0	1	58	0.0172414
NODE_3041_length_1325_cov_2.896411	0	58	2	57	58	0.9827586
NODE_3041_length_1325_cov_2.896411	8	67	2	58	59	0.9830508
NODE_3041_length_1325_cov_2.896411	8	67	4	1	59	0.0169492
NODE_3046_length_1324_cov_30.340408	939	1019	0	8	80	0.1000000
NODE_3046_length_1324_cov_30.340408	939	1019	9	5	80	0.0625000
NODE_3046_length_1324_cov_30.340408	939	1019	10	67	80	0.8375000
NODE_3046_length_1324_cov_30.340408	992	1072	0	61	80	0.7625000
NODE_3046_length_1324_cov_30.340408	992	1072	10	19	80	0.2375000
NODE_3047_length_1324_cov_7.391020	742	822	2	73	80	0.9125000
NODE_3047_length_1324_cov_7.391020	742	822	3	7	80	0.0875000
NODE_3047_length_1324_cov_7.391020	795	875	1	6	80	0.0750000
NODE_3047_length_1324_cov_7.391020	795	875	2	60	80	0.7500000
NODE_3047_length_1324_cov_7.391020	795	875	3	14	80	0.1750000
NODE_3053_length_1323_cov_30.600490	392	472	0	80	80	1.0000000
NODE_3053_length_1323_cov_30.600490	445	525	0	80	80	1.0000000
NODE_3053_length_1323_cov_30.600490	521	601	0	51	80	0.6375000
NODE_3053_length_1323_cov_30.600490	521	601	8	11	80	0.1375000
NODE_3053_length_1323_cov_30.600490	521	601	10	18	80	0.2250000
NODE_3053_length_1323_cov_30.600490	574	654	8	9	80	0.1125000
NODE_3053_length_1323_cov_30.600490	574	654	10	19	80	0.2375000
NODE_3053_length_1323_cov_30.600490	574	654	12	52	80	0.6500000
NODE_3054_length_1323_cov_20.888889	758	838	0	72	80	0.9000000
NODE_3054_length_1323_cov_20.888889	758	838	2	8	80	0.1000000
NODE_3054_length_1323_cov_20.888889	811	891	0	19	80	0.2375000
NODE_3054_length_1323_cov_20.888889	811	891	2	61	80	0.7625000
NODE_3061_length_1322_cov_8.988553	287	368	0	81	81	1.0000000
NODE_3061_length_1322_cov_8.988553	341	421	0	80	80	1.0000000
NODE_3061_length_1322_cov_8.988553	417	497	0	80	80	1.0000000
NODE_3061_length_1322_cov_8.988553	470	550	0	80	80	1.0000000
NODE_3068_length_1321_cov_57.885434	359	439	0	80	80	1.0000000
NODE_3068_length_1321_cov_57.885434	412	492	0	80	80	1.0000000
NODE_3068_length_1321_cov_57.885434	488	568	0	80	80	1.0000000
NODE_3068_length_1321_cov_57.885434	541	621	0	80	80	1.0000000
NODE_3071_length_1320_cov_70.753481	432	512	0	80	80	1.0000000
NODE_3071_length_1320_cov_70.753481	485	565	0	80	80	1.0000000
NODE_3071_length_1320_cov_70.753481	561	641	0	80	80	1.0000000
NODE_3071_length_1320_cov_70.753481	614	694	0	80	80	1.0000000
NODE_3072_length_1320_cov_39.149058	715	795	0	72	80	0.9000000
NODE_3072_length_1320_cov_39.149058	715	795	2	8	80	0.1000000
NODE_3072_length_1320_cov_39.149058	768	848	0	19	80	0.2375000
NODE_3072_length_1320_cov_39.149058	768	848	2	36	80	0.4500000
NODE_3072_length_1320_cov_39.149058	768	848	12	25	80	0.3125000
NODE_3072_length_1320_cov_39.149058	844	924	12	10	80	0.1250000
NODE_3072_length_1320_cov_39.149058	844	924	14	21	80	0.2625000
NODE_3072_length_1320_cov_39.149058	844	924	16	40	80	0.5000000
NODE_3072_length_1320_cov_39.149058	844	924	18	9	80	0.1125000
NODE_3072_length_1320_cov_39.149058	897	977	4	16	80	0.2000000
NODE_3072_length_1320_cov_39.149058	897	977	8	16	80	0.2000000
NODE_3072_length_1320_cov_39.149058	897	977	10	11	80	0.1375000
NODE_3072_length_1320_cov_39.149058	897	977	16	18	80	0.2250000
NODE_3072_length_1320_cov_39.149058	897	977	18	13	80	0.1625000
NODE_3072_length_1320_cov_39.149058	897	977	20	6	80	0.0750000
NODE_3073_length_1320_cov_19.175266	707	783	0	76	76	1.0000000
NODE_3073_length_1320_cov_19.175266	760	840	0	80	80	1.0000000
NODE_3074_length_1320_cov_11.224406	860	940	9	50	80	0.6250000
NODE_3074_length_1320_cov_11.224406	860	940	10	30	80	0.3750000
NODE_3074_length_1320_cov_11.224406	913	993	6	34	80	0.4250000
NODE_3074_length_1320_cov_11.224406	913	993	10	46	80	0.5750000
NODE_3075_length_1320_cov_11.036036	760	840	0	80	80	1.0000000
NODE_3075_length_1320_cov_11.036036	813	893	0	80	80	1.0000000
NODE_3076_length_1320_cov_8.357084	800	880	0	80	80	1.0000000
NODE_3076_length_1320_cov_8.357084	853	933	0	80	80	1.0000000
NODE_3080_length_1319_cov_27.098361	630	710	0	34	80	0.4250000
NODE_3080_length_1319_cov_27.098361	630	710	2	46	80	0.5750000
NODE_3080_length_1319_cov_27.098361	683	763	0	27	80	0.3375000
NODE_3080_length_1319_cov_27.098361	683	763	2	53	80	0.6625000
NODE_3081_length_1319_cov_22.992623	490	570	0	58	80	0.7250000
NODE_3081_length_1319_cov_22.992623	490	570	2	22	80	0.2750000
NODE_3081_length_1319_cov_22.992623	543	623	0	80	80	1.0000000
NODE_3086_length_1318_cov_13.624282	642	722	0	80	80	1.0000000
NODE_3086_length_1318_cov_13.624282	695	775	0	80	80	1.0000000
NODE_3086_length_1318_cov_13.624282	771	851	0	80	80	1.0000000
NODE_3086_length_1318_cov_13.624282	824	904	0	70	80	0.8750000
NODE_3086_length_1318_cov_13.624282	824	904	2	10	80	0.1250000
NODE_3089_length_1317_cov_162.041872	66	143	16	6	77	0.0779221
NODE_3089_length_1317_cov_162.041872	66	143	17	1	77	0.0129870
NODE_3089_length_1317_cov_162.041872	66	143	20	5	77	0.0649351
NODE_3089_length_1317_cov_162.041872	66	143	24	7	77	0.0909091
NODE_3089_length_1317_cov_162.041872	66	143	26	6	77	0.0779221
NODE_3089_length_1317_cov_162.041872	66	143	28	5	77	0.0649351
NODE_3089_length_1317_cov_162.041872	66	143	30	44	77	0.5714286
NODE_3089_length_1317_cov_162.041872	66	143	108	1	77	0.0129870
NODE_3089_length_1317_cov_162.041872	66	143	141	1	77	0.0129870
NODE_3089_length_1317_cov_162.041872	66	143	167	1	77	0.0129870
NODE_3090_length_1317_cov_19.736453	675	755	0	6	80	0.0750000
NODE_3090_length_1317_cov_19.736453	675	755	4	50	80	0.6250000
NODE_3090_length_1317_cov_19.736453	675	755	6	24	80	0.3000000
NODE_3090_length_1317_cov_19.736453	728	808	2	29	80	0.3625000
NODE_3090_length_1317_cov_19.736453	728	808	4	3	80	0.0375000
NODE_3090_length_1317_cov_19.736453	728	808	6	48	80	0.6000000
NODE_3090_length_1317_cov_19.736453	804	884	2	25	80	0.3125000
NODE_3090_length_1317_cov_19.736453	804	884	4	55	80	0.6875000
NODE_3090_length_1317_cov_19.736453	857	937	2	40	80	0.5000000
NODE_3090_length_1317_cov_19.736453	857	937	4	40	80	0.5000000
NODE_3092_length_1317_cov_2.203612	779	859	13	2	80	0.0250000
NODE_3092_length_1317_cov_2.203612	779	859	14	18	80	0.2250000
NODE_3092_length_1317_cov_2.203612	779	859	15	8	80	0.1000000
NODE_3092_length_1317_cov_2.203612	779	859	16	3	80	0.0375000
NODE_3092_length_1317_cov_2.203612	779	859	17	1	80	0.0125000
NODE_3092_length_1317_cov_2.203612	779	859	18	21	80	0.2625000
NODE_3092_length_1317_cov_2.203612	779	859	19	15	80	0.1875000
NODE_3092_length_1317_cov_2.203612	779	859	20	12	80	0.1500000
NODE_3095_length_1316_cov_25.377157	557	637	0	2	80	0.0250000
NODE_3095_length_1316_cov_25.377157	557	637	2	78	80	0.9750000
NODE_3095_length_1316_cov_25.377157	610	690	0	55	80	0.6875000
NODE_3095_length_1316_cov_25.377157	610	690	2	25	80	0.3125000
NODE_3096_length_1316_cov_15.891537	446	526	0	80	80	1.0000000
NODE_3096_length_1316_cov_15.891537	499	579	0	80	80	1.0000000
NODE_3096_length_1316_cov_15.891537	575	655	0	80	80	1.0000000
NODE_3096_length_1316_cov_15.891537	628	708	0	80	80	1.0000000
NODE_3101_length_1315_cov_24.136513	592	672	0	47	80	0.5875000
NODE_3101_length_1315_cov_24.136513	592	672	2	33	80	0.4125000
NODE_3101_length_1315_cov_24.136513	645	725	0	80	80	1.0000000
NODE_3105_length_1314_cov_38.391770	647	727	8	36	80	0.4500000
NODE_3105_length_1314_cov_38.391770	647	727	10	44	80	0.5500000
NODE_3105_length_1314_cov_38.391770	700	780	0	44	80	0.5500000
NODE_3105_length_1314_cov_38.391770	700	780	8	5	80	0.0625000
NODE_3105_length_1314_cov_38.391770	700	780	10	31	80	0.3875000
NODE_3105_length_1314_cov_38.391770	776	856	0	25	80	0.3125000
NODE_3105_length_1314_cov_38.391770	776	856	6	55	80	0.6875000
NODE_3105_length_1314_cov_38.391770	829	909	0	16	80	0.2000000
NODE_3105_length_1314_cov_38.391770	829	909	6	64	80	0.8000000
NODE_3106_length_1314_cov_30.167078	736	816	0	80	80	1.0000000
NODE_3106_length_1314_cov_30.167078	789	869	0	80	80	1.0000000
NODE_3107_length_1314_cov_11.221399	523	603	0	7	80	0.0875000
NODE_3107_length_1314_cov_11.221399	523	603	3	4	80	0.0500000
NODE_3107_length_1314_cov_11.221399	523	603	4	69	80	0.8625000
NODE_3107_length_1314_cov_11.221399	576	656	0	33	80	0.4125000
NODE_3107_length_1314_cov_11.221399	576	656	4	47	80	0.5875000
NODE_3114_length_1313_cov_29.315486	463	543	0	80	80	1.0000000
NODE_3114_length_1313_cov_29.315486	516	596	0	80	80	1.0000000
NODE_3115_length_1313_cov_25.144975	709	789	0	80	80	1.0000000
NODE_3115_length_1313_cov_25.144975	762	842	0	80	80	1.0000000
NODE_3115_length_1313_cov_25.144975	838	918	0	80	80	1.0000000
NODE_3115_length_1313_cov_25.144975	891	971	0	80	80	1.0000000
NODE_3118_length_1312_cov_20.378401	138	218	0	35	80	0.4375000
NODE_3118_length_1312_cov_20.378401	138	218	2	45	80	0.5625000
NODE_3118_length_1312_cov_20.378401	191	271	0	11	80	0.1375000
NODE_3118_length_1312_cov_20.378401	191	271	2	69	80	0.8625000
NODE_3121_length_1311_cov_38.468647	584	664	2	62	80	0.7750000
NODE_3121_length_1311_cov_38.468647	584	664	6	18	80	0.2250000
NODE_3121_length_1311_cov_38.468647	637	717	2	9	80	0.1125000
NODE_3121_length_1311_cov_38.468647	637	717	6	21	80	0.2625000
NODE_3121_length_1311_cov_38.468647	637	717	7	44	80	0.5500000
NODE_3121_length_1311_cov_38.468647	637	717	9	6	80	0.0750000
NODE_3121_length_1311_cov_38.468647	713	793	3	7	80	0.0875000
NODE_3121_length_1311_cov_38.468647	713	793	4	16	80	0.2000000
NODE_3121_length_1311_cov_38.468647	713	793	6	6	80	0.0750000
NODE_3121_length_1311_cov_38.468647	713	793	7	23	80	0.2875000
NODE_3121_length_1311_cov_38.468647	713	793	8	28	80	0.3500000
NODE_3121_length_1311_cov_38.468647	766	846	2	28	80	0.3500000
NODE_3121_length_1311_cov_38.468647	766	846	4	17	80	0.2125000
NODE_3121_length_1311_cov_38.468647	766	846	8	35	80	0.4375000
NODE_3125_length_1310_cov_37.739884	679	759	33	18	80	0.2250000
NODE_3125_length_1310_cov_37.739884	679	759	34	6	80	0.0750000
NODE_3125_length_1310_cov_37.739884	679	759	38	44	80	0.5500000
NODE_3125_length_1310_cov_37.739884	679	759	46	6	80	0.0750000
NODE_3125_length_1310_cov_37.739884	679	759	47	6	80	0.0750000
NODE_3125_length_1310_cov_37.739884	683	763	33	14	80	0.1750000
NODE_3125_length_1310_cov_37.739884	683	763	34	6	80	0.0750000
NODE_3125_length_1310_cov_37.739884	683	763	38	48	80	0.6000000
NODE_3125_length_1310_cov_37.739884	683	763	46	6	80	0.0750000
NODE_3125_length_1310_cov_37.739884	683	763	47	6	80	0.0750000
NODE_3125_length_1310_cov_37.739884	732	816	0	6	84	0.0714286
NODE_3125_length_1310_cov_37.739884	732	816	3	4	84	0.0476190
NODE_3125_length_1310_cov_37.739884	732	816	25	5	84	0.0595238
NODE_3125_length_1310_cov_37.739884	732	816	38	69	84	0.8214286
NODE_3125_length_1310_cov_37.739884	736	816	0	6	80	0.0750000
NODE_3125_length_1310_cov_37.739884	736	816	3	4	80	0.0500000
NODE_3125_length_1310_cov_37.739884	736	816	25	5	80	0.0625000
NODE_3125_length_1310_cov_37.739884	736	816	38	65	80	0.8125000
NODE_3125_length_1310_cov_37.739884	812	892	0	46	80	0.5750000
NODE_3125_length_1310_cov_37.739884	812	892	6	10	80	0.1250000
NODE_3125_length_1310_cov_37.739884	812	892	19	24	80	0.3000000
NODE_3125_length_1310_cov_37.739884	865	945	6	3	80	0.0375000
NODE_3125_length_1310_cov_37.739884	865	945	19	53	80	0.6625000
NODE_3125_length_1310_cov_37.739884	865	945	22	24	80	0.3000000
NODE_3126_length_1310_cov_12.245252	615	695	0	4	80	0.0500000
NODE_3126_length_1310_cov_12.245252	615	695	4	76	80	0.9500000
NODE_3126_length_1310_cov_12.245252	668	748	0	35	80	0.4375000
NODE_3126_length_1310_cov_12.245252	668	748	4	45	80	0.5625000
NODE_3127_length_1310_cov_10.184971	422	502	0	80	80	1.0000000
NODE_3127_length_1310_cov_10.184971	475	555	0	80	80	1.0000000
NODE_3128_length_1310_cov_3.186623	876	956	0	80	80	1.0000000
NODE_3128_length_1310_cov_3.186623	929	1009	0	80	80	1.0000000
NODE_3131_length_1310_cov_0.757225	1255	1310	0	7	55	0.1272727
NODE_3131_length_1310_cov_0.757225	1255	1310	2	17	55	0.3090909
NODE_3131_length_1310_cov_0.757225	1255	1310	4	6	55	0.1090909
NODE_3131_length_1310_cov_0.757225	1255	1310	6	2	55	0.0363636
NODE_3131_length_1310_cov_0.757225	1255	1310	8	1	55	0.0181818
NODE_3131_length_1310_cov_0.757225	1255	1310	10	5	55	0.0909091
NODE_3131_length_1310_cov_0.757225	1255	1310	12	8	55	0.1454545
NODE_3131_length_1310_cov_0.757225	1255	1310	14	9	55	0.1636364
NODE_3132_length_1309_cov_34.942149	474	554	0	80	80	1.0000000
NODE_3132_length_1309_cov_34.942149	527	607	0	80	80	1.0000000
NODE_3132_length_1309_cov_34.942149	603	683	0	80	80	1.0000000
NODE_3132_length_1309_cov_34.942149	656	736	0	80	80	1.0000000
NODE_3133_length_1309_cov_10.571074	839	921	0	82	82	1.0000000
NODE_3133_length_1309_cov_10.571074	894	974	0	80	80	1.0000000
NODE_3135_length_1308_cov_43.461538	330	410	0	80	80	1.0000000
NODE_3135_length_1308_cov_43.461538	383	463	0	80	80	1.0000000
NODE_3145_length_1307_cov_11.290563	595	673	0	78	78	1.0000000
NODE_3145_length_1307_cov_11.290563	646	726	0	80	80	1.0000000
NODE_3146_length_1307_cov_8.653146	430	510	0	80	80	1.0000000
NODE_3146_length_1307_cov_8.653146	483	563	0	80	80	1.0000000
NODE_3153_length_1306_cov_26.813587	369	449	0	80	80	1.0000000
NODE_3153_length_1306_cov_26.813587	422	502	0	80	80	1.0000000
NODE_3153_length_1306_cov_26.813587	498	578	0	33	80	0.4125000
NODE_3153_length_1306_cov_26.813587	498	578	4	47	80	0.5875000
NODE_3153_length_1306_cov_26.813587	551	631	4	60	80	0.7500000
NODE_3153_length_1306_cov_26.813587	551	631	6	20	80	0.2500000
NODE_3154_length_1306_cov_24.904722	634	714	0	80	80	1.0000000
NODE_3154_length_1306_cov_24.904722	687	767	0	80	80	1.0000000
NODE_3155_length_1306_cov_18.274234	388	468	0	13	80	0.1625000
NODE_3155_length_1306_cov_18.274234	388	468	6	67	80	0.8375000
NODE_3155_length_1306_cov_18.274234	441	521	0	19	80	0.2375000
NODE_3155_length_1306_cov_18.274234	441	521	2	9	80	0.1125000
NODE_3155_length_1306_cov_18.274234	441	521	4	38	80	0.4750000
NODE_3155_length_1306_cov_18.274234	441	521	6	14	80	0.1750000
NODE_3156_length_1306_cov_15.176471	1214	1294	0	80	80	1.0000000
NODE_3157_length_1306_cov_12.699254	458	538	0	80	80	1.0000000
NODE_3157_length_1306_cov_12.699254	511	591	0	80	80	1.0000000
NODE_3158_length_1306_cov_9.958575	630	710	2	80	80	1.0000000
NODE_3158_length_1306_cov_9.958575	683	764	0	7	81	0.0864198
NODE_3158_length_1306_cov_9.958575	683	764	1	36	81	0.4444444
NODE_3158_length_1306_cov_9.958575	683	764	2	38	81	0.4691358
NODE_3159_length_1306_cov_2.739851	1206	1246	0	40	40	1.0000000
NODE_3168_length_1304_cov_28.444813	511	591	0	80	80	1.0000000
NODE_3168_length_1304_cov_28.444813	564	644	0	41	80	0.5125000
NODE_3168_length_1304_cov_28.444813	564	644	2	39	80	0.4875000
NODE_3168_length_1304_cov_28.444813	640	720	0	12	80	0.1500000
NODE_3168_length_1304_cov_28.444813	640	720	2	68	80	0.8500000
NODE_3168_length_1304_cov_28.444813	693	773	0	65	80	0.8125000
NODE_3168_length_1304_cov_28.444813	693	773	2	15	80	0.1875000
NODE_3169_length_1304_cov_27.137759	575	655	0	19	80	0.2375000
NODE_3169_length_1304_cov_27.137759	575	655	2	46	80	0.5750000
NODE_3169_length_1304_cov_27.137759	575	655	4	15	80	0.1875000
NODE_3169_length_1304_cov_27.137759	628	708	2	12	80	0.1500000
NODE_3169_length_1304_cov_27.137759	628	708	4	34	80	0.4250000
NODE_3169_length_1304_cov_27.137759	628	708	6	24	80	0.3000000
NODE_3169_length_1304_cov_27.137759	628	708	8	10	80	0.1250000
NODE_3169_length_1304_cov_27.137759	704	784	6	24	80	0.3000000
NODE_3169_length_1304_cov_27.137759	704	784	8	34	80	0.4250000
NODE_3169_length_1304_cov_27.137759	704	784	16	2	80	0.0250000
NODE_3169_length_1304_cov_27.137759	704	784	18	2	80	0.0250000
NODE_3169_length_1304_cov_27.137759	704	784	25	1	80	0.0125000
NODE_3169_length_1304_cov_27.137759	704	784	26	4	80	0.0500000
NODE_3169_length_1304_cov_27.137759	704	784	28	13	80	0.1625000
NODE_3169_length_1304_cov_27.137759	757	837	6	5	80	0.0625000
NODE_3169_length_1304_cov_27.137759	757	837	16	2	80	0.0250000
NODE_3169_length_1304_cov_27.137759	757	837	18	2	80	0.0250000
NODE_3169_length_1304_cov_27.137759	757	837	25	1	80	0.0125000
NODE_3169_length_1304_cov_27.137759	757	837	26	57	80	0.7125000
NODE_3169_length_1304_cov_27.137759	757	837	28	13	80	0.1625000
NODE_3171_length_1303_cov_36.546512	458	538	6	80	80	1.0000000
NODE_3171_length_1303_cov_36.546512	511	591	0	38	80	0.4750000
NODE_3171_length_1303_cov_36.546512	511	591	6	42	80	0.5250000
NODE_3171_length_1303_cov_36.546512	587	667	0	39	80	0.4875000
NODE_3171_length_1303_cov_36.546512	587	667	2	41	80	0.5125000
NODE_3171_length_1303_cov_36.546512	640	720	0	21	80	0.2625000
NODE_3171_length_1303_cov_36.546512	640	720	2	59	80	0.7375000
NODE_3174_length_1302_cov_22.265170	747	827	0	80	80	1.0000000
NODE_3174_length_1302_cov_22.265170	800	880	0	80	80	1.0000000
NODE_3175_length_1302_cov_16.199501	480	560	1	58	80	0.7250000
NODE_3175_length_1302_cov_16.199501	480	560	2	22	80	0.2750000
NODE_3175_length_1302_cov_16.199501	533	613	1	58	80	0.7250000
NODE_3175_length_1302_cov_16.199501	533	613	2	22	80	0.2750000
NODE_3176_length_1302_cov_6.953450	687	767	0	26	80	0.3250000
NODE_3176_length_1302_cov_6.953450	687	767	2	14	80	0.1750000
NODE_3176_length_1302_cov_6.953450	687	767	6	40	80	0.5000000
NODE_3176_length_1302_cov_6.953450	740	820	0	1	80	0.0125000
NODE_3176_length_1302_cov_6.953450	740	820	2	10	80	0.1250000
NODE_3176_length_1302_cov_6.953450	740	820	6	69	80	0.8625000
NODE_3179_length_1301_cov_31.711314	401	481	14	41	80	0.5125000
NODE_3179_length_1301_cov_31.711314	401	481	18	9	80	0.1125000
NODE_3179_length_1301_cov_31.711314	401	481	26	30	80	0.3750000
NODE_3179_length_1301_cov_31.711314	454	534	11	27	80	0.3375000
NODE_3179_length_1301_cov_31.711314	454	534	12	2	80	0.0250000
NODE_3179_length_1301_cov_31.711314	454	534	22	3	80	0.0375000
NODE_3179_length_1301_cov_31.711314	454	534	26	48	80	0.6000000
NODE_3181_length_1301_cov_5.529950	246	326	0	80	80	1.0000000
NODE_3181_length_1301_cov_5.529950	299	379	0	80	80	1.0000000
NODE_3186_length_1300_cov_39.109908	602	682	0	80	80	1.0000000
NODE_3186_length_1300_cov_39.109908	655	735	0	80	80	1.0000000
NODE_3187_length_1300_cov_34.360533	586	666	0	80	80	1.0000000
NODE_3187_length_1300_cov_34.360533	639	719	0	80	80	1.0000000
NODE_3188_length_1300_cov_4.659450	454	535	0	39	81	0.4814815
NODE_3188_length_1300_cov_4.659450	454	535	2	42	81	0.5185185
NODE_3188_length_1300_cov_4.659450	508	588	0	80	80	1.0000000
NODE_3189_length_1299_cov_29.071667	452	532	0	6	80	0.0750000
NODE_3189_length_1299_cov_29.071667	452	532	2	74	80	0.9250000
NODE_3190_length_1299_cov_23.600833	818	898	0	80	80	1.0000000
NODE_3190_length_1299_cov_23.600833	871	951	0	80	80	1.0000000
NODE_3191_length_1299_cov_23.169167	625	705	0	80	80	1.0000000
NODE_3191_length_1299_cov_23.169167	678	758	0	80	80	1.0000000
NODE_3191_length_1299_cov_23.169167	754	834	0	80	80	1.0000000
NODE_3191_length_1299_cov_23.169167	807	887	0	80	80	1.0000000
NODE_3192_length_1299_cov_19.315000	306	386	0	80	80	1.0000000
NODE_3192_length_1299_cov_19.315000	359	439	0	80	80	1.0000000
NODE_3192_length_1299_cov_19.315000	435	515	0	74	80	0.9250000
NODE_3192_length_1299_cov_19.315000	435	515	2	6	80	0.0750000
NODE_3192_length_1299_cov_19.315000	488	568	0	21	80	0.2625000
NODE_3192_length_1299_cov_19.315000	488	568	2	26	80	0.3250000
NODE_3192_length_1299_cov_19.315000	488	568	4	33	80	0.4125000
NODE_3193_length_1299_cov_13.691667	540	620	0	25	80	0.3125000
NODE_3193_length_1299_cov_13.691667	540	620	2	3	80	0.0375000
NODE_3193_length_1299_cov_13.691667	540	620	4	5	80	0.0625000
NODE_3193_length_1299_cov_13.691667	540	620	6	13	80	0.1625000
NODE_3193_length_1299_cov_13.691667	540	620	10	34	80	0.4250000
NODE_3193_length_1299_cov_13.691667	593	673	4	15	80	0.1875000
NODE_3193_length_1299_cov_13.691667	593	673	6	3	80	0.0375000
NODE_3193_length_1299_cov_13.691667	593	673	10	62	80	0.7750000
NODE_3195_length_1298_cov_58.277731	679	759	0	80	80	1.0000000
NODE_3195_length_1298_cov_58.277731	732	812	0	80	80	1.0000000
NODE_3195_length_1298_cov_58.277731	808	888	0	25	80	0.3125000
NODE_3195_length_1298_cov_58.277731	808	888	2	55	80	0.6875000
NODE_3195_length_1298_cov_58.277731	861	941	2	80	80	1.0000000
NODE_3196_length_1298_cov_31.319433	375	455	0	54	80	0.6750000
NODE_3196_length_1298_cov_31.319433	375	455	3	26	80	0.3250000
NODE_3196_length_1298_cov_31.319433	428	508	0	58	80	0.7250000
NODE_3196_length_1298_cov_31.319433	428	508	2	22	80	0.2750000
NODE_3196_length_1298_cov_31.319433	504	584	2	24	80	0.3000000
NODE_3196_length_1298_cov_31.319433	504	584	6	56	80	0.7000000
NODE_3196_length_1298_cov_31.319433	557	637	4	2	80	0.0250000
NODE_3196_length_1298_cov_31.319433	557	637	6	78	80	0.9750000
NODE_3197_length_1298_cov_2.158465	294	360	0	66	66	1.0000000
NODE_3201_length_1296_cov_34.778613	620	700	4	48	80	0.6000000
NODE_3201_length_1296_cov_34.778613	620	700	8	32	80	0.4000000
NODE_3201_length_1296_cov_34.778613	673	753	0	38	80	0.4750000
NODE_3201_length_1296_cov_34.778613	673	753	4	42	80	0.5250000
NODE_3202_length_1296_cov_28.726817	671	751	0	80	80	1.0000000
NODE_3202_length_1296_cov_28.726817	724	804	0	69	80	0.8625000
NODE_3202_length_1296_cov_28.726817	724	804	2	11	80	0.1375000
NODE_3202_length_1296_cov_28.726817	800	880	2	32	80	0.4000000
NODE_3202_length_1296_cov_28.726817	800	880	4	48	80	0.6000000
NODE_3202_length_1296_cov_28.726817	853	933	2	39	80	0.4875000
NODE_3202_length_1296_cov_28.726817	853	933	4	41	80	0.5125000
NODE_3205_length_1295_cov_10.661371	818	898	0	7	80	0.0875000
NODE_3205_length_1295_cov_10.661371	818	898	6	73	80	0.9125000
NODE_3205_length_1295_cov_10.661371	871	951	0	60	80	0.7500000
NODE_3205_length_1295_cov_10.661371	871	951	6	20	80	0.2500000
NODE_3211_length_1294_cov_15.098745	353	433	1	38	80	0.4750000
NODE_3211_length_1294_cov_15.098745	353	433	3	5	80	0.0625000
NODE_3211_length_1294_cov_15.098745	353	433	5	37	80	0.4625000
NODE_3211_length_1294_cov_15.098745	406	486	0	15	80	0.1875000
NODE_3211_length_1294_cov_15.098745	406	486	1	1	80	0.0125000
NODE_3211_length_1294_cov_15.098745	406	486	3	10	80	0.1250000
NODE_3211_length_1294_cov_15.098745	406	486	5	54	80	0.6750000
NODE_3216_length_1293_cov_26.580402	595	675	3	12	80	0.1500000
NODE_3216_length_1293_cov_26.580402	595	675	8	26	80	0.3250000
NODE_3216_length_1293_cov_26.580402	595	675	10	39	80	0.4875000
NODE_3216_length_1293_cov_26.580402	595	675	11	3	80	0.0375000
NODE_3216_length_1293_cov_26.580402	648	728	2	14	80	0.1750000
NODE_3216_length_1293_cov_26.580402	648	728	3	45	80	0.5625000
NODE_3216_length_1293_cov_26.580402	648	728	4	6	80	0.0750000
NODE_3216_length_1293_cov_26.580402	648	728	8	4	80	0.0500000
NODE_3216_length_1293_cov_26.580402	648	728	10	8	80	0.1000000
NODE_3216_length_1293_cov_26.580402	648	728	11	3	80	0.0375000
NODE_3216_length_1293_cov_26.580402	724	804	2	61	80	0.7625000
NODE_3216_length_1293_cov_26.580402	724	804	6	19	80	0.2375000
NODE_3216_length_1293_cov_26.580402	777	857	1	17	80	0.2125000
NODE_3216_length_1293_cov_26.580402	777	857	2	8	80	0.1000000
NODE_3216_length_1293_cov_26.580402	777	857	5	30	80	0.3750000
NODE_3216_length_1293_cov_26.580402	777	857	6	25	80	0.3125000
NODE_3217_length_1293_cov_9.252094	1187	1207	2	20	20	1.0000000
NODE_3220_length_1293_cov_2.118090	1131	1195	6	64	64	1.0000000
NODE_3220_length_1293_cov_2.118090	1184	1248	3	27	64	0.4218750
NODE_3220_length_1293_cov_2.118090	1184	1248	6	37	64	0.5781250
NODE_3224_length_1292_cov_50.158424	402	482	0	41	80	0.5125000
NODE_3224_length_1292_cov_50.158424	402	482	5	1	80	0.0125000
NODE_3224_length_1292_cov_50.158424	402	482	6	38	80	0.4750000
NODE_3224_length_1292_cov_50.158424	455	535	6	80	80	1.0000000
NODE_3224_length_1292_cov_50.158424	531	611	4	7	80	0.0875000
NODE_3224_length_1292_cov_50.158424	531	611	6	72	80	0.9000000
NODE_3224_length_1292_cov_50.158424	531	611	9	1	80	0.0125000
NODE_3224_length_1292_cov_50.158424	584	664	4	34	80	0.4250000
NODE_3224_length_1292_cov_50.158424	584	664	6	46	80	0.5750000
NODE_3225_length_1292_cov_36.535624	670	750	2	54	80	0.6750000
NODE_3225_length_1292_cov_36.535624	670	750	4	26	80	0.3250000
NODE_3225_length_1292_cov_36.535624	723	803	2	31	80	0.3875000
NODE_3225_length_1292_cov_36.535624	723	803	4	49	80	0.6125000
NODE_3226_length_1292_cov_24.523889	420	500	0	80	80	1.0000000
NODE_3226_length_1292_cov_24.523889	473	553	0	44	80	0.5500000
NODE_3226_length_1292_cov_24.523889	473	553	2	36	80	0.4500000
NODE_3232_length_1291_cov_8.734060	623	703	0	80	80	1.0000000
NODE_3232_length_1291_cov_8.734060	676	756	0	80	80	1.0000000
NODE_3233_length_1291_cov_8.625839	756	836	0	33	80	0.4125000
NODE_3233_length_1291_cov_8.625839	756	836	5	5	80	0.0625000
NODE_3233_length_1291_cov_8.625839	756	836	7	8	80	0.1000000
NODE_3233_length_1291_cov_8.625839	756	836	9	8	80	0.1000000
NODE_3233_length_1291_cov_8.625839	756	836	10	2	80	0.0250000
NODE_3233_length_1291_cov_8.625839	756	836	12	24	80	0.3000000
NODE_3233_length_1291_cov_8.625839	809	889	2	2	80	0.0250000
NODE_3233_length_1291_cov_8.625839	809	889	9	1	80	0.0125000
NODE_3233_length_1291_cov_8.625839	809	889	10	16	80	0.2000000
NODE_3233_length_1291_cov_8.625839	809	889	12	61	80	0.7625000
NODE_3236_length_1290_cov_24.120067	497	577	0	78	80	0.9750000
NODE_3236_length_1290_cov_24.120067	497	577	2	2	80	0.0250000
NODE_3236_length_1290_cov_24.120067	550	630	0	33	80	0.4125000
NODE_3236_length_1290_cov_24.120067	550	630	2	47	80	0.5875000
NODE_3236_length_1290_cov_24.120067	626	706	0	80	80	1.0000000
NODE_3236_length_1290_cov_24.120067	679	759	0	38	80	0.4750000
NODE_3236_length_1290_cov_24.120067	679	759	2	42	80	0.5250000
NODE_3237_length_1290_cov_18.874895	671	751	0	80	80	1.0000000
NODE_3237_length_1290_cov_18.874895	724	804	0	80	80	1.0000000
NODE_3238_length_1290_cov_11.627204	573	653	0	42	80	0.5250000
NODE_3238_length_1290_cov_11.627204	573	653	2	38	80	0.4750000
NODE_3238_length_1290_cov_11.627204	626	706	0	15	80	0.1875000
NODE_3238_length_1290_cov_11.627204	626	706	2	65	80	0.8125000
NODE_3239_length_1290_cov_11.215785	373	453	0	80	80	1.0000000
NODE_3239_length_1290_cov_11.215785	426	506	0	80	80	1.0000000
NODE_3240_length_1290_cov_8.752309	788	868	0	80	80	1.0000000
NODE_3240_length_1290_cov_8.752309	841	921	0	80	80	1.0000000
NODE_3242_length_1289_cov_47.476471	919	999	0	27	80	0.3375000
NODE_3242_length_1289_cov_47.476471	919	999	2	53	80	0.6625000
NODE_3242_length_1289_cov_47.476471	972	1052	0	25	80	0.3125000
NODE_3242_length_1289_cov_47.476471	972	1052	2	55	80	0.6875000
NODE_3243_length_1289_cov_18.497479	688	768	0	80	80	1.0000000
NODE_3243_length_1289_cov_18.497479	741	821	0	80	80	1.0000000
NODE_3243_length_1289_cov_18.497479	817	893	0	76	76	1.0000000
NODE_3243_length_1289_cov_18.497479	878	958	0	80	80	1.0000000
NODE_3244_length_1289_cov_11.692437	574	654	0	80	80	1.0000000
NODE_3244_length_1289_cov_11.692437	627	707	0	80	80	1.0000000
NODE_3244_length_1289_cov_11.692437	703	783	0	80	80	1.0000000
NODE_3244_length_1289_cov_11.692437	756	836	0	80	80	1.0000000
NODE_3249_length_1288_cov_29.369218	711	791	2	10	80	0.1250000
NODE_3249_length_1288_cov_29.369218	711	791	8	68	80	0.8500000
NODE_3249_length_1288_cov_29.369218	711	791	10	2	80	0.0250000
NODE_3249_length_1288_cov_29.369218	764	844	2	19	80	0.2375000
NODE_3249_length_1288_cov_29.369218	764	844	8	59	80	0.7375000
NODE_3249_length_1288_cov_29.369218	764	844	10	2	80	0.0250000
NODE_3250_length_1288_cov_6.207738	735	815	0	19	80	0.2375000
NODE_3250_length_1288_cov_6.207738	735	815	2	61	80	0.7625000
NODE_3250_length_1288_cov_6.207738	788	868	0	26	80	0.3250000
NODE_3250_length_1288_cov_6.207738	788	868	2	54	80	0.6750000
NODE_3255_length_1288_cov_1.731707	1017	1095	0	7	78	0.0897436
NODE_3255_length_1288_cov_1.731707	1017	1095	2	2	78	0.0256410
NODE_3255_length_1288_cov_1.731707	1017	1095	4	2	78	0.0256410
NODE_3255_length_1288_cov_1.731707	1017	1095	8	44	78	0.5641026
NODE_3255_length_1288_cov_1.731707	1017	1095	10	9	78	0.1153846
NODE_3255_length_1288_cov_1.731707	1017	1095	12	14	78	0.1794872
NODE_3261_length_1287_cov_29.186027	730	810	0	80	80	1.0000000
NODE_3261_length_1287_cov_29.186027	783	863	0	80	80	1.0000000
NODE_3262_length_1287_cov_22.747475	168	248	0	8	80	0.1000000
NODE_3262_length_1287_cov_22.747475	168	248	2	71	80	0.8875000
NODE_3262_length_1287_cov_22.747475	168	248	6	1	80	0.0125000
NODE_3262_length_1287_cov_22.747475	221	301	0	4	80	0.0500000
NODE_3262_length_1287_cov_22.747475	221	301	2	22	80	0.2750000
NODE_3262_length_1287_cov_22.747475	221	301	4	1	80	0.0125000
NODE_3262_length_1287_cov_22.747475	221	301	6	53	80	0.6625000
NODE_3263_length_1287_cov_19.478956	575	655	0	80	80	1.0000000
NODE_3263_length_1287_cov_19.478956	628	708	0	80	80	1.0000000
NODE_3266_length_1286_cov_27.128054	428	508	0	80	80	1.0000000
NODE_3266_length_1286_cov_27.128054	481	561	0	80	80	1.0000000
NODE_3266_length_1286_cov_27.128054	557	637	0	80	80	1.0000000
NODE_3266_length_1286_cov_27.128054	610	690	0	80	80	1.0000000
NODE_3267_length_1286_cov_12.192081	647	727	0	31	80	0.3875000
NODE_3267_length_1286_cov_12.192081	647	727	2	49	80	0.6125000
NODE_3267_length_1286_cov_12.192081	700	780	0	42	80	0.5250000
NODE_3267_length_1286_cov_12.192081	700	780	2	38	80	0.4750000
NODE_3267_length_1286_cov_12.192081	776	856	0	80	80	1.0000000
NODE_3267_length_1286_cov_12.192081	829	909	0	80	80	1.0000000
NODE_3268_length_1286_cov_8.338669	577	657	0	26	80	0.3250000
NODE_3268_length_1286_cov_8.338669	577	657	4	54	80	0.6750000
NODE_3268_length_1286_cov_8.338669	630	710	0	22	80	0.2750000
NODE_3268_length_1286_cov_8.338669	630	710	4	58	80	0.7250000
NODE_3273_length_1285_cov_40.282462	751	831	0	13	80	0.1625000
NODE_3273_length_1285_cov_40.282462	751	831	2	67	80	0.8375000
NODE_3273_length_1285_cov_40.282462	804	884	0	29	80	0.3625000
NODE_3273_length_1285_cov_40.282462	804	884	2	51	80	0.6375000
NODE_3274_length_1285_cov_15.422428	647	727	2	12	80	0.1500000
NODE_3274_length_1285_cov_15.422428	647	727	4	62	80	0.7750000
NODE_3274_length_1285_cov_15.422428	647	727	6	6	80	0.0750000
NODE_3274_length_1285_cov_15.422428	700	780	4	33	80	0.4125000
NODE_3274_length_1285_cov_15.422428	700	780	5	11	80	0.1375000
NODE_3274_length_1285_cov_15.422428	700	780	6	35	80	0.4375000
NODE_3274_length_1285_cov_15.422428	700	780	8	1	80	0.0125000
NODE_3275_length_1285_cov_6.620573	589	669	0	80	80	1.0000000
NODE_3275_length_1285_cov_6.620573	642	722	0	80	80	1.0000000
NODE_3279_length_1284_cov_5.637975	294	374	0	10	80	0.1250000
NODE_3279_length_1284_cov_5.637975	294	374	2	70	80	0.8750000
NODE_3279_length_1284_cov_5.637975	347	427	0	49	80	0.6125000
NODE_3279_length_1284_cov_5.637975	347	427	2	31	80	0.3875000
NODE_3283_length_1283_cov_10.070101	408	488	0	65	80	0.8125000
NODE_3283_length_1283_cov_10.070101	408	488	2	15	80	0.1875000
NODE_3283_length_1283_cov_10.070101	461	541	0	80	80	1.0000000
NODE_3288_length_1282_cov_37.786137	649	729	0	80	80	1.0000000
NODE_3288_length_1282_cov_37.786137	702	782	0	62	80	0.7750000
NODE_3288_length_1282_cov_37.786137	702	782	2	18	80	0.2250000
NODE_3288_length_1282_cov_37.786137	778	858	2	32	80	0.4000000
NODE_3288_length_1282_cov_37.786137	778	858	10	2	80	0.0250000
NODE_3288_length_1282_cov_37.786137	778	858	11	7	80	0.0875000
NODE_3288_length_1282_cov_37.786137	778	858	12	39	80	0.4875000
NODE_3288_length_1282_cov_37.786137	831	911	10	55	80	0.6875000
NODE_3288_length_1282_cov_37.786137	831	911	12	25	80	0.3125000
NODE_3289_length_1282_cov_25.900254	85	167	10	5	82	0.0609756
NODE_3289_length_1282_cov_25.900254	85	167	12	2	82	0.0243902
NODE_3289_length_1282_cov_25.900254	85	167	14	1	82	0.0121951
NODE_3289_length_1282_cov_25.900254	85	167	16	1	82	0.0121951
NODE_3289_length_1282_cov_25.900254	85	167	24	2	82	0.0243902
NODE_3289_length_1282_cov_25.900254	85	167	26	4	82	0.0487805
NODE_3289_length_1282_cov_25.900254	85	167	32	5	82	0.0609756
NODE_3289_length_1282_cov_25.900254	85	167	34	4	82	0.0487805
NODE_3289_length_1282_cov_25.900254	85	167	36	1	82	0.0121951
NODE_3289_length_1282_cov_25.900254	85	167	40	3	82	0.0365854
NODE_3289_length_1282_cov_25.900254	85	167	44	10	82	0.1219512
NODE_3289_length_1282_cov_25.900254	85	167	46	5	82	0.0609756
NODE_3289_length_1282_cov_25.900254	85	167	48	6	82	0.0731707
NODE_3289_length_1282_cov_25.900254	85	167	50	15	82	0.1829268
NODE_3289_length_1282_cov_25.900254	85	167	52	18	82	0.2195122
NODE_3289_length_1282_cov_25.900254	140	183	4	1	43	0.0232558
NODE_3289_length_1282_cov_25.900254	140	183	6	1	43	0.0232558
NODE_3289_length_1282_cov_25.900254	140	183	8	14	43	0.3255814
NODE_3289_length_1282_cov_25.900254	140	183	10	5	43	0.1162791
NODE_3289_length_1282_cov_25.900254	140	183	12	2	43	0.0465116
NODE_3289_length_1282_cov_25.900254	140	183	14	1	43	0.0232558
NODE_3289_length_1282_cov_25.900254	140	183	16	1	43	0.0232558
NODE_3289_length_1282_cov_25.900254	140	183	24	2	43	0.0465116
NODE_3289_length_1282_cov_25.900254	140	183	26	4	43	0.0930233
NODE_3289_length_1282_cov_25.900254	140	183	32	5	43	0.1162791
NODE_3289_length_1282_cov_25.900254	140	183	34	4	43	0.0930233
NODE_3289_length_1282_cov_25.900254	140	183	36	1	43	0.0232558
NODE_3289_length_1282_cov_25.900254	140	183	40	2	43	0.0465116
NODE_3289_length_1282_cov_25.900254	1006	1086	12	1	80	0.0125000
NODE_3289_length_1282_cov_25.900254	1006	1086	15	10	80	0.1250000
NODE_3289_length_1282_cov_25.900254	1006	1086	16	11	80	0.1375000
NODE_3289_length_1282_cov_25.900254	1006	1086	22	2	80	0.0250000
NODE_3289_length_1282_cov_25.900254	1006	1086	23	10	80	0.1250000
NODE_3289_length_1282_cov_25.900254	1006	1086	24	9	80	0.1125000
NODE_3289_length_1282_cov_25.900254	1006	1086	27	4	80	0.0500000
NODE_3289_length_1282_cov_25.900254	1006	1086	30	1	80	0.0125000
NODE_3289_length_1282_cov_25.900254	1006	1086	34	1	80	0.0125000
NODE_3289_length_1282_cov_25.900254	1006	1086	36	1	80	0.0125000
NODE_3289_length_1282_cov_25.900254	1006	1086	38	3	80	0.0375000
NODE_3289_length_1282_cov_25.900254	1006	1086	39	1	80	0.0125000
NODE_3289_length_1282_cov_25.900254	1006	1086	40	3	80	0.0375000
NODE_3289_length_1282_cov_25.900254	1006	1086	43	1	80	0.0125000
NODE_3289_length_1282_cov_25.900254	1006	1086	49	4	80	0.0500000
NODE_3289_length_1282_cov_25.900254	1006	1086	51	1	80	0.0125000
NODE_3289_length_1282_cov_25.900254	1006	1086	55	5	80	0.0625000
NODE_3289_length_1282_cov_25.900254	1006	1086	56	2	80	0.0250000
NODE_3289_length_1282_cov_25.900254	1006	1086	60	1	80	0.0125000
NODE_3289_length_1282_cov_25.900254	1006	1086	62	3	80	0.0375000
NODE_3289_length_1282_cov_25.900254	1006	1086	65	2	80	0.0250000
NODE_3289_length_1282_cov_25.900254	1006	1086	67	1	80	0.0125000
NODE_3289_length_1282_cov_25.900254	1006	1086	69	3	80	0.0375000
NODE_3289_length_1282_cov_25.900254	1006	1086	12	1	80	0.0125000
NODE_3289_length_1282_cov_25.900254	1006	1086	15	10	80	0.1250000
NODE_3289_length_1282_cov_25.900254	1006	1086	16	11	80	0.1375000
NODE_3289_length_1282_cov_25.900254	1006	1086	22	2	80	0.0250000
NODE_3289_length_1282_cov_25.900254	1006	1086	23	10	80	0.1250000
NODE_3289_length_1282_cov_25.900254	1006	1086	24	9	80	0.1125000
NODE_3289_length_1282_cov_25.900254	1006	1086	27	4	80	0.0500000
NODE_3289_length_1282_cov_25.900254	1006	1086	30	1	80	0.0125000
NODE_3289_length_1282_cov_25.900254	1006	1086	34	1	80	0.0125000
NODE_3289_length_1282_cov_25.900254	1006	1086	36	1	80	0.0125000
NODE_3289_length_1282_cov_25.900254	1006	1086	38	3	80	0.0375000
NODE_3289_length_1282_cov_25.900254	1006	1086	39	1	80	0.0125000
NODE_3289_length_1282_cov_25.900254	1006	1086	40	3	80	0.0375000
NODE_3289_length_1282_cov_25.900254	1006	1086	43	1	80	0.0125000
NODE_3289_length_1282_cov_25.900254	1006	1086	49	4	80	0.0500000
NODE_3289_length_1282_cov_25.900254	1006	1086	51	1	80	0.0125000
NODE_3289_length_1282_cov_25.900254	1006	1086	55	5	80	0.0625000
NODE_3289_length_1282_cov_25.900254	1006	1086	56	2	80	0.0250000
NODE_3289_length_1282_cov_25.900254	1006	1086	60	1	80	0.0125000
NODE_3289_length_1282_cov_25.900254	1006	1086	62	3	80	0.0375000
NODE_3289_length_1282_cov_25.900254	1006	1086	65	2	80	0.0250000
NODE_3289_length_1282_cov_25.900254	1006	1086	67	1	80	0.0125000
NODE_3289_length_1282_cov_25.900254	1006	1086	69	3	80	0.0375000
NODE_3289_length_1282_cov_25.900254	1015	1086	15	3	71	0.0422535
NODE_3289_length_1282_cov_25.900254	1015	1086	16	10	71	0.1408451
NODE_3289_length_1282_cov_25.900254	1015	1086	22	2	71	0.0281690
NODE_3289_length_1282_cov_25.900254	1015	1086	23	10	71	0.1408451
NODE_3289_length_1282_cov_25.900254	1015	1086	24	9	71	0.1267606
NODE_3289_length_1282_cov_25.900254	1015	1086	27	4	71	0.0563380
NODE_3289_length_1282_cov_25.900254	1015	1086	30	1	71	0.0140845
NODE_3289_length_1282_cov_25.900254	1015	1086	34	1	71	0.0140845
NODE_3289_length_1282_cov_25.900254	1015	1086	36	1	71	0.0140845
NODE_3289_length_1282_cov_25.900254	1015	1086	38	3	71	0.0422535
NODE_3289_length_1282_cov_25.900254	1015	1086	39	1	71	0.0140845
NODE_3289_length_1282_cov_25.900254	1015	1086	40	3	71	0.0422535
NODE_3289_length_1282_cov_25.900254	1015	1086	43	1	71	0.0140845
NODE_3289_length_1282_cov_25.900254	1015	1086	49	4	71	0.0563380
NODE_3289_length_1282_cov_25.900254	1015	1086	51	1	71	0.0140845
NODE_3289_length_1282_cov_25.900254	1015	1086	55	5	71	0.0704225
NODE_3289_length_1282_cov_25.900254	1015	1086	56	2	71	0.0281690
NODE_3289_length_1282_cov_25.900254	1015	1086	60	1	71	0.0140845
NODE_3289_length_1282_cov_25.900254	1015	1086	62	3	71	0.0422535
NODE_3289_length_1282_cov_25.900254	1015	1086	65	2	71	0.0281690
NODE_3289_length_1282_cov_25.900254	1015	1086	67	1	71	0.0140845
NODE_3289_length_1282_cov_25.900254	1015	1086	69	3	71	0.0422535
NODE_3290_length_1282_cov_14.600169	429	477	0	48	48	1.0000000
NODE_3290_length_1282_cov_14.600169	708	788	0	50	80	0.6250000
NODE_3290_length_1282_cov_14.600169	708	788	2	30	80	0.3750000
NODE_3291_length_1282_cov_8.017751	343	420	0	13	77	0.1688312
NODE_3291_length_1282_cov_8.017751	343	420	2	64	77	0.8311688
NODE_3292_length_1282_cov_5.092984	239	319	0	80	80	1.0000000
NODE_3292_length_1282_cov_5.092984	292	372	0	80	80	1.0000000
NODE_3295_length_1281_cov_31.342640	470	550	1	80	80	1.0000000
NODE_3295_length_1281_cov_31.342640	523	603	0	31	80	0.3875000
NODE_3295_length_1281_cov_31.342640	523	603	1	49	80	0.6125000
NODE_3295_length_1281_cov_31.342640	599	679	0	80	80	1.0000000
NODE_3295_length_1281_cov_31.342640	652	732	0	80	80	1.0000000
NODE_3296_length_1281_cov_25.482234	474	554	0	2	80	0.0250000
NODE_3296_length_1281_cov_25.482234	474	554	4	24	80	0.3000000
NODE_3296_length_1281_cov_25.482234	474	554	6	54	80	0.6750000
NODE_3296_length_1281_cov_25.482234	527	607	0	15	80	0.1875000
NODE_3296_length_1281_cov_25.482234	527	607	2	1	80	0.0125000
NODE_3296_length_1281_cov_25.482234	527	607	6	64	80	0.8000000
NODE_3297_length_1281_cov_14.617597	809	887	0	78	78	1.0000000
NODE_3297_length_1281_cov_14.617597	860	940	0	80	80	1.0000000
NODE_3298_length_1281_cov_12.065144	655	735	2	3	80	0.0375000
NODE_3298_length_1281_cov_12.065144	655	735	3	7	80	0.0875000
NODE_3298_length_1281_cov_12.065144	655	735	4	40	80	0.5000000
NODE_3298_length_1281_cov_12.065144	655	735	5	1	80	0.0125000
NODE_3298_length_1281_cov_12.065144	655	735	6	29	80	0.3625000
NODE_3298_length_1281_cov_12.065144	708	788	2	2	80	0.0250000
NODE_3298_length_1281_cov_12.065144	708	788	5	1	80	0.0125000
NODE_3298_length_1281_cov_12.065144	708	788	6	33	80	0.4125000
NODE_3298_length_1281_cov_12.065144	708	788	7	44	80	0.5500000
NODE_3299_length_1281_cov_9.235195	408	488	0	13	80	0.1625000
NODE_3299_length_1281_cov_9.235195	408	488	4	26	80	0.3250000
NODE_3299_length_1281_cov_9.235195	408	488	6	41	80	0.5125000
NODE_3299_length_1281_cov_9.235195	461	541	0	22	80	0.2750000
NODE_3299_length_1281_cov_9.235195	461	541	2	19	80	0.2375000
NODE_3299_length_1281_cov_9.235195	461	541	6	39	80	0.4875000
NODE_3300_length_1281_cov_7.153976	469	549	0	80	80	1.0000000
NODE_3300_length_1281_cov_7.153976	522	602	0	80	80	1.0000000
NODE_3307_length_1280_cov_24.231160	418	498	2	71	80	0.8875000
NODE_3307_length_1280_cov_24.231160	418	498	4	9	80	0.1125000
NODE_3307_length_1280_cov_24.231160	471	551	0	19	80	0.2375000
NODE_3307_length_1280_cov_24.231160	471	551	2	61	80	0.7625000
NODE_3307_length_1280_cov_24.231160	547	627	0	80	80	1.0000000
NODE_3307_length_1280_cov_24.231160	600	680	0	80	80	1.0000000
NODE_3308_length_1280_cov_5.908552	1077	1138	22	1	61	0.0163934
NODE_3308_length_1280_cov_5.908552	1077	1138	32	3	61	0.0491803
NODE_3308_length_1280_cov_5.908552	1077	1138	36	1	61	0.0163934
NODE_3308_length_1280_cov_5.908552	1077	1138	40	1	61	0.0163934
NODE_3308_length_1280_cov_5.908552	1077	1138	47	1	61	0.0163934
NODE_3308_length_1280_cov_5.908552	1077	1138	51	1	61	0.0163934
NODE_3308_length_1280_cov_5.908552	1077	1138	54	2	61	0.0327869
NODE_3308_length_1280_cov_5.908552	1077	1138	61	1	61	0.0163934
NODE_3308_length_1280_cov_5.908552	1077	1138	64	3	61	0.0491803
NODE_3308_length_1280_cov_5.908552	1077	1138	69	1	61	0.0163934
NODE_3308_length_1280_cov_5.908552	1077	1138	77	1	61	0.0163934
NODE_3308_length_1280_cov_5.908552	1077	1138	78	2	61	0.0327869
NODE_3308_length_1280_cov_5.908552	1077	1138	80	1	61	0.0163934
NODE_3308_length_1280_cov_5.908552	1077	1138	81	1	61	0.0163934
NODE_3308_length_1280_cov_5.908552	1077	1138	84	1	61	0.0163934
NODE_3308_length_1280_cov_5.908552	1077	1138	87	1	61	0.0163934
NODE_3308_length_1280_cov_5.908552	1077	1138	91	6	61	0.0983607
NODE_3308_length_1280_cov_5.908552	1077	1138	93	1	61	0.0163934
NODE_3308_length_1280_cov_5.908552	1077	1138	94	1	61	0.0163934
NODE_3308_length_1280_cov_5.908552	1077	1138	96	1	61	0.0163934
NODE_3308_length_1280_cov_5.908552	1077	1138	99	1	61	0.0163934
NODE_3308_length_1280_cov_5.908552	1077	1138	104	1	61	0.0163934
NODE_3308_length_1280_cov_5.908552	1077	1138	106	1	61	0.0163934
NODE_3308_length_1280_cov_5.908552	1077	1138	109	1	61	0.0163934
NODE_3308_length_1280_cov_5.908552	1077	1138	126	1	61	0.0163934
NODE_3308_length_1280_cov_5.908552	1077	1138	127	2	61	0.0327869
NODE_3308_length_1280_cov_5.908552	1077	1138	130	1	61	0.0163934
NODE_3308_length_1280_cov_5.908552	1077	1138	131	1	61	0.0163934
NODE_3308_length_1280_cov_5.908552	1077	1138	133	1	61	0.0163934
NODE_3308_length_1280_cov_5.908552	1077	1138	139	1	61	0.0163934
NODE_3308_length_1280_cov_5.908552	1077	1138	141	2	61	0.0327869
NODE_3308_length_1280_cov_5.908552	1077	1138	151	2	61	0.0327869
NODE_3308_length_1280_cov_5.908552	1077	1138	156	3	61	0.0491803
NODE_3308_length_1280_cov_5.908552	1077	1138	158	3	61	0.0491803
NODE_3308_length_1280_cov_5.908552	1077	1138	160	1	61	0.0163934
NODE_3308_length_1280_cov_5.908552	1077	1138	162	1	61	0.0163934
NODE_3308_length_1280_cov_5.908552	1077	1138	167	2	61	0.0327869
NODE_3308_length_1280_cov_5.908552	1077	1138	172	1	61	0.0163934
NODE_3308_length_1280_cov_5.908552	1077	1138	175	1	61	0.0163934
NODE_3308_length_1280_cov_5.908552	1077	1138	179	3	61	0.0491803
NODE_3311_length_1279_cov_16.840678	749	829	0	80	80	1.0000000
NODE_3311_length_1279_cov_16.840678	802	882	0	80	80	1.0000000
NODE_3312_length_1279_cov_3.772881	951	981	4	30	30	1.0000000
NODE_3317_length_1278_cov_45.991518	411	491	0	80	80	1.0000000
NODE_3317_length_1278_cov_45.991518	464	530	0	66	66	1.0000000
NODE_3318_length_1278_cov_37.164546	447	527	0	80	80	1.0000000
NODE_3318_length_1278_cov_37.164546	500	580	0	80	80	1.0000000
NODE_3318_length_1278_cov_37.164546	576	656	0	80	80	1.0000000
NODE_3318_length_1278_cov_37.164546	629	709	0	80	80	1.0000000
NODE_3319_length_1278_cov_12.505513	522	602	0	28	80	0.3500000
NODE_3319_length_1278_cov_12.505513	522	602	2	52	80	0.6500000
NODE_3319_length_1278_cov_12.505513	575	655	0	70	80	0.8750000
NODE_3319_length_1278_cov_12.505513	575	655	2	10	80	0.1250000
NODE_3320_length_1278_cov_12.171332	212	292	0	80	80	1.0000000
NODE_3320_length_1278_cov_12.171332	265	344	0	79	79	1.0000000
NODE_3329_length_1277_cov_21.407470	667	717	3	33	50	0.6600000
NODE_3329_length_1277_cov_21.407470	667	717	4	17	50	0.3400000
NODE_3329_length_1277_cov_21.407470	690	770	3	10	80	0.1250000
NODE_3329_length_1277_cov_21.407470	690	770	4	70	80	0.8750000
NODE_3330_length_1277_cov_18.111205	834	914	0	80	80	1.0000000
NODE_3330_length_1277_cov_18.111205	887	967	0	80	80	1.0000000
NODE_3331_length_1277_cov_12.449066	276	356	0	80	80	1.0000000
NODE_3331_length_1277_cov_12.449066	329	409	0	80	80	1.0000000
NODE_3331_length_1277_cov_12.449066	405	485	0	80	80	1.0000000
NODE_3331_length_1277_cov_12.449066	458	538	0	80	80	1.0000000
NODE_3337_length_1276_cov_21.446899	526	606	0	80	80	1.0000000
NODE_3337_length_1276_cov_21.446899	579	659	0	80	80	1.0000000
NODE_3337_length_1276_cov_21.446899	655	735	0	80	80	1.0000000
NODE_3337_length_1276_cov_21.446899	708	788	0	80	80	1.0000000
NODE_3346_length_1275_cov_35.471939	632	712	0	43	80	0.5375000
NODE_3346_length_1275_cov_35.471939	632	712	6	37	80	0.4625000
NODE_3346_length_1275_cov_35.471939	685	765	0	80	80	1.0000000
NODE_3347_length_1275_cov_19.910714	361	441	0	80	80	1.0000000
NODE_3347_length_1275_cov_19.910714	414	494	0	80	80	1.0000000
NODE_3347_length_1275_cov_19.910714	879	949	6	29	70	0.4142857
NODE_3347_length_1275_cov_19.910714	879	949	8	41	70	0.5857143
NODE_3351_length_1274_cov_23.404255	427	507	0	20	80	0.2500000
NODE_3351_length_1274_cov_23.404255	427	507	6	60	80	0.7500000
NODE_3351_length_1274_cov_23.404255	480	560	0	4	80	0.0500000
NODE_3351_length_1274_cov_23.404255	480	560	6	76	80	0.9500000
NODE_3351_length_1274_cov_23.404255	556	636	0	64	80	0.8000000
NODE_3351_length_1274_cov_23.404255	556	636	2	16	80	0.2000000
NODE_3351_length_1274_cov_23.404255	609	689	0	11	80	0.1375000
NODE_3351_length_1274_cov_23.404255	609	689	2	20	80	0.2500000
NODE_3351_length_1274_cov_23.404255	609	689	3	2	80	0.0250000
NODE_3351_length_1274_cov_23.404255	609	689	4	15	80	0.1875000
NODE_3351_length_1274_cov_23.404255	609	689	5	16	80	0.2000000
NODE_3351_length_1274_cov_23.404255	609	689	6	16	80	0.2000000
NODE_3352_length_1274_cov_20.178723	545	625	0	4	80	0.0500000
NODE_3352_length_1274_cov_20.178723	545	625	4	76	80	0.9500000
NODE_3352_length_1274_cov_20.178723	598	678	0	28	80	0.3500000
NODE_3352_length_1274_cov_20.178723	598	678	4	52	80	0.6500000
NODE_3354_length_1274_cov_2.019574	841	907	0	39	66	0.5909091
NODE_3354_length_1274_cov_2.019574	841	907	2	27	66	0.4090909
NODE_3354_length_1274_cov_2.019574	894	961	0	67	67	1.0000000
NODE_3361_length_1273_cov_42.349233	337	417	0	80	80	1.0000000
NODE_3361_length_1273_cov_42.349233	390	470	0	79	80	0.9875000
NODE_3361_length_1273_cov_42.349233	390	470	6	1	80	0.0125000
NODE_3361_length_1273_cov_42.349233	466	546	0	3	80	0.0375000
NODE_3361_length_1273_cov_42.349233	466	546	6	77	80	0.9625000
NODE_3361_length_1273_cov_42.349233	519	599	0	6	80	0.0750000
NODE_3361_length_1273_cov_42.349233	519	599	6	74	80	0.9250000
NODE_3364_length_1273_cov_4.404600	407	487	0	13	80	0.1625000
NODE_3364_length_1273_cov_4.404600	407	487	6	67	80	0.8375000
NODE_3364_length_1273_cov_4.404600	460	540	5	15	80	0.1875000
NODE_3364_length_1273_cov_4.404600	460	540	6	65	80	0.8125000
NODE_3368_length_1272_cov_28.887468	588	668	0	77	80	0.9625000
NODE_3368_length_1272_cov_28.887468	588	668	4	3	80	0.0375000
NODE_3368_length_1272_cov_28.887468	641	721	0	24	80	0.3000000
NODE_3368_length_1272_cov_28.887468	641	721	4	56	80	0.7000000
NODE_3369_length_1272_cov_11.290708	366	447	10	27	81	0.3333333
NODE_3369_length_1272_cov_11.290708	366	447	12	12	81	0.1481481
NODE_3369_length_1272_cov_11.290708	366	447	14	42	81	0.5185185
NODE_3375_length_1270_cov_13.617421	365	445	0	80	80	1.0000000
NODE_3375_length_1270_cov_13.617421	396	473	0	77	77	1.0000000
NODE_3375_length_1270_cov_13.617421	418	498	0	80	80	1.0000000
NODE_3375_length_1270_cov_13.617421	449	473	0	24	24	1.0000000
NODE_3375_length_1270_cov_13.617421	465	498	0	33	33	1.0000000
NODE_3376_length_1270_cov_11.645602	294	374	0	72	80	0.9000000
NODE_3376_length_1270_cov_11.645602	294	374	4	8	80	0.1000000
NODE_3376_length_1270_cov_11.645602	347	427	0	19	80	0.2375000
NODE_3376_length_1270_cov_11.645602	347	427	4	43	80	0.5375000
NODE_3376_length_1270_cov_11.645602	347	427	5	13	80	0.1625000
NODE_3376_length_1270_cov_11.645602	347	427	6	5	80	0.0625000
NODE_3377_length_1270_cov_2.495303	74	131	7	2	57	0.0350877
NODE_3377_length_1270_cov_2.495303	74	131	9	2	57	0.0350877
NODE_3377_length_1270_cov_2.495303	74	131	10	18	57	0.3157895
NODE_3377_length_1270_cov_2.495303	74	131	12	5	57	0.0877193
NODE_3377_length_1270_cov_2.495303	74	131	14	30	57	0.5263158
NODE_3378_length_1269_cov_55.070940	492	569	0	7	77	0.0909091
NODE_3378_length_1269_cov_55.070940	492	569	2	70	77	0.9090909
NODE_3378_length_1269_cov_55.070940	545	625	0	63	80	0.7875000
NODE_3378_length_1269_cov_55.070940	545	625	2	17	80	0.2125000
NODE_3378_length_1269_cov_55.070940	621	701	0	51	80	0.6375000
NODE_3378_length_1269_cov_55.070940	621	701	6	29	80	0.3625000
NODE_3378_length_1269_cov_55.070940	674	754	6	80	80	1.0000000
NODE_3379_length_1269_cov_22.154701	1152	1216	24	6	64	0.0937500
NODE_3379_length_1269_cov_22.154701	1152	1216	26	58	64	0.9062500
NODE_3379_length_1269_cov_22.154701	1152	1216	24	6	64	0.0937500
NODE_3379_length_1269_cov_22.154701	1152	1216	26	58	64	0.9062500
NODE_3379_length_1269_cov_22.154701	1152	1216	24	6	64	0.0937500
NODE_3379_length_1269_cov_22.154701	1152	1216	26	58	64	0.9062500
NODE_3379_length_1269_cov_22.154701	1189	1269	8	8	80	0.1000000
NODE_3379_length_1269_cov_22.154701	1189	1269	10	6	80	0.0750000
NODE_3379_length_1269_cov_22.154701	1189	1269	16	4	80	0.0500000
NODE_3379_length_1269_cov_22.154701	1189	1269	22	34	80	0.4250000
NODE_3379_length_1269_cov_22.154701	1189	1269	24	7	80	0.0875000
NODE_3379_length_1269_cov_22.154701	1189	1269	26	21	80	0.2625000
NODE_3379_length_1269_cov_22.154701	1189	1269	8	8	80	0.1000000
NODE_3379_length_1269_cov_22.154701	1189	1269	10	6	80	0.0750000
NODE_3379_length_1269_cov_22.154701	1189	1269	16	4	80	0.0500000
NODE_3379_length_1269_cov_22.154701	1189	1269	22	34	80	0.4250000
NODE_3379_length_1269_cov_22.154701	1189	1269	24	7	80	0.0875000
NODE_3379_length_1269_cov_22.154701	1189	1269	26	21	80	0.2625000
NODE_3380_length_1269_cov_18.753846	317	398	2	2	81	0.0246914
NODE_3380_length_1269_cov_18.753846	317	398	4	2	81	0.0246914
NODE_3380_length_1269_cov_18.753846	317	398	8	5	81	0.0617284
NODE_3380_length_1269_cov_18.753846	317	398	10	1	81	0.0123457
NODE_3380_length_1269_cov_18.753846	317	398	18	16	81	0.1975309
NODE_3380_length_1269_cov_18.753846	317	398	20	20	81	0.2469136
NODE_3380_length_1269_cov_18.753846	317	398	24	1	81	0.0123457
NODE_3380_length_1269_cov_18.753846	317	398	26	28	81	0.3456790
NODE_3380_length_1269_cov_18.753846	317	398	28	6	81	0.0740741
NODE_3381_length_1269_cov_12.637607	580	660	0	44	80	0.5500000
NODE_3381_length_1269_cov_12.637607	580	660	2	36	80	0.4500000
NODE_3381_length_1269_cov_12.637607	633	713	2	78	80	0.9750000
NODE_3381_length_1269_cov_12.637607	633	713	4	2	80	0.0250000
NODE_3381_length_1269_cov_12.637607	709	729	2	2	20	0.1000000
NODE_3381_length_1269_cov_12.637607	709	729	4	18	20	0.9000000
NODE_3381_length_1269_cov_12.637607	709	789	2	56	80	0.7000000
NODE_3381_length_1269_cov_12.637607	709	789	4	24	80	0.3000000
NODE_3381_length_1269_cov_12.637607	762	842	2	80	80	1.0000000
NODE_3382_length_1269_cov_10.552137	765	845	0	80	80	1.0000000
NODE_3382_length_1269_cov_10.552137	818	898	0	80	80	1.0000000
NODE_3391_length_1268_cov_12.862275	300	350	18	1	50	0.0200000
NODE_3391_length_1268_cov_12.862275	300	350	23	1	50	0.0200000
NODE_3391_length_1268_cov_12.862275	300	350	28	1	50	0.0200000
NODE_3391_length_1268_cov_12.862275	300	350	30	4	50	0.0800000
NODE_3391_length_1268_cov_12.862275	300	350	32	1	50	0.0200000
NODE_3391_length_1268_cov_12.862275	300	350	36	4	50	0.0800000
NODE_3391_length_1268_cov_12.862275	300	350	38	15	50	0.3000000
NODE_3391_length_1268_cov_12.862275	300	350	39	7	50	0.1400000
NODE_3391_length_1268_cov_12.862275	300	350	40	1	50	0.0200000
NODE_3391_length_1268_cov_12.862275	300	350	42	2	50	0.0400000
NODE_3391_length_1268_cov_12.862275	300	350	46	3	50	0.0600000
NODE_3391_length_1268_cov_12.862275	300	350	48	1	50	0.0200000
NODE_3391_length_1268_cov_12.862275	300	350	50	1	50	0.0200000
NODE_3391_length_1268_cov_12.862275	300	350	52	1	50	0.0200000
NODE_3391_length_1268_cov_12.862275	300	350	54	7	50	0.1400000
NODE_3392_length_1268_cov_9.523524	265	345	0	80	80	1.0000000
NODE_3392_length_1268_cov_9.523524	318	398	0	80	80	1.0000000
NODE_3393_length_1267_cov_21.315068	299	379	0	13	80	0.1625000
NODE_3393_length_1267_cov_21.315068	299	379	4	59	80	0.7375000
NODE_3393_length_1267_cov_21.315068	299	379	6	8	80	0.1000000
NODE_3393_length_1267_cov_21.315068	352	432	0	13	80	0.1625000
NODE_3393_length_1267_cov_21.315068	352	432	4	6	80	0.0750000
NODE_3393_length_1267_cov_21.315068	352	432	6	61	80	0.7625000
NODE_3393_length_1267_cov_21.315068	698	778	2	55	80	0.6875000
NODE_3393_length_1267_cov_21.315068	698	778	4	25	80	0.3125000
NODE_3393_length_1267_cov_21.315068	751	831	2	10	80	0.1250000
NODE_3393_length_1267_cov_21.315068	751	831	4	36	80	0.4500000
NODE_3393_length_1267_cov_21.315068	751	831	6	34	80	0.4250000
NODE_3394_length_1267_cov_14.880137	606	686	0	60	80	0.7500000
NODE_3394_length_1267_cov_14.880137	606	686	2	20	80	0.2500000
NODE_3394_length_1267_cov_14.880137	659	739	0	24	80	0.3000000
NODE_3394_length_1267_cov_14.880137	659	739	2	56	80	0.7000000
NODE_3397_length_1266_cov_20.584404	357	437	7	5	80	0.0625000
NODE_3397_length_1266_cov_20.584404	357	437	8	7	80	0.0875000
NODE_3397_length_1266_cov_20.584404	357	437	10	27	80	0.3375000
NODE_3397_length_1266_cov_20.584404	357	437	11	19	80	0.2375000
NODE_3397_length_1266_cov_20.584404	357	437	12	12	80	0.1500000
NODE_3397_length_1266_cov_20.584404	357	437	14	10	80	0.1250000
NODE_3397_length_1266_cov_20.584404	410	490	6	15	80	0.1875000
NODE_3397_length_1266_cov_20.584404	410	490	8	5	80	0.0625000
NODE_3397_length_1266_cov_20.584404	410	490	10	60	80	0.7500000
NODE_3398_length_1266_cov_16.571551	359	435	0	76	76	1.0000000
NODE_3398_length_1266_cov_16.571551	408	488	0	80	80	1.0000000
NODE_3399_length_1266_cov_14.218509	517	595	0	78	78	1.0000000
NODE_3399_length_1266_cov_14.218509	568	648	0	80	80	1.0000000
NODE_3399_length_1266_cov_14.218509	644	724	0	4	80	0.0500000
NODE_3399_length_1266_cov_14.218509	644	724	2	23	80	0.2875000
NODE_3399_length_1266_cov_14.218509	644	724	6	8	80	0.1000000
NODE_3399_length_1266_cov_14.218509	644	724	14	8	80	0.1000000
NODE_3399_length_1266_cov_14.218509	644	724	16	23	80	0.2875000
NODE_3399_length_1266_cov_14.218509	644	724	18	6	80	0.0750000
NODE_3399_length_1266_cov_14.218509	644	724	20	8	80	0.1000000
NODE_3399_length_1266_cov_14.218509	697	777	14	28	80	0.3500000
NODE_3399_length_1266_cov_14.218509	697	777	16	13	80	0.1625000
NODE_3399_length_1266_cov_14.218509	697	777	18	7	80	0.0875000
NODE_3399_length_1266_cov_14.218509	697	777	20	32	80	0.4000000
NODE_3403_length_1265_cov_9.807890	429	509	0	22	80	0.2750000
NODE_3403_length_1265_cov_9.807890	429	509	2	58	80	0.7250000
NODE_3403_length_1265_cov_9.807890	482	562	0	22	80	0.2750000
NODE_3403_length_1265_cov_9.807890	482	562	2	58	80	0.7250000
NODE_3404_length_1265_cov_8.233276	160	207	0	6	47	0.1276596
NODE_3404_length_1265_cov_8.233276	160	207	12	2	47	0.0425532
NODE_3404_length_1265_cov_8.233276	160	207	14	39	47	0.8297873
NODE_3404_length_1265_cov_8.233276	1004	1058	0	54	54	1.0000000
NODE_3406_length_1265_cov_3.941681	503	583	0	80	80	1.0000000
NODE_3406_length_1265_cov_3.941681	556	636	0	80	80	1.0000000
NODE_3408_length_1264_cov_8.024034	290	370	0	80	80	1.0000000
NODE_3408_length_1264_cov_8.024034	343	423	0	80	80	1.0000000
NODE_3413_length_1263_cov_8.566151	698	778	0	41	80	0.5125000
NODE_3413_length_1263_cov_8.566151	698	778	2	20	80	0.2500000
NODE_3413_length_1263_cov_8.566151	698	778	4	19	80	0.2375000
NODE_3413_length_1263_cov_8.566151	751	831	2	15	80	0.1875000
NODE_3413_length_1263_cov_8.566151	751	831	4	65	80	0.8125000
NODE_3413_length_1263_cov_8.566151	833	910	0	48	77	0.6233766
NODE_3413_length_1263_cov_8.566151	833	910	2	29	77	0.3766234
NODE_3413_length_1263_cov_8.566151	883	963	0	7	80	0.0875000
NODE_3413_length_1263_cov_8.566151	883	963	2	73	80	0.9125000
NODE_3414_length_1263_cov_7.376289	1060	1140	0	23	80	0.2875000
NODE_3414_length_1263_cov_7.376289	1060	1140	2	57	80	0.7125000
NODE_3414_length_1263_cov_7.376289	1113	1213	0	27	100	0.2700000
NODE_3414_length_1263_cov_7.376289	1113	1213	2	73	100	0.7300000
NODE_3416_length_1263_cov_1.827320	227	307	0	80	80	1.0000000
NODE_3416_length_1263_cov_1.827320	280	360	0	80	80	1.0000000
NODE_3418_length_1262_cov_17.416165	404	484	0	80	80	1.0000000
NODE_3418_length_1262_cov_17.416165	457	537	0	80	80	1.0000000
NODE_3419_length_1262_cov_15.268272	648	728	0	61	80	0.7625000
NODE_3419_length_1262_cov_15.268272	648	728	2	19	80	0.2375000
NODE_3419_length_1262_cov_15.268272	701	781	0	8	80	0.1000000
NODE_3419_length_1262_cov_15.268272	701	781	2	72	80	0.9000000
NODE_3419_length_1262_cov_15.268272	777	857	0	8	80	0.1000000
NODE_3419_length_1262_cov_15.268272	777	857	2	65	80	0.8125000
NODE_3419_length_1262_cov_15.268272	777	857	4	7	80	0.0875000
NODE_3419_length_1262_cov_15.268272	830	910	2	57	80	0.7125000
NODE_3419_length_1262_cov_15.268272	830	910	4	23	80	0.2875000
NODE_3424_length_1261_cov_1.777969	272	318	0	46	46	1.0000000
NODE_3425_length_1260_cov_55.640827	499	579	0	80	80	1.0000000
NODE_3425_length_1260_cov_55.640827	552	632	0	80	80	1.0000000
NODE_3425_length_1260_cov_55.640827	628	708	0	71	80	0.8875000
NODE_3425_length_1260_cov_55.640827	628	708	2	9	80	0.1125000
NODE_3425_length_1260_cov_55.640827	681	761	0	18	80	0.2250000
NODE_3425_length_1260_cov_55.640827	681	761	2	10	80	0.1250000
NODE_3425_length_1260_cov_55.640827	681	761	4	52	80	0.6500000
NODE_3426_length_1260_cov_12.242894	427	507	0	80	80	1.0000000
NODE_3426_length_1260_cov_12.242894	480	560	0	30	80	0.3750000
NODE_3426_length_1260_cov_12.242894	480	560	2	50	80	0.6250000
NODE_3436_length_1259_cov_15.381897	509	589	0	57	80	0.7125000
NODE_3436_length_1259_cov_15.381897	509	589	6	23	80	0.2875000
NODE_3436_length_1259_cov_15.381897	562	642	0	4	80	0.0500000
NODE_3436_length_1259_cov_15.381897	562	642	6	76	80	0.9500000
NODE_3439_length_1258_cov_33.519413	608	688	0	66	80	0.8250000
NODE_3439_length_1258_cov_33.519413	608	688	2	14	80	0.1750000
NODE_3439_length_1258_cov_33.519413	661	741	0	13	80	0.1625000
NODE_3439_length_1258_cov_33.519413	661	741	2	67	80	0.8375000
NODE_3440_length_1258_cov_22.569456	583	663	2	80	80	1.0000000
NODE_3440_length_1258_cov_22.569456	636	716	0	46	80	0.5750000
NODE_3440_length_1258_cov_22.569456	636	716	2	34	80	0.4250000
NODE_3441_length_1258_cov_18.747196	308	388	0	21	80	0.2625000
NODE_3441_length_1258_cov_18.747196	308	388	2	59	80	0.7375000
NODE_3441_length_1258_cov_18.747196	361	441	0	74	80	0.9250000
NODE_3441_length_1258_cov_18.747196	361	441	2	6	80	0.0750000
NODE_3441_length_1258_cov_18.747196	437	517	0	80	80	1.0000000
NODE_3441_length_1258_cov_18.747196	490	570	0	80	80	1.0000000
NODE_3442_length_1258_cov_13.699741	332	412	0	29	80	0.3625000
NODE_3442_length_1258_cov_13.699741	332	412	2	40	80	0.5000000
NODE_3442_length_1258_cov_13.699741	332	412	3	2	80	0.0250000
NODE_3442_length_1258_cov_13.699741	332	412	6	9	80	0.1125000
NODE_3442_length_1258_cov_13.699741	385	465	2	16	80	0.2000000
NODE_3442_length_1258_cov_13.699741	385	465	3	2	80	0.0250000
NODE_3442_length_1258_cov_13.699741	385	465	6	43	80	0.5375000
NODE_3442_length_1258_cov_13.699741	385	465	9	1	80	0.0125000
NODE_3442_length_1258_cov_13.699741	385	465	10	18	80	0.2250000
NODE_3447_length_1257_cov_34.029361	567	647	0	18	80	0.2250000
NODE_3447_length_1257_cov_34.029361	567	647	6	44	80	0.5500000
NODE_3447_length_1257_cov_34.029361	567	647	8	6	80	0.0750000
NODE_3447_length_1257_cov_34.029361	567	647	10	12	80	0.1500000
NODE_3447_length_1257_cov_34.029361	620	700	6	35	80	0.4375000
NODE_3447_length_1257_cov_34.029361	620	700	8	6	80	0.0750000
NODE_3447_length_1257_cov_34.029361	620	700	10	37	80	0.4625000
NODE_3447_length_1257_cov_34.029361	620	700	12	2	80	0.0250000
NODE_3447_length_1257_cov_34.029361	696	776	6	80	80	1.0000000
NODE_3447_length_1257_cov_34.029361	749	829	0	21	80	0.2625000
NODE_3447_length_1257_cov_34.029361	749	829	2	23	80	0.2875000
NODE_3447_length_1257_cov_34.029361	749	829	3	1	80	0.0125000
NODE_3447_length_1257_cov_34.029361	749	829	4	5	80	0.0625000
NODE_3447_length_1257_cov_34.029361	749	829	6	30	80	0.3750000
NODE_3449_length_1257_cov_7.892919	317	397	0	80	80	1.0000000
NODE_3449_length_1257_cov_7.892919	370	450	0	80	80	1.0000000
NODE_3452_length_1256_cov_50.506482	389	469	0	76	80	0.9500000
NODE_3452_length_1256_cov_50.506482	389	469	2	4	80	0.0500000
NODE_3452_length_1256_cov_50.506482	442	522	0	23	80	0.2875000
NODE_3452_length_1256_cov_50.506482	442	522	2	17	80	0.2125000
NODE_3452_length_1256_cov_50.506482	442	522	4	6	80	0.0750000
NODE_3452_length_1256_cov_50.506482	442	522	6	34	80	0.4250000
NODE_3452_length_1256_cov_50.506482	518	598	6	45	80	0.5625000
NODE_3452_length_1256_cov_50.506482	518	598	8	35	80	0.4375000
NODE_3452_length_1256_cov_50.506482	571	651	2	13	80	0.1625000
NODE_3452_length_1256_cov_50.506482	571	651	4	6	80	0.0750000
NODE_3452_length_1256_cov_50.506482	571	651	6	41	80	0.5125000
NODE_3452_length_1256_cov_50.506482	571	651	7	1	80	0.0125000
NODE_3452_length_1256_cov_50.506482	571	651	8	19	80	0.2375000
NODE_3453_length_1256_cov_25.944685	754	834	0	80	80	1.0000000
NODE_3453_length_1256_cov_25.944685	807	887	0	80	80	1.0000000
NODE_3455_length_1256_cov_21.720830	713	793	0	19	80	0.2375000
NODE_3455_length_1256_cov_21.720830	713	793	2	23	80	0.2875000
NODE_3455_length_1256_cov_21.720830	713	793	6	38	80	0.4750000
NODE_3455_length_1256_cov_21.720830	766	846	2	16	80	0.2000000
NODE_3455_length_1256_cov_21.720830	766	846	6	64	80	0.8000000
NODE_3456_length_1256_cov_14.242005	595	675	0	80	80	1.0000000
NODE_3456_length_1256_cov_14.242005	648	728	0	77	80	0.9625000
NODE_3456_length_1256_cov_14.242005	648	728	2	3	80	0.0375000
NODE_3457_length_1256_cov_5.870354	879	959	0	80	80	1.0000000
NODE_3463_length_1255_cov_37.271626	458	538	2	43	80	0.5375000
NODE_3463_length_1255_cov_37.271626	458	538	6	35	80	0.4375000
NODE_3463_length_1255_cov_37.271626	458	538	7	1	80	0.0125000
NODE_3463_length_1255_cov_37.271626	458	538	8	1	80	0.0125000
NODE_3463_length_1255_cov_37.271626	511	591	2	4	80	0.0500000
NODE_3463_length_1255_cov_37.271626	511	591	6	76	80	0.9500000
NODE_3463_length_1255_cov_37.271626	587	667	0	70	80	0.8750000
NODE_3463_length_1255_cov_37.271626	587	667	2	10	80	0.1250000
NODE_3463_length_1255_cov_37.271626	640	720	0	80	80	1.0000000
NODE_3464_length_1255_cov_21.374567	516	596	0	80	80	1.0000000
NODE_3464_length_1255_cov_21.374567	569	649	0	80	80	1.0000000
NODE_3464_length_1255_cov_21.374567	645	725	0	80	80	1.0000000
NODE_3464_length_1255_cov_21.374567	698	778	0	80	80	1.0000000
NODE_3465_length_1255_cov_18.391869	521	601	0	80	80	1.0000000
NODE_3465_length_1255_cov_18.391869	574	654	0	80	80	1.0000000
NODE_3466_length_1255_cov_4.096021	1194	1242	0	48	48	1.0000000
NODE_3469_length_1254_cov_32.470996	612	692	0	80	80	1.0000000
NODE_3469_length_1254_cov_32.470996	665	745	0	80	80	1.0000000
NODE_3470_length_1254_cov_26.449351	488	568	0	28	80	0.3500000
NODE_3470_length_1254_cov_26.449351	488	568	4	52	80	0.6500000
NODE_3470_length_1254_cov_26.449351	541	621	0	18	80	0.2250000
NODE_3470_length_1254_cov_26.449351	541	621	4	62	80	0.7750000
NODE_3471_length_1254_cov_22.032035	531	611	0	30	80	0.3750000
NODE_3471_length_1254_cov_22.032035	531	611	4	50	80	0.6250000
NODE_3471_length_1254_cov_22.032035	584	664	0	33	80	0.4125000
NODE_3471_length_1254_cov_22.032035	584	664	4	47	80	0.5875000
NODE_3479_length_1253_cov_16.916811	651	731	0	80	80	1.0000000
NODE_3479_length_1253_cov_16.916811	704	784	0	28	80	0.3500000
NODE_3479_length_1253_cov_16.916811	704	784	2	19	80	0.2375000
NODE_3479_length_1253_cov_16.916811	704	784	6	18	80	0.2250000
NODE_3479_length_1253_cov_16.916811	704	784	8	15	80	0.1875000
NODE_3479_length_1253_cov_16.916811	780	860	2	9	80	0.1125000
NODE_3479_length_1253_cov_16.916811	780	860	6	71	80	0.8875000
NODE_3479_length_1253_cov_16.916811	833	913	0	23	80	0.2875000
NODE_3479_length_1253_cov_16.916811	833	913	2	39	80	0.4875000
NODE_3479_length_1253_cov_16.916811	833	913	6	18	80	0.2250000
NODE_3480_length_1253_cov_13.816291	811	891	0	25	80	0.3125000
NODE_3480_length_1253_cov_13.816291	811	891	2	55	80	0.6875000
NODE_3481_length_1253_cov_9.067591	306	386	0	80	80	1.0000000
NODE_3481_length_1253_cov_9.067591	359	439	0	80	80	1.0000000
NODE_3487_length_1252_cov_57.745880	477	557	0	80	80	1.0000000
NODE_3487_length_1252_cov_57.745880	530	610	0	80	80	1.0000000
NODE_3487_length_1252_cov_57.745880	606	686	0	34	80	0.4250000
NODE_3487_length_1252_cov_57.745880	606	686	4	39	80	0.4875000
NODE_3487_length_1252_cov_57.745880	606	686	6	7	80	0.0875000
NODE_3487_length_1252_cov_57.745880	659	739	4	20	80	0.2500000
NODE_3487_length_1252_cov_57.745880	659	739	6	60	80	0.7500000
NODE_3488_length_1252_cov_56.694709	594	674	5	9	80	0.1125000
NODE_3488_length_1252_cov_56.694709	594	674	6	71	80	0.8875000
NODE_3488_length_1252_cov_56.694709	647	727	1	28	80	0.3500000
NODE_3488_length_1252_cov_56.694709	647	727	5	13	80	0.1625000
NODE_3488_length_1252_cov_56.694709	647	727	6	39	80	0.4875000
NODE_3488_length_1252_cov_56.694709	723	803	1	13	80	0.1625000
NODE_3488_length_1252_cov_56.694709	723	803	10	50	80	0.6250000
NODE_3488_length_1252_cov_56.694709	723	803	11	17	80	0.2125000
NODE_3488_length_1252_cov_56.694709	785	847	0	5	62	0.0806452
NODE_3488_length_1252_cov_56.694709	785	847	8	1	62	0.0161290
NODE_3488_length_1252_cov_56.694709	785	847	9	28	62	0.4516129
NODE_3488_length_1252_cov_56.694709	785	847	10	28	62	0.4516129
NODE_3489_length_1252_cov_34.023417	468	548	2	74	80	0.9250000
NODE_3489_length_1252_cov_34.023417	468	548	4	6	80	0.0750000
NODE_3489_length_1252_cov_34.023417	521	601	2	30	80	0.3750000
NODE_3489_length_1252_cov_34.023417	521	601	4	38	80	0.4750000
NODE_3489_length_1252_cov_34.023417	521	601	6	8	80	0.1000000
NODE_3489_length_1252_cov_34.023417	521	601	7	4	80	0.0500000
NODE_3489_length_1252_cov_34.023417	597	677	5	14	80	0.1750000
NODE_3489_length_1252_cov_34.023417	597	677	7	10	80	0.1250000
NODE_3489_length_1252_cov_34.023417	597	677	8	3	80	0.0375000
NODE_3489_length_1252_cov_34.023417	597	677	9	1	80	0.0125000
NODE_3489_length_1252_cov_34.023417	597	677	10	33	80	0.4125000
NODE_3489_length_1252_cov_34.023417	597	677	12	19	80	0.2375000
NODE_3489_length_1252_cov_34.023417	650	730	10	8	80	0.1000000
NODE_3489_length_1252_cov_34.023417	650	730	12	30	80	0.3750000
NODE_3489_length_1252_cov_34.023417	650	730	14	42	80	0.5250000
NODE_3490_length_1252_cov_9.316565	573	653	2	10	80	0.1250000
NODE_3490_length_1252_cov_9.316565	573	653	6	8	80	0.1000000
NODE_3490_length_1252_cov_9.316565	573	653	10	53	80	0.6625000
NODE_3490_length_1252_cov_9.316565	573	653	12	9	80	0.1125000
NODE_3490_length_1252_cov_9.316565	626	706	10	27	80	0.3375000
NODE_3490_length_1252_cov_9.316565	626	706	12	15	80	0.1875000
NODE_3490_length_1252_cov_9.316565	626	706	14	38	80	0.4750000
NODE_3491_length_1252_cov_8.295750	602	682	0	80	80	1.0000000
NODE_3491_length_1252_cov_8.295750	655	735	0	74	80	0.9250000
NODE_3491_length_1252_cov_8.295750	655	735	2	6	80	0.0750000
NODE_3494_length_1251_cov_17.513889	579	659	0	80	80	1.0000000
NODE_3494_length_1251_cov_17.513889	632	712	0	80	80	1.0000000
NODE_3494_length_1251_cov_17.513889	708	788	0	40	80	0.5000000
NODE_3494_length_1251_cov_17.513889	708	788	2	25	80	0.3125000
NODE_3494_length_1251_cov_17.513889	708	788	4	15	80	0.1875000
NODE_3494_length_1251_cov_17.513889	761	841	2	40	80	0.5000000
NODE_3494_length_1251_cov_17.513889	761	841	4	40	80	0.5000000
NODE_3497_length_1251_cov_3.139757	0	76	0	76	76	1.0000000
NODE_3497_length_1251_cov_3.139757	49	98	0	45	49	0.9183673
NODE_3497_length_1251_cov_3.139757	49	98	2	1	49	0.0204082
NODE_3497_length_1251_cov_3.139757	49	98	4	1	49	0.0204082
NODE_3497_length_1251_cov_3.139757	49	98	12	2	49	0.0408163
NODE_3501_length_1250_cov_25.133797	325	405	0	80	80	1.0000000
NODE_3501_length_1250_cov_25.133797	378	458	0	80	80	1.0000000
NODE_3503_length_1250_cov_11.471764	652	733	0	81	81	1.0000000
NODE_3503_length_1250_cov_11.471764	706	786	0	80	80	1.0000000
NODE_3505_length_1249_cov_45.772174	543	623	0	14	80	0.1750000
NODE_3505_length_1249_cov_45.772174	543	623	2	66	80	0.8250000
NODE_3505_length_1249_cov_45.772174	596	676	0	25	80	0.3125000
NODE_3505_length_1249_cov_45.772174	596	676	2	55	80	0.6875000
NODE_3505_length_1249_cov_45.772174	672	749	0	46	77	0.5974026
NODE_3505_length_1249_cov_45.772174	672	749	2	31	77	0.4025974
NODE_3505_length_1249_cov_45.772174	729	802	0	16	73	0.2191781
NODE_3505_length_1249_cov_45.772174	729	802	2	57	73	0.7808219
NODE_3506_length_1249_cov_35.670435	515	595	1	12	80	0.1500000
NODE_3506_length_1249_cov_35.670435	515	595	2	68	80	0.8500000
NODE_3506_length_1249_cov_35.670435	568	648	0	35	80	0.4375000
NODE_3506_length_1249_cov_35.670435	568	648	1	30	80	0.3750000
NODE_3506_length_1249_cov_35.670435	568	648	2	15	80	0.1875000
NODE_3506_length_1249_cov_35.670435	644	724	0	40	80	0.5000000
NODE_3506_length_1249_cov_35.670435	644	724	2	40	80	0.5000000
NODE_3506_length_1249_cov_35.670435	697	777	2	80	80	1.0000000
NODE_3507_length_1249_cov_34.616522	576	656	0	80	80	1.0000000
NODE_3507_length_1249_cov_34.616522	629	709	0	80	80	1.0000000
NODE_3507_length_1249_cov_34.616522	705	785	0	80	80	1.0000000
NODE_3507_length_1249_cov_34.616522	758	838	0	80	80	1.0000000
NODE_3508_length_1249_cov_19.592174	461	541	0	80	80	1.0000000
NODE_3508_length_1249_cov_19.592174	514	594	0	80	80	1.0000000
NODE_3508_length_1249_cov_19.592174	860	940	0	71	80	0.8875000
NODE_3508_length_1249_cov_19.592174	860	940	2	9	80	0.1125000
NODE_3508_length_1249_cov_19.592174	913	993	0	18	80	0.2250000
NODE_3508_length_1249_cov_19.592174	913	993	2	62	80	0.7750000
NODE_3509_length_1249_cov_14.926957	1153	1219	2	26	66	0.3939394
NODE_3509_length_1249_cov_14.926957	1153	1219	4	40	66	0.6060606
NODE_3509_length_1249_cov_14.926957	1192	1249	0	16	57	0.2807018
NODE_3509_length_1249_cov_14.926957	1192	1249	2	40	57	0.7017544
NODE_3509_length_1249_cov_14.926957	1192	1249	4	1	57	0.0175439
NODE_3509_length_1249_cov_14.926957	1192	1247	0	14	55	0.2545455
NODE_3509_length_1249_cov_14.926957	1192	1247	2	40	55	0.7272727
NODE_3509_length_1249_cov_14.926957	1192	1247	4	1	55	0.0181818
NODE_3509_length_1249_cov_14.926957	1192	1249	0	16	57	0.2807018
NODE_3509_length_1249_cov_14.926957	1192	1249	2	40	57	0.7017544
NODE_3509_length_1249_cov_14.926957	1192	1249	4	1	57	0.0175439
NODE_3510_length_1249_cov_7.682609	757	837	0	80	80	1.0000000
NODE_3510_length_1249_cov_7.682609	810	890	0	80	80	1.0000000
NODE_3514_length_1248_cov_14.351610	469	549	2	80	80	1.0000000
NODE_3514_length_1248_cov_14.351610	522	602	0	50	80	0.6250000
NODE_3514_length_1248_cov_14.351610	522	602	2	30	80	0.3750000
NODE_3514_length_1248_cov_14.351610	598	678	0	80	80	1.0000000
NODE_3514_length_1248_cov_14.351610	651	731	0	80	80	1.0000000
NODE_3515_length_1248_cov_11.181027	303	383	0	80	80	1.0000000
NODE_3515_length_1248_cov_11.181027	356	436	0	80	80	1.0000000
NODE_3515_length_1248_cov_11.181027	432	512	0	80	80	1.0000000
NODE_3515_length_1248_cov_11.181027	485	565	0	80	80	1.0000000
NODE_3516_length_1248_cov_4.372498	17	98	0	9	81	0.1111111
NODE_3516_length_1248_cov_4.372498	17	98	4	72	81	0.8888889
NODE_3516_length_1248_cov_4.372498	94	152	0	35	58	0.6034483
NODE_3516_length_1248_cov_4.372498	94	152	2	2	58	0.0344828
NODE_3516_length_1248_cov_4.372498	94	152	4	21	58	0.3620690
NODE_3517_length_1248_cov_2.356832	952	1032	0	80	80	1.0000000
NODE_3517_length_1248_cov_2.356832	1005	1085	0	80	80	1.0000000
NODE_3518_length_1248_cov_2.283725	1102	1151	2	49	49	1.0000000
NODE_3522_length_1247_cov_25.355401	487	567	0	27	80	0.3375000
NODE_3522_length_1247_cov_25.355401	487	567	2	53	80	0.6625000
NODE_3522_length_1247_cov_25.355401	540	620	0	80	80	1.0000000
NODE_3522_length_1247_cov_25.355401	616	696	0	80	80	1.0000000
NODE_3522_length_1247_cov_25.355401	669	749	0	80	80	1.0000000
NODE_3528_length_1246_cov_30.231909	433	513	2	80	80	1.0000000
NODE_3528_length_1246_cov_30.231909	486	566	0	20	80	0.2500000
NODE_3528_length_1246_cov_30.231909	486	566	2	60	80	0.7500000
NODE_3528_length_1246_cov_30.231909	562	642	0	11	80	0.1375000
NODE_3528_length_1246_cov_30.231909	562	642	4	2	80	0.0250000
NODE_3528_length_1246_cov_30.231909	562	642	6	12	80	0.1500000
NODE_3528_length_1246_cov_30.231909	562	642	8	55	80	0.6875000
NODE_3528_length_1246_cov_30.231909	615	695	2	37	80	0.4625000
NODE_3528_length_1246_cov_30.231909	615	695	6	18	80	0.2250000
NODE_3528_length_1246_cov_30.231909	615	695	8	25	80	0.3125000
NODE_3529_length_1246_cov_13.847428	497	577	0	80	80	1.0000000
NODE_3529_length_1246_cov_13.847428	550	630	0	80	80	1.0000000
NODE_3535_length_1245_cov_31.472949	443	523	2	80	80	1.0000000
NODE_3535_length_1245_cov_31.472949	496	576	0	34	80	0.4250000
NODE_3535_length_1245_cov_31.472949	496	576	1	8	80	0.1000000
NODE_3535_length_1245_cov_31.472949	496	576	2	38	80	0.4750000
NODE_3536_length_1245_cov_30.068935	771	841	0	9	70	0.1285714
NODE_3536_length_1245_cov_30.068935	771	841	2	61	70	0.8714285
NODE_3537_length_1245_cov_24.765271	668	748	0	44	80	0.5500000
NODE_3537_length_1245_cov_24.765271	668	748	4	28	80	0.3500000
NODE_3537_length_1245_cov_24.765271	668	748	5	8	80	0.1000000
NODE_3537_length_1245_cov_24.765271	721	801	1	8	80	0.1000000
NODE_3537_length_1245_cov_24.765271	721	801	2	4	80	0.0500000
NODE_3537_length_1245_cov_24.765271	721	801	4	19	80	0.2375000
NODE_3537_length_1245_cov_24.765271	721	801	5	49	80	0.6125000
NODE_3537_length_1245_cov_24.765271	797	877	2	80	80	1.0000000
NODE_3537_length_1245_cov_24.765271	850	930	2	31	80	0.3875000
NODE_3537_length_1245_cov_24.765271	850	930	3	40	80	0.5000000
NODE_3537_length_1245_cov_24.765271	850	930	4	9	80	0.1125000
NODE_3538_length_1245_cov_16.854276	655	735	0	80	80	1.0000000
NODE_3538_length_1245_cov_16.854276	701	771	0	70	70	1.0000000
NODE_3538_length_1245_cov_16.854276	708	788	0	80	80	1.0000000
NODE_3540_length_1245_cov_1.187609	1148	1194	0	45	46	0.9782609
NODE_3540_length_1245_cov_1.187609	1148	1194	2	1	46	0.0217391
NODE_3540_length_1245_cov_1.187609	1167	1245	0	78	78	1.0000000
NODE_3541_length_1244_cov_52.633188	501	581	0	9	80	0.1125000
NODE_3541_length_1244_cov_52.633188	501	581	1	71	80	0.8875000
NODE_3541_length_1244_cov_52.633188	554	634	0	44	80	0.5500000
NODE_3541_length_1244_cov_52.633188	554	634	1	36	80	0.4500000
NODE_3541_length_1244_cov_52.633188	630	710	1	67	80	0.8375000
NODE_3541_length_1244_cov_52.633188	630	710	3	13	80	0.1625000
NODE_3541_length_1244_cov_52.633188	683	763	1	14	80	0.1750000
NODE_3541_length_1244_cov_52.633188	683	763	3	66	80	0.8250000
NODE_3542_length_1244_cov_33.889956	445	525	2	80	80	1.0000000
NODE_3542_length_1244_cov_33.889956	498	578	0	34	80	0.4250000
NODE_3542_length_1244_cov_33.889956	498	578	2	46	80	0.5750000
NODE_3542_length_1244_cov_33.889956	574	654	0	59	80	0.7375000
NODE_3542_length_1244_cov_33.889956	574	654	2	21	80	0.2625000
NODE_3542_length_1244_cov_33.889956	627	707	0	6	80	0.0750000
NODE_3542_length_1244_cov_33.889956	627	707	2	74	80	0.9250000
NODE_3543_length_1244_cov_16.798253	644	724	0	80	80	1.0000000
NODE_3543_length_1244_cov_16.798253	697	777	0	35	80	0.4375000
NODE_3543_length_1244_cov_16.798253	697	777	2	1	80	0.0125000
NODE_3543_length_1244_cov_16.798253	697	777	3	18	80	0.2250000
NODE_3543_length_1244_cov_16.798253	697	777	4	26	80	0.3250000
NODE_3544_length_1244_cov_1.735371	276	347	0	71	71	1.0000000
NODE_3544_length_1244_cov_1.735371	276	347	0	71	71	1.0000000
NODE_3544_length_1244_cov_1.735371	320	400	0	80	80	1.0000000
NODE_3544_length_1244_cov_1.735371	320	400	0	80	80	1.0000000
NODE_3548_length_1243_cov_34.284965	774	854	3	27	80	0.3375000
NODE_3548_length_1243_cov_34.284965	774	854	4	52	80	0.6500000
NODE_3548_length_1243_cov_34.284965	774	854	5	1	80	0.0125000
NODE_3548_length_1243_cov_34.284965	827	907	2	40	80	0.5000000
NODE_3548_length_1243_cov_34.284965	827	907	3	31	80	0.3875000
NODE_3548_length_1243_cov_34.284965	827	907	4	9	80	0.1125000
NODE_3552_length_1242_cov_29.665792	539	619	4	3	80	0.0375000
NODE_3552_length_1242_cov_29.665792	539	619	7	39	80	0.4875000
NODE_3552_length_1242_cov_29.665792	539	619	8	38	80	0.4750000
NODE_3552_length_1242_cov_29.665792	592	672	0	47	80	0.5875000
NODE_3552_length_1242_cov_29.665792	592	672	3	1	80	0.0125000
NODE_3552_length_1242_cov_29.665792	592	672	4	8	80	0.1000000
NODE_3552_length_1242_cov_29.665792	592	672	7	11	80	0.1375000
NODE_3552_length_1242_cov_29.665792	592	672	8	13	80	0.1625000
NODE_3553_length_1242_cov_28.304462	506	586	1	80	80	1.0000000
NODE_3553_length_1242_cov_28.304462	559	639	0	24	80	0.3000000
NODE_3553_length_1242_cov_28.304462	559	639	1	56	80	0.7000000
NODE_3553_length_1242_cov_28.304462	635	715	0	80	80	1.0000000
NODE_3553_length_1242_cov_28.304462	688	768	0	54	80	0.6750000
NODE_3553_length_1242_cov_28.304462	688	768	1	26	80	0.3250000
NODE_3554_length_1242_cov_16.383202	704	784	0	21	80	0.2625000
NODE_3554_length_1242_cov_16.383202	704	784	2	25	80	0.3125000
NODE_3554_length_1242_cov_16.383202	704	784	3	4	80	0.0500000
NODE_3554_length_1242_cov_16.383202	704	784	4	30	80	0.3750000
NODE_3554_length_1242_cov_16.383202	757	837	0	15	80	0.1875000
NODE_3554_length_1242_cov_16.383202	757	837	2	65	80	0.8125000
NODE_3555_length_1242_cov_8.081365	688	768	0	80	80	1.0000000
NODE_3555_length_1242_cov_8.081365	741	821	0	80	80	1.0000000
NODE_3561_length_1241_cov_36.544658	602	682	0	80	80	1.0000000
NODE_3561_length_1241_cov_36.544658	655	735	0	29	80	0.3625000
NODE_3561_length_1241_cov_36.544658	655	735	2	51	80	0.6375000
NODE_3562_length_1241_cov_19.894921	676	756	0	2	80	0.0250000
NODE_3562_length_1241_cov_19.894921	676	756	2	20	80	0.2500000
NODE_3562_length_1241_cov_19.894921	676	756	4	58	80	0.7250000
NODE_3562_length_1241_cov_19.894921	729	809	0	37	80	0.4625000
NODE_3562_length_1241_cov_19.894921	729	809	2	16	80	0.2000000
NODE_3562_length_1241_cov_19.894921	729	809	4	27	80	0.3375000
NODE_3569_length_1240_cov_38.375110	483	563	0	11	80	0.1375000
NODE_3569_length_1240_cov_38.375110	483	563	1	5	80	0.0625000
NODE_3569_length_1240_cov_38.375110	483	563	2	10	80	0.1250000
NODE_3569_length_1240_cov_38.375110	483	563	3	54	80	0.6750000
NODE_3569_length_1240_cov_38.375110	536	616	1	5	80	0.0625000
NODE_3569_length_1240_cov_38.375110	536	616	2	53	80	0.6625000
NODE_3569_length_1240_cov_38.375110	536	616	3	22	80	0.2750000
NODE_3569_length_1240_cov_38.375110	612	692	1	7	80	0.0875000
NODE_3569_length_1240_cov_38.375110	612	692	2	42	80	0.5250000
NODE_3569_length_1240_cov_38.375110	612	692	7	31	80	0.3875000
NODE_3569_length_1240_cov_38.375110	665	745	5	24	80	0.3000000
NODE_3569_length_1240_cov_38.375110	665	745	6	8	80	0.1000000
NODE_3569_length_1240_cov_38.375110	665	745	7	48	80	0.6000000
NODE_3570_length_1240_cov_24.975460	625	705	0	80	80	1.0000000
NODE_3570_length_1240_cov_24.975460	678	758	0	80	80	1.0000000
NODE_3571_length_1240_cov_23.812445	731	811	5	80	80	1.0000000
NODE_3571_length_1240_cov_23.812445	784	864	0	25	80	0.3125000
NODE_3571_length_1240_cov_23.812445	784	864	2	1	80	0.0125000
NODE_3571_length_1240_cov_23.812445	784	864	3	27	80	0.3375000
NODE_3571_length_1240_cov_23.812445	784	864	5	27	80	0.3375000
NODE_3576_length_1239_cov_37.657895	399	479	0	24	80	0.3000000
NODE_3576_length_1239_cov_37.657895	399	479	4	23	80	0.2875000
NODE_3576_length_1239_cov_37.657895	399	479	6	33	80	0.4125000
NODE_3576_length_1239_cov_37.657895	452	532	4	17	80	0.2125000
NODE_3576_length_1239_cov_37.657895	452	532	6	63	80	0.7875000
NODE_3576_length_1239_cov_37.657895	528	608	0	38	80	0.4750000
NODE_3576_length_1239_cov_37.657895	528	608	4	42	80	0.5250000
NODE_3576_length_1239_cov_37.657895	581	661	0	80	80	1.0000000
NODE_3577_length_1239_cov_14.984211	398	478	0	61	80	0.7625000
NODE_3577_length_1239_cov_14.984211	398	478	4	19	80	0.2375000
NODE_3577_length_1239_cov_14.984211	451	531	0	80	80	1.0000000
NODE_3577_length_1239_cov_14.984211	771	825	0	31	54	0.5740741
NODE_3577_length_1239_cov_14.984211	771	825	2	23	54	0.4259259
NODE_3577_length_1239_cov_14.984211	798	878	0	4	80	0.0500000
NODE_3577_length_1239_cov_14.984211	798	878	2	76	80	0.9500000
NODE_3578_length_1239_cov_13.312281	806	886	0	80	80	1.0000000
NODE_3578_length_1239_cov_13.312281	859	939	0	80	80	1.0000000
NODE_3579_length_1239_cov_7.116667	444	524	0	80	80	1.0000000
NODE_3579_length_1239_cov_7.116667	497	577	0	80	80	1.0000000
NODE_3582_length_1238_cov_33.830553	625	705	0	80	80	1.0000000
NODE_3582_length_1238_cov_33.830553	678	758	0	80	80	1.0000000
NODE_3583_length_1238_cov_8.163301	664	744	4	4	80	0.0500000
NODE_3583_length_1238_cov_8.163301	664	744	6	76	80	0.9500000
NODE_3583_length_1238_cov_8.163301	717	797	2	32	80	0.4000000
NODE_3583_length_1238_cov_8.163301	717	797	4	25	80	0.3125000
NODE_3583_length_1238_cov_8.163301	717	797	6	23	80	0.2875000
NODE_3586_length_1237_cov_24.562390	447	527	0	3	80	0.0375000
NODE_3586_length_1237_cov_24.562390	447	527	6	5	80	0.0625000
NODE_3586_length_1237_cov_24.562390	447	527	10	72	80	0.9000000
NODE_3586_length_1237_cov_24.562390	500	580	0	56	80	0.7000000
NODE_3586_length_1237_cov_24.562390	500	580	6	5	80	0.0625000
NODE_3586_length_1237_cov_24.562390	500	580	10	19	80	0.2375000
NODE_3587_length_1237_cov_9.297012	515	595	0	80	80	1.0000000
NODE_3587_length_1237_cov_9.297012	568	648	0	80	80	1.0000000
NODE_3594_length_1236_cov_46.661390	632	712	26	14	80	0.1750000
NODE_3594_length_1236_cov_46.661390	632	712	32	2	80	0.0250000
NODE_3594_length_1236_cov_46.661390	632	712	34	22	80	0.2750000
NODE_3594_length_1236_cov_46.661390	632	712	36	29	80	0.3625000
NODE_3594_length_1236_cov_46.661390	632	712	38	13	80	0.1625000
NODE_3594_length_1236_cov_46.661390	685	765	0	6	80	0.0750000
NODE_3594_length_1236_cov_46.661390	685	765	7	1	80	0.0125000
NODE_3594_length_1236_cov_46.661390	685	765	8	14	80	0.1750000
NODE_3594_length_1236_cov_46.661390	685	765	19	10	80	0.1250000
NODE_3594_length_1236_cov_46.661390	685	765	21	7	80	0.0875000
NODE_3594_length_1236_cov_46.661390	685	765	23	1	80	0.0125000
NODE_3594_length_1236_cov_46.661390	685	765	24	2	80	0.0250000
NODE_3594_length_1236_cov_46.661390	685	765	26	12	80	0.1500000
NODE_3594_length_1236_cov_46.661390	685	765	36	14	80	0.1750000
NODE_3594_length_1236_cov_46.661390	685	765	38	13	80	0.1625000
NODE_3595_length_1236_cov_8.625330	735	815	0	80	80	1.0000000
NODE_3595_length_1236_cov_8.625330	788	868	0	80	80	1.0000000
NODE_3597_length_1235_cov_31.619718	331	411	0	80	80	1.0000000
NODE_3597_length_1235_cov_31.619718	384	464	0	80	80	1.0000000
NODE_3598_length_1235_cov_20.252641	559	639	0	80	80	1.0000000
NODE_3598_length_1235_cov_20.252641	612	692	0	80	80	1.0000000
NODE_3598_length_1235_cov_20.252641	688	768	0	80	80	1.0000000
NODE_3598_length_1235_cov_20.252641	741	821	0	80	80	1.0000000
NODE_3599_length_1235_cov_18.462148	695	775	0	9	80	0.1125000
NODE_3599_length_1235_cov_18.462148	695	775	2	71	80	0.8875000
NODE_3599_length_1235_cov_18.462148	748	828	2	66	80	0.8250000
NODE_3599_length_1235_cov_18.462148	748	828	4	14	80	0.1750000
NODE_3600_length_1235_cov_8.696303	765	845	2	44	80	0.5500000
NODE_3600_length_1235_cov_8.696303	765	845	6	32	80	0.4000000
NODE_3600_length_1235_cov_8.696303	765	845	8	4	80	0.0500000
NODE_3600_length_1235_cov_8.696303	818	898	0	17	80	0.2125000
NODE_3600_length_1235_cov_8.696303	818	898	2	63	80	0.7875000
NODE_3601_length_1235_cov_5.580106	544	624	0	7	80	0.0875000
NODE_3601_length_1235_cov_5.580106	544	624	2	1	80	0.0125000
NODE_3601_length_1235_cov_5.580106	544	624	4	72	80	0.9000000
NODE_3601_length_1235_cov_5.580106	597	677	0	4	80	0.0500000
NODE_3601_length_1235_cov_5.580106	597	677	2	43	80	0.5375000
NODE_3601_length_1235_cov_5.580106	597	677	4	33	80	0.4125000
NODE_3608_length_1234_cov_27.136564	528	608	0	32	80	0.4000000
NODE_3608_length_1234_cov_27.136564	528	608	2	48	80	0.6000000
NODE_3608_length_1234_cov_27.136564	581	661	0	80	80	1.0000000
NODE_3611_length_1233_cov_64.374780	497	577	0	80	80	1.0000000
NODE_3611_length_1233_cov_64.374780	550	630	0	80	80	1.0000000
NODE_3611_length_1233_cov_64.374780	626	706	0	80	80	1.0000000
NODE_3611_length_1233_cov_64.374780	679	759	0	80	80	1.0000000
NODE_3612_length_1233_cov_52.833333	654	734	0	44	80	0.5500000
NODE_3612_length_1233_cov_52.833333	654	734	1	13	80	0.1625000
NODE_3612_length_1233_cov_52.833333	654	734	3	23	80	0.2875000
NODE_3612_length_1233_cov_52.833333	707	787	1	4	80	0.0500000
NODE_3612_length_1233_cov_52.833333	707	787	3	25	80	0.3125000
NODE_3612_length_1233_cov_52.833333	707	787	9	48	80	0.6000000
NODE_3612_length_1233_cov_52.833333	707	787	11	3	80	0.0375000
NODE_3613_length_1233_cov_18.096120	522	602	0	77	80	0.9625000
NODE_3613_length_1233_cov_18.096120	522	602	2	1	80	0.0125000
NODE_3613_length_1233_cov_18.096120	522	602	4	2	80	0.0250000
NODE_3613_length_1233_cov_18.096120	575	655	0	80	80	1.0000000
NODE_3613_length_1233_cov_18.096120	651	731	0	80	80	1.0000000
NODE_3613_length_1233_cov_18.096120	704	784	0	80	80	1.0000000
NODE_3614_length_1233_cov_15.360670	585	656	0	71	71	1.0000000
NODE_3614_length_1233_cov_15.360670	631	709	0	78	78	1.0000000
NODE_3620_length_1232_cov_62.112974	552	632	0	13	80	0.1625000
NODE_3620_length_1232_cov_62.112974	552	632	2	11	80	0.1375000
NODE_3620_length_1232_cov_62.112974	552	632	4	2	80	0.0250000
NODE_3620_length_1232_cov_62.112974	552	632	6	54	80	0.6750000
NODE_3620_length_1232_cov_62.112974	605	694	0	7	89	0.0786517
NODE_3620_length_1232_cov_62.112974	605	694	4	57	89	0.6404495
NODE_3620_length_1232_cov_62.112974	605	694	6	25	89	0.2808989
NODE_3620_length_1232_cov_62.112974	690	770	0	67	80	0.8375000
NODE_3620_length_1232_cov_62.112974	690	770	2	13	80	0.1625000
NODE_3620_length_1232_cov_62.112974	743	823	0	14	80	0.1750000
NODE_3620_length_1232_cov_62.112974	743	823	2	66	80	0.8250000
NODE_3621_length_1232_cov_34.635481	469	549	0	24	80	0.3000000
NODE_3621_length_1232_cov_34.635481	469	549	2	47	80	0.5875000
NODE_3621_length_1232_cov_34.635481	469	549	4	9	80	0.1125000
NODE_3621_length_1232_cov_34.635481	522	602	2	59	80	0.7375000
NODE_3621_length_1232_cov_34.635481	522	602	4	21	80	0.2625000
NODE_3622_length_1232_cov_16.362754	774	854	0	80	80	1.0000000
NODE_3622_length_1232_cov_16.362754	827	907	0	80	80	1.0000000
NODE_3623_length_1232_cov_13.395410	234	315	0	81	81	1.0000000
NODE_3623_length_1232_cov_13.395410	287	368	0	81	81	1.0000000
NODE_3623_length_1232_cov_13.395410	364	444	0	80	80	1.0000000
NODE_3623_length_1232_cov_13.395410	417	497	0	80	80	1.0000000
NODE_3625_length_1231_cov_47.606890	509	589	2	48	80	0.6000000
NODE_3625_length_1231_cov_47.606890	509	589	3	1	80	0.0125000
NODE_3625_length_1231_cov_47.606890	509	589	4	31	80	0.3875000
NODE_3625_length_1231_cov_47.606890	562	642	2	74	80	0.9250000
NODE_3625_length_1231_cov_47.606890	562	642	4	6	80	0.0750000
NODE_3625_length_1231_cov_47.606890	638	718	2	80	80	1.0000000
NODE_3625_length_1231_cov_47.606890	691	771	2	63	80	0.7875000
NODE_3625_length_1231_cov_47.606890	691	771	4	17	80	0.2125000
NODE_3626_length_1231_cov_27.498233	698	777	0	43	79	0.5443038
NODE_3626_length_1231_cov_27.498233	698	777	3	34	79	0.4303797
NODE_3626_length_1231_cov_27.498233	698	777	6	2	79	0.0253165
NODE_3626_length_1231_cov_27.498233	750	830	3	25	80	0.3125000
NODE_3626_length_1231_cov_27.498233	750	830	6	53	80	0.6625000
NODE_3626_length_1231_cov_27.498233	750	830	10	2	80	0.0250000
NODE_3627_length_1231_cov_21.245583	673	753	2	80	80	1.0000000
NODE_3627_length_1231_cov_21.245583	726	806	0	34	80	0.4250000
NODE_3627_length_1231_cov_21.245583	726	806	2	46	80	0.5750000
NODE_3627_length_1231_cov_21.245583	802	882	0	80	80	1.0000000
NODE_3627_length_1231_cov_21.245583	860	935	0	75	75	1.0000000
NODE_3628_length_1231_cov_9.895760	515	595	0	12	80	0.1500000
NODE_3628_length_1231_cov_9.895760	515	595	2	68	80	0.8500000
NODE_3628_length_1231_cov_9.895760	568	648	0	34	80	0.4250000
NODE_3628_length_1231_cov_9.895760	568	648	2	46	80	0.5750000
NODE_3630_length_1230_cov_43.705570	412	492	6	9	80	0.1125000
NODE_3630_length_1230_cov_43.705570	412	492	10	5	80	0.0625000
NODE_3630_length_1230_cov_43.705570	412	492	16	66	80	0.8250000
NODE_3630_length_1230_cov_43.705570	465	545	0	34	80	0.4250000
NODE_3630_length_1230_cov_43.705570	465	545	6	28	80	0.3500000
NODE_3630_length_1230_cov_43.705570	465	545	10	4	80	0.0500000
NODE_3630_length_1230_cov_43.705570	465	545	16	14	80	0.1750000
NODE_3631_length_1230_cov_43.663130	501	581	0	49	80	0.6125000
NODE_3631_length_1230_cov_43.663130	501	581	2	8	80	0.1000000
NODE_3631_length_1230_cov_43.663130	501	581	12	23	80	0.2875000
NODE_3631_length_1230_cov_43.663130	554	634	2	4	80	0.0500000
NODE_3631_length_1230_cov_43.663130	554	634	10	10	80	0.1250000
NODE_3631_length_1230_cov_43.663130	554	634	12	66	80	0.8250000
NODE_3632_length_1230_cov_33.173298	315	395	0	80	80	1.0000000
NODE_3632_length_1230_cov_33.173298	368	448	0	80	80	1.0000000
NODE_3633_length_1230_cov_12.939876	201	281	2	14	80	0.1750000
NODE_3633_length_1230_cov_12.939876	201	281	4	1	80	0.0125000
NODE_3633_length_1230_cov_12.939876	201	281	8	36	80	0.4500000
NODE_3633_length_1230_cov_12.939876	201	281	10	29	80	0.3625000
NODE_3633_length_1230_cov_12.939876	218	273	8	34	55	0.6181818
NODE_3633_length_1230_cov_12.939876	218	273	10	21	55	0.3818182
NODE_3633_length_1230_cov_12.939876	254	334	2	20	80	0.2500000
NODE_3633_length_1230_cov_12.939876	254	334	4	8	80	0.1000000
NODE_3633_length_1230_cov_12.939876	254	334	6	15	80	0.1875000
NODE_3633_length_1230_cov_12.939876	254	334	10	37	80	0.4625000
NODE_3633_length_1230_cov_12.939876	330	410	2	50	80	0.6250000
NODE_3633_length_1230_cov_12.939876	330	410	4	30	80	0.3750000
NODE_3633_length_1230_cov_12.939876	383	463	0	8	80	0.1000000
NODE_3633_length_1230_cov_12.939876	383	463	2	72	80	0.9000000
NODE_3634_length_1230_cov_5.155615	248	328	0	80	80	1.0000000
NODE_3634_length_1230_cov_5.155615	301	381	0	80	80	1.0000000
NODE_3640_length_1229_cov_30.214159	341	421	0	17	80	0.2125000
NODE_3640_length_1229_cov_30.214159	341	421	2	32	80	0.4000000
NODE_3640_length_1229_cov_30.214159	341	421	4	8	80	0.1000000
NODE_3640_length_1229_cov_30.214159	341	421	7	1	80	0.0125000
NODE_3640_length_1229_cov_30.214159	341	421	8	22	80	0.2750000
NODE_3640_length_1229_cov_30.214159	394	474	4	24	80	0.3000000
NODE_3640_length_1229_cov_30.214159	394	474	6	19	80	0.2375000
NODE_3640_length_1229_cov_30.214159	394	474	7	1	80	0.0125000
NODE_3640_length_1229_cov_30.214159	394	474	8	36	80	0.4500000
NODE_3641_length_1229_cov_23.165487	376	456	2	69	80	0.8625000
NODE_3641_length_1229_cov_23.165487	376	456	4	11	80	0.1375000
NODE_3641_length_1229_cov_23.165487	429	509	0	34	80	0.4250000
NODE_3641_length_1229_cov_23.165487	429	509	2	46	80	0.5750000
NODE_3641_length_1229_cov_23.165487	505	585	0	80	80	1.0000000
NODE_3641_length_1229_cov_23.165487	558	638	0	80	80	1.0000000
NODE_3642_length_1229_cov_19.376991	484	564	0	80	80	1.0000000
NODE_3642_length_1229_cov_19.376991	537	614	0	77	77	1.0000000
NODE_3643_length_1229_cov_11.799115	670	748	0	78	78	1.0000000
NODE_3643_length_1229_cov_11.799115	728	801	0	73	73	1.0000000
NODE_3644_length_1229_cov_8.140708	970	1050	0	80	80	1.0000000
NODE_3644_length_1229_cov_8.140708	1023	1103	0	80	80	1.0000000
NODE_3646_length_1229_cov_3.654867	765	840	0	19	75	0.2533333
NODE_3646_length_1229_cov_3.654867	765	840	2	56	75	0.7466667
NODE_3646_length_1229_cov_3.654867	813	893	0	20	80	0.2500000
NODE_3646_length_1229_cov_3.654867	813	893	2	60	80	0.7500000
NODE_3652_length_1229_cov_0.949558	1034	1079	0	43	45	0.9555556
NODE_3652_length_1229_cov_0.949558	1034	1079	2	2	45	0.0444444
NODE_3652_length_1229_cov_0.949558	1090	1130	2	1	40	0.0250000
NODE_3652_length_1229_cov_0.949558	1090	1130	4	39	40	0.9750000
NODE_3654_length_1228_cov_22.622675	604	684	0	80	80	1.0000000
NODE_3654_length_1228_cov_22.622675	657	738	0	81	81	1.0000000
NODE_3655_length_1228_cov_17.900797	423	503	0	80	80	1.0000000
NODE_3655_length_1228_cov_17.900797	423	503	0	80	80	1.0000000
NODE_3655_length_1228_cov_17.900797	423	503	0	80	80	1.0000000
NODE_3655_length_1228_cov_17.900797	476	538	0	62	62	1.0000000
NODE_3655_length_1228_cov_17.900797	476	538	0	62	62	1.0000000
NODE_3655_length_1228_cov_17.900797	476	538	0	62	62	1.0000000
NODE_3655_length_1228_cov_17.900797	476	556	0	80	80	1.0000000
NODE_3656_length_1228_cov_14.554473	367	447	0	80	80	1.0000000
NODE_3656_length_1228_cov_14.554473	420	500	0	66	80	0.8250000
NODE_3656_length_1228_cov_14.554473	420	500	2	14	80	0.1750000
NODE_3657_length_1228_cov_10.021258	661	741	2	80	80	1.0000000
NODE_3657_length_1228_cov_10.021258	714	794	0	16	80	0.2000000
NODE_3657_length_1228_cov_10.021258	714	794	2	64	80	0.8000000
NODE_3660_length_1228_cov_3.987600	1139	1219	0	80	80	1.0000000
NODE_3662_length_1227_cov_29.002660	423	503	0	80	80	1.0000000
NODE_3662_length_1227_cov_29.002660	476	556	0	80	80	1.0000000
NODE_3663_length_1227_cov_17.479610	759	839	0	80	80	1.0000000
NODE_3663_length_1227_cov_17.479610	812	892	0	80	80	1.0000000
NODE_3666_length_1227_cov_3.808511	120	186	6	40	66	0.6060606
NODE_3666_length_1227_cov_3.808511	120	186	8	26	66	0.3939394
NODE_3666_length_1227_cov_3.808511	173	239	4	6	66	0.0909091
NODE_3666_length_1227_cov_3.808511	173	239	5	3	66	0.0454545
NODE_3666_length_1227_cov_3.808511	173	239	6	22	66	0.3333333
NODE_3666_length_1227_cov_3.808511	173	239	8	35	66	0.5303030
NODE_3666_length_1227_cov_3.808511	229	299	0	40	70	0.5714286
NODE_3666_length_1227_cov_3.808511	229	299	2	6	70	0.0857143
NODE_3666_length_1227_cov_3.808511	229	299	4	20	70	0.2857143
NODE_3666_length_1227_cov_3.808511	229	299	5	3	70	0.0428571
NODE_3666_length_1227_cov_3.808511	229	299	6	1	70	0.0142857
NODE_3672_length_1226_cov_23.792369	579	659	0	80	80	1.0000000
NODE_3672_length_1226_cov_23.792369	632	712	0	80	80	1.0000000
NODE_3672_length_1226_cov_23.792369	708	788	0	80	80	1.0000000
NODE_3672_length_1226_cov_23.792369	761	839	0	78	78	1.0000000
NODE_3673_length_1226_cov_5.620231	463	543	0	80	80	1.0000000
NODE_3673_length_1226_cov_5.620231	516	596	0	50	80	0.6250000
NODE_3673_length_1226_cov_5.620231	516	596	6	30	80	0.3750000
NODE_3674_length_1226_cov_4.881988	582	662	0	80	80	1.0000000
NODE_3674_length_1226_cov_4.881988	635	715	0	80	80	1.0000000
NODE_3682_length_1225_cov_55.596803	637	717	2	80	80	1.0000000
NODE_3682_length_1225_cov_55.596803	690	770	0	18	80	0.2250000
NODE_3682_length_1225_cov_55.596803	690	770	1	4	80	0.0500000
NODE_3682_length_1225_cov_55.596803	690	770	2	58	80	0.7250000
NODE_3682_length_1225_cov_55.596803	766	846	0	48	80	0.6000000
NODE_3682_length_1225_cov_55.596803	766	846	2	32	80	0.4000000
NODE_3682_length_1225_cov_55.596803	819	899	2	80	80	1.0000000
NODE_3683_length_1225_cov_35.189165	661	742	1	11	81	0.1358025
NODE_3683_length_1225_cov_35.189165	661	742	2	7	81	0.0864198
NODE_3683_length_1225_cov_35.189165	661	742	3	63	81	0.7777778
NODE_3683_length_1225_cov_35.189165	714	795	0	53	81	0.6543210
NODE_3683_length_1225_cov_35.189165	714	795	2	7	81	0.0864198
NODE_3683_length_1225_cov_35.189165	714	795	3	21	81	0.2592593
NODE_3684_length_1225_cov_33.755773	456	535	0	79	79	1.0000000
NODE_3684_length_1225_cov_33.755773	508	588	0	80	80	1.0000000
NODE_3685_length_1225_cov_30.116341	566	646	0	80	80	1.0000000
NODE_3685_length_1225_cov_30.116341	619	699	0	80	80	1.0000000
NODE_3685_length_1225_cov_30.116341	695	775	0	80	80	1.0000000
NODE_3685_length_1225_cov_30.116341	748	828	0	80	80	1.0000000
NODE_3686_length_1225_cov_29.177620	195	275	0	80	80	1.0000000
NODE_3686_length_1225_cov_29.177620	248	328	0	80	80	1.0000000
NODE_3687_length_1225_cov_26.849023	588	668	4	62	80	0.7750000
NODE_3687_length_1225_cov_26.849023	588	668	7	1	80	0.0125000
NODE_3687_length_1225_cov_26.849023	588	668	8	17	80	0.2125000
NODE_3687_length_1225_cov_26.849023	641	721	0	22	80	0.2750000
NODE_3687_length_1225_cov_26.849023	641	721	4	54	80	0.6750000
NODE_3687_length_1225_cov_26.849023	641	721	8	4	80	0.0500000
NODE_3687_length_1225_cov_26.849023	717	797	0	73	80	0.9125000
NODE_3687_length_1225_cov_26.849023	717	797	6	7	80	0.0875000
NODE_3687_length_1225_cov_26.849023	770	850	0	20	80	0.2500000
NODE_3687_length_1225_cov_26.849023	770	850	6	60	80	0.7500000
NODE_3688_length_1225_cov_24.444938	386	466	0	24	80	0.3000000
NODE_3688_length_1225_cov_24.444938	386	466	2	12	80	0.1500000
NODE_3688_length_1225_cov_24.444938	386	466	8	44	80	0.5500000
NODE_3688_length_1225_cov_24.444938	439	519	0	34	80	0.4250000
NODE_3688_length_1225_cov_24.444938	439	519	6	11	80	0.1375000
NODE_3688_length_1225_cov_24.444938	439	519	8	35	80	0.4375000
NODE_3690_length_1225_cov_19.369449	491	571	0	80	80	1.0000000
NODE_3690_length_1225_cov_19.369449	544	624	0	80	80	1.0000000
NODE_3690_length_1225_cov_19.369449	620	700	0	80	80	1.0000000
NODE_3690_length_1225_cov_19.369449	673	753	0	80	80	1.0000000
NODE_3691_length_1225_cov_13.281528	462	542	0	80	80	1.0000000
NODE_3691_length_1225_cov_13.281528	515	595	0	80	80	1.0000000
NODE_3691_length_1225_cov_13.281528	591	671	0	80	80	1.0000000
NODE_3691_length_1225_cov_13.281528	644	724	0	80	80	1.0000000
NODE_3692_length_1225_cov_10.887211	566	646	2	80	80	1.0000000
NODE_3692_length_1225_cov_10.887211	619	699	0	40	80	0.5000000
NODE_3692_length_1225_cov_10.887211	619	699	2	40	80	0.5000000
NODE_3696_length_1224_cov_24.568889	613	693	2	16	80	0.2000000
NODE_3696_length_1224_cov_24.568889	613	693	3	1	80	0.0125000
NODE_3696_length_1224_cov_24.568889	613	693	4	49	80	0.6125000
NODE_3696_length_1224_cov_24.568889	613	693	6	14	80	0.1750000
NODE_3696_length_1224_cov_24.568889	666	746	4	21	80	0.2625000
NODE_3696_length_1224_cov_24.568889	666	746	5	9	80	0.1125000
NODE_3696_length_1224_cov_24.568889	666	746	6	50	80	0.6250000
NODE_3697_length_1224_cov_17.538667	762	842	0	80	80	1.0000000
NODE_3697_length_1224_cov_17.538667	815	895	0	80	80	1.0000000
NODE_3698_length_1224_cov_14.138667	389	469	0	80	80	1.0000000
NODE_3698_length_1224_cov_14.138667	442	522	0	80	80	1.0000000
NODE_3699_length_1224_cov_11.358222	704	784	0	15	80	0.1875000
NODE_3699_length_1224_cov_11.358222	704	784	3	16	80	0.2000000
NODE_3699_length_1224_cov_11.358222	704	784	6	49	80	0.6125000
NODE_3699_length_1224_cov_11.358222	757	837	6	80	80	1.0000000
NODE_3700_length_1224_cov_6.963556	516	581	0	65	65	1.0000000
NODE_3705_length_1223_cov_44.608541	548	630	10	82	82	1.0000000
NODE_3705_length_1223_cov_44.608541	601	683	0	53	82	0.6463414
NODE_3705_length_1223_cov_44.608541	601	683	10	29	82	0.3536585
NODE_3705_length_1223_cov_44.608541	679	759	0	4	80	0.0500000
NODE_3705_length_1223_cov_44.608541	679	759	2	76	80	0.9500000
NODE_3705_length_1223_cov_44.608541	732	812	0	6	80	0.0750000
NODE_3705_length_1223_cov_44.608541	732	812	2	74	80	0.9250000
NODE_3706_length_1223_cov_26.730427	508	588	6	80	80	1.0000000
NODE_3706_length_1223_cov_26.730427	561	641	2	23	80	0.2875000
NODE_3706_length_1223_cov_26.730427	561	641	4	24	80	0.3000000
NODE_3706_length_1223_cov_26.730427	561	641	6	33	80	0.4125000
NODE_3707_length_1223_cov_18.902135	460	540	0	80	80	1.0000000
NODE_3707_length_1223_cov_18.902135	513	593	0	80	80	1.0000000
NODE_3708_length_1223_cov_6.989324	707	778	4	71	71	1.0000000
NODE_3710_length_1223_cov_5.251779	666	746	0	80	80	1.0000000
NODE_3710_length_1223_cov_5.251779	719	799	0	52	80	0.6500000
NODE_3710_length_1223_cov_5.251779	719	799	2	9	80	0.1125000
NODE_3710_length_1223_cov_5.251779	719	799	8	19	80	0.2375000
NODE_3710_length_1223_cov_5.251779	795	875	8	5	80	0.0625000
NODE_3710_length_1223_cov_5.251779	795	875	12	15	80	0.1875000
NODE_3710_length_1223_cov_5.251779	795	875	14	29	80	0.3625000
NODE_3710_length_1223_cov_5.251779	795	875	16	31	80	0.3875000
NODE_3710_length_1223_cov_5.251779	848	928	0	13	80	0.1625000
NODE_3710_length_1223_cov_5.251779	848	928	4	12	80	0.1500000
NODE_3710_length_1223_cov_5.251779	848	928	6	10	80	0.1250000
NODE_3710_length_1223_cov_5.251779	848	928	12	30	80	0.3750000
NODE_3710_length_1223_cov_5.251779	848	928	14	11	80	0.1375000
NODE_3710_length_1223_cov_5.251779	848	928	16	4	80	0.0500000
NODE_3716_length_1222_cov_18.406946	273	353	0	6	80	0.0750000
NODE_3716_length_1222_cov_18.406946	273	353	4	13	80	0.1625000
NODE_3716_length_1222_cov_18.406946	273	353	6	9	80	0.1125000
NODE_3716_length_1222_cov_18.406946	273	353	7	52	80	0.6500000
NODE_3716_length_1222_cov_18.406946	326	406	1	37	80	0.4625000
NODE_3716_length_1222_cov_18.406946	326	406	3	2	80	0.0250000
NODE_3716_length_1222_cov_18.406946	326	406	7	41	80	0.5125000
NODE_3720_length_1221_cov_33.261141	505	577	0	72	72	1.0000000
NODE_3720_length_1221_cov_33.261141	558	637	0	33	79	0.4177215
NODE_3720_length_1221_cov_33.261141	558	637	2	46	79	0.5822785
NODE_3720_length_1221_cov_33.261141	633	713	0	60	80	0.7500000
NODE_3720_length_1221_cov_33.261141	633	713	2	20	80	0.2500000
NODE_3720_length_1221_cov_33.261141	686	766	0	80	80	1.0000000
NODE_3721_length_1221_cov_19.466132	541	621	0	27	80	0.3375000
NODE_3721_length_1221_cov_19.466132	541	621	2	53	80	0.6625000
NODE_3721_length_1221_cov_19.466132	594	674	0	40	80	0.5000000
NODE_3721_length_1221_cov_19.466132	594	674	2	40	80	0.5000000
NODE_3722_length_1221_cov_15.940285	788	868	2	8	80	0.1000000
NODE_3722_length_1221_cov_15.940285	788	868	4	20	80	0.2500000
NODE_3722_length_1221_cov_15.940285	788	868	6	52	80	0.6500000
NODE_3722_length_1221_cov_15.940285	841	921	0	30	80	0.3750000
NODE_3722_length_1221_cov_15.940285	841	921	2	31	80	0.3875000
NODE_3722_length_1221_cov_15.940285	841	921	6	19	80	0.2375000
NODE_3722_length_1221_cov_15.940285	917	997	0	27	80	0.3375000
NODE_3722_length_1221_cov_15.940285	917	997	6	53	80	0.6625000
NODE_3722_length_1221_cov_15.940285	970	1050	0	11	80	0.1375000
NODE_3722_length_1221_cov_15.940285	970	1050	6	69	80	0.8625000
NODE_3723_length_1221_cov_15.796791	484	564	2	7	80	0.0875000
NODE_3723_length_1221_cov_15.796791	484	564	5	10	80	0.1250000
NODE_3723_length_1221_cov_15.796791	484	564	6	55	80	0.6875000
NODE_3723_length_1221_cov_15.796791	484	564	8	8	80	0.1000000
NODE_3723_length_1221_cov_15.796791	537	617	2	60	80	0.7500000
NODE_3723_length_1221_cov_15.796791	537	617	5	10	80	0.1250000
NODE_3723_length_1221_cov_15.796791	537	617	6	2	80	0.0250000
NODE_3723_length_1221_cov_15.796791	537	617	8	8	80	0.1000000
NODE_3724_length_1221_cov_15.312834	342	415	0	45	73	0.6164383
NODE_3724_length_1221_cov_15.312834	342	415	2	28	73	0.3835616
NODE_3724_length_1221_cov_15.312834	395	474	0	27	79	0.3417721
NODE_3724_length_1221_cov_15.312834	395	474	2	52	79	0.6582279
NODE_3725_length_1221_cov_9.695187	988	1068	2	14	80	0.1750000
NODE_3725_length_1221_cov_9.695187	988	1068	4	30	80	0.3750000
NODE_3725_length_1221_cov_9.695187	988	1068	6	36	80	0.4500000
NODE_3725_length_1221_cov_9.695187	1041	1100	2	18	59	0.3050847
NODE_3725_length_1221_cov_9.695187	1041	1100	4	12	59	0.2033898
NODE_3725_length_1221_cov_9.695187	1041	1100	6	29	59	0.4915254
NODE_3726_length_1221_cov_9.043672	695	775	0	80	80	1.0000000
NODE_3726_length_1221_cov_9.043672	748	828	0	80	80	1.0000000
NODE_3727_length_1221_cov_7.946524	147	227	0	35	80	0.4375000
NODE_3727_length_1221_cov_7.946524	147	227	2	38	80	0.4750000
NODE_3727_length_1221_cov_7.946524	147	227	4	7	80	0.0875000
NODE_3727_length_1221_cov_7.946524	200	280	2	20	80	0.2500000
NODE_3727_length_1221_cov_7.946524	200	280	4	60	80	0.7500000
NODE_3728_length_1221_cov_5.122103	248	328	4	19	80	0.2375000
NODE_3728_length_1221_cov_5.122103	248	328	6	61	80	0.7625000
NODE_3728_length_1221_cov_5.122103	301	381	0	28	80	0.3500000
NODE_3728_length_1221_cov_5.122103	301	381	2	1	80	0.0125000
NODE_3728_length_1221_cov_5.122103	301	381	6	51	80	0.6375000
NODE_3736_length_1220_cov_44.501338	319	399	0	25	80	0.3125000
NODE_3736_length_1220_cov_44.501338	319	399	1	33	80	0.4125000
NODE_3736_length_1220_cov_44.501338	319	399	2	22	80	0.2750000
NODE_3736_length_1220_cov_44.501338	372	452	1	5	80	0.0625000
NODE_3736_length_1220_cov_44.501338	372	452	2	75	80	0.9375000
NODE_3736_length_1220_cov_44.501338	448	528	2	19	80	0.2375000
NODE_3736_length_1220_cov_44.501338	448	528	6	1	80	0.0125000
NODE_3736_length_1220_cov_44.501338	448	528	7	33	80	0.4125000
NODE_3736_length_1220_cov_44.501338	448	528	8	27	80	0.3375000
NODE_3736_length_1220_cov_44.501338	501	581	0	48	80	0.6000000
NODE_3736_length_1220_cov_44.501338	501	581	6	6	80	0.0750000
NODE_3736_length_1220_cov_44.501338	501	581	7	26	80	0.3250000
NODE_3737_length_1220_cov_43.868867	720	800	1	46	80	0.5750000
NODE_3737_length_1220_cov_43.868867	720	800	2	34	80	0.4250000
NODE_3737_length_1220_cov_43.868867	773	853	1	19	80	0.2375000
NODE_3737_length_1220_cov_43.868867	773	853	2	61	80	0.7625000
NODE_3738_length_1220_cov_41.900089	593	673	0	13	80	0.1625000
NODE_3738_length_1220_cov_41.900089	593	673	2	67	80	0.8375000
NODE_3738_length_1220_cov_41.900089	646	726	0	48	80	0.6000000
NODE_3738_length_1220_cov_41.900089	646	726	2	32	80	0.4000000
NODE_3738_length_1220_cov_41.900089	722	802	0	80	80	1.0000000
NODE_3738_length_1220_cov_41.900089	775	855	0	80	80	1.0000000
NODE_3739_length_1220_cov_15.485281	395	475	0	15	80	0.1875000
NODE_3739_length_1220_cov_15.485281	395	475	6	65	80	0.8125000
NODE_3739_length_1220_cov_15.485281	448	528	0	68	80	0.8500000
NODE_3739_length_1220_cov_15.485281	448	528	6	12	80	0.1500000
NODE_3745_length_1219_cov_30.493750	643	723	1	41	80	0.5125000
NODE_3745_length_1219_cov_30.493750	643	723	2	39	80	0.4875000
NODE_3745_length_1219_cov_30.493750	696	776	2	63	80	0.7875000
NODE_3745_length_1219_cov_30.493750	696	776	4	17	80	0.2125000
NODE_3745_length_1219_cov_30.493750	772	852	2	18	80	0.2250000
NODE_3745_length_1219_cov_30.493750	772	852	3	41	80	0.5125000
NODE_3745_length_1219_cov_30.493750	772	852	4	21	80	0.2625000
NODE_3745_length_1219_cov_30.493750	825	905	0	35	80	0.4375000
NODE_3745_length_1219_cov_30.493750	825	905	2	36	80	0.4500000
NODE_3745_length_1219_cov_30.493750	825	905	3	9	80	0.1125000
NODE_3746_length_1219_cov_24.991071	566	646	0	80	80	1.0000000
NODE_3746_length_1219_cov_24.991071	619	699	0	80	80	1.0000000
NODE_3746_length_1219_cov_24.991071	695	775	0	19	80	0.2375000
NODE_3746_length_1219_cov_24.991071	695	775	2	35	80	0.4375000
NODE_3746_length_1219_cov_24.991071	695	775	5	26	80	0.3250000
NODE_3746_length_1219_cov_24.991071	748	828	2	1	80	0.0125000
NODE_3746_length_1219_cov_24.991071	748	828	5	48	80	0.6000000
NODE_3746_length_1219_cov_24.991071	748	828	6	31	80	0.3875000
NODE_3747_length_1219_cov_24.728571	465	545	2	80	80	1.0000000
NODE_3747_length_1219_cov_24.728571	518	598	2	31	80	0.3875000
NODE_3747_length_1219_cov_24.728571	518	598	10	3	80	0.0375000
NODE_3747_length_1219_cov_24.728571	518	598	11	4	80	0.0500000
NODE_3747_length_1219_cov_24.728571	518	598	12	42	80	0.5250000
NODE_3747_length_1219_cov_24.728571	594	674	12	64	80	0.8000000
NODE_3747_length_1219_cov_24.728571	594	674	14	16	80	0.2000000
NODE_3747_length_1219_cov_24.728571	647	727	2	13	80	0.1625000
NODE_3747_length_1219_cov_24.728571	647	727	3	1	80	0.0125000
NODE_3747_length_1219_cov_24.728571	647	727	4	15	80	0.1875000
NODE_3747_length_1219_cov_24.728571	647	727	12	35	80	0.4375000
NODE_3747_length_1219_cov_24.728571	647	727	14	16	80	0.2000000
NODE_3748_length_1219_cov_11.130357	535	615	0	57	80	0.7125000
NODE_3748_length_1219_cov_11.130357	535	615	2	7	80	0.0875000
NODE_3748_length_1219_cov_11.130357	535	615	4	16	80	0.2000000
NODE_3748_length_1219_cov_11.130357	588	668	0	4	80	0.0500000
NODE_3748_length_1219_cov_11.130357	588	668	2	24	80	0.3000000
NODE_3748_length_1219_cov_11.130357	588	668	4	52	80	0.6500000
NODE_3749_length_1219_cov_9.696429	734	814	0	1	80	0.0125000
NODE_3749_length_1219_cov_9.696429	734	814	2	45	80	0.5625000
NODE_3749_length_1219_cov_9.696429	734	814	4	19	80	0.2375000
NODE_3749_length_1219_cov_9.696429	734	814	8	15	80	0.1875000
NODE_3749_length_1219_cov_9.696429	787	867	0	54	80	0.6750000
NODE_3749_length_1219_cov_9.696429	787	867	2	26	80	0.3250000
NODE_3754_length_1218_cov_40.159071	554	634	0	80	80	1.0000000
NODE_3754_length_1218_cov_40.159071	607	687	0	80	80	1.0000000
NODE_3754_length_1218_cov_40.159071	683	763	0	9	80	0.1125000
NODE_3754_length_1218_cov_40.159071	683	763	16	71	80	0.8875000
NODE_3754_length_1218_cov_40.159071	736	816	0	7	80	0.0875000
NODE_3754_length_1218_cov_40.159071	736	816	16	73	80	0.9125000
NODE_3765_length_1216_cov_99.538944	44	124	191	1	80	0.0125000
NODE_3765_length_1216_cov_99.538944	44	124	195	1	80	0.0125000
NODE_3765_length_1216_cov_99.538944	44	124	201	1	80	0.0125000
NODE_3765_length_1216_cov_99.538944	44	124	206	1	80	0.0125000
NODE_3765_length_1216_cov_99.538944	44	124	218	1	80	0.0125000
NODE_3765_length_1216_cov_99.538944	44	124	222	1	80	0.0125000
NODE_3765_length_1216_cov_99.538944	44	124	224	1	80	0.0125000
NODE_3765_length_1216_cov_99.538944	44	124	232	1	80	0.0125000
NODE_3765_length_1216_cov_99.538944	44	124	234	1	80	0.0125000
NODE_3765_length_1216_cov_99.538944	44	124	239	1	80	0.0125000
NODE_3765_length_1216_cov_99.538944	44	124	249	1	80	0.0125000
NODE_3765_length_1216_cov_99.538944	44	124	251	1	80	0.0125000
NODE_3765_length_1216_cov_99.538944	44	124	260	1	80	0.0125000
NODE_3765_length_1216_cov_99.538944	44	124	268	1	80	0.0125000
NODE_3765_length_1216_cov_99.538944	44	124	276	1	80	0.0125000
NODE_3765_length_1216_cov_99.538944	44	124	277	1	80	0.0125000
NODE_3765_length_1216_cov_99.538944	44	124	283	2	80	0.0250000
NODE_3765_length_1216_cov_99.538944	44	124	289	1	80	0.0125000
NODE_3765_length_1216_cov_99.538944	44	124	300	3	80	0.0375000
NODE_3765_length_1216_cov_99.538944	44	124	302	1	80	0.0125000
NODE_3765_length_1216_cov_99.538944	44	124	311	1	80	0.0125000
NODE_3765_length_1216_cov_99.538944	44	124	315	1	80	0.0125000
NODE_3765_length_1216_cov_99.538944	44	124	321	2	80	0.0250000
NODE_3765_length_1216_cov_99.538944	44	124	326	1	80	0.0125000
NODE_3765_length_1216_cov_99.538944	44	124	337	1	80	0.0125000
NODE_3765_length_1216_cov_99.538944	44	124	340	1	80	0.0125000
NODE_3765_length_1216_cov_99.538944	44	124	348	1	80	0.0125000
NODE_3765_length_1216_cov_99.538944	44	124	349	1	80	0.0125000
NODE_3765_length_1216_cov_99.538944	44	124	353	2	80	0.0250000
NODE_3765_length_1216_cov_99.538944	44	124	357	3	80	0.0375000
NODE_3765_length_1216_cov_99.538944	44	124	358	2	80	0.0250000
NODE_3765_length_1216_cov_99.538944	44	124	367	4	80	0.0500000
NODE_3765_length_1216_cov_99.538944	44	124	369	1	80	0.0125000
NODE_3765_length_1216_cov_99.538944	44	124	374	1	80	0.0125000
NODE_3765_length_1216_cov_99.538944	44	124	376	1	80	0.0125000
NODE_3765_length_1216_cov_99.538944	44	124	381	1	80	0.0125000
NODE_3765_length_1216_cov_99.538944	44	124	383	1	80	0.0125000
NODE_3765_length_1216_cov_99.538944	44	124	393	3	80	0.0375000
NODE_3765_length_1216_cov_99.538944	44	124	395	1	80	0.0125000
NODE_3765_length_1216_cov_99.538944	44	124	401	1	80	0.0125000
NODE_3765_length_1216_cov_99.538944	44	124	408	1	80	0.0125000
NODE_3765_length_1216_cov_99.538944	44	124	418	1	80	0.0125000
NODE_3765_length_1216_cov_99.538944	44	124	424	1	80	0.0125000
NODE_3765_length_1216_cov_99.538944	44	124	426	1	80	0.0125000
NODE_3765_length_1216_cov_99.538944	44	124	428	3	80	0.0375000
NODE_3765_length_1216_cov_99.538944	44	124	433	2	80	0.0250000
NODE_3765_length_1216_cov_99.538944	44	124	437	2	80	0.0250000
NODE_3765_length_1216_cov_99.538944	44	124	439	4	80	0.0500000
NODE_3765_length_1216_cov_99.538944	44	124	440	2	80	0.0250000
NODE_3765_length_1216_cov_99.538944	44	124	441	1	80	0.0125000
NODE_3765_length_1216_cov_99.538944	44	124	443	2	80	0.0250000
NODE_3765_length_1216_cov_99.538944	44	124	444	1	80	0.0125000
NODE_3765_length_1216_cov_99.538944	44	124	445	1	80	0.0125000
NODE_3765_length_1216_cov_99.538944	44	124	446	1	80	0.0125000
NODE_3765_length_1216_cov_99.538944	44	124	447	2	80	0.0250000
NODE_3765_length_1216_cov_99.538944	44	124	448	1	80	0.0125000
NODE_3765_length_1216_cov_99.538944	44	124	449	1	80	0.0125000
NODE_3765_length_1216_cov_99.538944	97	157	406	1	60	0.0166667
NODE_3765_length_1216_cov_99.538944	97	157	408	2	60	0.0333333
NODE_3765_length_1216_cov_99.538944	97	157	410	1	60	0.0166667
NODE_3765_length_1216_cov_99.538944	97	157	418	1	60	0.0166667
NODE_3765_length_1216_cov_99.538944	97	157	424	1	60	0.0166667
NODE_3765_length_1216_cov_99.538944	97	157	426	1	60	0.0166667
NODE_3765_length_1216_cov_99.538944	97	157	428	3	60	0.0500000
NODE_3765_length_1216_cov_99.538944	97	157	433	2	60	0.0333333
NODE_3765_length_1216_cov_99.538944	97	157	434	1	60	0.0166667
NODE_3765_length_1216_cov_99.538944	97	157	435	1	60	0.0166667
NODE_3765_length_1216_cov_99.538944	97	157	437	2	60	0.0333333
NODE_3765_length_1216_cov_99.538944	97	157	439	4	60	0.0666667
NODE_3765_length_1216_cov_99.538944	97	157	440	2	60	0.0333333
NODE_3765_length_1216_cov_99.538944	97	157	441	1	60	0.0166667
NODE_3765_length_1216_cov_99.538944	97	157	443	2	60	0.0333333
NODE_3765_length_1216_cov_99.538944	97	157	444	1	60	0.0166667
NODE_3765_length_1216_cov_99.538944	97	157	445	1	60	0.0166667
NODE_3765_length_1216_cov_99.538944	97	157	446	2	60	0.0333333
NODE_3765_length_1216_cov_99.538944	97	157	447	5	60	0.0833333
NODE_3765_length_1216_cov_99.538944	97	157	448	4	60	0.0666667
NODE_3765_length_1216_cov_99.538944	97	157	449	4	60	0.0666667
NODE_3765_length_1216_cov_99.538944	97	157	451	3	60	0.0500000
NODE_3765_length_1216_cov_99.538944	97	157	452	1	60	0.0166667
NODE_3765_length_1216_cov_99.538944	97	157	453	2	60	0.0333333
NODE_3765_length_1216_cov_99.538944	97	157	455	2	60	0.0333333
NODE_3765_length_1216_cov_99.538944	97	157	456	2	60	0.0333333
NODE_3765_length_1216_cov_99.538944	97	157	457	2	60	0.0333333
NODE_3765_length_1216_cov_99.538944	97	157	459	4	60	0.0666667
NODE_3765_length_1216_cov_99.538944	97	157	460	1	60	0.0166667
NODE_3765_length_1216_cov_99.538944	97	157	464	1	60	0.0166667
NODE_3765_length_1216_cov_99.538944	824	903	150	1	79	0.0126582
NODE_3765_length_1216_cov_99.538944	824	903	152	2	79	0.0253165
NODE_3765_length_1216_cov_99.538944	824	903	154	1	79	0.0126582
NODE_3765_length_1216_cov_99.538944	824	903	155	2	79	0.0253165
NODE_3765_length_1216_cov_99.538944	824	903	157	1	79	0.0126582
NODE_3765_length_1216_cov_99.538944	824	903	158	3	79	0.0379747
NODE_3765_length_1216_cov_99.538944	824	903	159	2	79	0.0253165
NODE_3765_length_1216_cov_99.538944	824	903	160	4	79	0.0506329
NODE_3765_length_1216_cov_99.538944	824	903	161	1	79	0.0126582
NODE_3765_length_1216_cov_99.538944	824	903	163	1	79	0.0126582
NODE_3765_length_1216_cov_99.538944	824	903	164	3	79	0.0379747
NODE_3765_length_1216_cov_99.538944	824	903	165	2	79	0.0253165
NODE_3765_length_1216_cov_99.538944	824	903	166	1	79	0.0126582
NODE_3765_length_1216_cov_99.538944	824	903	167	5	79	0.0632911
NODE_3765_length_1216_cov_99.538944	824	903	168	1	79	0.0126582
NODE_3765_length_1216_cov_99.538944	824	903	170	5	79	0.0632911
NODE_3765_length_1216_cov_99.538944	824	903	171	4	79	0.0506329
NODE_3765_length_1216_cov_99.538944	824	903	172	2	79	0.0253165
NODE_3765_length_1216_cov_99.538944	824	903	176	1	79	0.0126582
NODE_3765_length_1216_cov_99.538944	824	903	179	3	79	0.0379747
NODE_3765_length_1216_cov_99.538944	824	903	183	1	79	0.0126582
NODE_3765_length_1216_cov_99.538944	824	903	185	1	79	0.0126582
NODE_3765_length_1216_cov_99.538944	824	903	189	1	79	0.0126582
NODE_3765_length_1216_cov_99.538944	824	903	190	3	79	0.0379747
NODE_3765_length_1216_cov_99.538944	824	903	193	2	79	0.0253165
NODE_3765_length_1216_cov_99.538944	824	903	194	1	79	0.0126582
NODE_3765_length_1216_cov_99.538944	824	903	196	2	79	0.0253165
NODE_3765_length_1216_cov_99.538944	824	903	199	2	79	0.0253165
NODE_3765_length_1216_cov_99.538944	824	903	200	1	79	0.0126582
NODE_3765_length_1216_cov_99.538944	824	903	201	1	79	0.0126582
NODE_3765_length_1216_cov_99.538944	824	903	204	1	79	0.0126582
NODE_3765_length_1216_cov_99.538944	824	903	206	3	79	0.0379747
NODE_3765_length_1216_cov_99.538944	824	903	207	2	79	0.0253165
NODE_3765_length_1216_cov_99.538944	824	903	208	8	79	0.1012658
NODE_3765_length_1216_cov_99.538944	824	903	209	4	79	0.0506329
NODE_3765_length_1216_cov_99.538944	824	903	211	1	79	0.0126582
NODE_3766_length_1216_cov_15.855864	668	748	4	5	80	0.0625000
NODE_3766_length_1216_cov_15.855864	668	748	8	16	80	0.2000000
NODE_3766_length_1216_cov_15.855864	668	748	10	59	80	0.7375000
NODE_3766_length_1216_cov_15.855864	721	801	2	27	80	0.3375000
NODE_3766_length_1216_cov_15.855864	721	801	6	6	80	0.0750000
NODE_3766_length_1216_cov_15.855864	721	801	9	1	80	0.0125000
NODE_3766_length_1216_cov_15.855864	721	801	10	46	80	0.5750000
NODE_3767_length_1216_cov_4.128917	720	800	0	34	80	0.4250000
NODE_3767_length_1216_cov_4.128917	720	800	2	46	80	0.5750000
NODE_3767_length_1216_cov_4.128917	773	853	2	80	80	1.0000000
NODE_3774_length_1215_cov_32.293011	411	491	2	78	80	0.9750000
NODE_3774_length_1215_cov_32.293011	411	491	4	2	80	0.0250000
NODE_3774_length_1215_cov_32.293011	464	544	0	15	80	0.1875000
NODE_3774_length_1215_cov_32.293011	464	544	2	63	80	0.7875000
NODE_3774_length_1215_cov_32.293011	464	544	4	2	80	0.0250000
NODE_3775_length_1215_cov_24.177419	729	809	0	43	80	0.5375000
NODE_3775_length_1215_cov_24.177419	729	809	4	37	80	0.4625000
NODE_3775_length_1215_cov_24.177419	782	862	0	5	80	0.0625000
NODE_3775_length_1215_cov_24.177419	782	862	4	39	80	0.4875000
NODE_3775_length_1215_cov_24.177419	782	862	6	36	80	0.4500000
NODE_3776_length_1215_cov_21.566308	645	725	0	49	80	0.6125000
NODE_3776_length_1215_cov_21.566308	645	725	2	31	80	0.3875000
NODE_3776_length_1215_cov_21.566308	698	778	1	7	80	0.0875000
NODE_3776_length_1215_cov_21.566308	698	778	2	73	80	0.9125000
NODE_3777_length_1215_cov_19.278674	630	710	2	57	80	0.7125000
NODE_3777_length_1215_cov_19.278674	630	710	3	15	80	0.1875000
NODE_3777_length_1215_cov_19.278674	630	710	4	8	80	0.1000000
NODE_3777_length_1215_cov_19.278674	683	763	0	3	80	0.0375000
NODE_3777_length_1215_cov_19.278674	683	763	2	77	80	0.9625000
NODE_3778_length_1215_cov_15.074373	664	744	0	78	80	0.9750000
NODE_3778_length_1215_cov_15.074373	664	744	4	2	80	0.0250000
NODE_3778_length_1215_cov_15.074373	717	797	0	80	80	1.0000000
NODE_3779_length_1215_cov_5.932796	507	587	0	80	80	1.0000000
NODE_3779_length_1215_cov_5.932796	560	640	0	80	80	1.0000000
NODE_3787_length_1214_cov_26.771300	420	500	62	2	80	0.0250000
NODE_3787_length_1214_cov_26.771300	420	500	68	3	80	0.0375000
NODE_3787_length_1214_cov_26.771300	420	500	72	2	80	0.0250000
NODE_3787_length_1214_cov_26.771300	420	500	74	2	80	0.0250000
NODE_3787_length_1214_cov_26.771300	420	500	78	2	80	0.0250000
NODE_3787_length_1214_cov_26.771300	420	500	82	1	80	0.0125000
NODE_3787_length_1214_cov_26.771300	420	500	84	2	80	0.0250000
NODE_3787_length_1214_cov_26.771300	420	500	89	1	80	0.0125000
NODE_3787_length_1214_cov_26.771300	420	500	97	1	80	0.0125000
NODE_3787_length_1214_cov_26.771300	420	500	98	2	80	0.0250000
NODE_3787_length_1214_cov_26.771300	420	500	100	1	80	0.0125000
NODE_3787_length_1214_cov_26.771300	420	500	114	8	80	0.1000000
NODE_3787_length_1214_cov_26.771300	420	500	120	3	80	0.0375000
NODE_3787_length_1214_cov_26.771300	420	500	136	5	80	0.0625000
NODE_3787_length_1214_cov_26.771300	420	500	144	1	80	0.0125000
NODE_3787_length_1214_cov_26.771300	420	500	148	3	80	0.0375000
NODE_3787_length_1214_cov_26.771300	420	500	152	1	80	0.0125000
NODE_3787_length_1214_cov_26.771300	420	500	154	1	80	0.0125000
NODE_3787_length_1214_cov_26.771300	420	500	156	3	80	0.0375000
NODE_3787_length_1214_cov_26.771300	420	500	160	1	80	0.0125000
NODE_3787_length_1214_cov_26.771300	420	500	162	2	80	0.0250000
NODE_3787_length_1214_cov_26.771300	420	500	164	2	80	0.0250000
NODE_3787_length_1214_cov_26.771300	420	500	166	1	80	0.0125000
NODE_3787_length_1214_cov_26.771300	420	500	168	9	80	0.1125000
NODE_3787_length_1214_cov_26.771300	420	500	170	8	80	0.1000000
NODE_3787_length_1214_cov_26.771300	420	500	174	13	80	0.1625000
NODE_3787_length_1214_cov_26.771300	473	553	28	1	80	0.0125000
NODE_3787_length_1214_cov_26.771300	473	553	44	1	80	0.0125000
NODE_3787_length_1214_cov_26.771300	473	553	55	1	80	0.0125000
NODE_3787_length_1214_cov_26.771300	473	553	58	1	80	0.0125000
NODE_3787_length_1214_cov_26.771300	473	553	60	1	80	0.0125000
NODE_3787_length_1214_cov_26.771300	473	553	70	1	80	0.0125000
NODE_3787_length_1214_cov_26.771300	473	553	72	4	80	0.0500000
NODE_3787_length_1214_cov_26.771300	473	553	78	1	80	0.0125000
NODE_3787_length_1214_cov_26.771300	473	553	84	7	80	0.0875000
NODE_3787_length_1214_cov_26.771300	473	553	86	4	80	0.0500000
NODE_3787_length_1214_cov_26.771300	473	553	90	1	80	0.0125000
NODE_3787_length_1214_cov_26.771300	473	553	92	6	80	0.0750000
NODE_3787_length_1214_cov_26.771300	473	553	104	1	80	0.0125000
NODE_3787_length_1214_cov_26.771300	473	553	106	2	80	0.0250000
NODE_3787_length_1214_cov_26.771300	473	553	114	1	80	0.0125000
NODE_3787_length_1214_cov_26.771300	473	553	118	1	80	0.0125000
NODE_3787_length_1214_cov_26.771300	473	553	122	1	80	0.0125000
NODE_3787_length_1214_cov_26.771300	473	553	124	3	80	0.0375000
NODE_3787_length_1214_cov_26.771300	473	553	126	1	80	0.0125000
NODE_3787_length_1214_cov_26.771300	473	553	130	1	80	0.0125000
NODE_3787_length_1214_cov_26.771300	473	553	134	1	80	0.0125000
NODE_3787_length_1214_cov_26.771300	473	553	136	8	80	0.1000000
NODE_3787_length_1214_cov_26.771300	473	553	138	2	80	0.0250000
NODE_3787_length_1214_cov_26.771300	473	553	142	1	80	0.0125000
NODE_3787_length_1214_cov_26.771300	473	553	152	2	80	0.0250000
NODE_3787_length_1214_cov_26.771300	473	553	154	1	80	0.0125000
NODE_3787_length_1214_cov_26.771300	473	553	156	1	80	0.0125000
NODE_3787_length_1214_cov_26.771300	473	553	162	1	80	0.0125000
NODE_3787_length_1214_cov_26.771300	473	553	164	2	80	0.0250000
NODE_3787_length_1214_cov_26.771300	473	553	168	9	80	0.1125000
NODE_3787_length_1214_cov_26.771300	473	553	170	4	80	0.0500000
NODE_3787_length_1214_cov_26.771300	473	553	174	8	80	0.1000000
NODE_3788_length_1214_cov_24.555157	480	560	0	13	80	0.1625000
NODE_3788_length_1214_cov_24.555157	480	560	2	67	80	0.8375000
NODE_3788_length_1214_cov_24.555157	533	613	0	66	80	0.8250000
NODE_3788_length_1214_cov_24.555157	533	613	2	14	80	0.1750000
NODE_3789_length_1214_cov_23.167713	623	703	0	80	80	1.0000000
NODE_3789_length_1214_cov_23.167713	676	756	0	80	80	1.0000000
NODE_3790_length_1214_cov_18.452915	555	635	0	80	80	1.0000000
NODE_3790_length_1214_cov_18.452915	608	688	0	80	80	1.0000000
NODE_3790_length_1214_cov_18.452915	684	764	0	80	80	1.0000000
NODE_3790_length_1214_cov_18.452915	737	817	0	80	80	1.0000000
NODE_3791_length_1214_cov_8.906726	206	286	0	80	80	1.0000000
NODE_3791_length_1214_cov_8.906726	259	339	0	80	80	1.0000000
NODE_3792_length_1214_cov_3.686996	415	495	0	80	80	1.0000000
NODE_3792_length_1214_cov_3.686996	468	548	0	80	80	1.0000000
NODE_3799_length_1214_cov_0.967713	1049	1129	224	1	80	0.0125000
NODE_3799_length_1214_cov_0.967713	1049	1129	231	1	80	0.0125000
NODE_3799_length_1214_cov_0.967713	1049	1129	235	1	80	0.0125000
NODE_3799_length_1214_cov_0.967713	1049	1129	244	1	80	0.0125000
NODE_3799_length_1214_cov_0.967713	1049	1129	274	1	80	0.0125000
NODE_3799_length_1214_cov_0.967713	1049	1129	278	1	80	0.0125000
NODE_3799_length_1214_cov_0.967713	1049	1129	290	1	80	0.0125000
NODE_3799_length_1214_cov_0.967713	1049	1129	292	1	80	0.0125000
NODE_3799_length_1214_cov_0.967713	1049	1129	312	1	80	0.0125000
NODE_3799_length_1214_cov_0.967713	1049	1129	314	1	80	0.0125000
NODE_3799_length_1214_cov_0.967713	1049	1129	318	1	80	0.0125000
NODE_3799_length_1214_cov_0.967713	1049	1129	329	1	80	0.0125000
NODE_3799_length_1214_cov_0.967713	1049	1129	379	2	80	0.0250000
NODE_3799_length_1214_cov_0.967713	1049	1129	381	1	80	0.0125000
NODE_3799_length_1214_cov_0.967713	1049	1129	382	1	80	0.0125000
NODE_3799_length_1214_cov_0.967713	1049	1129	383	2	80	0.0250000
NODE_3799_length_1214_cov_0.967713	1049	1129	385	2	80	0.0250000
NODE_3799_length_1214_cov_0.967713	1049	1129	386	1	80	0.0125000
NODE_3799_length_1214_cov_0.967713	1049	1129	388	5	80	0.0625000
NODE_3799_length_1214_cov_0.967713	1049	1129	389	1	80	0.0125000
NODE_3799_length_1214_cov_0.967713	1049	1129	391	1	80	0.0125000
NODE_3799_length_1214_cov_0.967713	1049	1129	392	2	80	0.0250000
NODE_3799_length_1214_cov_0.967713	1049	1129	396	1	80	0.0125000
NODE_3799_length_1214_cov_0.967713	1049	1129	397	2	80	0.0250000
NODE_3799_length_1214_cov_0.967713	1049	1129	398	3	80	0.0375000
NODE_3799_length_1214_cov_0.967713	1049	1129	403	2	80	0.0250000
NODE_3799_length_1214_cov_0.967713	1049	1129	404	2	80	0.0250000
NODE_3799_length_1214_cov_0.967713	1049	1129	407	1	80	0.0125000
NODE_3799_length_1214_cov_0.967713	1049	1129	409	2	80	0.0250000
NODE_3799_length_1214_cov_0.967713	1049	1129	410	1	80	0.0125000
NODE_3799_length_1214_cov_0.967713	1049	1129	411	1	80	0.0125000
NODE_3799_length_1214_cov_0.967713	1049	1129	413	4	80	0.0500000
NODE_3799_length_1214_cov_0.967713	1049	1129	415	1	80	0.0125000
NODE_3799_length_1214_cov_0.967713	1049	1129	416	5	80	0.0625000
NODE_3799_length_1214_cov_0.967713	1049	1129	418	5	80	0.0625000
NODE_3799_length_1214_cov_0.967713	1049	1129	419	7	80	0.0875000
NODE_3799_length_1214_cov_0.967713	1049	1129	421	1	80	0.0125000
NODE_3799_length_1214_cov_0.967713	1049	1129	422	2	80	0.0250000
NODE_3799_length_1214_cov_0.967713	1049	1129	423	2	80	0.0250000
NODE_3799_length_1214_cov_0.967713	1049	1129	424	2	80	0.0250000
NODE_3799_length_1214_cov_0.967713	1049	1129	425	1	80	0.0125000
NODE_3799_length_1214_cov_0.967713	1049	1129	428	1	80	0.0125000
NODE_3799_length_1214_cov_0.967713	1049	1129	430	3	80	0.0375000
NODE_3799_length_1214_cov_0.967713	1049	1129	432	1	80	0.0125000
NODE_3800_length_1213_cov_19.524237	499	579	0	2	80	0.0250000
NODE_3800_length_1213_cov_19.524237	499	579	2	78	80	0.9750000
NODE_3800_length_1213_cov_19.524237	552	632	0	36	80	0.4500000
NODE_3800_length_1213_cov_19.524237	552	632	2	44	80	0.5500000
NODE_3806_length_1212_cov_32.663073	688	768	0	4	80	0.0500000
NODE_3806_length_1212_cov_32.663073	688	768	2	4	80	0.0500000
NODE_3806_length_1212_cov_32.663073	688	768	14	15	80	0.1875000
NODE_3806_length_1212_cov_32.663073	688	768	16	57	80	0.7125000
NODE_3806_length_1212_cov_32.663073	741	821	0	57	80	0.7125000
NODE_3806_length_1212_cov_32.663073	741	821	2	4	80	0.0500000
NODE_3806_length_1212_cov_32.663073	741	821	16	19	80	0.2375000
NODE_3807_length_1212_cov_15.981132	33	113	12	13	80	0.1625000
NODE_3807_length_1212_cov_15.981132	33	113	14	8	80	0.1000000
NODE_3807_length_1212_cov_15.981132	33	113	16	1	80	0.0125000
NODE_3807_length_1212_cov_15.981132	33	113	18	4	80	0.0500000
NODE_3807_length_1212_cov_15.981132	33	113	20	1	80	0.0125000
NODE_3807_length_1212_cov_15.981132	33	113	22	53	80	0.6625000
NODE_3807_length_1212_cov_15.981132	511	591	2	43	80	0.5375000
NODE_3807_length_1212_cov_15.981132	511	591	4	37	80	0.4625000
NODE_3807_length_1212_cov_15.981132	564	637	2	53	73	0.7260274
NODE_3807_length_1212_cov_15.981132	564	637	4	20	73	0.2739726
NODE_3813_length_1211_cov_30.513489	561	641	0	79	80	0.9875000
NODE_3813_length_1211_cov_30.513489	561	641	2	1	80	0.0125000
NODE_3813_length_1211_cov_30.513489	614	694	0	26	80	0.3250000
NODE_3813_length_1211_cov_30.513489	614	694	2	40	80	0.5000000
NODE_3813_length_1211_cov_30.513489	614	694	6	14	80	0.1750000
NODE_3813_length_1211_cov_30.513489	690	770	4	48	80	0.6000000
NODE_3813_length_1211_cov_30.513489	690	770	6	32	80	0.4000000
NODE_3813_length_1211_cov_30.513489	743	823	0	49	80	0.6125000
NODE_3813_length_1211_cov_30.513489	743	823	4	31	80	0.3875000
NODE_3815_length_1211_cov_10.073741	380	460	0	21	80	0.2625000
NODE_3815_length_1211_cov_10.073741	380	460	2	12	80	0.1500000
NODE_3815_length_1211_cov_10.073741	380	460	4	47	80	0.5875000
NODE_3815_length_1211_cov_10.073741	433	513	2	38	80	0.4750000
NODE_3815_length_1211_cov_10.073741	433	513	4	42	80	0.5250000
NODE_3816_length_1211_cov_7.561151	598	678	0	10	80	0.1250000
NODE_3816_length_1211_cov_7.561151	598	678	2	18	80	0.2250000
NODE_3816_length_1211_cov_7.561151	598	678	4	52	80	0.6500000
NODE_3816_length_1211_cov_7.561151	651	731	0	63	80	0.7875000
NODE_3816_length_1211_cov_7.561151	651	731	2	17	80	0.2125000
NODE_3820_length_1210_cov_49.743474	398	478	0	17	80	0.2125000
NODE_3820_length_1210_cov_49.743474	398	478	2	63	80	0.7875000
NODE_3820_length_1210_cov_49.743474	451	531	0	3	80	0.0375000
NODE_3820_length_1210_cov_49.743474	451	531	2	77	80	0.9625000
NODE_3821_length_1210_cov_15.647165	647	727	0	57	80	0.7125000
NODE_3821_length_1210_cov_15.647165	647	727	6	23	80	0.2875000
NODE_3821_length_1210_cov_15.647165	700	780	0	4	80	0.0500000
NODE_3821_length_1210_cov_15.647165	700	780	6	64	80	0.8000000
NODE_3821_length_1210_cov_15.647165	700	780	8	12	80	0.1500000
NODE_3822_length_1210_cov_11.194419	794	874	0	12	80	0.1500000
NODE_3822_length_1210_cov_11.194419	794	874	2	31	80	0.3875000
NODE_3822_length_1210_cov_11.194419	794	874	4	37	80	0.4625000
NODE_3822_length_1210_cov_11.194419	847	927	0	12	80	0.1500000
NODE_3822_length_1210_cov_11.194419	847	927	2	68	80	0.8500000
NODE_3826_length_1209_cov_24.504505	582	662	0	19	80	0.2375000
NODE_3826_length_1209_cov_24.504505	582	662	1	29	80	0.3625000
NODE_3826_length_1209_cov_24.504505	582	662	2	32	80	0.4000000
NODE_3826_length_1209_cov_24.504505	635	715	0	72	80	0.9000000
NODE_3826_length_1209_cov_24.504505	635	715	1	8	80	0.1000000
NODE_3826_length_1209_cov_24.504505	711	791	0	80	80	1.0000000
NODE_3826_length_1209_cov_24.504505	764	844	0	80	80	1.0000000
NODE_3827_length_1209_cov_21.846847	520	600	0	80	80	1.0000000
NODE_3827_length_1209_cov_21.846847	573	653	0	80	80	1.0000000
NODE_3827_length_1209_cov_21.846847	649	729	0	80	80	1.0000000
NODE_3827_length_1209_cov_21.846847	702	782	0	80	80	1.0000000
NODE_3828_length_1209_cov_9.026126	782	862	0	62	80	0.7750000
NODE_3828_length_1209_cov_9.026126	782	862	2	18	80	0.2250000
NODE_3828_length_1209_cov_9.026126	835	915	0	9	80	0.1125000
NODE_3828_length_1209_cov_9.026126	835	915	2	71	80	0.8875000
NODE_3830_length_1209_cov_5.721622	926	1006	0	80	80	1.0000000
NODE_3830_length_1209_cov_5.721622	979	1059	0	80	80	1.0000000
NODE_3833_length_1208_cov_40.717764	886	966	94	1	80	0.0125000
NODE_3833_length_1208_cov_40.717764	886	966	96	1	80	0.0125000
NODE_3833_length_1208_cov_40.717764	886	966	98	1	80	0.0125000
NODE_3833_length_1208_cov_40.717764	886	966	100	1	80	0.0125000
NODE_3833_length_1208_cov_40.717764	886	966	101	1	80	0.0125000
NODE_3833_length_1208_cov_40.717764	886	966	102	2	80	0.0250000
NODE_3833_length_1208_cov_40.717764	886	966	104	1	80	0.0125000
NODE_3833_length_1208_cov_40.717764	886	966	105	1	80	0.0125000
NODE_3833_length_1208_cov_40.717764	886	966	108	1	80	0.0125000
NODE_3833_length_1208_cov_40.717764	886	966	114	2	80	0.0250000
NODE_3833_length_1208_cov_40.717764	886	966	122	2	80	0.0250000
NODE_3833_length_1208_cov_40.717764	886	966	123	2	80	0.0250000
NODE_3833_length_1208_cov_40.717764	886	966	124	5	80	0.0625000
NODE_3833_length_1208_cov_40.717764	886	966	126	3	80	0.0375000
NODE_3833_length_1208_cov_40.717764	886	966	127	1	80	0.0125000
NODE_3833_length_1208_cov_40.717764	886	966	129	1	80	0.0125000
NODE_3833_length_1208_cov_40.717764	886	966	130	1	80	0.0125000
NODE_3833_length_1208_cov_40.717764	886	966	133	1	80	0.0125000
NODE_3833_length_1208_cov_40.717764	886	966	137	1	80	0.0125000
NODE_3833_length_1208_cov_40.717764	886	966	138	1	80	0.0125000
NODE_3833_length_1208_cov_40.717764	886	966	141	1	80	0.0125000
NODE_3833_length_1208_cov_40.717764	886	966	144	1	80	0.0125000
NODE_3833_length_1208_cov_40.717764	886	966	146	1	80	0.0125000
NODE_3833_length_1208_cov_40.717764	886	966	156	1	80	0.0125000
NODE_3833_length_1208_cov_40.717764	886	966	160	1	80	0.0125000
NODE_3833_length_1208_cov_40.717764	886	966	163	2	80	0.0250000
NODE_3833_length_1208_cov_40.717764	886	966	169	2	80	0.0250000
NODE_3833_length_1208_cov_40.717764	886	966	171	1	80	0.0125000
NODE_3833_length_1208_cov_40.717764	886	966	174	1	80	0.0125000
NODE_3833_length_1208_cov_40.717764	886	966	175	1	80	0.0125000
NODE_3833_length_1208_cov_40.717764	886	966	178	4	80	0.0500000
NODE_3833_length_1208_cov_40.717764	886	966	179	2	80	0.0250000
NODE_3833_length_1208_cov_40.717764	886	966	180	1	80	0.0125000
NODE_3833_length_1208_cov_40.717764	886	966	183	1	80	0.0125000
NODE_3833_length_1208_cov_40.717764	886	966	185	1	80	0.0125000
NODE_3833_length_1208_cov_40.717764	886	966	187	1	80	0.0125000
NODE_3833_length_1208_cov_40.717764	886	966	189	1	80	0.0125000
NODE_3833_length_1208_cov_40.717764	886	966	212	1	80	0.0125000
NODE_3833_length_1208_cov_40.717764	886	966	217	1	80	0.0125000
NODE_3833_length_1208_cov_40.717764	886	966	240	1	80	0.0125000
NODE_3833_length_1208_cov_40.717764	886	966	260	1	80	0.0125000
NODE_3833_length_1208_cov_40.717764	886	966	262	1	80	0.0125000
NODE_3833_length_1208_cov_40.717764	886	966	266	2	80	0.0250000
NODE_3833_length_1208_cov_40.717764	886	966	268	1	80	0.0125000
NODE_3833_length_1208_cov_40.717764	886	966	270	3	80	0.0375000
NODE_3833_length_1208_cov_40.717764	886	966	272	1	80	0.0125000
NODE_3833_length_1208_cov_40.717764	886	966	278	1	80	0.0125000
NODE_3833_length_1208_cov_40.717764	886	966	281	1	80	0.0125000
NODE_3833_length_1208_cov_40.717764	886	966	291	1	80	0.0125000
NODE_3833_length_1208_cov_40.717764	886	966	295	1	80	0.0125000
NODE_3833_length_1208_cov_40.717764	886	966	299	1	80	0.0125000
NODE_3833_length_1208_cov_40.717764	886	966	304	2	80	0.0250000
NODE_3833_length_1208_cov_40.717764	886	966	313	1	80	0.0125000
NODE_3833_length_1208_cov_40.717764	886	966	322	1	80	0.0125000
NODE_3833_length_1208_cov_40.717764	886	966	332	1	80	0.0125000
NODE_3833_length_1208_cov_40.717764	886	966	342	1	80	0.0125000
NODE_3833_length_1208_cov_40.717764	886	966	346	1	80	0.0125000
NODE_3833_length_1208_cov_40.717764	886	966	358	1	80	0.0125000
NODE_3833_length_1208_cov_40.717764	886	966	386	1	80	0.0125000
NODE_3833_length_1208_cov_40.717764	886	966	399	1	80	0.0125000
NODE_3833_length_1208_cov_40.717764	939	985	212	1	46	0.0217391
NODE_3833_length_1208_cov_40.717764	939	985	217	1	46	0.0217391
NODE_3833_length_1208_cov_40.717764	939	985	240	1	46	0.0217391
NODE_3833_length_1208_cov_40.717764	939	985	260	1	46	0.0217391
NODE_3833_length_1208_cov_40.717764	939	985	262	1	46	0.0217391
NODE_3833_length_1208_cov_40.717764	939	985	266	2	46	0.0434783
NODE_3833_length_1208_cov_40.717764	939	985	268	1	46	0.0217391
NODE_3833_length_1208_cov_40.717764	939	985	270	3	46	0.0652174
NODE_3833_length_1208_cov_40.717764	939	985	272	1	46	0.0217391
NODE_3833_length_1208_cov_40.717764	939	985	278	1	46	0.0217391
NODE_3833_length_1208_cov_40.717764	939	985	281	1	46	0.0217391
NODE_3833_length_1208_cov_40.717764	939	985	291	1	46	0.0217391
NODE_3833_length_1208_cov_40.717764	939	985	295	1	46	0.0217391
NODE_3833_length_1208_cov_40.717764	939	985	299	1	46	0.0217391
NODE_3833_length_1208_cov_40.717764	939	985	304	2	46	0.0434783
NODE_3833_length_1208_cov_40.717764	939	985	313	1	46	0.0217391
NODE_3833_length_1208_cov_40.717764	939	985	322	1	46	0.0217391
NODE_3833_length_1208_cov_40.717764	939	985	332	1	46	0.0217391
NODE_3833_length_1208_cov_40.717764	939	985	342	1	46	0.0217391
NODE_3833_length_1208_cov_40.717764	939	985	346	1	46	0.0217391
NODE_3833_length_1208_cov_40.717764	939	985	358	1	46	0.0217391
NODE_3833_length_1208_cov_40.717764	939	985	386	1	46	0.0217391
NODE_3833_length_1208_cov_40.717764	939	985	399	1	46	0.0217391
NODE_3833_length_1208_cov_40.717764	939	985	408	1	46	0.0217391
NODE_3833_length_1208_cov_40.717764	939	985	414	1	46	0.0217391
NODE_3833_length_1208_cov_40.717764	939	985	426	1	46	0.0217391
NODE_3833_length_1208_cov_40.717764	939	985	433	1	46	0.0217391
NODE_3833_length_1208_cov_40.717764	939	985	438	1	46	0.0217391
NODE_3833_length_1208_cov_40.717764	939	985	443	1	46	0.0217391
NODE_3833_length_1208_cov_40.717764	939	985	458	1	46	0.0217391
NODE_3833_length_1208_cov_40.717764	939	985	472	1	46	0.0217391
NODE_3833_length_1208_cov_40.717764	939	985	474	1	46	0.0217391
NODE_3833_length_1208_cov_40.717764	939	985	479	1	46	0.0217391
NODE_3833_length_1208_cov_40.717764	939	985	480	1	46	0.0217391
NODE_3833_length_1208_cov_40.717764	939	985	491	1	46	0.0217391
NODE_3833_length_1208_cov_40.717764	939	985	492	2	46	0.0434783
NODE_3833_length_1208_cov_40.717764	939	985	493	3	46	0.0652174
NODE_3833_length_1208_cov_40.717764	939	985	497	2	46	0.0434783
NODE_3834_length_1208_cov_28.528404	614	694	0	15	80	0.1875000
NODE_3834_length_1208_cov_28.528404	614	694	2	65	80	0.8125000
NODE_3834_length_1208_cov_28.528404	667	747	0	27	80	0.3375000
NODE_3834_length_1208_cov_28.528404	667	747	2	53	80	0.6625000
NODE_3835_length_1208_cov_19.688007	682	762	0	80	80	1.0000000
NODE_3835_length_1208_cov_19.688007	735	815	0	80	80	1.0000000
NODE_3836_length_1208_cov_18.577096	455	535	0	24	80	0.3000000
NODE_3836_length_1208_cov_18.577096	455	535	6	56	80	0.7000000
NODE_3836_length_1208_cov_18.577096	508	588	6	32	80	0.4000000
NODE_3836_length_1208_cov_18.577096	508	588	8	8	80	0.1000000
NODE_3836_length_1208_cov_18.577096	508	588	11	30	80	0.3750000
NODE_3836_length_1208_cov_18.577096	508	588	12	7	80	0.0875000
NODE_3836_length_1208_cov_18.577096	508	588	13	3	80	0.0375000
NODE_3836_length_1208_cov_18.577096	584	664	4	3	80	0.0375000
NODE_3836_length_1208_cov_18.577096	584	664	6	4	80	0.0500000
NODE_3836_length_1208_cov_18.577096	584	664	8	51	80	0.6375000
NODE_3836_length_1208_cov_18.577096	584	664	11	1	80	0.0125000
NODE_3836_length_1208_cov_18.577096	584	664	13	21	80	0.2625000
NODE_3836_length_1208_cov_18.577096	637	717	6	5	80	0.0625000
NODE_3836_length_1208_cov_18.577096	637	717	8	75	80	0.9375000
NODE_3837_length_1208_cov_12.733995	766	846	0	80	80	1.0000000
NODE_3837_length_1208_cov_12.733995	819	899	0	80	80	1.0000000
NODE_3837_length_1208_cov_12.733995	895	975	0	80	80	1.0000000
NODE_3837_length_1208_cov_12.733995	948	1028	0	80	80	1.0000000
NODE_3838_length_1207_cov_20.461191	874	954	2	59	80	0.7375000
NODE_3838_length_1207_cov_20.461191	874	954	6	2	80	0.0250000
NODE_3838_length_1207_cov_20.461191	874	954	8	19	80	0.2375000
NODE_3838_length_1207_cov_20.461191	927	1007	0	45	80	0.5625000
NODE_3838_length_1207_cov_20.461191	927	1007	2	35	80	0.4375000
NODE_3846_length_1206_cov_59.851852	540	620	0	80	80	1.0000000
NODE_3846_length_1206_cov_59.851852	593	673	0	80	80	1.0000000
NODE_3846_length_1206_cov_59.851852	669	749	0	80	80	1.0000000
NODE_3846_length_1206_cov_59.851852	722	802	0	80	80	1.0000000
NODE_3847_length_1206_cov_23.752484	669	749	1	10	80	0.1250000
NODE_3847_length_1206_cov_23.752484	669	749	5	37	80	0.4625000
NODE_3847_length_1206_cov_23.752484	669	749	6	33	80	0.4125000
NODE_3847_length_1206_cov_23.752484	722	802	1	33	80	0.4125000
NODE_3847_length_1206_cov_23.752484	722	802	5	43	80	0.5375000
NODE_3847_length_1206_cov_23.752484	722	802	6	4	80	0.0500000
NODE_3848_length_1206_cov_21.226739	585	665	2	80	80	1.0000000
NODE_3848_length_1206_cov_21.226739	638	718	0	48	80	0.6000000
NODE_3848_length_1206_cov_21.226739	638	718	2	32	80	0.4000000
NODE_3855_length_1205_cov_23.990054	355	435	0	6	80	0.0750000
NODE_3855_length_1205_cov_23.990054	355	435	5	8	80	0.1000000
NODE_3855_length_1205_cov_23.990054	355	435	8	53	80	0.6625000
NODE_3855_length_1205_cov_23.990054	355	435	9	13	80	0.1625000
NODE_3855_length_1205_cov_23.990054	408	488	6	14	80	0.1750000
NODE_3855_length_1205_cov_23.990054	408	488	8	14	80	0.1750000
NODE_3855_length_1205_cov_23.990054	408	488	9	21	80	0.2625000
NODE_3855_length_1205_cov_23.990054	408	488	12	31	80	0.3875000
NODE_3856_length_1205_cov_10.473779	780	860	0	80	80	1.0000000
NODE_3856_length_1205_cov_10.473779	833	913	0	80	80	1.0000000
NODE_3863_length_1204_cov_19.396380	537	617	0	2	80	0.0250000
NODE_3863_length_1204_cov_19.396380	537	617	4	78	80	0.9750000
NODE_3863_length_1204_cov_19.396380	590	670	0	6	80	0.0750000
NODE_3863_length_1204_cov_19.396380	590	670	4	74	80	0.9250000
NODE_3864_length_1204_cov_17.716742	448	528	0	80	80	1.0000000
NODE_3864_length_1204_cov_17.716742	501	581	0	80	80	1.0000000
NODE_3865_length_1204_cov_15.206335	426	506	0	62	80	0.7750000
NODE_3865_length_1204_cov_15.206335	426	506	2	4	80	0.0500000
NODE_3865_length_1204_cov_15.206335	426	506	4	14	80	0.1750000
NODE_3865_length_1204_cov_15.206335	479	559	0	9	80	0.1125000
NODE_3865_length_1204_cov_15.206335	479	559	2	4	80	0.0500000
NODE_3865_length_1204_cov_15.206335	479	559	3	27	80	0.3375000
NODE_3865_length_1204_cov_15.206335	479	559	4	40	80	0.5000000
NODE_3866_length_1204_cov_14.097738	632	712	0	80	80	1.0000000
NODE_3866_length_1204_cov_14.097738	685	765	0	80	80	1.0000000
NODE_3867_length_1204_cov_11.971946	549	629	4	78	80	0.9750000
NODE_3867_length_1204_cov_11.971946	549	629	6	2	80	0.0250000
NODE_3867_length_1204_cov_11.971946	602	682	2	32	80	0.4000000
NODE_3867_length_1204_cov_11.971946	602	682	4	48	80	0.6000000
NODE_3867_length_1204_cov_11.971946	678	758	0	72	80	0.9000000
NODE_3867_length_1204_cov_11.971946	678	758	2	8	80	0.1000000
NODE_3867_length_1204_cov_11.971946	731	811	0	80	80	1.0000000
NODE_3868_length_1204_cov_11.665158	499	579	2	10	80	0.1250000
NODE_3868_length_1204_cov_11.665158	499	579	4	3	80	0.0375000
NODE_3868_length_1204_cov_11.665158	499	579	5	5	80	0.0625000
NODE_3868_length_1204_cov_11.665158	499	579	6	62	80	0.7750000
NODE_3868_length_1204_cov_11.665158	552	632	2	10	80	0.1250000
NODE_3868_length_1204_cov_11.665158	552	632	4	3	80	0.0375000
NODE_3868_length_1204_cov_11.665158	552	632	5	5	80	0.0625000
NODE_3868_length_1204_cov_11.665158	552	632	6	62	80	0.7750000
NODE_3869_length_1204_cov_7.028959	637	717	0	80	80	1.0000000
NODE_3869_length_1204_cov_7.028959	690	770	0	80	80	1.0000000
NODE_3870_length_1204_cov_4.677828	807	887	0	80	80	1.0000000
NODE_3870_length_1204_cov_4.677828	860	940	0	80	80	1.0000000
NODE_3873_length_1203_cov_46.789855	515	595	0	80	80	1.0000000
NODE_3873_length_1203_cov_46.789855	568	648	0	80	80	1.0000000
NODE_3873_length_1203_cov_46.789855	644	724	0	80	80	1.0000000
NODE_3873_length_1203_cov_46.789855	697	777	0	80	80	1.0000000
NODE_3874_length_1203_cov_44.029891	471	551	0	80	80	1.0000000
NODE_3874_length_1203_cov_44.029891	524	604	0	80	80	1.0000000
NODE_3874_length_1203_cov_44.029891	600	680	0	80	80	1.0000000
NODE_3874_length_1203_cov_44.029891	653	733	0	80	80	1.0000000
NODE_3875_length_1203_cov_23.790761	308	388	0	47	80	0.5875000
NODE_3875_length_1203_cov_23.790761	308	388	1	8	80	0.1000000
NODE_3875_length_1203_cov_23.790761	308	388	2	25	80	0.3125000
NODE_3875_length_1203_cov_23.790761	361	441	1	2	80	0.0250000
NODE_3875_length_1203_cov_23.790761	361	441	2	78	80	0.9750000
NODE_3875_length_1203_cov_23.790761	437	517	2	39	80	0.4875000
NODE_3875_length_1203_cov_23.790761	437	517	3	8	80	0.1000000
NODE_3875_length_1203_cov_23.790761	437	517	4	33	80	0.4125000
NODE_3875_length_1203_cov_23.790761	490	570	0	10	80	0.1250000
NODE_3875_length_1203_cov_23.790761	490	570	2	47	80	0.5875000
NODE_3875_length_1203_cov_23.790761	490	570	3	8	80	0.1000000
NODE_3875_length_1203_cov_23.790761	490	570	4	15	80	0.1875000
NODE_3876_length_1203_cov_19.498188	336	416	8	80	80	1.0000000
NODE_3876_length_1203_cov_19.498188	389	469	0	40	80	0.5000000
NODE_3876_length_1203_cov_19.498188	389	469	8	40	80	0.5000000
NODE_3877_length_1203_cov_10.996377	317	397	0	80	80	1.0000000
NODE_3877_length_1203_cov_10.996377	370	450	0	39	80	0.4875000
NODE_3877_length_1203_cov_10.996377	370	450	4	41	80	0.5125000
NODE_3878_length_1203_cov_5.747283	725	805	0	80	80	1.0000000
NODE_3878_length_1203_cov_5.747283	778	858	0	64	80	0.8000000
NODE_3878_length_1203_cov_5.747283	778	858	2	16	80	0.2000000
NODE_3881_length_1202_cov_39.333636	475	555	0	78	80	0.9750000
NODE_3881_length_1202_cov_39.333636	475	555	6	2	80	0.0250000
NODE_3881_length_1202_cov_39.333636	528	608	0	25	80	0.3125000
NODE_3881_length_1202_cov_39.333636	528	608	5	7	80	0.0875000
NODE_3881_length_1202_cov_39.333636	528	608	6	48	80	0.6000000
NODE_3881_length_1202_cov_39.333636	604	684	0	24	80	0.3000000
NODE_3881_length_1202_cov_39.333636	604	684	5	56	80	0.7000000
NODE_3881_length_1202_cov_39.333636	657	737	0	77	80	0.9625000
NODE_3881_length_1202_cov_39.333636	657	737	5	3	80	0.0375000
NODE_3882_length_1202_cov_17.556664	599	679	0	40	80	0.5000000
NODE_3882_length_1202_cov_17.556664	599	679	4	20	80	0.2500000
NODE_3882_length_1202_cov_17.556664	599	679	6	20	80	0.2500000
NODE_3882_length_1202_cov_17.556664	652	732	4	7	80	0.0875000
NODE_3882_length_1202_cov_17.556664	652	732	6	26	80	0.3250000
NODE_3882_length_1202_cov_17.556664	652	732	10	47	80	0.5875000
NODE_3883_length_1202_cov_12.338169	634	714	10	80	80	1.0000000
NODE_3883_length_1202_cov_12.338169	687	767	0	23	80	0.2875000
NODE_3883_length_1202_cov_12.338169	687	767	4	26	80	0.3250000
NODE_3883_length_1202_cov_12.338169	687	767	10	31	80	0.3875000
NODE_3884_length_1202_cov_11.800544	520	600	0	53	80	0.6625000
NODE_3884_length_1202_cov_11.800544	520	600	4	27	80	0.3375000
NODE_3884_length_1202_cov_11.800544	573	653	0	1	80	0.0125000
NODE_3884_length_1202_cov_11.800544	573	653	4	79	80	0.9875000
NODE_3887_length_1201_cov_12.161525	434	514	0	80	80	1.0000000
NODE_3887_length_1201_cov_12.161525	487	567	0	80	80	1.0000000
NODE_3888_length_1201_cov_12.046279	643	723	0	80	80	1.0000000
NODE_3888_length_1201_cov_12.046279	696	776	0	80	80	1.0000000
NODE_3891_length_1200_cov_76.694823	630	710	0	35	80	0.4375000
NODE_3891_length_1200_cov_76.694823	630	710	2	45	80	0.5625000
NODE_3891_length_1200_cov_76.694823	683	763	0	80	80	1.0000000
NODE_3891_length_1200_cov_76.694823	759	839	0	29	80	0.3625000
NODE_3891_length_1200_cov_76.694823	759	839	1	4	80	0.0500000
NODE_3891_length_1200_cov_76.694823	759	839	2	47	80	0.5875000
NODE_3891_length_1200_cov_76.694823	812	892	2	80	80	1.0000000
NODE_3892_length_1200_cov_16.881926	827	902	6	21	75	0.2800000
NODE_3892_length_1200_cov_16.881926	827	902	7	21	75	0.2800000
NODE_3892_length_1200_cov_16.881926	827	902	8	3	75	0.0400000
NODE_3892_length_1200_cov_16.881926	827	902	9	20	75	0.2666667
NODE_3892_length_1200_cov_16.881926	827	902	11	10	75	0.1333333
NODE_3892_length_1200_cov_16.881926	828	904	6	20	76	0.2631579
NODE_3892_length_1200_cov_16.881926	828	904	7	21	76	0.2763158
NODE_3892_length_1200_cov_16.881926	828	904	8	3	76	0.0394737
NODE_3892_length_1200_cov_16.881926	828	904	9	22	76	0.2894737
NODE_3892_length_1200_cov_16.881926	828	904	11	10	76	0.1315790
NODE_3892_length_1200_cov_16.881926	841	907	6	7	66	0.1060606
NODE_3892_length_1200_cov_16.881926	841	907	7	21	66	0.3181818
NODE_3892_length_1200_cov_16.881926	841	907	8	3	66	0.0454545
NODE_3892_length_1200_cov_16.881926	841	907	9	25	66	0.3787879
NODE_3892_length_1200_cov_16.881926	841	907	11	10	66	0.1515152
NODE_3892_length_1200_cov_16.881926	880	957	8	2	77	0.0259740
NODE_3892_length_1200_cov_16.881926	880	957	9	34	77	0.4415585
NODE_3892_length_1200_cov_16.881926	880	957	10	8	77	0.1038961
NODE_3892_length_1200_cov_16.881926	880	957	11	31	77	0.4025974
NODE_3892_length_1200_cov_16.881926	880	957	14	2	77	0.0259740
NODE_3892_length_1200_cov_16.881926	880	957	8	2	77	0.0259740
NODE_3892_length_1200_cov_16.881926	880	957	9	34	77	0.4415585
NODE_3892_length_1200_cov_16.881926	880	957	10	8	77	0.1038961
NODE_3892_length_1200_cov_16.881926	880	957	11	31	77	0.4025974
NODE_3892_length_1200_cov_16.881926	880	957	14	2	77	0.0259740
NODE_3892_length_1200_cov_16.881926	880	957	8	2	77	0.0259740
NODE_3892_length_1200_cov_16.881926	880	957	9	34	77	0.4415585
NODE_3892_length_1200_cov_16.881926	880	957	10	8	77	0.1038961
NODE_3892_length_1200_cov_16.881926	880	957	11	31	77	0.4025974
NODE_3892_length_1200_cov_16.881926	880	957	14	2	77	0.0259740
NODE_3893_length_1200_cov_15.374205	605	685	4	80	80	1.0000000
NODE_3893_length_1200_cov_15.374205	658	738	0	36	80	0.4500000
NODE_3893_length_1200_cov_15.374205	658	738	2	6	80	0.0750000
NODE_3893_length_1200_cov_15.374205	658	738	4	38	80	0.4750000
NODE_3894_length_1200_cov_12.953678	486	550	12	3	64	0.0468750
NODE_3894_length_1200_cov_12.953678	486	550	14	23	64	0.3593750
NODE_3894_length_1200_cov_12.953678	486	550	16	5	64	0.0781250
NODE_3894_length_1200_cov_12.953678	486	550	17	32	64	0.5000000
NODE_3894_length_1200_cov_12.953678	486	550	18	1	64	0.0156250
NODE_3899_length_1199_cov_14.843636	222	302	0	71	80	0.8875000
NODE_3899_length_1199_cov_14.843636	222	302	2	9	80	0.1125000
NODE_3899_length_1199_cov_14.843636	275	355	0	18	80	0.2250000
NODE_3899_length_1199_cov_14.843636	275	355	2	62	80	0.7750000
NODE_3900_length_1199_cov_12.005455	383	463	0	80	80	1.0000000
NODE_3900_length_1199_cov_12.005455	436	516	0	80	80	1.0000000
NODE_3900_length_1199_cov_12.005455	512	592	0	25	80	0.3125000
NODE_3900_length_1199_cov_12.005455	512	592	4	55	80	0.6875000
NODE_3900_length_1199_cov_12.005455	565	645	0	15	80	0.1875000
NODE_3900_length_1199_cov_12.005455	565	645	4	65	80	0.8125000
NODE_3902_length_1198_cov_36.830755	619	699	0	18	80	0.2250000
NODE_3902_length_1198_cov_36.830755	619	699	2	62	80	0.7750000
NODE_3902_length_1198_cov_36.830755	672	752	2	48	80	0.6000000
NODE_3902_length_1198_cov_36.830755	672	752	4	32	80	0.4000000
NODE_3903_length_1198_cov_22.864422	719	799	0	80	80	1.0000000
NODE_3903_length_1198_cov_22.864422	772	852	0	80	80	1.0000000
NODE_3904_length_1198_cov_17.619654	260	340	0	37	80	0.4625000
NODE_3904_length_1198_cov_17.619654	260	340	2	43	80	0.5375000
NODE_3904_length_1198_cov_17.619654	313	392	2	67	79	0.8481013
NODE_3904_length_1198_cov_17.619654	313	392	4	12	79	0.1518987
NODE_3905_length_1198_cov_10.148317	718	798	2	59	80	0.7375000
NODE_3905_length_1198_cov_10.148317	718	798	4	21	80	0.2625000
NODE_3905_length_1198_cov_10.148317	771	851	2	53	80	0.6625000
NODE_3905_length_1198_cov_10.148317	771	851	4	27	80	0.3375000
NODE_3906_length_1198_cov_6.733394	549	629	0	80	80	1.0000000
NODE_3906_length_1198_cov_6.733394	602	682	0	80	80	1.0000000
NODE_3912_length_1197_cov_27.653005	417	497	0	77	80	0.9625000
NODE_3912_length_1197_cov_27.653005	417	497	2	3	80	0.0375000
NODE_3912_length_1197_cov_27.653005	470	550	0	80	80	1.0000000
NODE_3912_length_1197_cov_27.653005	546	626	0	80	80	1.0000000
NODE_3912_length_1197_cov_27.653005	599	679	0	80	80	1.0000000
NODE_3913_length_1197_cov_14.653916	490	570	0	32	80	0.4000000
NODE_3913_length_1197_cov_14.653916	490	570	1	48	80	0.6000000
NODE_3913_length_1197_cov_14.653916	543	623	1	80	80	1.0000000
NODE_3921_length_1196_cov_26.169553	298	378	0	26	80	0.3250000
NODE_3921_length_1196_cov_26.169553	298	378	2	54	80	0.6750000
NODE_3921_length_1196_cov_26.169553	351	431	0	21	80	0.2625000
NODE_3921_length_1196_cov_26.169553	351	431	2	59	80	0.7375000
NODE_3921_length_1196_cov_26.169553	427	507	0	80	80	1.0000000
NODE_3921_length_1196_cov_26.169553	480	560	0	80	80	1.0000000
NODE_3922_length_1196_cov_21.755697	521	601	0	80	80	1.0000000
NODE_3922_length_1196_cov_21.755697	574	654	0	80	80	1.0000000
NODE_3922_length_1196_cov_21.755697	650	730	0	41	80	0.5125000
NODE_3922_length_1196_cov_21.755697	650	730	2	39	80	0.4875000
NODE_3922_length_1196_cov_21.755697	703	783	0	12	80	0.1500000
NODE_3922_length_1196_cov_21.755697	703	783	2	68	80	0.8500000
NODE_3923_length_1196_cov_5.966272	556	636	0	29	80	0.3625000
NODE_3923_length_1196_cov_5.966272	556	636	2	19	80	0.2375000
NODE_3923_length_1196_cov_5.966272	556	636	4	32	80	0.4000000
NODE_3923_length_1196_cov_5.966272	609	689	2	7	80	0.0875000
NODE_3923_length_1196_cov_5.966272	609	689	4	73	80	0.9125000
NODE_3927_length_1195_cov_69.056569	474	554	2	16	80	0.2000000
NODE_3927_length_1195_cov_69.056569	474	554	4	2	80	0.0250000
NODE_3927_length_1195_cov_69.056569	474	554	5	62	80	0.7750000
NODE_3927_length_1195_cov_69.056569	527	607	1	15	80	0.1875000
NODE_3927_length_1195_cov_69.056569	527	607	2	22	80	0.2750000
NODE_3927_length_1195_cov_69.056569	527	607	3	9	80	0.1125000
NODE_3927_length_1195_cov_69.056569	527	607	5	34	80	0.4250000
NODE_3927_length_1195_cov_69.056569	603	683	2	23	80	0.2875000
NODE_3927_length_1195_cov_69.056569	603	683	4	13	80	0.1625000
NODE_3927_length_1195_cov_69.056569	603	683	6	14	80	0.1750000
NODE_3927_length_1195_cov_69.056569	603	683	7	30	80	0.3750000
NODE_3927_length_1195_cov_69.056569	656	736	0	1	80	0.0125000
NODE_3927_length_1195_cov_69.056569	656	736	1	10	80	0.1250000
NODE_3927_length_1195_cov_69.056569	656	736	3	1	80	0.0125000
NODE_3927_length_1195_cov_69.056569	656	736	4	14	80	0.1750000
NODE_3927_length_1195_cov_69.056569	656	736	6	25	80	0.3125000
NODE_3927_length_1195_cov_69.056569	656	736	7	29	80	0.3625000
NODE_3928_length_1195_cov_65.062044	579	659	2	5	80	0.0625000
NODE_3928_length_1195_cov_65.062044	579	659	4	75	80	0.9375000
NODE_3928_length_1195_cov_65.062044	632	712	2	23	80	0.2875000
NODE_3928_length_1195_cov_65.062044	632	712	4	57	80	0.7125000
NODE_3928_length_1195_cov_65.062044	708	788	0	3	80	0.0375000
NODE_3928_length_1195_cov_65.062044	708	788	2	77	80	0.9625000
NODE_3928_length_1195_cov_65.062044	761	841	0	56	80	0.7000000
NODE_3928_length_1195_cov_65.062044	761	841	2	24	80	0.3000000
NODE_3929_length_1195_cov_23.187044	460	540	0	80	80	1.0000000
NODE_3929_length_1195_cov_23.187044	513	593	0	80	80	1.0000000
NODE_3930_length_1195_cov_18.983577	521	601	2	80	80	1.0000000
NODE_3930_length_1195_cov_18.983577	574	654	0	23	80	0.2875000
NODE_3930_length_1195_cov_18.983577	574	654	2	57	80	0.7125000
NODE_3931_length_1195_cov_14.119526	726	806	0	80	80	1.0000000
NODE_3931_length_1195_cov_14.119526	779	859	0	80	80	1.0000000
NODE_3931_length_1195_cov_14.119526	855	935	0	80	80	1.0000000
NODE_3931_length_1195_cov_14.119526	908	988	0	80	80	1.0000000
NODE_3932_length_1195_cov_13.805657	759	839	0	36	80	0.4500000
NODE_3932_length_1195_cov_13.805657	759	839	2	44	80	0.5500000
NODE_3932_length_1195_cov_13.805657	812	892	0	7	80	0.0875000
NODE_3932_length_1195_cov_13.805657	812	892	2	73	80	0.9125000
NODE_3938_length_1195_cov_1.969891	912	992	4	28	80	0.3500000
NODE_3938_length_1195_cov_1.969891	912	992	6	52	80	0.6500000
NODE_3938_length_1195_cov_1.969891	912	992	4	28	80	0.3500000
NODE_3938_length_1195_cov_1.969891	912	992	6	52	80	0.6500000
NODE_3941_length_1194_cov_40.157991	237	317	0	27	80	0.3375000
NODE_3941_length_1194_cov_40.157991	237	317	2	34	80	0.4250000
NODE_3941_length_1194_cov_40.157991	237	317	4	19	80	0.2375000
NODE_3941_length_1194_cov_40.157991	290	370	0	80	80	1.0000000
NODE_3946_length_1193_cov_34.295247	443	523	0	8	80	0.1000000
NODE_3946_length_1193_cov_34.295247	443	523	2	72	80	0.9000000
NODE_3946_length_1193_cov_34.295247	496	576	0	46	80	0.5750000
NODE_3946_length_1193_cov_34.295247	496	576	2	34	80	0.4250000
NODE_3947_length_1193_cov_16.930530	124	154	10	30	30	1.0000000
NODE_3947_length_1193_cov_16.930530	390	470	0	17	80	0.2125000
NODE_3947_length_1193_cov_16.930530	390	470	3	1	80	0.0125000
NODE_3947_length_1193_cov_16.930530	390	470	4	24	80	0.3000000
NODE_3947_length_1193_cov_16.930530	390	470	6	29	80	0.3625000
NODE_3947_length_1193_cov_16.930530	390	470	10	9	80	0.1125000
NODE_3947_length_1193_cov_16.930530	443	523	0	70	80	0.8750000
NODE_3947_length_1193_cov_16.930530	443	523	3	1	80	0.0125000
NODE_3947_length_1193_cov_16.930530	443	523	4	9	80	0.1125000
NODE_3949_length_1192_cov_26.803294	205	285	4	80	80	1.0000000
NODE_3949_length_1192_cov_26.803294	258	338	0	53	80	0.6625000
NODE_3949_length_1192_cov_26.803294	258	338	4	27	80	0.3375000
NODE_3949_length_1192_cov_26.803294	334	414	0	80	80	1.0000000
NODE_3949_length_1192_cov_26.803294	387	467	0	64	80	0.8000000
NODE_3949_length_1192_cov_26.803294	387	467	2	16	80	0.2000000
NODE_3950_length_1192_cov_23.228728	487	567	0	80	80	1.0000000
NODE_3950_length_1192_cov_23.228728	540	620	0	80	80	1.0000000
NODE_3950_length_1192_cov_23.228728	616	696	0	12	80	0.1500000
NODE_3950_length_1192_cov_23.228728	616	696	2	62	80	0.7750000
NODE_3950_length_1192_cov_23.228728	616	696	4	6	80	0.0750000
NODE_3950_length_1192_cov_23.228728	669	749	2	21	80	0.2625000
NODE_3950_length_1192_cov_23.228728	669	749	4	18	80	0.2250000
NODE_3950_length_1192_cov_23.228728	669	749	6	41	80	0.5125000
NODE_3951_length_1192_cov_18.314730	613	693	0	80	80	1.0000000
NODE_3951_length_1192_cov_18.314730	666	746	0	80	80	1.0000000
NODE_3951_length_1192_cov_18.314730	742	822	0	80	80	1.0000000
NODE_3951_length_1192_cov_18.314730	795	875	0	80	80	1.0000000
NODE_3952_length_1192_cov_14.888381	622	702	0	41	80	0.5125000
NODE_3952_length_1192_cov_14.888381	622	702	2	39	80	0.4875000
NODE_3952_length_1192_cov_14.888381	675	755	2	46	80	0.5750000
NODE_3952_length_1192_cov_14.888381	675	755	4	34	80	0.4250000
NODE_3952_length_1192_cov_14.888381	751	831	2	10	80	0.1250000
NODE_3952_length_1192_cov_14.888381	751	831	4	23	80	0.2875000
NODE_3952_length_1192_cov_14.888381	751	831	6	47	80	0.5875000
NODE_3952_length_1192_cov_14.888381	804	884	0	34	80	0.4250000
NODE_3952_length_1192_cov_14.888381	804	884	3	4	80	0.0500000
NODE_3952_length_1192_cov_14.888381	804	884	4	38	80	0.4750000
NODE_3952_length_1192_cov_14.888381	804	884	6	4	80	0.0500000
NODE_3953_length_1192_cov_9.995425	161	241	2	25	80	0.3125000
NODE_3953_length_1192_cov_9.995425	161	241	4	55	80	0.6875000
NODE_3953_length_1192_cov_9.995425	214	294	0	50	80	0.6250000
NODE_3953_length_1192_cov_9.995425	214	294	2	25	80	0.3125000
NODE_3953_length_1192_cov_9.995425	214	294	4	5	80	0.0625000
NODE_3954_length_1192_cov_5.078683	749	829	14	20	80	0.2500000
NODE_3954_length_1192_cov_5.078683	749	829	16	60	80	0.7500000
NODE_3954_length_1192_cov_5.078683	802	882	2	8	80	0.1000000
NODE_3954_length_1192_cov_5.078683	802	882	4	20	80	0.2500000
NODE_3954_length_1192_cov_5.078683	802	882	8	1	80	0.0125000
NODE_3954_length_1192_cov_5.078683	802	882	10	6	80	0.0750000
NODE_3954_length_1192_cov_5.078683	802	882	14	11	80	0.1375000
NODE_3954_length_1192_cov_5.078683	802	882	16	34	80	0.4250000
NODE_3960_length_1192_cov_0.614822	1046	1126	0	80	80	1.0000000
NODE_3961_length_1191_cov_55.466117	392	472	2	80	80	1.0000000
NODE_3961_length_1191_cov_55.466117	445	525	1	2	80	0.0250000
NODE_3961_length_1191_cov_55.466117	445	525	2	78	80	0.9750000
NODE_3961_length_1191_cov_55.466117	521	601	0	67	80	0.8375000
NODE_3961_length_1191_cov_55.466117	521	601	1	11	80	0.1375000
NODE_3961_length_1191_cov_55.466117	521	601	2	2	80	0.0250000
NODE_3961_length_1191_cov_55.466117	574	654	0	80	80	1.0000000
NODE_3963_length_1191_cov_20.677656	695	775	0	80	80	1.0000000
NODE_3963_length_1191_cov_20.677656	748	828	0	78	80	0.9750000
NODE_3963_length_1191_cov_20.677656	748	828	2	2	80	0.0250000
NODE_3964_length_1191_cov_9.074176	420	500	0	80	80	1.0000000
NODE_3964_length_1191_cov_9.074176	473	553	0	80	80	1.0000000
NODE_3968_length_1190_cov_40.916590	521	601	0	5	80	0.0625000
NODE_3968_length_1190_cov_40.916590	521	601	8	1	80	0.0125000
NODE_3968_length_1190_cov_40.916590	521	601	9	11	80	0.1375000
NODE_3968_length_1190_cov_40.916590	521	601	17	36	80	0.4500000
NODE_3968_length_1190_cov_40.916590	521	601	18	27	80	0.3375000
NODE_3968_length_1190_cov_40.916590	574	654	17	80	80	1.0000000
NODE_3968_length_1190_cov_40.916590	650	730	0	42	80	0.5250000
NODE_3968_length_1190_cov_40.916590	650	730	6	1	80	0.0125000
NODE_3968_length_1190_cov_40.916590	650	730	9	11	80	0.1375000
NODE_3968_length_1190_cov_40.916590	650	730	16	1	80	0.0125000
NODE_3968_length_1190_cov_40.916590	650	730	17	25	80	0.3125000
NODE_3968_length_1190_cov_40.916590	703	783	0	80	80	1.0000000
NODE_3969_length_1190_cov_20.715857	257	337	0	80	80	1.0000000
NODE_3969_length_1190_cov_20.715857	310	390	0	80	80	1.0000000
NODE_3970_length_1190_cov_19.724106	296	376	0	80	80	1.0000000
NODE_3970_length_1190_cov_19.724106	349	429	0	80	80	1.0000000
NODE_3973_length_1190_cov_2.698442	1022	1070	1	27	48	0.5625000
NODE_3973_length_1190_cov_2.698442	1022	1070	3	3	48	0.0625000
NODE_3973_length_1190_cov_2.698442	1022	1070	5	15	48	0.3125000
NODE_3973_length_1190_cov_2.698442	1022	1070	7	3	48	0.0625000
NODE_3973_length_1190_cov_2.698442	1075	1123	6	36	48	0.7500000
NODE_3973_length_1190_cov_2.698442	1075	1123	7	12	48	0.2500000
NODE_3977_length_1189_cov_29.193578	576	656	2	12	80	0.1500000
NODE_3977_length_1189_cov_29.193578	576	656	4	20	80	0.2500000
NODE_3977_length_1189_cov_29.193578	576	656	6	48	80	0.6000000
NODE_3977_length_1189_cov_29.193578	629	709	4	57	80	0.7125000
NODE_3977_length_1189_cov_29.193578	629	709	6	23	80	0.2875000
NODE_3978_length_1189_cov_13.484404	315	341	0	26	26	1.0000000
NODE_3978_length_1189_cov_13.484404	366	446	2	70	80	0.8750000
NODE_3978_length_1189_cov_13.484404	366	446	4	10	80	0.1250000
NODE_3984_length_1188_cov_19.278237	396	476	4	1	80	0.0125000
NODE_3984_length_1188_cov_19.278237	396	476	6	22	80	0.2750000
NODE_3984_length_1188_cov_19.278237	396	476	8	5	80	0.0625000
NODE_3984_length_1188_cov_19.278237	396	476	9	1	80	0.0125000
NODE_3984_length_1188_cov_19.278237	396	476	10	51	80	0.6375000
NODE_3984_length_1188_cov_19.278237	449	529	8	58	80	0.7250000
NODE_3984_length_1188_cov_19.278237	449	529	10	22	80	0.2750000
NODE_3990_length_1187_cov_63.185662	529	609	0	4	80	0.0500000
NODE_3990_length_1187_cov_63.185662	529	609	2	29	80	0.3625000
NODE_3990_length_1187_cov_63.185662	529	609	4	47	80	0.5875000
NODE_3990_length_1187_cov_63.185662	582	662	0	4	80	0.0500000
NODE_3990_length_1187_cov_63.185662	582	662	2	16	80	0.2000000
NODE_3990_length_1187_cov_63.185662	582	662	4	60	80	0.7500000
NODE_3990_length_1187_cov_63.185662	658	738	0	28	80	0.3500000
NODE_3990_length_1187_cov_63.185662	658	738	4	52	80	0.6500000
NODE_3990_length_1187_cov_63.185662	711	791	0	80	80	1.0000000
NODE_3991_length_1187_cov_36.926471	432	512	0	9	80	0.1125000
NODE_3991_length_1187_cov_36.926471	432	512	7	51	80	0.6375000
NODE_3991_length_1187_cov_36.926471	432	512	8	20	80	0.2500000
NODE_3991_length_1187_cov_36.926471	485	565	0	14	80	0.1750000
NODE_3991_length_1187_cov_36.926471	485	565	7	7	80	0.0875000
NODE_3991_length_1187_cov_36.926471	485	565	8	59	80	0.7375000
NODE_3991_length_1187_cov_36.926471	561	641	0	22	80	0.2750000
NODE_3991_length_1187_cov_36.926471	561	641	8	58	80	0.7250000
NODE_3991_length_1187_cov_36.926471	614	694	0	13	80	0.1625000
NODE_3991_length_1187_cov_36.926471	614	694	8	67	80	0.8375000
NODE_3992_length_1187_cov_20.383272	492	572	0	32	80	0.4000000
NODE_3992_length_1187_cov_20.383272	492	572	6	48	80	0.6000000
NODE_3992_length_1187_cov_20.383272	545	625	2	14	80	0.1750000
NODE_3992_length_1187_cov_20.383272	545	625	6	36	80	0.4500000
NODE_3992_length_1187_cov_20.383272	545	625	8	30	80	0.3750000
NODE_3993_length_1187_cov_17.941176	377	457	0	80	80	1.0000000
NODE_3993_length_1187_cov_17.941176	430	510	0	80	80	1.0000000
NODE_3993_length_1187_cov_17.941176	506	586	0	27	80	0.3375000
NODE_3993_length_1187_cov_17.941176	506	586	4	53	80	0.6625000
NODE_3993_length_1187_cov_17.941176	559	639	0	4	80	0.0500000
NODE_3993_length_1187_cov_17.941176	559	639	4	76	80	0.9500000
NODE_3997_length_1186_cov_59.606256	338	418	5	18	80	0.2250000
NODE_3997_length_1186_cov_59.606256	338	418	6	31	80	0.3875000
NODE_3997_length_1186_cov_59.606256	338	418	7	31	80	0.3875000
NODE_3997_length_1186_cov_59.606256	391	471	1	15	80	0.1875000
NODE_3997_length_1186_cov_59.606256	391	471	3	33	80	0.4125000
NODE_3997_length_1186_cov_59.606256	391	471	5	21	80	0.2625000
NODE_3997_length_1186_cov_59.606256	391	471	7	11	80	0.1375000
NODE_3997_length_1186_cov_59.606256	480	551	0	25	71	0.3521127
NODE_3997_length_1186_cov_59.606256	480	551	13	1	71	0.0140845
NODE_3997_length_1186_cov_59.606256	480	551	15	6	71	0.0845070
NODE_3997_length_1186_cov_59.606256	480	551	16	39	71	0.5492958
NODE_3997_length_1186_cov_59.606256	524	604	0	25	80	0.3125000
NODE_3997_length_1186_cov_59.606256	524	604	14	1	80	0.0125000
NODE_3997_length_1186_cov_59.606256	524	604	15	20	80	0.2500000
NODE_3997_length_1186_cov_59.606256	524	604	16	34	80	0.4250000
NODE_3998_length_1186_cov_34.937443	582	662	0	28	80	0.3500000
NODE_3998_length_1186_cov_34.937443	582	662	2	52	80	0.6500000
NODE_3998_length_1186_cov_34.937443	635	715	0	80	80	1.0000000
NODE_3998_length_1186_cov_34.937443	711	791	0	40	80	0.5000000
NODE_3998_length_1186_cov_34.937443	711	791	4	40	80	0.5000000
NODE_3998_length_1186_cov_34.937443	764	844	0	4	80	0.0500000
NODE_3998_length_1186_cov_34.937443	764	844	4	76	80	0.9500000
NODE_3999_length_1186_cov_29.840846	511	591	9	3	80	0.0375000
NODE_3999_length_1186_cov_29.840846	511	591	17	77	80	0.9625000
NODE_3999_length_1186_cov_29.840846	564	644	0	4	80	0.0500000
NODE_3999_length_1186_cov_29.840846	564	644	8	16	80	0.2000000
NODE_3999_length_1186_cov_29.840846	564	644	10	12	80	0.1500000
NODE_3999_length_1186_cov_29.840846	564	644	15	4	80	0.0500000
NODE_3999_length_1186_cov_29.840846	564	644	17	44	80	0.5500000
NODE_3999_length_1186_cov_29.840846	640	720	0	80	80	1.0000000
NODE_3999_length_1186_cov_29.840846	693	773	0	80	80	1.0000000
NODE_4000_length_1186_cov_13.108556	578	658	0	80	80	1.0000000
NODE_4000_length_1186_cov_13.108556	631	711	0	80	80	1.0000000
NODE_4001_length_1186_cov_12.867525	404	484	0	80	80	1.0000000
NODE_4001_length_1186_cov_12.867525	457	534	0	75	77	0.9740260
NODE_4001_length_1186_cov_12.867525	457	534	2	2	77	0.0259740
NODE_4001_length_1186_cov_12.867525	536	613	2	3	77	0.0389610
NODE_4001_length_1186_cov_12.867525	536	613	4	74	77	0.9610389
NODE_4001_length_1186_cov_12.867525	586	666	2	6	80	0.0750000
NODE_4001_length_1186_cov_12.867525	586	666	4	47	80	0.5875000
NODE_4001_length_1186_cov_12.867525	586	666	6	27	80	0.3375000
NODE_4002_length_1186_cov_12.135235	643	723	5	55	80	0.6875000
NODE_4002_length_1186_cov_12.135235	643	723	6	25	80	0.3125000
NODE_4002_length_1186_cov_12.135235	696	776	0	28	80	0.3500000
NODE_4002_length_1186_cov_12.135235	696	776	5	2	80	0.0250000
NODE_4002_length_1186_cov_12.135235	696	776	6	50	80	0.6250000
NODE_4012_length_1185_cov_36.974217	423	503	0	80	80	1.0000000
NODE_4012_length_1185_cov_36.974217	476	556	0	80	80	1.0000000
NODE_4013_length_1185_cov_28.410681	448	528	0	80	80	1.0000000
NODE_4013_length_1185_cov_28.410681	501	581	0	80	80	1.0000000
NODE_4014_length_1185_cov_19.768877	411	491	0	51	80	0.6375000
NODE_4014_length_1185_cov_19.768877	411	491	2	29	80	0.3625000
NODE_4014_length_1185_cov_19.768877	464	544	0	26	80	0.3250000
NODE_4014_length_1185_cov_19.768877	464	544	2	54	80	0.6750000
NODE_4014_length_1185_cov_19.768877	540	620	0	80	80	1.0000000
NODE_4014_length_1185_cov_19.768877	593	673	0	29	80	0.3625000
NODE_4014_length_1185_cov_19.768877	593	673	4	51	80	0.6375000
NODE_4015_length_1185_cov_14.490792	379	459	0	3	80	0.0375000
NODE_4015_length_1185_cov_14.490792	379	459	2	11	80	0.1375000
NODE_4015_length_1185_cov_14.490792	379	459	4	66	80	0.8250000
NODE_4015_length_1185_cov_14.490792	432	512	0	56	80	0.7000000
NODE_4015_length_1185_cov_14.490792	432	512	2	9	80	0.1125000
NODE_4015_length_1185_cov_14.490792	432	512	4	15	80	0.1875000
NODE_4016_length_1185_cov_13.686004	677	757	2	80	80	1.0000000
NODE_4016_length_1185_cov_13.686004	730	810	0	48	80	0.6000000
NODE_4016_length_1185_cov_13.686004	730	810	2	32	80	0.4000000
NODE_4017_length_1185_cov_12.362799	711	791	0	80	80	1.0000000
NODE_4017_length_1185_cov_12.362799	764	844	0	80	80	1.0000000
NODE_4024_length_1184_cov_30.061751	416	497	2	81	81	1.0000000
NODE_4024_length_1184_cov_30.061751	470	550	0	45	80	0.5625000
NODE_4024_length_1184_cov_30.061751	470	550	2	35	80	0.4375000
NODE_4024_length_1184_cov_30.061751	546	627	0	40	81	0.4938272
NODE_4024_length_1184_cov_30.061751	546	627	4	41	81	0.5061728
NODE_4024_length_1184_cov_30.061751	600	680	4	80	80	1.0000000
NODE_4025_length_1184_cov_19.544700	550	630	0	15	80	0.1875000
NODE_4025_length_1184_cov_19.544700	550	630	2	65	80	0.8125000
NODE_4025_length_1184_cov_19.544700	603	683	0	61	80	0.7625000
NODE_4025_length_1184_cov_19.544700	603	683	2	19	80	0.2375000
NODE_4025_length_1184_cov_19.544700	679	759	0	57	80	0.7125000
NODE_4025_length_1184_cov_19.544700	679	759	4	23	80	0.2875000
NODE_4025_length_1184_cov_19.544700	732	812	0	4	80	0.0500000
NODE_4025_length_1184_cov_19.544700	732	812	4	76	80	0.9500000
NODE_4026_length_1184_cov_9.129954	624	704	0	80	80	1.0000000
NODE_4026_length_1184_cov_9.129954	677	757	0	80	80	1.0000000
NODE_4031_length_1183_cov_17.260148	545	625	0	80	80	1.0000000
NODE_4031_length_1183_cov_17.260148	598	678	0	80	80	1.0000000
NODE_4031_length_1183_cov_17.260148	674	754	0	21	80	0.2625000
NODE_4031_length_1183_cov_17.260148	674	754	2	59	80	0.7375000
NODE_4031_length_1183_cov_17.260148	727	807	0	20	80	0.2500000
NODE_4031_length_1183_cov_17.260148	727	807	2	36	80	0.4500000
NODE_4031_length_1183_cov_17.260148	727	807	4	24	80	0.3000000
NODE_4032_length_1183_cov_9.777675	484	564	0	80	80	1.0000000
NODE_4032_length_1183_cov_9.777675	537	617	0	80	80	1.0000000
NODE_4033_length_1183_cov_6.847786	711	791	0	80	80	1.0000000
NODE_4033_length_1183_cov_6.847786	764	844	0	80	80	1.0000000
NODE_4033_length_1183_cov_6.847786	840	920	0	80	80	1.0000000
NODE_4033_length_1183_cov_6.847786	893	973	0	80	80	1.0000000
NODE_4035_length_1183_cov_2.680812	59	139	2	25	80	0.3125000
NODE_4035_length_1183_cov_2.680812	59	139	4	55	80	0.6875000
NODE_4040_length_1182_cov_64.600185	588	668	2	22	80	0.2750000
NODE_4040_length_1182_cov_64.600185	588	668	4	26	80	0.3250000
NODE_4040_length_1182_cov_64.600185	588	668	6	32	80	0.4000000
NODE_4040_length_1182_cov_64.600185	641	721	2	18	80	0.2250000
NODE_4040_length_1182_cov_64.600185	641	721	4	21	80	0.2625000
NODE_4040_length_1182_cov_64.600185	641	721	6	41	80	0.5125000
NODE_4040_length_1182_cov_64.600185	717	797	4	32	80	0.4000000
NODE_4040_length_1182_cov_64.600185	717	797	6	31	80	0.3875000
NODE_4040_length_1182_cov_64.600185	717	797	8	17	80	0.2125000
NODE_4040_length_1182_cov_64.600185	770	849	0	11	79	0.1392405
NODE_4040_length_1182_cov_64.600185	770	849	2	20	79	0.2531646
NODE_4040_length_1182_cov_64.600185	770	849	6	48	79	0.6075949
NODE_4041_length_1182_cov_18.584488	487	557	0	30	70	0.4285714
NODE_4041_length_1182_cov_18.584488	487	557	2	40	70	0.5714286
NODE_4041_length_1182_cov_18.584488	536	612	2	76	76	1.0000000
NODE_4041_length_1182_cov_18.584488	608	688	0	30	80	0.3750000
NODE_4041_length_1182_cov_18.584488	608	688	2	50	80	0.6250000
NODE_4041_length_1182_cov_18.584488	671	741	0	70	70	1.0000000
NODE_4042_length_1182_cov_18.075716	598	678	0	80	80	1.0000000
NODE_4042_length_1182_cov_18.075716	651	731	0	80	80	1.0000000
NODE_4042_length_1182_cov_18.075716	727	807	0	6	80	0.0750000
NODE_4042_length_1182_cov_18.075716	727	807	2	74	80	0.9250000
NODE_4042_length_1182_cov_18.075716	780	860	0	50	80	0.6250000
NODE_4042_length_1182_cov_18.075716	780	860	2	30	80	0.3750000
NODE_4043_length_1182_cov_8.716528	464	544	0	80	80	1.0000000
NODE_4043_length_1182_cov_8.716528	517	597	0	80	80	1.0000000
NODE_4044_length_1182_cov_4.109880	793	873	0	80	80	1.0000000
NODE_4044_length_1182_cov_4.109880	846	926	0	80	80	1.0000000
NODE_4045_length_1182_cov_3.433980	1052	1100	0	48	48	1.0000000
NODE_4050_length_1181_cov_13.856747	687	767	0	80	80	1.0000000
NODE_4050_length_1181_cov_13.856747	740	820	0	80	80	1.0000000
NODE_4051_length_1181_cov_8.239372	735	815	0	80	80	1.0000000
NODE_4059_length_1180_cov_46.345051	695	775	0	80	80	1.0000000
NODE_4059_length_1180_cov_46.345051	748	828	0	80	80	1.0000000
NODE_4066_length_1179_cov_93.272222	660	740	292	2	80	0.0250000
NODE_4066_length_1179_cov_93.272222	660	740	295	3	80	0.0375000
NODE_4066_length_1179_cov_93.272222	660	740	296	1	80	0.0125000
NODE_4066_length_1179_cov_93.272222	660	740	297	1	80	0.0125000
NODE_4066_length_1179_cov_93.272222	660	740	299	2	80	0.0250000
NODE_4066_length_1179_cov_93.272222	660	740	301	1	80	0.0125000
NODE_4066_length_1179_cov_93.272222	660	740	302	1	80	0.0125000
NODE_4066_length_1179_cov_93.272222	660	740	305	3	80	0.0375000
NODE_4066_length_1179_cov_93.272222	660	740	306	3	80	0.0375000
NODE_4066_length_1179_cov_93.272222	660	740	308	3	80	0.0375000
NODE_4066_length_1179_cov_93.272222	660	740	312	1	80	0.0125000
NODE_4066_length_1179_cov_93.272222	660	740	314	3	80	0.0375000
NODE_4066_length_1179_cov_93.272222	660	740	315	2	80	0.0250000
NODE_4066_length_1179_cov_93.272222	660	740	316	1	80	0.0125000
NODE_4066_length_1179_cov_93.272222	660	740	317	1	80	0.0125000
NODE_4066_length_1179_cov_93.272222	660	740	319	3	80	0.0375000
NODE_4066_length_1179_cov_93.272222	660	740	323	1	80	0.0125000
NODE_4066_length_1179_cov_93.272222	660	740	324	1	80	0.0125000
NODE_4066_length_1179_cov_93.272222	660	740	325	2	80	0.0250000
NODE_4066_length_1179_cov_93.272222	660	740	327	1	80	0.0125000
NODE_4066_length_1179_cov_93.272222	660	740	328	4	80	0.0500000
NODE_4066_length_1179_cov_93.272222	660	740	330	3	80	0.0375000
NODE_4066_length_1179_cov_93.272222	660	740	332	1	80	0.0125000
NODE_4066_length_1179_cov_93.272222	660	740	334	1	80	0.0125000
NODE_4066_length_1179_cov_93.272222	660	740	339	1	80	0.0125000
NODE_4066_length_1179_cov_93.272222	660	740	341	2	80	0.0250000
NODE_4066_length_1179_cov_93.272222	660	740	342	1	80	0.0125000
NODE_4066_length_1179_cov_93.272222	660	740	343	4	80	0.0500000
NODE_4066_length_1179_cov_93.272222	660	740	347	1	80	0.0125000
NODE_4066_length_1179_cov_93.272222	660	740	349	3	80	0.0375000
NODE_4066_length_1179_cov_93.272222	660	740	350	2	80	0.0250000
NODE_4066_length_1179_cov_93.272222	660	740	351	1	80	0.0125000
NODE_4066_length_1179_cov_93.272222	660	740	352	3	80	0.0375000
NODE_4066_length_1179_cov_93.272222	660	740	353	4	80	0.0500000
NODE_4066_length_1179_cov_93.272222	660	740	355	3	80	0.0375000
NODE_4066_length_1179_cov_93.272222	660	740	356	3	80	0.0375000
NODE_4066_length_1179_cov_93.272222	660	740	357	3	80	0.0375000
NODE_4066_length_1179_cov_93.272222	660	740	358	3	80	0.0375000
NODE_4066_length_1179_cov_93.272222	660	740	361	1	80	0.0125000
NODE_4066_length_1179_cov_93.272222	713	793	160	2	80	0.0250000
NODE_4066_length_1179_cov_93.272222	713	793	163	1	80	0.0125000
NODE_4066_length_1179_cov_93.272222	713	793	173	2	80	0.0250000
NODE_4066_length_1179_cov_93.272222	713	793	181	1	80	0.0125000
NODE_4066_length_1179_cov_93.272222	713	793	184	1	80	0.0125000
NODE_4066_length_1179_cov_93.272222	713	793	188	1	80	0.0125000
NODE_4066_length_1179_cov_93.272222	713	793	197	2	80	0.0250000
NODE_4066_length_1179_cov_93.272222	713	793	199	1	80	0.0125000
NODE_4066_length_1179_cov_93.272222	713	793	204	1	80	0.0125000
NODE_4066_length_1179_cov_93.272222	713	793	206	1	80	0.0125000
NODE_4066_length_1179_cov_93.272222	713	793	208	1	80	0.0125000
NODE_4066_length_1179_cov_93.272222	713	793	210	1	80	0.0125000
NODE_4066_length_1179_cov_93.272222	713	793	212	1	80	0.0125000
NODE_4066_length_1179_cov_93.272222	713	793	230	1	80	0.0125000
NODE_4066_length_1179_cov_93.272222	713	793	232	1	80	0.0125000
NODE_4066_length_1179_cov_93.272222	713	793	257	2	80	0.0250000
NODE_4066_length_1179_cov_93.272222	713	793	259	1	80	0.0125000
NODE_4066_length_1179_cov_93.272222	713	793	272	2	80	0.0250000
NODE_4066_length_1179_cov_93.272222	713	793	275	3	80	0.0375000
NODE_4066_length_1179_cov_93.272222	713	793	276	3	80	0.0375000
NODE_4066_length_1179_cov_93.272222	713	793	277	1	80	0.0125000
NODE_4066_length_1179_cov_93.272222	713	793	278	4	80	0.0500000
NODE_4066_length_1179_cov_93.272222	713	793	279	2	80	0.0250000
NODE_4066_length_1179_cov_93.272222	713	793	280	3	80	0.0375000
NODE_4066_length_1179_cov_93.272222	713	793	283	5	80	0.0625000
NODE_4066_length_1179_cov_93.272222	713	793	284	1	80	0.0125000
NODE_4066_length_1179_cov_93.272222	713	793	285	2	80	0.0250000
NODE_4066_length_1179_cov_93.272222	713	793	287	1	80	0.0125000
NODE_4066_length_1179_cov_93.272222	713	793	289	1	80	0.0125000
NODE_4066_length_1179_cov_93.272222	713	793	291	4	80	0.0500000
NODE_4066_length_1179_cov_93.272222	713	793	295	2	80	0.0250000
NODE_4066_length_1179_cov_93.272222	713	793	296	1	80	0.0125000
NODE_4066_length_1179_cov_93.272222	713	793	297	1	80	0.0125000
NODE_4066_length_1179_cov_93.272222	713	793	299	1	80	0.0125000
NODE_4066_length_1179_cov_93.272222	713	793	301	1	80	0.0125000
NODE_4066_length_1179_cov_93.272222	713	793	306	3	80	0.0375000
NODE_4066_length_1179_cov_93.272222	713	793	308	2	80	0.0250000
NODE_4066_length_1179_cov_93.272222	713	793	312	1	80	0.0125000
NODE_4066_length_1179_cov_93.272222	713	793	315	2	80	0.0250000
NODE_4066_length_1179_cov_93.272222	713	793	316	1	80	0.0125000
NODE_4066_length_1179_cov_93.272222	713	793	319	3	80	0.0375000
NODE_4066_length_1179_cov_93.272222	713	793	323	1	80	0.0125000
NODE_4066_length_1179_cov_93.272222	713	793	325	2	80	0.0250000
NODE_4066_length_1179_cov_93.272222	713	793	327	1	80	0.0125000
NODE_4066_length_1179_cov_93.272222	713	793	328	2	80	0.0250000
NODE_4066_length_1179_cov_93.272222	713	793	330	3	80	0.0375000
NODE_4067_length_1179_cov_55.355556	547	627	0	50	80	0.6250000
NODE_4067_length_1179_cov_55.355556	547	627	2	22	80	0.2750000
NODE_4067_length_1179_cov_55.355556	547	627	4	8	80	0.1000000
NODE_4067_length_1179_cov_55.355556	600	680	0	19	80	0.2375000
NODE_4067_length_1179_cov_55.355556	600	680	4	61	80	0.7625000
NODE_4068_length_1179_cov_29.712037	613	693	0	45	80	0.5625000
NODE_4068_length_1179_cov_29.712037	613	693	2	35	80	0.4375000
NODE_4068_length_1179_cov_29.712037	666	746	0	46	80	0.5750000
NODE_4068_length_1179_cov_29.712037	666	746	2	34	80	0.4250000
NODE_4069_length_1179_cov_26.767593	483	563	0	8	80	0.1000000
NODE_4069_length_1179_cov_26.767593	483	563	2	72	80	0.9000000
NODE_4069_length_1179_cov_26.767593	536	616	0	61	80	0.7625000
NODE_4069_length_1179_cov_26.767593	536	616	2	19	80	0.2375000
NODE_4069_length_1179_cov_26.767593	612	692	0	23	80	0.2875000
NODE_4069_length_1179_cov_26.767593	612	692	3	1	80	0.0125000
NODE_4069_length_1179_cov_26.767593	612	692	4	56	80	0.7000000
NODE_4069_length_1179_cov_26.767593	665	745	0	10	80	0.1250000
NODE_4069_length_1179_cov_26.767593	665	745	4	70	80	0.8750000
NODE_4070_length_1179_cov_22.249074	581	661	0	80	80	1.0000000
NODE_4070_length_1179_cov_22.249074	634	714	0	80	80	1.0000000
NODE_4071_length_1179_cov_16.538889	498	568	0	70	70	1.0000000
NODE_4072_length_1179_cov_15.442593	535	615	0	1	80	0.0125000
NODE_4072_length_1179_cov_15.442593	535	615	1	1	80	0.0125000
NODE_4072_length_1179_cov_15.442593	535	615	18	29	80	0.3625000
NODE_4072_length_1179_cov_15.442593	535	615	24	36	80	0.4500000
NODE_4072_length_1179_cov_15.442593	535	615	28	13	80	0.1625000
NODE_4072_length_1179_cov_15.442593	588	668	22	22	80	0.2750000
NODE_4072_length_1179_cov_15.442593	588	668	24	14	80	0.1750000
NODE_4072_length_1179_cov_15.442593	588	668	26	17	80	0.2125000
NODE_4072_length_1179_cov_15.442593	588	668	28	27	80	0.3375000
NODE_4076_length_1179_cov_2.419444	1108	1155	0	47	47	1.0000000
NODE_4078_length_1179_cov_1.009259	944	1024	0	80	80	1.0000000
NODE_4078_length_1179_cov_1.009259	997	1077	0	80	80	1.0000000
NODE_4079_length_1178_cov_42.484708	423	503	0	80	80	1.0000000
NODE_4079_length_1178_cov_42.484708	476	556	0	80	80	1.0000000
NODE_4079_length_1178_cov_42.484708	552	632	0	80	80	1.0000000
NODE_4079_length_1178_cov_42.484708	605	685	0	80	80	1.0000000
NODE_4080_length_1178_cov_15.332715	215	295	0	68	80	0.8500000
NODE_4080_length_1178_cov_15.332715	215	295	2	12	80	0.1500000
NODE_4080_length_1178_cov_15.332715	268	348	0	80	80	1.0000000
NODE_4081_length_1178_cov_11.403151	527	607	0	80	80	1.0000000
NODE_4081_length_1178_cov_11.403151	580	660	0	80	80	1.0000000
NODE_4084_length_1177_cov_34.920223	369	449	0	80	80	1.0000000
NODE_4084_length_1177_cov_34.920223	422	502	0	80	80	1.0000000
NODE_4084_length_1177_cov_34.920223	498	578	0	19	80	0.2375000
NODE_4084_length_1177_cov_34.920223	498	578	2	61	80	0.7625000
NODE_4084_length_1177_cov_34.920223	551	631	0	46	80	0.5750000
NODE_4084_length_1177_cov_34.920223	551	631	2	34	80	0.4250000
NODE_4085_length_1177_cov_12.186456	481	561	0	73	80	0.9125000
NODE_4085_length_1177_cov_12.186456	481	561	2	7	80	0.0875000
NODE_4085_length_1177_cov_12.186456	534	614	0	80	80	1.0000000
NODE_4085_length_1177_cov_12.186456	610	690	0	24	80	0.3000000
NODE_4085_length_1177_cov_12.186456	610	690	2	20	80	0.2500000
NODE_4085_length_1177_cov_12.186456	610	690	4	23	80	0.2875000
NODE_4085_length_1177_cov_12.186456	610	690	6	13	80	0.1625000
NODE_4085_length_1177_cov_12.186456	663	743	2	10	80	0.1250000
NODE_4085_length_1177_cov_12.186456	663	743	4	17	80	0.2125000
NODE_4085_length_1177_cov_12.186456	663	743	6	53	80	0.6625000
NODE_4086_length_1177_cov_11.926716	443	523	0	58	80	0.7250000
NODE_4086_length_1177_cov_11.926716	443	523	4	14	80	0.1750000
NODE_4086_length_1177_cov_11.926716	443	523	6	8	80	0.1000000
NODE_4086_length_1177_cov_11.926716	496	578	0	5	82	0.0609756
NODE_4086_length_1177_cov_11.926716	496	578	4	14	82	0.1707317
NODE_4086_length_1177_cov_11.926716	496	578	6	63	82	0.7682927
NODE_4088_length_1177_cov_5.923933	358	438	0	80	80	1.0000000
NODE_4088_length_1177_cov_5.923933	411	491	0	80	80	1.0000000
NODE_4089_length_1177_cov_5.775510	760	840	0	34	80	0.4250000
NODE_4089_length_1177_cov_5.775510	760	840	2	46	80	0.5750000
NODE_4089_length_1177_cov_5.775510	813	893	2	80	80	1.0000000
NODE_4096_length_1176_cov_26.994429	377	457	0	80	80	1.0000000
NODE_4096_length_1176_cov_26.994429	430	510	0	80	80	1.0000000
NODE_4096_length_1176_cov_26.994429	506	586	0	80	80	1.0000000
NODE_4096_length_1176_cov_26.994429	559	639	0	80	80	1.0000000
NODE_4097_length_1176_cov_15.766945	531	611	2	55	80	0.6875000
NODE_4097_length_1176_cov_15.766945	531	611	4	25	80	0.3125000
NODE_4097_length_1176_cov_15.766945	584	664	0	43	80	0.5375000
NODE_4097_length_1176_cov_15.766945	584	664	2	37	80	0.4625000
NODE_4098_length_1176_cov_14.882080	628	708	2	15	80	0.1875000
NODE_4098_length_1176_cov_14.882080	628	708	6	47	80	0.5875000
NODE_4098_length_1176_cov_14.882080	628	708	8	9	80	0.1125000
NODE_4098_length_1176_cov_14.882080	628	708	10	9	80	0.1125000
NODE_4098_length_1176_cov_14.882080	681	761	6	9	80	0.1125000
NODE_4098_length_1176_cov_14.882080	681	761	8	62	80	0.7750000
NODE_4098_length_1176_cov_14.882080	681	761	10	9	80	0.1125000
NODE_4099_length_1176_cov_10.692665	392	472	0	17	80	0.2125000
NODE_4099_length_1176_cov_10.692665	392	472	2	63	80	0.7875000
NODE_4099_length_1176_cov_10.692665	445	525	0	31	80	0.3875000
NODE_4099_length_1176_cov_10.692665	445	525	2	49	80	0.6125000
NODE_4106_length_1175_cov_50.754647	526	606	0	80	80	1.0000000
NODE_4106_length_1175_cov_50.754647	579	659	0	80	80	1.0000000
NODE_4107_length_1175_cov_42.638476	327	407	0	80	80	1.0000000
NODE_4107_length_1175_cov_42.638476	380	460	0	36	80	0.4500000
NODE_4107_length_1175_cov_42.638476	380	460	2	39	80	0.4875000
NODE_4107_length_1175_cov_42.638476	380	460	6	5	80	0.0625000
NODE_4107_length_1175_cov_42.638476	456	536	4	65	80	0.8125000
NODE_4107_length_1175_cov_42.638476	456	536	6	15	80	0.1875000
NODE_4107_length_1175_cov_42.638476	509	589	0	45	80	0.5625000
NODE_4107_length_1175_cov_42.638476	509	589	4	35	80	0.4375000
NODE_4108_length_1175_cov_40.217472	437	517	0	49	80	0.6125000
NODE_4108_length_1175_cov_40.217472	437	517	2	15	80	0.1875000
NODE_4108_length_1175_cov_40.217472	437	517	4	16	80	0.2000000
NODE_4108_length_1175_cov_40.217472	490	570	2	38	80	0.4750000
NODE_4108_length_1175_cov_40.217472	490	570	4	42	80	0.5250000
NODE_4108_length_1175_cov_40.217472	566	646	0	48	80	0.6000000
NODE_4108_length_1175_cov_40.217472	566	646	2	32	80	0.4000000
NODE_4108_length_1175_cov_40.217472	619	699	0	80	80	1.0000000
NODE_4109_length_1175_cov_12.834572	775	855	0	70	80	0.8750000
NODE_4109_length_1175_cov_12.834572	775	855	2	10	80	0.1250000
NODE_4109_length_1175_cov_12.834572	828	908	0	17	80	0.2125000
NODE_4109_length_1175_cov_12.834572	828	908	2	22	80	0.2750000
NODE_4109_length_1175_cov_12.834572	828	908	4	41	80	0.5125000
NODE_4115_length_1174_cov_20.569302	433	513	0	9	80	0.1125000
NODE_4115_length_1174_cov_20.569302	433	513	2	60	80	0.7500000
NODE_4115_length_1174_cov_20.569302	433	513	4	11	80	0.1375000
NODE_4115_length_1174_cov_20.569302	486	566	0	9	80	0.1125000
NODE_4115_length_1174_cov_20.569302	486	566	2	71	80	0.8875000
NODE_4115_length_1174_cov_20.569302	562	642	2	27	80	0.3375000
NODE_4115_length_1174_cov_20.569302	562	642	4	53	80	0.6625000
NODE_4115_length_1174_cov_20.569302	615	695	0	35	80	0.4375000
NODE_4115_length_1174_cov_20.569302	615	695	2	14	80	0.1750000
NODE_4115_length_1174_cov_20.569302	615	695	4	31	80	0.3875000
NODE_4116_length_1174_cov_18.797209	578	658	0	57	80	0.7125000
NODE_4116_length_1174_cov_18.797209	578	658	2	14	80	0.1750000
NODE_4116_length_1174_cov_18.797209	578	658	4	9	80	0.1125000
NODE_4116_length_1174_cov_18.797209	631	711	0	4	80	0.0500000
NODE_4116_length_1174_cov_18.797209	631	711	2	14	80	0.1750000
NODE_4116_length_1174_cov_18.797209	631	711	4	62	80	0.7750000
NODE_4117_length_1174_cov_17.486512	589	669	0	42	80	0.5250000
NODE_4117_length_1174_cov_17.486512	589	669	4	38	80	0.4750000
NODE_4117_length_1174_cov_17.486512	642	722	4	80	80	1.0000000
NODE_4118_length_1174_cov_15.888372	570	650	0	36	80	0.4500000
NODE_4118_length_1174_cov_15.888372	570	650	2	1	80	0.0125000
NODE_4118_length_1174_cov_15.888372	570	650	6	43	80	0.5375000
NODE_4118_length_1174_cov_15.888372	623	703	0	22	80	0.2750000
NODE_4118_length_1174_cov_15.888372	623	703	6	58	80	0.7250000
NODE_4118_length_1174_cov_15.888372	699	779	0	80	80	1.0000000
NODE_4118_length_1174_cov_15.888372	752	832	0	80	80	1.0000000
NODE_4124_length_1174_cov_1.536744	1066	1115	4	28	49	0.5714286
NODE_4124_length_1174_cov_1.536744	1066	1115	8	21	49	0.4285714
NODE_4124_length_1174_cov_1.536744	1088	1168	2	17	80	0.2125000
NODE_4124_length_1174_cov_1.536744	1088	1168	4	63	80	0.7875000
NODE_4128_length_1173_cov_29.562384	455	535	2	33	80	0.4125000
NODE_4128_length_1173_cov_29.562384	455	535	4	47	80	0.5875000
NODE_4128_length_1173_cov_29.562384	508	588	0	45	80	0.5625000
NODE_4128_length_1173_cov_29.562384	508	588	2	35	80	0.4375000
NODE_4128_length_1173_cov_29.562384	584	664	0	80	80	1.0000000
NODE_4128_length_1173_cov_29.562384	637	717	0	27	80	0.3375000
NODE_4128_length_1173_cov_29.562384	637	717	2	53	80	0.6625000
NODE_4129_length_1173_cov_25.206704	395	475	0	7	80	0.0875000
NODE_4129_length_1173_cov_25.206704	395	475	6	73	80	0.9125000
NODE_4129_length_1173_cov_25.206704	448	528	0	36	80	0.4500000
NODE_4129_length_1173_cov_25.206704	448	528	5	1	80	0.0125000
NODE_4129_length_1173_cov_25.206704	448	528	6	43	80	0.5375000
NODE_4130_length_1173_cov_9.486965	693	773	0	80	80	1.0000000
NODE_4130_length_1173_cov_9.486965	746	826	0	80	80	1.0000000
NODE_4131_length_1173_cov_7.946927	201	281	0	63	80	0.7875000
NODE_4131_length_1173_cov_7.946927	201	281	2	17	80	0.2125000
NODE_4131_length_1173_cov_7.946927	254	334	0	10	80	0.1250000
NODE_4131_length_1173_cov_7.946927	254	334	2	33	80	0.4125000
NODE_4131_length_1173_cov_7.946927	254	334	6	37	80	0.4625000
NODE_4136_length_1172_cov_37.177074	527	607	0	51	80	0.6375000
NODE_4136_length_1172_cov_37.177074	527	607	4	29	80	0.3625000
NODE_4136_length_1172_cov_37.177074	580	660	4	80	80	1.0000000
NODE_4137_length_1172_cov_20.397018	677	757	0	73	80	0.9125000
NODE_4137_length_1172_cov_20.397018	677	757	2	7	80	0.0875000
NODE_4137_length_1172_cov_20.397018	730	810	0	20	80	0.2500000
NODE_4137_length_1172_cov_20.397018	730	810	2	60	80	0.7500000
NODE_4138_length_1172_cov_15.018639	460	540	0	80	80	1.0000000
NODE_4138_length_1172_cov_15.018639	513	593	0	80	80	1.0000000
NODE_4139_length_1172_cov_13.199441	622	702	0	5	80	0.0625000
NODE_4139_length_1172_cov_13.199441	622	702	2	75	80	0.9375000
NODE_4139_length_1172_cov_13.199441	675	755	2	80	80	1.0000000
NODE_4140_length_1172_cov_10.720410	499	579	0	9	80	0.1125000
NODE_4140_length_1172_cov_10.720410	499	579	2	71	80	0.8875000
NODE_4140_length_1172_cov_10.720410	552	632	0	62	80	0.7750000
NODE_4140_length_1172_cov_10.720410	552	632	2	18	80	0.2250000
NODE_4140_length_1172_cov_10.720410	628	708	0	12	80	0.1500000
NODE_4140_length_1172_cov_10.720410	628	708	4	35	80	0.4375000
NODE_4140_length_1172_cov_10.720410	628	708	6	33	80	0.4125000
NODE_4140_length_1172_cov_10.720410	681	761	0	18	80	0.2250000
NODE_4140_length_1172_cov_10.720410	681	761	2	31	80	0.3875000
NODE_4140_length_1172_cov_10.720410	681	761	6	31	80	0.3875000
NODE_4141_length_1172_cov_10.574091	951	1021	20	13	70	0.1857143
NODE_4141_length_1172_cov_10.574091	951	1021	22	5	70	0.0714286
NODE_4141_length_1172_cov_10.574091	951	1021	24	4	70	0.0571429
NODE_4141_length_1172_cov_10.574091	951	1021	30	24	70	0.3428572
NODE_4141_length_1172_cov_10.574091	951	1021	31	16	70	0.2285714
NODE_4141_length_1172_cov_10.574091	951	1021	32	3	70	0.0428571
NODE_4141_length_1172_cov_10.574091	951	1021	33	5	70	0.0714286
NODE_4142_length_1172_cov_9.204101	276	356	0	80	80	1.0000000
NODE_4142_length_1172_cov_9.204101	329	409	0	80	80	1.0000000
NODE_4148_length_1171_cov_13.311567	666	746	0	80	80	1.0000000
NODE_4148_length_1171_cov_13.311567	719	803	0	46	84	0.5476190
NODE_4148_length_1171_cov_13.311567	719	803	2	29	84	0.3452381
NODE_4148_length_1171_cov_13.311567	719	803	4	9	84	0.1071429
NODE_4149_length_1171_cov_9.154851	198	278	0	80	80	1.0000000
NODE_4149_length_1171_cov_9.154851	251	331	0	80	80	1.0000000
NODE_4157_length_1170_cov_65.480859	402	482	0	80	80	1.0000000
NODE_4157_length_1170_cov_65.480859	455	535	0	80	80	1.0000000
NODE_4158_length_1170_cov_35.283847	704	784	0	80	80	1.0000000
NODE_4158_length_1170_cov_35.283847	757	837	0	29	80	0.3625000
NODE_4158_length_1170_cov_35.283847	757	837	2	9	80	0.1125000
NODE_4158_length_1170_cov_35.283847	757	837	6	42	80	0.5250000
NODE_4159_length_1170_cov_23.600373	450	530	0	80	80	1.0000000
NODE_4159_length_1170_cov_23.600373	503	583	0	80	80	1.0000000
NODE_4159_length_1170_cov_23.600373	579	659	0	45	80	0.5625000
NODE_4159_length_1170_cov_23.600373	579	659	4	35	80	0.4375000
NODE_4159_length_1170_cov_23.600373	632	705	4	73	73	1.0000000
NODE_4160_length_1170_cov_19.783380	325	405	2	8	80	0.1000000
NODE_4160_length_1170_cov_19.783380	325	405	4	71	80	0.8875000
NODE_4160_length_1170_cov_19.783380	325	405	6	1	80	0.0125000
NODE_4160_length_1170_cov_19.783380	378	458	2	8	80	0.1000000
NODE_4160_length_1170_cov_19.783380	378	458	4	71	80	0.8875000
NODE_4160_length_1170_cov_19.783380	378	458	6	1	80	0.0125000
NODE_4168_length_1169_cov_61.689720	464	544	2	80	80	1.0000000
NODE_4168_length_1169_cov_61.689720	517	597	0	15	80	0.1875000
NODE_4168_length_1169_cov_61.689720	517	597	2	65	80	0.8125000
NODE_4168_length_1169_cov_61.689720	593	673	0	58	80	0.7250000
NODE_4168_length_1169_cov_61.689720	593	673	2	22	80	0.2750000
NODE_4168_length_1169_cov_61.689720	646	726	0	5	80	0.0625000
NODE_4168_length_1169_cov_61.689720	646	726	2	75	80	0.9375000
NODE_4169_length_1169_cov_55.247664	640	720	0	18	80	0.2250000
NODE_4169_length_1169_cov_55.247664	640	720	2	14	80	0.1750000
NODE_4169_length_1169_cov_55.247664	640	720	6	30	80	0.3750000
NODE_4169_length_1169_cov_55.247664	640	720	10	2	80	0.0250000
NODE_4169_length_1169_cov_55.247664	640	720	12	1	80	0.0125000
NODE_4169_length_1169_cov_55.247664	640	720	14	15	80	0.1875000
NODE_4169_length_1169_cov_55.247664	693	773	6	9	80	0.1125000
NODE_4169_length_1169_cov_55.247664	693	773	10	2	80	0.0250000
NODE_4169_length_1169_cov_55.247664	693	773	12	41	80	0.5125000
NODE_4169_length_1169_cov_55.247664	693	773	14	28	80	0.3500000
NODE_4170_length_1169_cov_39.016822	447	527	2	23	80	0.2875000
NODE_4170_length_1169_cov_39.016822	447	527	4	26	80	0.3250000
NODE_4170_length_1169_cov_39.016822	447	527	6	22	80	0.2750000
NODE_4170_length_1169_cov_39.016822	447	527	8	9	80	0.1125000
NODE_4170_length_1169_cov_39.016822	500	580	4	35	80	0.4375000
NODE_4170_length_1169_cov_39.016822	500	580	6	40	80	0.5000000
NODE_4170_length_1169_cov_39.016822	500	580	8	5	80	0.0625000
NODE_4170_length_1169_cov_39.016822	576	656	0	36	80	0.4500000
NODE_4170_length_1169_cov_39.016822	576	656	2	1	80	0.0125000
NODE_4170_length_1169_cov_39.016822	576	656	3	32	80	0.4000000
NODE_4170_length_1169_cov_39.016822	576	656	4	11	80	0.1375000
NODE_4170_length_1169_cov_39.016822	629	709	3	48	80	0.6000000
NODE_4170_length_1169_cov_39.016822	629	709	4	32	80	0.4000000
NODE_4171_length_1169_cov_35.383178	582	662	0	32	80	0.4000000
NODE_4171_length_1169_cov_35.383178	582	662	2	48	80	0.6000000
NODE_4171_length_1169_cov_35.383178	635	715	0	16	80	0.2000000
NODE_4171_length_1169_cov_35.383178	635	715	2	64	80	0.8000000
NODE_4173_length_1169_cov_12.010280	338	418	0	80	80	1.0000000
NODE_4173_length_1169_cov_12.010280	391	471	0	80	80	1.0000000
NODE_4175_length_1169_cov_4.172897	74	135	0	61	61	1.0000000
NODE_4175_length_1169_cov_4.172897	74	135	0	61	61	1.0000000
NODE_4175_length_1169_cov_4.172897	74	135	0	61	61	1.0000000
NODE_4183_length_1168_cov_27.350795	517	597	0	80	80	1.0000000
NODE_4183_length_1168_cov_27.350795	570	650	0	80	80	1.0000000
NODE_4183_length_1168_cov_27.350795	646	726	0	31	80	0.3875000
NODE_4183_length_1168_cov_27.350795	646	726	2	49	80	0.6125000
NODE_4183_length_1168_cov_27.350795	699	779	0	30	80	0.3750000
NODE_4183_length_1168_cov_27.350795	699	779	2	50	80	0.6250000
NODE_4184_length_1168_cov_25.777362	672	752	12	80	80	1.0000000
NODE_4184_length_1168_cov_25.777362	725	805	0	40	80	0.5000000
NODE_4184_length_1168_cov_25.777362	725	805	7	1	80	0.0125000
NODE_4184_length_1168_cov_25.777362	725	805	12	39	80	0.4875000
NODE_4185_length_1168_cov_25.295603	543	623	0	6	80	0.0750000
NODE_4185_length_1168_cov_25.295603	543	623	4	74	80	0.9250000
NODE_4185_length_1168_cov_25.295603	596	676	0	59	80	0.7375000
NODE_4185_length_1168_cov_25.295603	596	676	4	21	80	0.2625000
NODE_4185_length_1168_cov_25.295603	672	752	0	28	80	0.3500000
NODE_4185_length_1168_cov_25.295603	672	752	2	45	80	0.5625000
NODE_4185_length_1168_cov_25.295603	672	752	4	7	80	0.0875000
NODE_4185_length_1168_cov_25.295603	725	804	2	43	79	0.5443038
NODE_4185_length_1168_cov_25.295603	725	804	4	36	79	0.4556962
NODE_4186_length_1168_cov_20.202058	434	514	0	11	80	0.1375000
NODE_4186_length_1168_cov_20.202058	434	514	2	69	80	0.8625000
NODE_4186_length_1168_cov_20.202058	487	567	0	64	80	0.8000000
NODE_4186_length_1168_cov_20.202058	487	567	2	16	80	0.2000000
NODE_4187_length_1168_cov_16.787652	405	485	4	80	80	1.0000000
NODE_4187_length_1168_cov_16.787652	458	538	0	13	80	0.1625000
NODE_4187_length_1168_cov_16.787652	458	538	2	5	80	0.0625000
NODE_4187_length_1168_cov_16.787652	458	538	4	62	80	0.7750000
NODE_4188_length_1168_cov_10.079514	722	802	2	80	80	1.0000000
NODE_4188_length_1168_cov_10.079514	775	855	0	34	80	0.4250000
NODE_4188_length_1168_cov_10.079514	775	855	1	10	80	0.1250000
NODE_4188_length_1168_cov_10.079514	775	855	2	36	80	0.4500000
NODE_4198_length_1167_cov_27.961610	591	671	8	3	80	0.0375000
NODE_4198_length_1167_cov_27.961610	591	671	12	10	80	0.1250000
NODE_4198_length_1167_cov_27.961610	591	671	16	37	80	0.4625000
NODE_4198_length_1167_cov_27.961610	591	671	18	30	80	0.3750000
NODE_4198_length_1167_cov_27.961610	644	724	8	12	80	0.1500000
NODE_4198_length_1167_cov_27.961610	644	724	14	35	80	0.4375000
NODE_4198_length_1167_cov_27.961610	644	724	16	33	80	0.4125000
NODE_4199_length_1167_cov_12.393258	670	750	2	80	80	1.0000000
NODE_4199_length_1167_cov_12.393258	723	803	0	21	80	0.2625000
NODE_4199_length_1167_cov_12.393258	723	803	2	59	80	0.7375000
NODE_4200_length_1167_cov_11.189139	434	514	0	57	80	0.7125000
NODE_4200_length_1167_cov_11.189139	434	514	2	23	80	0.2875000
NODE_4200_length_1167_cov_11.189139	487	567	0	80	80	1.0000000
NODE_4201_length_1167_cov_7.998127	711	791	0	80	80	1.0000000
NODE_4201_length_1167_cov_7.998127	764	844	0	80	80	1.0000000
NODE_4206_length_1166_cov_313.815370	444	524	98	9	80	0.1125000
NODE_4206_length_1166_cov_313.815370	444	524	118	4	80	0.0500000
NODE_4206_length_1166_cov_313.815370	444	524	119	1	80	0.0125000
NODE_4206_length_1166_cov_313.815370	444	524	128	1	80	0.0125000
NODE_4206_length_1166_cov_313.815370	444	524	151	1	80	0.0125000
NODE_4206_length_1166_cov_313.815370	444	524	155	1	80	0.0125000
NODE_4206_length_1166_cov_313.815370	444	524	163	1	80	0.0125000
NODE_4206_length_1166_cov_313.815370	444	524	164	1	80	0.0125000
NODE_4206_length_1166_cov_313.815370	444	524	165	1	80	0.0125000
NODE_4206_length_1166_cov_313.815370	444	524	170	1	80	0.0125000
NODE_4206_length_1166_cov_313.815370	444	524	187	1	80	0.0125000
NODE_4206_length_1166_cov_313.815370	444	524	189	1	80	0.0125000
NODE_4206_length_1166_cov_313.815370	444	524	190	6	80	0.0750000
NODE_4206_length_1166_cov_313.815370	444	524	193	1	80	0.0125000
NODE_4206_length_1166_cov_313.815370	444	524	194	1	80	0.0125000
NODE_4206_length_1166_cov_313.815370	444	524	202	1	80	0.0125000
NODE_4206_length_1166_cov_313.815370	444	524	205	1	80	0.0125000
NODE_4206_length_1166_cov_313.815370	444	524	238	1	80	0.0125000
NODE_4206_length_1166_cov_313.815370	444	524	240	1	80	0.0125000
NODE_4206_length_1166_cov_313.815370	444	524	251	1	80	0.0125000
NODE_4206_length_1166_cov_313.815370	444	524	256	1	80	0.0125000
NODE_4206_length_1166_cov_313.815370	444	524	278	1	80	0.0125000
NODE_4206_length_1166_cov_313.815370	444	524	304	1	80	0.0125000
NODE_4206_length_1166_cov_313.815370	444	524	305	2	80	0.0250000
NODE_4206_length_1166_cov_313.815370	444	524	339	1	80	0.0125000
NODE_4206_length_1166_cov_313.815370	444	524	341	1	80	0.0125000
NODE_4206_length_1166_cov_313.815370	444	524	350	1	80	0.0125000
NODE_4206_length_1166_cov_313.815370	444	524	373	1	80	0.0125000
NODE_4206_length_1166_cov_313.815370	444	524	389	1	80	0.0125000
NODE_4206_length_1166_cov_313.815370	444	524	398	3	80	0.0375000
NODE_4206_length_1166_cov_313.815370	444	524	411	2	80	0.0250000
NODE_4206_length_1166_cov_313.815370	444	524	412	1	80	0.0125000
NODE_4206_length_1166_cov_313.815370	444	524	434	1	80	0.0125000
NODE_4206_length_1166_cov_313.815370	444	524	435	1	80	0.0125000
NODE_4206_length_1166_cov_313.815370	444	524	439	1	80	0.0125000
NODE_4206_length_1166_cov_313.815370	444	524	443	2	80	0.0250000
NODE_4206_length_1166_cov_313.815370	444	524	452	1	80	0.0125000
NODE_4206_length_1166_cov_313.815370	444	524	475	1	80	0.0125000
NODE_4206_length_1166_cov_313.815370	444	524	490	1	80	0.0125000
NODE_4206_length_1166_cov_313.815370	444	524	513	1	80	0.0125000
NODE_4206_length_1166_cov_313.815370	444	524	516	1	80	0.0125000
NODE_4206_length_1166_cov_313.815370	444	524	533	1	80	0.0125000
NODE_4206_length_1166_cov_313.815370	444	524	556	1	80	0.0125000
NODE_4206_length_1166_cov_313.815370	444	524	566	1	80	0.0125000
NODE_4206_length_1166_cov_313.815370	444	524	567	1	80	0.0125000
NODE_4206_length_1166_cov_313.815370	444	524	581	1	80	0.0125000
NODE_4206_length_1166_cov_313.815370	444	524	583	1	80	0.0125000
NODE_4206_length_1166_cov_313.815370	444	524	592	1	80	0.0125000
NODE_4206_length_1166_cov_313.815370	444	524	596	1	80	0.0125000
NODE_4206_length_1166_cov_313.815370	444	524	600	1	80	0.0125000
NODE_4206_length_1166_cov_313.815370	444	524	604	1	80	0.0125000
NODE_4206_length_1166_cov_313.815370	444	524	605	2	80	0.0250000
NODE_4206_length_1166_cov_313.815370	444	524	606	1	80	0.0125000
NODE_4206_length_1166_cov_313.815370	444	524	607	1	80	0.0125000
NODE_4206_length_1166_cov_313.815370	444	524	611	1	80	0.0125000
NODE_4206_length_1166_cov_313.815370	444	524	615	2	80	0.0250000
NODE_4206_length_1166_cov_313.815370	444	524	631	1	80	0.0125000
NODE_4206_length_1166_cov_313.815370	444	524	98	9	80	0.1125000
NODE_4206_length_1166_cov_313.815370	444	524	118	4	80	0.0500000
NODE_4206_length_1166_cov_313.815370	444	524	119	1	80	0.0125000
NODE_4206_length_1166_cov_313.815370	444	524	128	1	80	0.0125000
NODE_4206_length_1166_cov_313.815370	444	524	151	1	80	0.0125000
NODE_4206_length_1166_cov_313.815370	444	524	155	1	80	0.0125000
NODE_4206_length_1166_cov_313.815370	444	524	163	1	80	0.0125000
NODE_4206_length_1166_cov_313.815370	444	524	164	1	80	0.0125000
NODE_4206_length_1166_cov_313.815370	444	524	165	1	80	0.0125000
NODE_4206_length_1166_cov_313.815370	444	524	170	1	80	0.0125000
NODE_4206_length_1166_cov_313.815370	444	524	187	1	80	0.0125000
NODE_4206_length_1166_cov_313.815370	444	524	189	1	80	0.0125000
NODE_4206_length_1166_cov_313.815370	444	524	190	6	80	0.0750000
NODE_4206_length_1166_cov_313.815370	444	524	193	1	80	0.0125000
NODE_4206_length_1166_cov_313.815370	444	524	194	1	80	0.0125000
NODE_4206_length_1166_cov_313.815370	444	524	202	1	80	0.0125000
NODE_4206_length_1166_cov_313.815370	444	524	205	1	80	0.0125000
NODE_4206_length_1166_cov_313.815370	444	524	238	1	80	0.0125000
NODE_4206_length_1166_cov_313.815370	444	524	240	1	80	0.0125000
NODE_4206_length_1166_cov_313.815370	444	524	251	1	80	0.0125000
NODE_4206_length_1166_cov_313.815370	444	524	256	1	80	0.0125000
NODE_4206_length_1166_cov_313.815370	444	524	278	1	80	0.0125000
NODE_4206_length_1166_cov_313.815370	444	524	304	1	80	0.0125000
NODE_4206_length_1166_cov_313.815370	444	524	305	2	80	0.0250000
NODE_4206_length_1166_cov_313.815370	444	524	339	1	80	0.0125000
NODE_4206_length_1166_cov_313.815370	444	524	341	1	80	0.0125000
NODE_4206_length_1166_cov_313.815370	444	524	350	1	80	0.0125000
NODE_4206_length_1166_cov_313.815370	444	524	373	1	80	0.0125000
NODE_4206_length_1166_cov_313.815370	444	524	389	1	80	0.0125000
NODE_4206_length_1166_cov_313.815370	444	524	398	3	80	0.0375000
NODE_4206_length_1166_cov_313.815370	444	524	411	2	80	0.0250000
NODE_4206_length_1166_cov_313.815370	444	524	412	1	80	0.0125000
NODE_4206_length_1166_cov_313.815370	444	524	434	1	80	0.0125000
NODE_4206_length_1166_cov_313.815370	444	524	435	1	80	0.0125000
NODE_4206_length_1166_cov_313.815370	444	524	439	1	80	0.0125000
NODE_4206_length_1166_cov_313.815370	444	524	443	2	80	0.0250000
NODE_4206_length_1166_cov_313.815370	444	524	452	1	80	0.0125000
NODE_4206_length_1166_cov_313.815370	444	524	475	1	80	0.0125000
NODE_4206_length_1166_cov_313.815370	444	524	490	1	80	0.0125000
NODE_4206_length_1166_cov_313.815370	444	524	513	1	80	0.0125000
NODE_4206_length_1166_cov_313.815370	444	524	516	1	80	0.0125000
NODE_4206_length_1166_cov_313.815370	444	524	533	1	80	0.0125000
NODE_4206_length_1166_cov_313.815370	444	524	556	1	80	0.0125000
NODE_4206_length_1166_cov_313.815370	444	524	566	1	80	0.0125000
NODE_4206_length_1166_cov_313.815370	444	524	567	1	80	0.0125000
NODE_4206_length_1166_cov_313.815370	444	524	581	1	80	0.0125000
NODE_4206_length_1166_cov_313.815370	444	524	583	1	80	0.0125000
NODE_4206_length_1166_cov_313.815370	444	524	592	1	80	0.0125000
NODE_4206_length_1166_cov_313.815370	444	524	596	1	80	0.0125000
NODE_4206_length_1166_cov_313.815370	444	524	600	1	80	0.0125000
NODE_4206_length_1166_cov_313.815370	444	524	604	1	80	0.0125000
NODE_4206_length_1166_cov_313.815370	444	524	605	2	80	0.0250000
NODE_4206_length_1166_cov_313.815370	444	524	606	1	80	0.0125000
NODE_4206_length_1166_cov_313.815370	444	524	607	1	80	0.0125000
NODE_4206_length_1166_cov_313.815370	444	524	611	1	80	0.0125000
NODE_4206_length_1166_cov_313.815370	444	524	615	2	80	0.0250000
NODE_4206_length_1166_cov_313.815370	444	524	631	1	80	0.0125000
NODE_4206_length_1166_cov_313.815370	444	524	98	9	80	0.1125000
NODE_4206_length_1166_cov_313.815370	444	524	118	4	80	0.0500000
NODE_4206_length_1166_cov_313.815370	444	524	119	1	80	0.0125000
NODE_4206_length_1166_cov_313.815370	444	524	128	1	80	0.0125000
NODE_4206_length_1166_cov_313.815370	444	524	151	1	80	0.0125000
NODE_4206_length_1166_cov_313.815370	444	524	155	1	80	0.0125000
NODE_4206_length_1166_cov_313.815370	444	524	163	1	80	0.0125000
NODE_4206_length_1166_cov_313.815370	444	524	164	1	80	0.0125000
NODE_4206_length_1166_cov_313.815370	444	524	165	1	80	0.0125000
NODE_4206_length_1166_cov_313.815370	444	524	170	1	80	0.0125000
NODE_4206_length_1166_cov_313.815370	444	524	187	1	80	0.0125000
NODE_4206_length_1166_cov_313.815370	444	524	189	1	80	0.0125000
NODE_4206_length_1166_cov_313.815370	444	524	190	6	80	0.0750000
NODE_4206_length_1166_cov_313.815370	444	524	193	1	80	0.0125000
NODE_4206_length_1166_cov_313.815370	444	524	194	1	80	0.0125000
NODE_4206_length_1166_cov_313.815370	444	524	202	1	80	0.0125000
NODE_4206_length_1166_cov_313.815370	444	524	205	1	80	0.0125000
NODE_4206_length_1166_cov_313.815370	444	524	238	1	80	0.0125000
NODE_4206_length_1166_cov_313.815370	444	524	240	1	80	0.0125000
NODE_4206_length_1166_cov_313.815370	444	524	251	1	80	0.0125000
NODE_4206_length_1166_cov_313.815370	444	524	256	1	80	0.0125000
NODE_4206_length_1166_cov_313.815370	444	524	278	1	80	0.0125000
NODE_4206_length_1166_cov_313.815370	444	524	304	1	80	0.0125000
NODE_4206_length_1166_cov_313.815370	444	524	305	2	80	0.0250000
NODE_4206_length_1166_cov_313.815370	444	524	339	1	80	0.0125000
NODE_4206_length_1166_cov_313.815370	444	524	341	1	80	0.0125000
NODE_4206_length_1166_cov_313.815370	444	524	350	1	80	0.0125000
NODE_4206_length_1166_cov_313.815370	444	524	373	1	80	0.0125000
NODE_4206_length_1166_cov_313.815370	444	524	389	1	80	0.0125000
NODE_4206_length_1166_cov_313.815370	444	524	398	3	80	0.0375000
NODE_4206_length_1166_cov_313.815370	444	524	411	2	80	0.0250000
NODE_4206_length_1166_cov_313.815370	444	524	412	1	80	0.0125000
NODE_4206_length_1166_cov_313.815370	444	524	434	1	80	0.0125000
NODE_4206_length_1166_cov_313.815370	444	524	435	1	80	0.0125000
NODE_4206_length_1166_cov_313.815370	444	524	439	1	80	0.0125000
NODE_4206_length_1166_cov_313.815370	444	524	443	2	80	0.0250000
NODE_4206_length_1166_cov_313.815370	444	524	452	1	80	0.0125000
NODE_4206_length_1166_cov_313.815370	444	524	475	1	80	0.0125000
NODE_4206_length_1166_cov_313.815370	444	524	490	1	80	0.0125000
NODE_4206_length_1166_cov_313.815370	444	524	513	1	80	0.0125000
NODE_4206_length_1166_cov_313.815370	444	524	516	1	80	0.0125000
NODE_4206_length_1166_cov_313.815370	444	524	533	1	80	0.0125000
NODE_4206_length_1166_cov_313.815370	444	524	556	1	80	0.0125000
NODE_4206_length_1166_cov_313.815370	444	524	566	1	80	0.0125000
NODE_4206_length_1166_cov_313.815370	444	524	567	1	80	0.0125000
NODE_4206_length_1166_cov_313.815370	444	524	581	1	80	0.0125000
NODE_4206_length_1166_cov_313.815370	444	524	583	1	80	0.0125000
NODE_4206_length_1166_cov_313.815370	444	524	592	1	80	0.0125000
NODE_4206_length_1166_cov_313.815370	444	524	596	1	80	0.0125000
NODE_4206_length_1166_cov_313.815370	444	524	600	1	80	0.0125000
NODE_4206_length_1166_cov_313.815370	444	524	604	1	80	0.0125000
NODE_4206_length_1166_cov_313.815370	444	524	605	2	80	0.0250000
NODE_4206_length_1166_cov_313.815370	444	524	606	1	80	0.0125000
NODE_4206_length_1166_cov_313.815370	444	524	607	1	80	0.0125000
NODE_4206_length_1166_cov_313.815370	444	524	611	1	80	0.0125000
NODE_4206_length_1166_cov_313.815370	444	524	615	2	80	0.0250000
NODE_4206_length_1166_cov_313.815370	444	524	631	1	80	0.0125000
NODE_4206_length_1166_cov_313.815370	444	524	98	9	80	0.1125000
NODE_4206_length_1166_cov_313.815370	444	524	118	4	80	0.0500000
NODE_4206_length_1166_cov_313.815370	444	524	119	1	80	0.0125000
NODE_4206_length_1166_cov_313.815370	444	524	128	1	80	0.0125000
NODE_4206_length_1166_cov_313.815370	444	524	151	1	80	0.0125000
NODE_4206_length_1166_cov_313.815370	444	524	155	1	80	0.0125000
NODE_4206_length_1166_cov_313.815370	444	524	163	1	80	0.0125000
NODE_4206_length_1166_cov_313.815370	444	524	164	1	80	0.0125000
NODE_4206_length_1166_cov_313.815370	444	524	165	1	80	0.0125000
NODE_4206_length_1166_cov_313.815370	444	524	170	1	80	0.0125000
NODE_4206_length_1166_cov_313.815370	444	524	187	1	80	0.0125000
NODE_4206_length_1166_cov_313.815370	444	524	189	1	80	0.0125000
NODE_4206_length_1166_cov_313.815370	444	524	190	6	80	0.0750000
NODE_4206_length_1166_cov_313.815370	444	524	193	1	80	0.0125000
NODE_4206_length_1166_cov_313.815370	444	524	194	1	80	0.0125000
NODE_4206_length_1166_cov_313.815370	444	524	202	1	80	0.0125000
NODE_4206_length_1166_cov_313.815370	444	524	205	1	80	0.0125000
NODE_4206_length_1166_cov_313.815370	444	524	238	1	80	0.0125000
NODE_4206_length_1166_cov_313.815370	444	524	240	1	80	0.0125000
NODE_4206_length_1166_cov_313.815370	444	524	251	1	80	0.0125000
NODE_4206_length_1166_cov_313.815370	444	524	256	1	80	0.0125000
NODE_4206_length_1166_cov_313.815370	444	524	278	1	80	0.0125000
NODE_4206_length_1166_cov_313.815370	444	524	304	1	80	0.0125000
NODE_4206_length_1166_cov_313.815370	444	524	305	2	80	0.0250000
NODE_4206_length_1166_cov_313.815370	444	524	339	1	80	0.0125000
NODE_4206_length_1166_cov_313.815370	444	524	341	1	80	0.0125000
NODE_4206_length_1166_cov_313.815370	444	524	350	1	80	0.0125000
NODE_4206_length_1166_cov_313.815370	444	524	373	1	80	0.0125000
NODE_4206_length_1166_cov_313.815370	444	524	389	1	80	0.0125000
NODE_4206_length_1166_cov_313.815370	444	524	398	3	80	0.0375000
NODE_4206_length_1166_cov_313.815370	444	524	411	2	80	0.0250000
NODE_4206_length_1166_cov_313.815370	444	524	412	1	80	0.0125000
NODE_4206_length_1166_cov_313.815370	444	524	434	1	80	0.0125000
NODE_4206_length_1166_cov_313.815370	444	524	435	1	80	0.0125000
NODE_4206_length_1166_cov_313.815370	444	524	439	1	80	0.0125000
NODE_4206_length_1166_cov_313.815370	444	524	443	2	80	0.0250000
NODE_4206_length_1166_cov_313.815370	444	524	452	1	80	0.0125000
NODE_4206_length_1166_cov_313.815370	444	524	475	1	80	0.0125000
NODE_4206_length_1166_cov_313.815370	444	524	490	1	80	0.0125000
NODE_4206_length_1166_cov_313.815370	444	524	513	1	80	0.0125000
NODE_4206_length_1166_cov_313.815370	444	524	516	1	80	0.0125000
NODE_4206_length_1166_cov_313.815370	444	524	533	1	80	0.0125000
NODE_4206_length_1166_cov_313.815370	444	524	556	1	80	0.0125000
NODE_4206_length_1166_cov_313.815370	444	524	566	1	80	0.0125000
NODE_4206_length_1166_cov_313.815370	444	524	567	1	80	0.0125000
NODE_4206_length_1166_cov_313.815370	444	524	581	1	80	0.0125000
NODE_4206_length_1166_cov_313.815370	444	524	583	1	80	0.0125000
NODE_4206_length_1166_cov_313.815370	444	524	592	1	80	0.0125000
NODE_4206_length_1166_cov_313.815370	444	524	596	1	80	0.0125000
NODE_4206_length_1166_cov_313.815370	444	524	600	1	80	0.0125000
NODE_4206_length_1166_cov_313.815370	444	524	604	1	80	0.0125000
NODE_4206_length_1166_cov_313.815370	444	524	605	2	80	0.0250000
NODE_4206_length_1166_cov_313.815370	444	524	606	1	80	0.0125000
NODE_4206_length_1166_cov_313.815370	444	524	607	1	80	0.0125000
NODE_4206_length_1166_cov_313.815370	444	524	611	1	80	0.0125000
NODE_4206_length_1166_cov_313.815370	444	524	615	2	80	0.0250000
NODE_4206_length_1166_cov_313.815370	444	524	631	1	80	0.0125000
NODE_4206_length_1166_cov_313.815370	444	524	98	9	80	0.1125000
NODE_4206_length_1166_cov_313.815370	444	524	118	4	80	0.0500000
NODE_4206_length_1166_cov_313.815370	444	524	119	1	80	0.0125000
NODE_4206_length_1166_cov_313.815370	444	524	128	1	80	0.0125000
NODE_4206_length_1166_cov_313.815370	444	524	151	1	80	0.0125000
NODE_4206_length_1166_cov_313.815370	444	524	155	1	80	0.0125000
NODE_4206_length_1166_cov_313.815370	444	524	163	1	80	0.0125000
NODE_4206_length_1166_cov_313.815370	444	524	164	1	80	0.0125000
NODE_4206_length_1166_cov_313.815370	444	524	165	1	80	0.0125000
NODE_4206_length_1166_cov_313.815370	444	524	170	1	80	0.0125000
NODE_4206_length_1166_cov_313.815370	444	524	187	1	80	0.0125000
NODE_4206_length_1166_cov_313.815370	444	524	189	1	80	0.0125000
NODE_4206_length_1166_cov_313.815370	444	524	190	6	80	0.0750000
NODE_4206_length_1166_cov_313.815370	444	524	193	1	80	0.0125000
NODE_4206_length_1166_cov_313.815370	444	524	194	1	80	0.0125000
NODE_4206_length_1166_cov_313.815370	444	524	202	1	80	0.0125000
NODE_4206_length_1166_cov_313.815370	444	524	205	1	80	0.0125000
NODE_4206_length_1166_cov_313.815370	444	524	238	1	80	0.0125000
NODE_4206_length_1166_cov_313.815370	444	524	240	1	80	0.0125000
NODE_4206_length_1166_cov_313.815370	444	524	251	1	80	0.0125000
NODE_4206_length_1166_cov_313.815370	444	524	256	1	80	0.0125000
NODE_4206_length_1166_cov_313.815370	444	524	278	1	80	0.0125000
NODE_4206_length_1166_cov_313.815370	444	524	304	1	80	0.0125000
NODE_4206_length_1166_cov_313.815370	444	524	305	2	80	0.0250000
NODE_4206_length_1166_cov_313.815370	444	524	339	1	80	0.0125000
NODE_4206_length_1166_cov_313.815370	444	524	341	1	80	0.0125000
NODE_4206_length_1166_cov_313.815370	444	524	350	1	80	0.0125000
NODE_4206_length_1166_cov_313.815370	444	524	373	1	80	0.0125000
NODE_4206_length_1166_cov_313.815370	444	524	389	1	80	0.0125000
NODE_4206_length_1166_cov_313.815370	444	524	398	3	80	0.0375000
NODE_4206_length_1166_cov_313.815370	444	524	411	2	80	0.0250000
NODE_4206_length_1166_cov_313.815370	444	524	412	1	80	0.0125000
NODE_4206_length_1166_cov_313.815370	444	524	434	1	80	0.0125000
NODE_4206_length_1166_cov_313.815370	444	524	435	1	80	0.0125000
NODE_4206_length_1166_cov_313.815370	444	524	439	1	80	0.0125000
NODE_4206_length_1166_cov_313.815370	444	524	443	2	80	0.0250000
NODE_4206_length_1166_cov_313.815370	444	524	452	1	80	0.0125000
NODE_4206_length_1166_cov_313.815370	444	524	475	1	80	0.0125000
NODE_4206_length_1166_cov_313.815370	444	524	490	1	80	0.0125000
NODE_4206_length_1166_cov_313.815370	444	524	513	1	80	0.0125000
NODE_4206_length_1166_cov_313.815370	444	524	516	1	80	0.0125000
NODE_4206_length_1166_cov_313.815370	444	524	533	1	80	0.0125000
NODE_4206_length_1166_cov_313.815370	444	524	556	1	80	0.0125000
NODE_4206_length_1166_cov_313.815370	444	524	566	1	80	0.0125000
NODE_4206_length_1166_cov_313.815370	444	524	567	1	80	0.0125000
NODE_4206_length_1166_cov_313.815370	444	524	581	1	80	0.0125000
NODE_4206_length_1166_cov_313.815370	444	524	583	1	80	0.0125000
NODE_4206_length_1166_cov_313.815370	444	524	592	1	80	0.0125000
NODE_4206_length_1166_cov_313.815370	444	524	596	1	80	0.0125000
NODE_4206_length_1166_cov_313.815370	444	524	600	1	80	0.0125000
NODE_4206_length_1166_cov_313.815370	444	524	604	1	80	0.0125000
NODE_4206_length_1166_cov_313.815370	444	524	605	2	80	0.0250000
NODE_4206_length_1166_cov_313.815370	444	524	606	1	80	0.0125000
NODE_4206_length_1166_cov_313.815370	444	524	607	1	80	0.0125000
NODE_4206_length_1166_cov_313.815370	444	524	611	1	80	0.0125000
NODE_4206_length_1166_cov_313.815370	444	524	615	2	80	0.0250000
NODE_4206_length_1166_cov_313.815370	444	524	631	1	80	0.0125000
NODE_4206_length_1166_cov_313.815370	444	524	98	9	80	0.1125000
NODE_4206_length_1166_cov_313.815370	444	524	118	4	80	0.0500000
NODE_4206_length_1166_cov_313.815370	444	524	119	1	80	0.0125000
NODE_4206_length_1166_cov_313.815370	444	524	128	1	80	0.0125000
NODE_4206_length_1166_cov_313.815370	444	524	151	1	80	0.0125000
NODE_4206_length_1166_cov_313.815370	444	524	155	1	80	0.0125000
NODE_4206_length_1166_cov_313.815370	444	524	163	1	80	0.0125000
NODE_4206_length_1166_cov_313.815370	444	524	164	1	80	0.0125000
NODE_4206_length_1166_cov_313.815370	444	524	165	1	80	0.0125000
NODE_4206_length_1166_cov_313.815370	444	524	170	1	80	0.0125000
NODE_4206_length_1166_cov_313.815370	444	524	187	1	80	0.0125000
NODE_4206_length_1166_cov_313.815370	444	524	189	1	80	0.0125000
NODE_4206_length_1166_cov_313.815370	444	524	190	6	80	0.0750000
NODE_4206_length_1166_cov_313.815370	444	524	193	1	80	0.0125000
NODE_4206_length_1166_cov_313.815370	444	524	194	1	80	0.0125000
NODE_4206_length_1166_cov_313.815370	444	524	202	1	80	0.0125000
NODE_4206_length_1166_cov_313.815370	444	524	205	1	80	0.0125000
NODE_4206_length_1166_cov_313.815370	444	524	238	1	80	0.0125000
NODE_4206_length_1166_cov_313.815370	444	524	240	1	80	0.0125000
NODE_4206_length_1166_cov_313.815370	444	524	251	1	80	0.0125000
NODE_4206_length_1166_cov_313.815370	444	524	256	1	80	0.0125000
NODE_4206_length_1166_cov_313.815370	444	524	278	1	80	0.0125000
NODE_4206_length_1166_cov_313.815370	444	524	304	1	80	0.0125000
NODE_4206_length_1166_cov_313.815370	444	524	305	2	80	0.0250000
NODE_4206_length_1166_cov_313.815370	444	524	339	1	80	0.0125000
NODE_4206_length_1166_cov_313.815370	444	524	341	1	80	0.0125000
NODE_4206_length_1166_cov_313.815370	444	524	350	1	80	0.0125000
NODE_4206_length_1166_cov_313.815370	444	524	373	1	80	0.0125000
NODE_4206_length_1166_cov_313.815370	444	524	389	1	80	0.0125000
NODE_4206_length_1166_cov_313.815370	444	524	398	3	80	0.0375000
NODE_4206_length_1166_cov_313.815370	444	524	411	2	80	0.0250000
NODE_4206_length_1166_cov_313.815370	444	524	412	1	80	0.0125000
NODE_4206_length_1166_cov_313.815370	444	524	434	1	80	0.0125000
NODE_4206_length_1166_cov_313.815370	444	524	435	1	80	0.0125000
NODE_4206_length_1166_cov_313.815370	444	524	439	1	80	0.0125000
NODE_4206_length_1166_cov_313.815370	444	524	443	2	80	0.0250000
NODE_4206_length_1166_cov_313.815370	444	524	452	1	80	0.0125000
NODE_4206_length_1166_cov_313.815370	444	524	475	1	80	0.0125000
NODE_4206_length_1166_cov_313.815370	444	524	490	1	80	0.0125000
NODE_4206_length_1166_cov_313.815370	444	524	513	1	80	0.0125000
NODE_4206_length_1166_cov_313.815370	444	524	516	1	80	0.0125000
NODE_4206_length_1166_cov_313.815370	444	524	533	1	80	0.0125000
NODE_4206_length_1166_cov_313.815370	444	524	556	1	80	0.0125000
NODE_4206_length_1166_cov_313.815370	444	524	566	1	80	0.0125000
NODE_4206_length_1166_cov_313.815370	444	524	567	1	80	0.0125000
NODE_4206_length_1166_cov_313.815370	444	524	581	1	80	0.0125000
NODE_4206_length_1166_cov_313.815370	444	524	583	1	80	0.0125000
NODE_4206_length_1166_cov_313.815370	444	524	592	1	80	0.0125000
NODE_4206_length_1166_cov_313.815370	444	524	596	1	80	0.0125000
NODE_4206_length_1166_cov_313.815370	444	524	600	1	80	0.0125000
NODE_4206_length_1166_cov_313.815370	444	524	604	1	80	0.0125000
NODE_4206_length_1166_cov_313.815370	444	524	605	2	80	0.0250000
NODE_4206_length_1166_cov_313.815370	444	524	606	1	80	0.0125000
NODE_4206_length_1166_cov_313.815370	444	524	607	1	80	0.0125000
NODE_4206_length_1166_cov_313.815370	444	524	611	1	80	0.0125000
NODE_4206_length_1166_cov_313.815370	444	524	615	2	80	0.0250000
NODE_4206_length_1166_cov_313.815370	444	524	631	1	80	0.0125000
NODE_4206_length_1166_cov_313.815370	497	577	435	1	80	0.0125000
NODE_4206_length_1166_cov_313.815370	497	577	439	1	80	0.0125000
NODE_4206_length_1166_cov_313.815370	497	577	443	2	80	0.0250000
NODE_4206_length_1166_cov_313.815370	497	577	452	1	80	0.0125000
NODE_4206_length_1166_cov_313.815370	497	577	475	1	80	0.0125000
NODE_4206_length_1166_cov_313.815370	497	577	490	1	80	0.0125000
NODE_4206_length_1166_cov_313.815370	497	577	513	1	80	0.0125000
NODE_4206_length_1166_cov_313.815370	497	577	516	1	80	0.0125000
NODE_4206_length_1166_cov_313.815370	497	577	533	1	80	0.0125000
NODE_4206_length_1166_cov_313.815370	497	577	556	1	80	0.0125000
NODE_4206_length_1166_cov_313.815370	497	577	566	1	80	0.0125000
NODE_4206_length_1166_cov_313.815370	497	577	567	1	80	0.0125000
NODE_4206_length_1166_cov_313.815370	497	577	581	1	80	0.0125000
NODE_4206_length_1166_cov_313.815370	497	577	583	1	80	0.0125000
NODE_4206_length_1166_cov_313.815370	497	577	592	1	80	0.0125000
NODE_4206_length_1166_cov_313.815370	497	577	596	1	80	0.0125000
NODE_4206_length_1166_cov_313.815370	497	577	600	1	80	0.0125000
NODE_4206_length_1166_cov_313.815370	497	577	604	1	80	0.0125000
NODE_4206_length_1166_cov_313.815370	497	577	605	2	80	0.0250000
NODE_4206_length_1166_cov_313.815370	497	577	606	1	80	0.0125000
NODE_4206_length_1166_cov_313.815370	497	577	607	1	80	0.0125000
NODE_4206_length_1166_cov_313.815370	497	577	611	1	80	0.0125000
NODE_4206_length_1166_cov_313.815370	497	577	615	2	80	0.0250000
NODE_4206_length_1166_cov_313.815370	497	577	621	1	80	0.0125000
NODE_4206_length_1166_cov_313.815370	497	577	622	6	80	0.0750000
NODE_4206_length_1166_cov_313.815370	497	577	630	4	80	0.0500000
NODE_4206_length_1166_cov_313.815370	497	577	631	1	80	0.0125000
NODE_4206_length_1166_cov_313.815370	497	577	632	1	80	0.0125000
NODE_4206_length_1166_cov_313.815370	497	577	633	7	80	0.0875000
NODE_4206_length_1166_cov_313.815370	497	577	634	5	80	0.0625000
NODE_4206_length_1166_cov_313.815370	497	577	637	4	80	0.0500000
NODE_4206_length_1166_cov_313.815370	497	577	639	2	80	0.0250000
NODE_4206_length_1166_cov_313.815370	497	577	640	1	80	0.0125000
NODE_4206_length_1166_cov_313.815370	497	577	641	3	80	0.0375000
NODE_4206_length_1166_cov_313.815370	497	577	642	9	80	0.1125000
NODE_4206_length_1166_cov_313.815370	497	577	643	8	80	0.1000000
NODE_4206_length_1166_cov_313.815370	497	577	651	1	80	0.0125000
NODE_4206_length_1166_cov_313.815370	497	577	653	1	80	0.0125000
NODE_4206_length_1166_cov_313.815370	497	577	435	1	80	0.0125000
NODE_4206_length_1166_cov_313.815370	497	577	439	1	80	0.0125000
NODE_4206_length_1166_cov_313.815370	497	577	443	2	80	0.0250000
NODE_4206_length_1166_cov_313.815370	497	577	452	1	80	0.0125000
NODE_4206_length_1166_cov_313.815370	497	577	475	1	80	0.0125000
NODE_4206_length_1166_cov_313.815370	497	577	490	1	80	0.0125000
NODE_4206_length_1166_cov_313.815370	497	577	513	1	80	0.0125000
NODE_4206_length_1166_cov_313.815370	497	577	516	1	80	0.0125000
NODE_4206_length_1166_cov_313.815370	497	577	533	1	80	0.0125000
NODE_4206_length_1166_cov_313.815370	497	577	556	1	80	0.0125000
NODE_4206_length_1166_cov_313.815370	497	577	566	1	80	0.0125000
NODE_4206_length_1166_cov_313.815370	497	577	567	1	80	0.0125000
NODE_4206_length_1166_cov_313.815370	497	577	581	1	80	0.0125000
NODE_4206_length_1166_cov_313.815370	497	577	583	1	80	0.0125000
NODE_4206_length_1166_cov_313.815370	497	577	592	1	80	0.0125000
NODE_4206_length_1166_cov_313.815370	497	577	596	1	80	0.0125000
NODE_4206_length_1166_cov_313.815370	497	577	600	1	80	0.0125000
NODE_4206_length_1166_cov_313.815370	497	577	604	1	80	0.0125000
NODE_4206_length_1166_cov_313.815370	497	577	605	2	80	0.0250000
NODE_4206_length_1166_cov_313.815370	497	577	606	1	80	0.0125000
NODE_4206_length_1166_cov_313.815370	497	577	607	1	80	0.0125000
NODE_4206_length_1166_cov_313.815370	497	577	611	1	80	0.0125000
NODE_4206_length_1166_cov_313.815370	497	577	615	2	80	0.0250000
NODE_4206_length_1166_cov_313.815370	497	577	621	1	80	0.0125000
NODE_4206_length_1166_cov_313.815370	497	577	622	6	80	0.0750000
NODE_4206_length_1166_cov_313.815370	497	577	630	4	80	0.0500000
NODE_4206_length_1166_cov_313.815370	497	577	631	1	80	0.0125000
NODE_4206_length_1166_cov_313.815370	497	577	632	1	80	0.0125000
NODE_4206_length_1166_cov_313.815370	497	577	633	7	80	0.0875000
NODE_4206_length_1166_cov_313.815370	497	577	634	5	80	0.0625000
NODE_4206_length_1166_cov_313.815370	497	577	637	4	80	0.0500000
NODE_4206_length_1166_cov_313.815370	497	577	639	2	80	0.0250000
NODE_4206_length_1166_cov_313.815370	497	577	640	1	80	0.0125000
NODE_4206_length_1166_cov_313.815370	497	577	641	3	80	0.0375000
NODE_4206_length_1166_cov_313.815370	497	577	642	9	80	0.1125000
NODE_4206_length_1166_cov_313.815370	497	577	643	8	80	0.1000000
NODE_4206_length_1166_cov_313.815370	497	577	651	1	80	0.0125000
NODE_4206_length_1166_cov_313.815370	497	577	653	1	80	0.0125000
NODE_4206_length_1166_cov_313.815370	497	577	435	1	80	0.0125000
NODE_4206_length_1166_cov_313.815370	497	577	439	1	80	0.0125000
NODE_4206_length_1166_cov_313.815370	497	577	443	2	80	0.0250000
NODE_4206_length_1166_cov_313.815370	497	577	452	1	80	0.0125000
NODE_4206_length_1166_cov_313.815370	497	577	475	1	80	0.0125000
NODE_4206_length_1166_cov_313.815370	497	577	490	1	80	0.0125000
NODE_4206_length_1166_cov_313.815370	497	577	513	1	80	0.0125000
NODE_4206_length_1166_cov_313.815370	497	577	516	1	80	0.0125000
NODE_4206_length_1166_cov_313.815370	497	577	533	1	80	0.0125000
NODE_4206_length_1166_cov_313.815370	497	577	556	1	80	0.0125000
NODE_4206_length_1166_cov_313.815370	497	577	566	1	80	0.0125000
NODE_4206_length_1166_cov_313.815370	497	577	567	1	80	0.0125000
NODE_4206_length_1166_cov_313.815370	497	577	581	1	80	0.0125000
NODE_4206_length_1166_cov_313.815370	497	577	583	1	80	0.0125000
NODE_4206_length_1166_cov_313.815370	497	577	592	1	80	0.0125000
NODE_4206_length_1166_cov_313.815370	497	577	596	1	80	0.0125000
NODE_4206_length_1166_cov_313.815370	497	577	600	1	80	0.0125000
NODE_4206_length_1166_cov_313.815370	497	577	604	1	80	0.0125000
NODE_4206_length_1166_cov_313.815370	497	577	605	2	80	0.0250000
NODE_4206_length_1166_cov_313.815370	497	577	606	1	80	0.0125000
NODE_4206_length_1166_cov_313.815370	497	577	607	1	80	0.0125000
NODE_4206_length_1166_cov_313.815370	497	577	611	1	80	0.0125000
NODE_4206_length_1166_cov_313.815370	497	577	615	2	80	0.0250000
NODE_4206_length_1166_cov_313.815370	497	577	621	1	80	0.0125000
NODE_4206_length_1166_cov_313.815370	497	577	622	6	80	0.0750000
NODE_4206_length_1166_cov_313.815370	497	577	630	4	80	0.0500000
NODE_4206_length_1166_cov_313.815370	497	577	631	1	80	0.0125000
NODE_4206_length_1166_cov_313.815370	497	577	632	1	80	0.0125000
NODE_4206_length_1166_cov_313.815370	497	577	633	7	80	0.0875000
NODE_4206_length_1166_cov_313.815370	497	577	634	5	80	0.0625000
NODE_4206_length_1166_cov_313.815370	497	577	637	4	80	0.0500000
NODE_4206_length_1166_cov_313.815370	497	577	639	2	80	0.0250000
NODE_4206_length_1166_cov_313.815370	497	577	640	1	80	0.0125000
NODE_4206_length_1166_cov_313.815370	497	577	641	3	80	0.0375000
NODE_4206_length_1166_cov_313.815370	497	577	642	9	80	0.1125000
NODE_4206_length_1166_cov_313.815370	497	577	643	8	80	0.1000000
NODE_4206_length_1166_cov_313.815370	497	577	651	1	80	0.0125000
NODE_4206_length_1166_cov_313.815370	497	577	653	1	80	0.0125000
NODE_4206_length_1166_cov_313.815370	497	577	435	1	80	0.0125000
NODE_4206_length_1166_cov_313.815370	497	577	439	1	80	0.0125000
NODE_4206_length_1166_cov_313.815370	497	577	443	2	80	0.0250000
NODE_4206_length_1166_cov_313.815370	497	577	452	1	80	0.0125000
NODE_4206_length_1166_cov_313.815370	497	577	475	1	80	0.0125000
NODE_4206_length_1166_cov_313.815370	497	577	490	1	80	0.0125000
NODE_4206_length_1166_cov_313.815370	497	577	513	1	80	0.0125000
NODE_4206_length_1166_cov_313.815370	497	577	516	1	80	0.0125000
NODE_4206_length_1166_cov_313.815370	497	577	533	1	80	0.0125000
NODE_4206_length_1166_cov_313.815370	497	577	556	1	80	0.0125000
NODE_4206_length_1166_cov_313.815370	497	577	566	1	80	0.0125000
NODE_4206_length_1166_cov_313.815370	497	577	567	1	80	0.0125000
NODE_4206_length_1166_cov_313.815370	497	577	581	1	80	0.0125000
NODE_4206_length_1166_cov_313.815370	497	577	583	1	80	0.0125000
NODE_4206_length_1166_cov_313.815370	497	577	592	1	80	0.0125000
NODE_4206_length_1166_cov_313.815370	497	577	596	1	80	0.0125000
NODE_4206_length_1166_cov_313.815370	497	577	600	1	80	0.0125000
NODE_4206_length_1166_cov_313.815370	497	577	604	1	80	0.0125000
NODE_4206_length_1166_cov_313.815370	497	577	605	2	80	0.0250000
NODE_4206_length_1166_cov_313.815370	497	577	606	1	80	0.0125000
NODE_4206_length_1166_cov_313.815370	497	577	607	1	80	0.0125000
NODE_4206_length_1166_cov_313.815370	497	577	611	1	80	0.0125000
NODE_4206_length_1166_cov_313.815370	497	577	615	2	80	0.0250000
NODE_4206_length_1166_cov_313.815370	497	577	621	1	80	0.0125000
NODE_4206_length_1166_cov_313.815370	497	577	622	6	80	0.0750000
NODE_4206_length_1166_cov_313.815370	497	577	630	4	80	0.0500000
NODE_4206_length_1166_cov_313.815370	497	577	631	1	80	0.0125000
NODE_4206_length_1166_cov_313.815370	497	577	632	1	80	0.0125000
NODE_4206_length_1166_cov_313.815370	497	577	633	7	80	0.0875000
NODE_4206_length_1166_cov_313.815370	497	577	634	5	80	0.0625000
NODE_4206_length_1166_cov_313.815370	497	577	637	4	80	0.0500000
NODE_4206_length_1166_cov_313.815370	497	577	639	2	80	0.0250000
NODE_4206_length_1166_cov_313.815370	497	577	640	1	80	0.0125000
NODE_4206_length_1166_cov_313.815370	497	577	641	3	80	0.0375000
NODE_4206_length_1166_cov_313.815370	497	577	642	9	80	0.1125000
NODE_4206_length_1166_cov_313.815370	497	577	643	8	80	0.1000000
NODE_4206_length_1166_cov_313.815370	497	577	651	1	80	0.0125000
NODE_4206_length_1166_cov_313.815370	497	577	653	1	80	0.0125000
NODE_4206_length_1166_cov_313.815370	497	577	435	1	80	0.0125000
NODE_4206_length_1166_cov_313.815370	497	577	439	1	80	0.0125000
NODE_4206_length_1166_cov_313.815370	497	577	443	2	80	0.0250000
NODE_4206_length_1166_cov_313.815370	497	577	452	1	80	0.0125000
NODE_4206_length_1166_cov_313.815370	497	577	475	1	80	0.0125000
NODE_4206_length_1166_cov_313.815370	497	577	490	1	80	0.0125000
NODE_4206_length_1166_cov_313.815370	497	577	513	1	80	0.0125000
NODE_4206_length_1166_cov_313.815370	497	577	516	1	80	0.0125000
NODE_4206_length_1166_cov_313.815370	497	577	533	1	80	0.0125000
NODE_4206_length_1166_cov_313.815370	497	577	556	1	80	0.0125000
NODE_4206_length_1166_cov_313.815370	497	577	566	1	80	0.0125000
NODE_4206_length_1166_cov_313.815370	497	577	567	1	80	0.0125000
NODE_4206_length_1166_cov_313.815370	497	577	581	1	80	0.0125000
NODE_4206_length_1166_cov_313.815370	497	577	583	1	80	0.0125000
NODE_4206_length_1166_cov_313.815370	497	577	592	1	80	0.0125000
NODE_4206_length_1166_cov_313.815370	497	577	596	1	80	0.0125000
NODE_4206_length_1166_cov_313.815370	497	577	600	1	80	0.0125000
NODE_4206_length_1166_cov_313.815370	497	577	604	1	80	0.0125000
NODE_4206_length_1166_cov_313.815370	497	577	605	2	80	0.0250000
NODE_4206_length_1166_cov_313.815370	497	577	606	1	80	0.0125000
NODE_4206_length_1166_cov_313.815370	497	577	607	1	80	0.0125000
NODE_4206_length_1166_cov_313.815370	497	577	611	1	80	0.0125000
NODE_4206_length_1166_cov_313.815370	497	577	615	2	80	0.0250000
NODE_4206_length_1166_cov_313.815370	497	577	621	1	80	0.0125000
NODE_4206_length_1166_cov_313.815370	497	577	622	6	80	0.0750000
NODE_4206_length_1166_cov_313.815370	497	577	630	4	80	0.0500000
NODE_4206_length_1166_cov_313.815370	497	577	631	1	80	0.0125000
NODE_4206_length_1166_cov_313.815370	497	577	632	1	80	0.0125000
NODE_4206_length_1166_cov_313.815370	497	577	633	7	80	0.0875000
NODE_4206_length_1166_cov_313.815370	497	577	634	5	80	0.0625000
NODE_4206_length_1166_cov_313.815370	497	577	637	4	80	0.0500000
NODE_4206_length_1166_cov_313.815370	497	577	639	2	80	0.0250000
NODE_4206_length_1166_cov_313.815370	497	577	640	1	80	0.0125000
NODE_4206_length_1166_cov_313.815370	497	577	641	3	80	0.0375000
NODE_4206_length_1166_cov_313.815370	497	577	642	9	80	0.1125000
NODE_4206_length_1166_cov_313.815370	497	577	643	8	80	0.1000000
NODE_4206_length_1166_cov_313.815370	497	577	651	1	80	0.0125000
NODE_4206_length_1166_cov_313.815370	497	577	653	1	80	0.0125000
NODE_4206_length_1166_cov_313.815370	497	577	435	1	80	0.0125000
NODE_4206_length_1166_cov_313.815370	497	577	439	1	80	0.0125000
NODE_4206_length_1166_cov_313.815370	497	577	443	2	80	0.0250000
NODE_4206_length_1166_cov_313.815370	497	577	452	1	80	0.0125000
NODE_4206_length_1166_cov_313.815370	497	577	475	1	80	0.0125000
NODE_4206_length_1166_cov_313.815370	497	577	490	1	80	0.0125000
NODE_4206_length_1166_cov_313.815370	497	577	513	1	80	0.0125000
NODE_4206_length_1166_cov_313.815370	497	577	516	1	80	0.0125000
NODE_4206_length_1166_cov_313.815370	497	577	533	1	80	0.0125000
NODE_4206_length_1166_cov_313.815370	497	577	556	1	80	0.0125000
NODE_4206_length_1166_cov_313.815370	497	577	566	1	80	0.0125000
NODE_4206_length_1166_cov_313.815370	497	577	567	1	80	0.0125000
NODE_4206_length_1166_cov_313.815370	497	577	581	1	80	0.0125000
NODE_4206_length_1166_cov_313.815370	497	577	583	1	80	0.0125000
NODE_4206_length_1166_cov_313.815370	497	577	592	1	80	0.0125000
NODE_4206_length_1166_cov_313.815370	497	577	596	1	80	0.0125000
NODE_4206_length_1166_cov_313.815370	497	577	600	1	80	0.0125000
NODE_4206_length_1166_cov_313.815370	497	577	604	1	80	0.0125000
NODE_4206_length_1166_cov_313.815370	497	577	605	2	80	0.0250000
NODE_4206_length_1166_cov_313.815370	497	577	606	1	80	0.0125000
NODE_4206_length_1166_cov_313.815370	497	577	607	1	80	0.0125000
NODE_4206_length_1166_cov_313.815370	497	577	611	1	80	0.0125000
NODE_4206_length_1166_cov_313.815370	497	577	615	2	80	0.0250000
NODE_4206_length_1166_cov_313.815370	497	577	621	1	80	0.0125000
NODE_4206_length_1166_cov_313.815370	497	577	622	6	80	0.0750000
NODE_4206_length_1166_cov_313.815370	497	577	630	4	80	0.0500000
NODE_4206_length_1166_cov_313.815370	497	577	631	1	80	0.0125000
NODE_4206_length_1166_cov_313.815370	497	577	632	1	80	0.0125000
NODE_4206_length_1166_cov_313.815370	497	577	633	7	80	0.0875000
NODE_4206_length_1166_cov_313.815370	497	577	634	5	80	0.0625000
NODE_4206_length_1166_cov_313.815370	497	577	637	4	80	0.0500000
NODE_4206_length_1166_cov_313.815370	497	577	639	2	80	0.0250000
NODE_4206_length_1166_cov_313.815370	497	577	640	1	80	0.0125000
NODE_4206_length_1166_cov_313.815370	497	577	641	3	80	0.0375000
NODE_4206_length_1166_cov_313.815370	497	577	642	9	80	0.1125000
NODE_4206_length_1166_cov_313.815370	497	577	643	8	80	0.1000000
NODE_4206_length_1166_cov_313.815370	497	577	651	1	80	0.0125000
NODE_4206_length_1166_cov_313.815370	497	577	653	1	80	0.0125000
NODE_4206_length_1166_cov_313.815370	497	568	435	1	71	0.0140845
NODE_4206_length_1166_cov_313.815370	497	568	439	1	71	0.0140845
NODE_4206_length_1166_cov_313.815370	497	568	443	2	71	0.0281690
NODE_4206_length_1166_cov_313.815370	497	568	452	1	71	0.0140845
NODE_4206_length_1166_cov_313.815370	497	568	475	1	71	0.0140845
NODE_4206_length_1166_cov_313.815370	497	568	490	1	71	0.0140845
NODE_4206_length_1166_cov_313.815370	497	568	513	1	71	0.0140845
NODE_4206_length_1166_cov_313.815370	497	568	516	1	71	0.0140845
NODE_4206_length_1166_cov_313.815370	497	568	533	1	71	0.0140845
NODE_4206_length_1166_cov_313.815370	497	568	556	1	71	0.0140845
NODE_4206_length_1166_cov_313.815370	497	568	566	1	71	0.0140845
NODE_4206_length_1166_cov_313.815370	497	568	567	1	71	0.0140845
NODE_4206_length_1166_cov_313.815370	497	568	581	1	71	0.0140845
NODE_4206_length_1166_cov_313.815370	497	568	583	1	71	0.0140845
NODE_4206_length_1166_cov_313.815370	497	568	592	1	71	0.0140845
NODE_4206_length_1166_cov_313.815370	497	568	596	1	71	0.0140845
NODE_4206_length_1166_cov_313.815370	497	568	600	1	71	0.0140845
NODE_4206_length_1166_cov_313.815370	497	568	604	1	71	0.0140845
NODE_4206_length_1166_cov_313.815370	497	568	605	2	71	0.0281690
NODE_4206_length_1166_cov_313.815370	497	568	606	1	71	0.0140845
NODE_4206_length_1166_cov_313.815370	497	568	607	1	71	0.0140845
NODE_4206_length_1166_cov_313.815370	497	568	611	1	71	0.0140845
NODE_4206_length_1166_cov_313.815370	497	568	615	2	71	0.0281690
NODE_4206_length_1166_cov_313.815370	497	568	630	4	71	0.0563380
NODE_4206_length_1166_cov_313.815370	497	568	631	1	71	0.0140845
NODE_4206_length_1166_cov_313.815370	497	568	633	6	71	0.0845070
NODE_4206_length_1166_cov_313.815370	497	568	634	5	71	0.0704225
NODE_4206_length_1166_cov_313.815370	497	568	637	4	71	0.0563380
NODE_4206_length_1166_cov_313.815370	497	568	639	2	71	0.0281690
NODE_4206_length_1166_cov_313.815370	497	568	640	1	71	0.0140845
NODE_4206_length_1166_cov_313.815370	497	568	641	3	71	0.0422535
NODE_4206_length_1166_cov_313.815370	497	568	642	9	71	0.1267606
NODE_4206_length_1166_cov_313.815370	497	568	643	8	71	0.1126761
NODE_4206_length_1166_cov_313.815370	497	568	651	1	71	0.0140845
NODE_4206_length_1166_cov_313.815370	497	568	653	1	71	0.0140845
NODE_4206_length_1166_cov_313.815370	500	570	443	1	70	0.0142857
NODE_4206_length_1166_cov_313.815370	500	570	452	1	70	0.0142857
NODE_4206_length_1166_cov_313.815370	500	570	475	1	70	0.0142857
NODE_4206_length_1166_cov_313.815370	500	570	490	1	70	0.0142857
NODE_4206_length_1166_cov_313.815370	500	570	513	1	70	0.0142857
NODE_4206_length_1166_cov_313.815370	500	570	516	1	70	0.0142857
NODE_4206_length_1166_cov_313.815370	500	570	533	1	70	0.0142857
NODE_4206_length_1166_cov_313.815370	500	570	556	1	70	0.0142857
NODE_4206_length_1166_cov_313.815370	500	570	566	1	70	0.0142857
NODE_4206_length_1166_cov_313.815370	500	570	567	1	70	0.0142857
NODE_4206_length_1166_cov_313.815370	500	570	581	1	70	0.0142857
NODE_4206_length_1166_cov_313.815370	500	570	583	1	70	0.0142857
NODE_4206_length_1166_cov_313.815370	500	570	592	1	70	0.0142857
NODE_4206_length_1166_cov_313.815370	500	570	596	1	70	0.0142857
NODE_4206_length_1166_cov_313.815370	500	570	600	1	70	0.0142857
NODE_4206_length_1166_cov_313.815370	500	570	604	1	70	0.0142857
NODE_4206_length_1166_cov_313.815370	500	570	605	2	70	0.0285714
NODE_4206_length_1166_cov_313.815370	500	570	606	1	70	0.0142857
NODE_4206_length_1166_cov_313.815370	500	570	607	1	70	0.0142857
NODE_4206_length_1166_cov_313.815370	500	570	611	1	70	0.0142857
NODE_4206_length_1166_cov_313.815370	500	570	615	2	70	0.0285714
NODE_4206_length_1166_cov_313.815370	500	570	630	4	70	0.0571429
NODE_4206_length_1166_cov_313.815370	500	570	631	1	70	0.0142857
NODE_4206_length_1166_cov_313.815370	500	570	632	1	70	0.0142857
NODE_4206_length_1166_cov_313.815370	500	570	633	7	70	0.1000000
NODE_4206_length_1166_cov_313.815370	500	570	634	5	70	0.0714286
NODE_4206_length_1166_cov_313.815370	500	570	637	4	70	0.0571429
NODE_4206_length_1166_cov_313.815370	500	570	639	2	70	0.0285714
NODE_4206_length_1166_cov_313.815370	500	570	640	1	70	0.0142857
NODE_4206_length_1166_cov_313.815370	500	570	641	3	70	0.0428571
NODE_4206_length_1166_cov_313.815370	500	570	642	9	70	0.1285714
NODE_4206_length_1166_cov_313.815370	500	570	643	8	70	0.1142857
NODE_4206_length_1166_cov_313.815370	500	570	651	1	70	0.0142857
NODE_4206_length_1166_cov_313.815370	500	570	653	1	70	0.0142857
NODE_4206_length_1166_cov_313.815370	997	1077	8	2	80	0.0250000
NODE_4206_length_1166_cov_313.815370	997	1077	18	4	80	0.0500000
NODE_4206_length_1166_cov_313.815370	997	1077	26	8	80	0.1000000
NODE_4206_length_1166_cov_313.815370	997	1077	27	4	80	0.0500000
NODE_4206_length_1166_cov_313.815370	997	1077	28	37	80	0.4625000
NODE_4206_length_1166_cov_313.815370	997	1077	29	2	80	0.0250000
NODE_4206_length_1166_cov_313.815370	997	1077	30	7	80	0.0875000
NODE_4206_length_1166_cov_313.815370	997	1077	31	13	80	0.1625000
NODE_4206_length_1166_cov_313.815370	997	1077	32	3	80	0.0375000
NODE_4206_length_1166_cov_313.815370	1050	1130	6	8	80	0.1000000
NODE_4206_length_1166_cov_313.815370	1050	1130	16	31	80	0.3875000
NODE_4206_length_1166_cov_313.815370	1050	1130	17	4	80	0.0500000
NODE_4206_length_1166_cov_313.815370	1050	1130	26	18	80	0.2250000
NODE_4206_length_1166_cov_313.815370	1050	1130	30	7	80	0.0875000
NODE_4206_length_1166_cov_313.815370	1050	1130	31	12	80	0.1500000
NODE_4206_length_1166_cov_313.815370	1050	1130	6	8	80	0.1000000
NODE_4206_length_1166_cov_313.815370	1050	1130	16	31	80	0.3875000
NODE_4206_length_1166_cov_313.815370	1050	1130	17	4	80	0.0500000
NODE_4206_length_1166_cov_313.815370	1050	1130	26	18	80	0.2250000
NODE_4206_length_1166_cov_313.815370	1050	1130	30	7	80	0.0875000
NODE_4206_length_1166_cov_313.815370	1050	1130	31	12	80	0.1500000
NODE_4206_length_1166_cov_313.815370	1050	1121	16	30	71	0.4225352
NODE_4206_length_1166_cov_313.815370	1050	1121	17	4	71	0.0563380
NODE_4206_length_1166_cov_313.815370	1050	1121	26	18	71	0.2535211
NODE_4206_length_1166_cov_313.815370	1050	1121	30	7	71	0.0985916
NODE_4206_length_1166_cov_313.815370	1050	1121	31	12	71	0.1690141
NODE_4207_length_1166_cov_25.107779	561	641	8	46	80	0.5750000
NODE_4207_length_1166_cov_25.107779	561	641	9	3	80	0.0375000
NODE_4207_length_1166_cov_25.107779	561	641	10	31	80	0.3875000
NODE_4207_length_1166_cov_25.107779	614	694	6	29	80	0.3625000
NODE_4207_length_1166_cov_25.107779	614	694	8	27	80	0.3375000
NODE_4207_length_1166_cov_25.107779	614	694	14	24	80	0.3000000
NODE_4209_length_1166_cov_18.820056	325	405	0	78	80	0.9750000
NODE_4209_length_1166_cov_18.820056	325	405	6	2	80	0.0250000
NODE_4209_length_1166_cov_18.820056	378	458	0	25	80	0.3125000
NODE_4209_length_1166_cov_18.820056	378	458	6	55	80	0.6875000
NODE_4210_length_1166_cov_18.404873	676	756	0	80	80	1.0000000
NODE_4210_length_1166_cov_18.404873	729	809	0	80	80	1.0000000
NODE_4214_length_1166_cov_1.893158	0	71	0	71	71	1.0000000
NODE_4214_length_1166_cov_1.893158	44	99	0	55	55	1.0000000
NODE_4218_length_1165_cov_29.402439	497	577	0	80	80	1.0000000
NODE_4218_length_1165_cov_29.402439	550	630	0	80	80	1.0000000
NODE_4218_length_1165_cov_29.402439	626	706	0	28	80	0.3500000
NODE_4218_length_1165_cov_29.402439	626	706	12	52	80	0.6500000
NODE_4218_length_1165_cov_29.402439	679	759	12	80	80	1.0000000
NODE_4219_length_1165_cov_28.366792	663	743	0	8	80	0.1000000
NODE_4219_length_1165_cov_28.366792	663	743	10	26	80	0.3250000
NODE_4219_length_1165_cov_28.366792	663	743	11	23	80	0.2875000
NODE_4219_length_1165_cov_28.366792	663	743	12	17	80	0.2125000
NODE_4219_length_1165_cov_28.366792	663	743	13	6	80	0.0750000
NODE_4219_length_1165_cov_28.366792	716	796	11	6	80	0.0750000
NODE_4219_length_1165_cov_28.366792	716	796	12	25	80	0.3125000
NODE_4219_length_1165_cov_28.366792	716	796	13	49	80	0.6125000
NODE_4220_length_1165_cov_23.841463	631	711	0	80	80	1.0000000
NODE_4220_length_1165_cov_23.841463	684	765	0	81	81	1.0000000
NODE_4220_length_1165_cov_23.841463	761	841	0	6	80	0.0750000
NODE_4220_length_1165_cov_23.841463	761	841	2	74	80	0.9250000
NODE_4220_length_1165_cov_23.841463	814	894	0	8	80	0.1000000
NODE_4220_length_1165_cov_23.841463	814	894	2	72	80	0.9000000
NODE_4221_length_1165_cov_21.883677	482	562	0	80	80	1.0000000
NODE_4221_length_1165_cov_21.883677	535	615	0	80	80	1.0000000
NODE_4222_length_1165_cov_14.591932	295	375	0	80	80	1.0000000
NODE_4222_length_1165_cov_14.591932	348	428	0	80	80	1.0000000
NODE_4223_length_1165_cov_13.683865	502	582	0	80	80	1.0000000
NODE_4223_length_1165_cov_13.683865	555	635	0	80	80	1.0000000
NODE_4224_length_1165_cov_7.915572	383	463	0	29	80	0.3625000
NODE_4224_length_1165_cov_7.915572	383	463	2	51	80	0.6375000
NODE_4224_length_1165_cov_7.915572	436	516	0	31	80	0.3875000
NODE_4224_length_1165_cov_7.915572	436	516	1	1	80	0.0125000
NODE_4224_length_1165_cov_7.915572	436	516	2	48	80	0.6000000
NODE_4225_length_1165_cov_7.466229	552	632	2	80	80	1.0000000
NODE_4225_length_1165_cov_7.466229	605	685	2	75	80	0.9375000
NODE_4225_length_1165_cov_7.466229	605	685	4	5	80	0.0625000
NODE_4226_length_1165_cov_5.617261	676	756	0	8	80	0.1000000
NODE_4226_length_1165_cov_5.617261	676	756	2	72	80	0.9000000
NODE_4226_length_1165_cov_5.617261	729	809	0	27	80	0.3375000
NODE_4226_length_1165_cov_5.617261	729	809	2	53	80	0.6625000
NODE_4227_length_1165_cov_3.658537	554	602	0	48	48	1.0000000
NODE_4233_length_1164_cov_55.273239	459	539	0	12	80	0.1500000
NODE_4233_length_1164_cov_55.273239	459	539	4	59	80	0.7375000
NODE_4233_length_1164_cov_55.273239	459	539	7	9	80	0.1125000
NODE_4233_length_1164_cov_55.273239	512	592	3	27	80	0.3375000
NODE_4233_length_1164_cov_55.273239	512	592	4	18	80	0.2250000
NODE_4233_length_1164_cov_55.273239	512	592	7	35	80	0.4375000
NODE_4234_length_1164_cov_44.183099	571	651	0	21	80	0.2625000
NODE_4234_length_1164_cov_44.183099	571	651	2	59	80	0.7375000
NODE_4234_length_1164_cov_44.183099	624	704	0	4	80	0.0500000
NODE_4234_length_1164_cov_44.183099	624	704	2	76	80	0.9500000
NODE_4234_length_1164_cov_44.183099	700	780	0	80	80	1.0000000
NODE_4234_length_1164_cov_44.183099	753	833	0	80	80	1.0000000
NODE_4235_length_1164_cov_14.277934	1029	1109	38	14	80	0.1750000
NODE_4235_length_1164_cov_14.277934	1029	1109	40	2	80	0.0250000
NODE_4235_length_1164_cov_14.277934	1029	1109	46	3	80	0.0375000
NODE_4235_length_1164_cov_14.277934	1029	1109	58	2	80	0.0250000
NODE_4235_length_1164_cov_14.277934	1029	1109	61	4	80	0.0500000
NODE_4235_length_1164_cov_14.277934	1029	1109	62	1	80	0.0125000
NODE_4235_length_1164_cov_14.277934	1029	1109	63	15	80	0.1875000
NODE_4235_length_1164_cov_14.277934	1029	1109	64	24	80	0.3000000
NODE_4235_length_1164_cov_14.277934	1029	1109	66	15	80	0.1875000
NODE_4235_length_1164_cov_14.277934	1097	1162	0	10	65	0.1538462
NODE_4235_length_1164_cov_14.277934	1097	1162	10	1	65	0.0153846
NODE_4235_length_1164_cov_14.277934	1097	1162	12	2	65	0.0307692
NODE_4235_length_1164_cov_14.277934	1097	1162	16	5	65	0.0769231
NODE_4235_length_1164_cov_14.277934	1097	1162	23	1	65	0.0153846
NODE_4235_length_1164_cov_14.277934	1097	1162	27	1	65	0.0153846
NODE_4235_length_1164_cov_14.277934	1097	1162	30	13	65	0.2000000
NODE_4235_length_1164_cov_14.277934	1097	1162	33	17	65	0.2615385
NODE_4235_length_1164_cov_14.277934	1097	1162	36	1	65	0.0153846
NODE_4235_length_1164_cov_14.277934	1097	1162	38	14	65	0.2153846
NODE_4236_length_1164_cov_12.880751	415	495	0	80	80	1.0000000
NODE_4236_length_1164_cov_12.880751	468	548	0	80	80	1.0000000
NODE_4237_length_1164_cov_6.924883	415	495	0	4	80	0.0500000
NODE_4237_length_1164_cov_6.924883	415	495	2	76	80	0.9500000
NODE_4237_length_1164_cov_6.924883	468	548	0	57	80	0.7125000
NODE_4237_length_1164_cov_6.924883	468	548	2	23	80	0.2875000
NODE_4245_length_1163_cov_36.315789	458	538	0	80	80	1.0000000
NODE_4245_length_1163_cov_36.315789	511	591	0	66	80	0.8250000
NODE_4245_length_1163_cov_36.315789	511	591	4	1	80	0.0125000
NODE_4245_length_1163_cov_36.315789	511	591	6	13	80	0.1625000
NODE_4245_length_1163_cov_36.315789	587	667	4	18	80	0.2250000
NODE_4245_length_1163_cov_36.315789	587	667	6	62	80	0.7750000
NODE_4245_length_1163_cov_36.315789	640	720	0	30	80	0.3750000
NODE_4245_length_1163_cov_36.315789	640	720	4	41	80	0.5125000
NODE_4245_length_1163_cov_36.315789	640	720	6	9	80	0.1125000
NODE_4246_length_1163_cov_29.466165	542	622	0	9	80	0.1125000
NODE_4246_length_1163_cov_29.466165	542	622	6	1	80	0.0125000
NODE_4246_length_1163_cov_29.466165	542	622	7	32	80	0.4000000
NODE_4246_length_1163_cov_29.466165	542	622	9	1	80	0.0125000
NODE_4246_length_1163_cov_29.466165	542	622	10	14	80	0.1750000
NODE_4246_length_1163_cov_29.466165	542	622	12	23	80	0.2875000
NODE_4246_length_1163_cov_29.466165	595	675	0	62	80	0.7750000
NODE_4246_length_1163_cov_29.466165	595	675	6	1	80	0.0125000
NODE_4246_length_1163_cov_29.466165	595	675	7	17	80	0.2125000
NODE_4246_length_1163_cov_29.466165	671	751	0	80	80	1.0000000
NODE_4246_length_1163_cov_29.466165	724	804	0	80	80	1.0000000
NODE_4247_length_1163_cov_15.107143	668	748	0	18	80	0.2250000
NODE_4247_length_1163_cov_15.107143	668	748	2	49	80	0.6125000
NODE_4247_length_1163_cov_15.107143	668	748	6	13	80	0.1625000
NODE_4247_length_1163_cov_15.107143	721	801	0	6	80	0.0750000
NODE_4247_length_1163_cov_15.107143	721	801	2	14	80	0.1750000
NODE_4247_length_1163_cov_15.107143	721	801	4	23	80	0.2875000
NODE_4247_length_1163_cov_15.107143	721	801	5	2	80	0.0250000
NODE_4247_length_1163_cov_15.107143	721	801	6	35	80	0.4375000
NODE_4248_length_1163_cov_14.347744	540	620	0	1	80	0.0125000
NODE_4248_length_1163_cov_14.347744	540	620	1	63	80	0.7875000
NODE_4248_length_1163_cov_14.347744	540	620	2	16	80	0.2000000
NODE_4248_length_1163_cov_14.347744	593	673	1	11	80	0.1375000
NODE_4248_length_1163_cov_14.347744	593	673	2	69	80	0.8625000
NODE_4249_length_1163_cov_11.650376	354	434	0	80	80	1.0000000
NODE_4249_length_1163_cov_11.650376	407	487	0	27	80	0.3375000
NODE_4249_length_1163_cov_11.650376	407	487	2	53	80	0.6625000
NODE_4249_length_1163_cov_11.650376	738	818	0	80	80	1.0000000
NODE_4249_length_1163_cov_11.650376	791	871	0	80	80	1.0000000
NODE_4253_length_1162_cov_30.049859	359	439	2	80	80	1.0000000
NODE_4253_length_1162_cov_30.049859	412	492	0	52	80	0.6500000
NODE_4253_length_1162_cov_30.049859	412	492	2	28	80	0.3500000
NODE_4254_length_1162_cov_25.960489	440	520	0	80	80	1.0000000
NODE_4254_length_1162_cov_25.960489	493	573	0	80	80	1.0000000
NODE_4254_length_1162_cov_25.960489	569	649	0	52	80	0.6500000
NODE_4254_length_1162_cov_25.960489	569	649	4	1	80	0.0125000
NODE_4254_length_1162_cov_25.960489	569	649	5	27	80	0.3375000
NODE_4254_length_1162_cov_25.960489	622	702	5	61	80	0.7625000
NODE_4254_length_1162_cov_25.960489	622	702	6	19	80	0.2375000
NODE_4255_length_1162_cov_24.843838	523	603	0	59	80	0.7375000
NODE_4255_length_1162_cov_24.843838	523	603	4	21	80	0.2625000
NODE_4255_length_1162_cov_24.843838	576	656	0	6	80	0.0750000
NODE_4255_length_1162_cov_24.843838	576	656	4	74	80	0.9250000
NODE_4255_length_1162_cov_24.843838	652	732	0	50	80	0.6250000
NODE_4255_length_1162_cov_24.843838	652	732	4	30	80	0.3750000
NODE_4255_length_1162_cov_24.843838	705	785	0	80	80	1.0000000
NODE_4257_length_1162_cov_17.131703	302	382	2	80	80	1.0000000
NODE_4257_length_1162_cov_17.131703	355	435	0	30	80	0.3750000
NODE_4257_length_1162_cov_17.131703	355	435	2	50	80	0.6250000
NODE_4257_length_1162_cov_17.131703	431	511	0	80	80	1.0000000
NODE_4257_length_1162_cov_17.131703	484	564	0	80	80	1.0000000
NODE_4258_length_1162_cov_14.766698	630	710	0	80	80	1.0000000
NODE_4258_length_1162_cov_14.766698	683	763	0	80	80	1.0000000
NODE_4259_length_1162_cov_13.968015	423	503	0	80	80	1.0000000
NODE_4259_length_1162_cov_13.968015	476	556	0	80	80	1.0000000
NODE_4264_length_1162_cov_1.977422	855	926	0	18	71	0.2535211
NODE_4264_length_1162_cov_1.977422	855	926	2	53	71	0.7464789
NODE_4264_length_1162_cov_1.977422	908	977	0	69	69	1.0000000
NODE_4264_length_1162_cov_1.977422	908	977	0	69	69	1.0000000
NODE_4266_length_1161_cov_33.312618	456	536	0	20	80	0.2500000
NODE_4266_length_1161_cov_33.312618	456	536	2	53	80	0.6625000
NODE_4266_length_1161_cov_33.312618	456	536	4	7	80	0.0875000
NODE_4266_length_1161_cov_33.312618	509	587	2	50	78	0.6410257
NODE_4266_length_1161_cov_33.312618	509	587	4	28	78	0.3589744
NODE_4267_length_1161_cov_30.466102	594	674	0	80	80	1.0000000
NODE_4267_length_1161_cov_30.466102	647	727	0	80	80	1.0000000
NODE_4268_length_1161_cov_29.628060	426	506	0	38	80	0.4750000
NODE_4268_length_1161_cov_29.628060	426	506	2	17	80	0.2125000
NODE_4268_length_1161_cov_29.628060	426	506	4	8	80	0.1000000
NODE_4268_length_1161_cov_29.628060	426	506	6	17	80	0.2125000
NODE_4268_length_1161_cov_29.628060	479	559	2	2	80	0.0250000
NODE_4268_length_1161_cov_29.628060	479	559	4	38	80	0.4750000
NODE_4268_length_1161_cov_29.628060	479	559	6	40	80	0.5000000
NODE_4268_length_1161_cov_29.628060	603	683	0	9	80	0.1125000
NODE_4268_length_1161_cov_29.628060	603	683	2	71	80	0.8875000
NODE_4268_length_1161_cov_29.628060	656	736	0	56	80	0.7000000
NODE_4268_length_1161_cov_29.628060	656	736	2	24	80	0.3000000
NODE_4269_length_1161_cov_22.923729	492	572	0	80	80	1.0000000
NODE_4269_length_1161_cov_22.923729	545	625	0	80	80	1.0000000
NODE_4269_length_1161_cov_22.923729	621	701	0	80	80	1.0000000
NODE_4269_length_1161_cov_22.923729	674	754	0	80	80	1.0000000
NODE_4270_length_1161_cov_20.184557	480	560	0	80	80	1.0000000
NODE_4270_length_1161_cov_20.184557	533	613	0	80	80	1.0000000
NODE_4271_length_1161_cov_17.437853	375	455	0	37	80	0.4625000
NODE_4271_length_1161_cov_17.437853	375	455	2	43	80	0.5375000
NODE_4271_length_1161_cov_17.437853	428	508	0	35	80	0.4375000
NODE_4271_length_1161_cov_17.437853	428	508	2	45	80	0.5625000
NODE_4272_length_1161_cov_14.062147	375	455	0	29	80	0.3625000
NODE_4272_length_1161_cov_14.062147	375	455	4	51	80	0.6375000
NODE_4272_length_1161_cov_14.062147	428	508	4	80	80	1.0000000
NODE_4273_length_1161_cov_12.304143	381	461	0	44	80	0.5500000
NODE_4273_length_1161_cov_12.304143	381	461	4	36	80	0.4500000
NODE_4273_length_1161_cov_12.304143	434	514	0	35	80	0.4375000
NODE_4273_length_1161_cov_12.304143	434	514	4	45	80	0.5625000
NODE_4274_length_1161_cov_10.297552	598	678	0	47	80	0.5875000
NODE_4274_length_1161_cov_10.297552	598	678	2	33	80	0.4125000
NODE_4274_length_1161_cov_10.297552	651	731	0	80	80	1.0000000
NODE_4283_length_1160_cov_86.515551	613	693	0	80	80	1.0000000
NODE_4283_length_1160_cov_86.515551	666	746	0	80	80	1.0000000
NODE_4284_length_1160_cov_29.272385	526	606	0	9	80	0.1125000
NODE_4284_length_1160_cov_29.272385	526	606	2	28	80	0.3500000
NODE_4284_length_1160_cov_29.272385	526	606	8	43	80	0.5375000
NODE_4284_length_1160_cov_29.272385	579	659	0	4	80	0.0500000
NODE_4284_length_1160_cov_29.272385	579	659	8	27	80	0.3375000
NODE_4284_length_1160_cov_29.272385	579	659	9	1	80	0.0125000
NODE_4284_length_1160_cov_29.272385	579	659	10	42	80	0.5250000
NODE_4284_length_1160_cov_29.272385	579	659	12	6	80	0.0750000
NODE_4285_length_1160_cov_21.391140	767	847	2	3	80	0.0375000
NODE_4285_length_1160_cov_21.391140	767	847	6	4	80	0.0500000
NODE_4285_length_1160_cov_21.391140	767	847	14	35	80	0.4375000
NODE_4285_length_1160_cov_21.391140	767	847	15	32	80	0.4000000
NODE_4285_length_1160_cov_21.391140	767	847	16	6	80	0.0750000
NODE_4296_length_1159_cov_147.794340	911	991	76	3	80	0.0375000
NODE_4296_length_1159_cov_147.794340	911	991	103	1	80	0.0125000
NODE_4296_length_1159_cov_147.794340	911	991	123	1	80	0.0125000
NODE_4296_length_1159_cov_147.794340	911	991	125	2	80	0.0250000
NODE_4296_length_1159_cov_147.794340	911	991	126	4	80	0.0500000
NODE_4296_length_1159_cov_147.794340	911	991	127	1	80	0.0125000
NODE_4296_length_1159_cov_147.794340	911	991	128	1	80	0.0125000
NODE_4296_length_1159_cov_147.794340	911	991	131	5	80	0.0625000
NODE_4296_length_1159_cov_147.794340	911	991	136	1	80	0.0125000
NODE_4296_length_1159_cov_147.794340	911	991	137	1	80	0.0125000
NODE_4296_length_1159_cov_147.794340	911	991	138	2	80	0.0250000
NODE_4296_length_1159_cov_147.794340	911	991	140	2	80	0.0250000
NODE_4296_length_1159_cov_147.794340	911	991	143	1	80	0.0125000
NODE_4296_length_1159_cov_147.794340	911	991	144	1	80	0.0125000
NODE_4296_length_1159_cov_147.794340	911	991	146	1	80	0.0125000
NODE_4296_length_1159_cov_147.794340	911	991	148	1	80	0.0125000
NODE_4296_length_1159_cov_147.794340	911	991	150	1	80	0.0125000
NODE_4296_length_1159_cov_147.794340	911	991	152	4	80	0.0500000
NODE_4296_length_1159_cov_147.794340	911	991	156	1	80	0.0125000
NODE_4296_length_1159_cov_147.794340	911	991	157	2	80	0.0250000
NODE_4296_length_1159_cov_147.794340	911	991	158	1	80	0.0125000
NODE_4296_length_1159_cov_147.794340	911	991	160	1	80	0.0125000
NODE_4296_length_1159_cov_147.794340	911	991	164	1	80	0.0125000
NODE_4296_length_1159_cov_147.794340	911	991	170	2	80	0.0250000
NODE_4296_length_1159_cov_147.794340	911	991	172	1	80	0.0125000
NODE_4296_length_1159_cov_147.794340	911	991	174	1	80	0.0125000
NODE_4296_length_1159_cov_147.794340	911	991	180	1	80	0.0125000
NODE_4296_length_1159_cov_147.794340	911	991	182	3	80	0.0375000
NODE_4296_length_1159_cov_147.794340	911	991	183	1	80	0.0125000
NODE_4296_length_1159_cov_147.794340	911	991	184	8	80	0.1000000
NODE_4296_length_1159_cov_147.794340	911	991	185	6	80	0.0750000
NODE_4296_length_1159_cov_147.794340	911	991	186	1	80	0.0125000
NODE_4296_length_1159_cov_147.794340	911	991	187	2	80	0.0250000
NODE_4296_length_1159_cov_147.794340	911	991	190	2	80	0.0250000
NODE_4296_length_1159_cov_147.794340	911	991	191	1	80	0.0125000
NODE_4296_length_1159_cov_147.794340	911	991	193	1	80	0.0125000
NODE_4296_length_1159_cov_147.794340	911	991	195	1	80	0.0125000
NODE_4296_length_1159_cov_147.794340	911	991	197	2	80	0.0250000
NODE_4296_length_1159_cov_147.794340	911	991	199	1	80	0.0125000
NODE_4296_length_1159_cov_147.794340	911	991	200	3	80	0.0375000
NODE_4296_length_1159_cov_147.794340	911	991	201	3	80	0.0375000
NODE_4296_length_1159_cov_147.794340	911	991	202	1	80	0.0125000
NODE_4296_length_1159_cov_147.794340	964	1044	140	2	80	0.0250000
NODE_4296_length_1159_cov_147.794340	964	1044	142	2	80	0.0250000
NODE_4296_length_1159_cov_147.794340	964	1044	144	2	80	0.0250000
NODE_4296_length_1159_cov_147.794340	964	1044	149	1	80	0.0125000
NODE_4296_length_1159_cov_147.794340	964	1044	155	7	80	0.0875000
NODE_4296_length_1159_cov_147.794340	964	1044	157	1	80	0.0125000
NODE_4296_length_1159_cov_147.794340	964	1044	159	1	80	0.0125000
NODE_4296_length_1159_cov_147.794340	964	1044	160	4	80	0.0500000
NODE_4296_length_1159_cov_147.794340	964	1044	161	1	80	0.0125000
NODE_4296_length_1159_cov_147.794340	964	1044	163	2	80	0.0250000
NODE_4296_length_1159_cov_147.794340	964	1044	165	1	80	0.0125000
NODE_4296_length_1159_cov_147.794340	964	1044	166	2	80	0.0250000
NODE_4296_length_1159_cov_147.794340	964	1044	167	2	80	0.0250000
NODE_4296_length_1159_cov_147.794340	964	1044	168	1	80	0.0125000
NODE_4296_length_1159_cov_147.794340	964	1044	170	4	80	0.0500000
NODE_4296_length_1159_cov_147.794340	964	1044	171	1	80	0.0125000
NODE_4296_length_1159_cov_147.794340	964	1044	172	3	80	0.0375000
NODE_4296_length_1159_cov_147.794340	964	1044	175	4	80	0.0500000
NODE_4296_length_1159_cov_147.794340	964	1044	176	1	80	0.0125000
NODE_4296_length_1159_cov_147.794340	964	1044	179	2	80	0.0250000
NODE_4296_length_1159_cov_147.794340	964	1044	181	1	80	0.0125000
NODE_4296_length_1159_cov_147.794340	964	1044	182	3	80	0.0375000
NODE_4296_length_1159_cov_147.794340	964	1044	183	1	80	0.0125000
NODE_4296_length_1159_cov_147.794340	964	1044	184	9	80	0.1125000
NODE_4296_length_1159_cov_147.794340	964	1044	185	6	80	0.0750000
NODE_4296_length_1159_cov_147.794340	964	1044	186	2	80	0.0250000
NODE_4296_length_1159_cov_147.794340	964	1044	190	2	80	0.0250000
NODE_4296_length_1159_cov_147.794340	964	1044	193	1	80	0.0125000
NODE_4296_length_1159_cov_147.794340	964	1044	195	1	80	0.0125000
NODE_4296_length_1159_cov_147.794340	964	1044	197	2	80	0.0250000
NODE_4296_length_1159_cov_147.794340	964	1044	199	1	80	0.0125000
NODE_4296_length_1159_cov_147.794340	964	1044	200	3	80	0.0375000
NODE_4296_length_1159_cov_147.794340	964	1044	201	3	80	0.0375000
NODE_4296_length_1159_cov_147.794340	964	1044	202	1	80	0.0125000
NODE_4297_length_1159_cov_57.566981	457	537	0	80	80	1.0000000
NODE_4297_length_1159_cov_57.566981	510	590	0	33	80	0.4125000
NODE_4297_length_1159_cov_57.566981	510	590	1	47	80	0.5875000
NODE_4297_length_1159_cov_57.566981	586	666	1	19	80	0.2375000
NODE_4297_length_1159_cov_57.566981	586	666	2	61	80	0.7625000
NODE_4297_length_1159_cov_57.566981	639	719	2	28	80	0.3500000
NODE_4297_length_1159_cov_57.566981	639	719	3	27	80	0.3375000
NODE_4297_length_1159_cov_57.566981	639	719	4	25	80	0.3125000
NODE_4298_length_1159_cov_44.053774	329	409	0	35	80	0.4375000
NODE_4298_length_1159_cov_44.053774	329	409	2	45	80	0.5625000
NODE_4298_length_1159_cov_44.053774	382	462	2	80	80	1.0000000
NODE_4298_length_1159_cov_44.053774	458	538	0	13	80	0.1625000
NODE_4298_length_1159_cov_44.053774	458	538	2	16	80	0.2000000
NODE_4298_length_1159_cov_44.053774	458	538	3	18	80	0.2250000
NODE_4298_length_1159_cov_44.053774	458	538	4	33	80	0.4125000
NODE_4298_length_1159_cov_44.053774	511	591	4	80	80	1.0000000
NODE_4299_length_1159_cov_40.194340	391	471	0	75	80	0.9375000
NODE_4299_length_1159_cov_40.194340	391	471	6	1	80	0.0125000
NODE_4299_length_1159_cov_40.194340	391	471	8	4	80	0.0500000
NODE_4299_length_1159_cov_40.194340	444	524	0	22	80	0.2750000
NODE_4299_length_1159_cov_40.194340	444	524	6	1	80	0.0125000
NODE_4299_length_1159_cov_40.194340	444	524	8	57	80	0.7125000
NODE_4301_length_1159_cov_25.919811	456	536	0	80	80	1.0000000
NODE_4301_length_1159_cov_25.919811	509	591	0	82	82	1.0000000
NODE_4302_length_1159_cov_18.306604	538	618	0	33	80	0.4125000
NODE_4302_length_1159_cov_18.306604	538	618	2	47	80	0.5875000
NODE_4302_length_1159_cov_18.306604	591	671	0	80	80	1.0000000
NODE_4303_length_1159_cov_14.457547	358	438	0	80	80	1.0000000
NODE_4303_length_1159_cov_14.457547	411	491	0	80	80	1.0000000
NODE_4304_length_1159_cov_11.566981	625	705	2	7	80	0.0875000
NODE_4304_length_1159_cov_11.566981	625	705	4	18	80	0.2250000
NODE_4304_length_1159_cov_11.566981	625	705	8	29	80	0.3625000
NODE_4304_length_1159_cov_11.566981	625	705	9	1	80	0.0125000
NODE_4304_length_1159_cov_11.566981	625	705	10	25	80	0.3125000
NODE_4304_length_1159_cov_11.566981	678	758	8	26	80	0.3250000
NODE_4304_length_1159_cov_11.566981	678	758	9	54	80	0.6750000
NODE_4305_length_1159_cov_9.927358	278	358	2	80	80	1.0000000
NODE_4305_length_1159_cov_9.927358	331	411	0	27	80	0.3375000
NODE_4305_length_1159_cov_9.927358	331	411	2	53	80	0.6625000
NODE_4314_length_1159_cov_1.568868	513	562	0	49	49	1.0000000
NODE_4316_length_1158_cov_33.529745	357	437	0	80	80	1.0000000
NODE_4316_length_1158_cov_33.529745	410	490	0	79	80	0.9875000
NODE_4316_length_1158_cov_33.529745	410	490	4	1	80	0.0125000
NODE_4316_length_1158_cov_33.529745	486	566	0	3	80	0.0375000
NODE_4316_length_1158_cov_33.529745	486	566	4	77	80	0.9625000
NODE_4316_length_1158_cov_33.529745	539	619	0	2	80	0.0250000
NODE_4316_length_1158_cov_33.529745	539	619	4	78	80	0.9750000
NODE_4317_length_1158_cov_31.368272	416	496	10	5	80	0.0625000
NODE_4317_length_1158_cov_31.368272	416	496	12	75	80	0.9375000
NODE_4317_length_1158_cov_31.368272	469	549	0	34	80	0.4250000
NODE_4317_length_1158_cov_31.368272	469	549	4	4	80	0.0500000
NODE_4317_length_1158_cov_31.368272	469	549	6	14	80	0.1750000
NODE_4317_length_1158_cov_31.368272	469	549	12	28	80	0.3500000
NODE_4317_length_1158_cov_31.368272	545	626	0	11	81	0.1358025
NODE_4317_length_1158_cov_31.368272	545	626	2	44	81	0.5432099
NODE_4317_length_1158_cov_31.368272	545	626	10	26	81	0.3209876
NODE_4317_length_1158_cov_31.368272	599	679	2	1	80	0.0125000
NODE_4317_length_1158_cov_31.368272	599	679	8	43	80	0.5375000
NODE_4317_length_1158_cov_31.368272	599	679	10	36	80	0.4500000
NODE_4318_length_1158_cov_31.240793	430	510	0	80	80	1.0000000
NODE_4318_length_1158_cov_31.240793	483	563	0	78	80	0.9750000
NODE_4318_length_1158_cov_31.240793	483	563	2	2	80	0.0250000
NODE_4318_length_1158_cov_31.240793	559	639	0	34	80	0.4250000
NODE_4318_length_1158_cov_31.240793	559	639	2	46	80	0.5750000
NODE_4318_length_1158_cov_31.240793	612	692	0	80	80	1.0000000
NODE_4319_length_1158_cov_29.216242	405	485	6	80	80	1.0000000
NODE_4319_length_1158_cov_29.216242	458	538	0	53	80	0.6625000
NODE_4319_length_1158_cov_29.216242	458	538	6	27	80	0.3375000
NODE_4320_length_1158_cov_25.245515	500	580	0	10	80	0.1250000
NODE_4320_length_1158_cov_25.245515	500	580	2	70	80	0.8750000
NODE_4320_length_1158_cov_25.245515	553	633	0	16	80	0.2000000
NODE_4320_length_1158_cov_25.245515	553	633	2	64	80	0.8000000
NODE_4320_length_1158_cov_25.245515	629	709	0	50	80	0.6250000
NODE_4320_length_1158_cov_25.245515	629	709	2	30	80	0.3750000
NODE_4320_length_1158_cov_25.245515	682	762	0	80	80	1.0000000
NODE_4321_length_1158_cov_16.566572	396	476	0	64	80	0.8000000
NODE_4321_length_1158_cov_16.566572	396	476	2	16	80	0.2000000
NODE_4321_length_1158_cov_16.566572	449	529	0	80	80	1.0000000
NODE_4322_length_1158_cov_13.092540	372	452	0	10	80	0.1250000
NODE_4322_length_1158_cov_13.092540	372	452	4	63	80	0.7875000
NODE_4322_length_1158_cov_13.092540	372	452	6	7	80	0.0875000
NODE_4322_length_1158_cov_13.092540	425	505	2	11	80	0.1375000
NODE_4322_length_1158_cov_13.092540	425	505	4	20	80	0.2500000
NODE_4322_length_1158_cov_13.092540	425	505	6	49	80	0.6125000
NODE_4322_length_1158_cov_13.092540	735	815	0	80	80	1.0000000
NODE_4322_length_1158_cov_13.092540	788	868	0	80	80	1.0000000
NODE_4323_length_1158_cov_7.408876	656	736	0	80	80	1.0000000
NODE_4323_length_1158_cov_7.408876	709	789	0	80	80	1.0000000
NODE_4324_length_1158_cov_6.242682	239	310	0	71	71	1.0000000
NODE_4325_length_1158_cov_6.043437	531	611	0	80	80	1.0000000
NODE_4325_length_1158_cov_6.043437	584	634	0	50	50	1.0000000
NODE_4326_length_1158_cov_5.855524	324	404	0	20	80	0.2500000
NODE_4326_length_1158_cov_5.855524	324	404	2	60	80	0.7500000
NODE_4326_length_1158_cov_5.855524	377	457	0	73	80	0.9125000
NODE_4326_length_1158_cov_5.855524	377	457	2	7	80	0.0875000
NODE_4329_length_1157_cov_32.233459	472	552	0	80	80	1.0000000
NODE_4329_length_1157_cov_32.233459	525	605	0	80	80	1.0000000
NODE_4329_length_1157_cov_32.233459	601	681	0	80	80	1.0000000
NODE_4329_length_1157_cov_32.233459	654	734	0	80	80	1.0000000
NODE_4330_length_1157_cov_6.438563	765	788	0	23	23	1.0000000
NODE_4332_length_1157_cov_4.068053	221	292	0	71	71	1.0000000
NODE_4333_length_1156_cov_46.381268	328	408	0	21	80	0.2625000
NODE_4333_length_1156_cov_46.381268	328	408	2	2	80	0.0250000
NODE_4333_length_1156_cov_46.381268	328	408	3	7	80	0.0875000
NODE_4333_length_1156_cov_46.381268	328	408	4	17	80	0.2125000
NODE_4333_length_1156_cov_46.381268	328	408	5	33	80	0.4125000
NODE_4333_length_1156_cov_46.381268	381	461	4	66	80	0.8250000
NODE_4333_length_1156_cov_46.381268	381	461	5	14	80	0.1750000
NODE_4333_length_1156_cov_46.381268	457	537	0	29	80	0.3625000
NODE_4333_length_1156_cov_46.381268	457	537	3	9	80	0.1125000
NODE_4333_length_1156_cov_46.381268	457	537	5	42	80	0.5250000
NODE_4333_length_1156_cov_46.381268	510	590	0	80	80	1.0000000
NODE_4334_length_1156_cov_32.198675	378	458	0	43	80	0.5375000
NODE_4334_length_1156_cov_32.198675	378	458	2	37	80	0.4625000
NODE_4334_length_1156_cov_32.198675	431	511	0	80	80	1.0000000
NODE_4334_length_1156_cov_32.198675	507	587	0	80	80	1.0000000
NODE_4334_length_1156_cov_32.198675	560	641	0	81	81	1.0000000
NODE_4335_length_1156_cov_12.683065	593	673	0	67	80	0.8375000
NODE_4335_length_1156_cov_12.683065	593	673	1	13	80	0.1625000
NODE_4335_length_1156_cov_12.683065	646	726	0	80	80	1.0000000
NODE_4336_length_1156_cov_9.287606	680	760	0	64	80	0.8000000
NODE_4336_length_1156_cov_9.287606	680	760	2	4	80	0.0500000
NODE_4336_length_1156_cov_9.287606	680	760	4	12	80	0.1500000
NODE_4336_length_1156_cov_9.287606	733	813	0	11	80	0.1375000
NODE_4336_length_1156_cov_9.287606	733	813	2	4	80	0.0500000
NODE_4336_length_1156_cov_9.287606	733	813	4	65	80	0.8125000
NODE_4339_length_1155_cov_19.570076	437	517	0	80	80	1.0000000
NODE_4339_length_1155_cov_19.570076	490	570	0	80	80	1.0000000
NODE_4340_length_1155_cov_18.666667	332	412	2	26	80	0.3250000
NODE_4340_length_1155_cov_18.666667	332	412	6	33	80	0.4125000
NODE_4340_length_1155_cov_18.666667	332	412	8	21	80	0.2625000
NODE_4340_length_1155_cov_18.666667	385	465	2	11	80	0.1375000
NODE_4340_length_1155_cov_18.666667	385	465	6	45	80	0.5625000
NODE_4340_length_1155_cov_18.666667	385	465	8	24	80	0.3000000
NODE_4346_length_1154_cov_61.769668	488	568	0	3	80	0.0375000
NODE_4346_length_1154_cov_61.769668	488	568	2	54	80	0.6750000
NODE_4346_length_1154_cov_61.769668	488	568	10	23	80	0.2875000
NODE_4346_length_1154_cov_61.769668	541	621	0	3	80	0.0375000
NODE_4346_length_1154_cov_61.769668	541	621	2	1	80	0.0125000
NODE_4346_length_1154_cov_61.769668	541	621	10	38	80	0.4750000
NODE_4346_length_1154_cov_61.769668	541	621	11	1	80	0.0125000
NODE_4346_length_1154_cov_61.769668	541	621	12	5	80	0.0625000
NODE_4346_length_1154_cov_61.769668	541	621	13	32	80	0.4000000
NODE_4347_length_1154_cov_50.909005	409	489	0	20	80	0.2500000
NODE_4347_length_1154_cov_50.909005	409	489	4	60	80	0.7500000
NODE_4347_length_1154_cov_50.909005	462	542	0	73	80	0.9125000
NODE_4347_length_1154_cov_50.909005	462	542	4	7	80	0.0875000
NODE_4347_length_1154_cov_50.909005	538	618	0	16	80	0.2000000
NODE_4347_length_1154_cov_50.909005	538	618	2	18	80	0.2250000
NODE_4347_length_1154_cov_50.909005	538	618	6	46	80	0.5750000
NODE_4347_length_1154_cov_50.909005	591	671	0	22	80	0.2750000
NODE_4347_length_1154_cov_50.909005	591	671	2	12	80	0.1500000
NODE_4347_length_1154_cov_50.909005	591	671	6	46	80	0.5750000
NODE_4348_length_1154_cov_28.941232	695	775	0	80	80	1.0000000
NODE_4348_length_1154_cov_28.941232	748	828	0	80	80	1.0000000
NODE_4349_length_1154_cov_13.765877	322	402	2	21	80	0.2625000
NODE_4349_length_1154_cov_13.765877	322	402	4	32	80	0.4000000
NODE_4349_length_1154_cov_13.765877	322	402	5	1	80	0.0125000
NODE_4349_length_1154_cov_13.765877	322	402	6	26	80	0.3250000
NODE_4349_length_1154_cov_13.765877	375	455	0	4	80	0.0500000
NODE_4349_length_1154_cov_13.765877	375	455	2	43	80	0.5375000
NODE_4349_length_1154_cov_13.765877	375	455	4	8	80	0.1000000
NODE_4349_length_1154_cov_13.765877	375	455	6	25	80	0.3125000
NODE_4351_length_1154_cov_5.930806	497	577	0	9	80	0.1125000
NODE_4351_length_1154_cov_5.930806	497	577	3	41	80	0.5125000
NODE_4351_length_1154_cov_5.930806	497	577	7	30	80	0.3750000
NODE_4351_length_1154_cov_5.930806	550	622	7	72	72	1.0000000
NODE_4357_length_1153_cov_65.486717	416	496	0	54	80	0.6750000
NODE_4357_length_1153_cov_65.486717	416	496	2	20	80	0.2500000
NODE_4357_length_1153_cov_65.486717	416	496	6	6	80	0.0750000
NODE_4357_length_1153_cov_65.486717	469	549	0	1	80	0.0125000
NODE_4357_length_1153_cov_65.486717	469	549	2	20	80	0.2500000
NODE_4357_length_1153_cov_65.486717	469	549	6	59	80	0.7375000
NODE_4357_length_1153_cov_65.486717	545	625	0	48	80	0.6000000
NODE_4357_length_1153_cov_65.486717	545	625	4	26	80	0.3250000
NODE_4357_length_1153_cov_65.486717	545	625	6	6	80	0.0750000
NODE_4357_length_1153_cov_65.486717	598	678	0	80	80	1.0000000
NODE_4358_length_1153_cov_50.733397	404	484	0	80	80	1.0000000
NODE_4358_length_1153_cov_50.733397	457	537	0	80	80	1.0000000
NODE_4358_length_1153_cov_50.733397	533	613	0	80	80	1.0000000
NODE_4358_length_1153_cov_50.733397	586	666	0	80	80	1.0000000
NODE_4359_length_1153_cov_26.131879	493	573	0	80	80	1.0000000
NODE_4359_length_1153_cov_26.131879	546	626	0	80	80	1.0000000
NODE_4360_length_1153_cov_10.195446	500	580	0	80	80	1.0000000
NODE_4360_length_1153_cov_10.195446	553	633	0	80	80	1.0000000
NODE_4361_length_1153_cov_8.286528	558	638	2	80	80	1.0000000
NODE_4361_length_1153_cov_8.286528	611	691	0	20	80	0.2500000
NODE_4361_length_1153_cov_8.286528	611	691	2	60	80	0.7500000
NODE_4368_length_1152_cov_19.800570	553	633	0	65	80	0.8125000
NODE_4368_length_1152_cov_19.800570	553	633	2	15	80	0.1875000
NODE_4368_length_1152_cov_19.800570	606	686	0	12	80	0.1500000
NODE_4368_length_1152_cov_19.800570	606	686	2	68	80	0.8500000
NODE_4369_length_1152_cov_19.365622	490	570	2	61	80	0.7625000
NODE_4369_length_1152_cov_19.365622	490	570	4	19	80	0.2375000
NODE_4369_length_1152_cov_19.365622	543	623	2	72	80	0.9000000
NODE_4369_length_1152_cov_19.365622	543	623	4	8	80	0.1000000
NODE_4370_length_1152_cov_18.654321	594	674	0	80	80	1.0000000
NODE_4370_length_1152_cov_18.654321	647	727	0	80	80	1.0000000
NODE_4371_length_1152_cov_18.075024	377	457	0	23	80	0.2875000
NODE_4371_length_1152_cov_18.075024	377	457	2	57	80	0.7125000
NODE_4371_length_1152_cov_18.075024	430	510	0	35	80	0.4375000
NODE_4371_length_1152_cov_18.075024	430	510	2	45	80	0.5625000
NODE_4371_length_1152_cov_18.075024	506	586	0	4	80	0.0500000
NODE_4371_length_1152_cov_18.075024	506	586	2	76	80	0.9500000
NODE_4371_length_1152_cov_18.075024	559	639	0	46	80	0.5750000
NODE_4371_length_1152_cov_18.075024	559	639	2	34	80	0.4250000
NODE_4373_length_1152_cov_16.047483	543	623	0	80	80	1.0000000
NODE_4373_length_1152_cov_16.047483	596	676	0	80	80	1.0000000
NODE_4373_length_1152_cov_16.047483	672	752	0	44	80	0.5500000
NODE_4373_length_1152_cov_16.047483	672	752	1	1	80	0.0125000
NODE_4373_length_1152_cov_16.047483	672	752	2	35	80	0.4375000
NODE_4373_length_1152_cov_16.047483	725	805	2	80	80	1.0000000
NODE_4374_length_1152_cov_13.981007	583	663	0	20	80	0.2500000
NODE_4374_length_1152_cov_13.981007	583	663	2	60	80	0.7500000
NODE_4374_length_1152_cov_13.981007	636	716	0	19	80	0.2375000
NODE_4374_length_1152_cov_13.981007	636	716	2	61	80	0.7625000
NODE_4380_length_1151_cov_30.469582	479	559	0	80	80	1.0000000
NODE_4380_length_1151_cov_30.469582	532	612	0	80	80	1.0000000
NODE_4381_length_1151_cov_26.650190	567	647	0	80	80	1.0000000
NODE_4381_length_1151_cov_26.650190	620	700	0	54	80	0.6750000
NODE_4381_length_1151_cov_26.650190	620	700	2	26	80	0.3250000
NODE_4382_length_1151_cov_26.375475	441	521	0	45	80	0.5625000
NODE_4382_length_1151_cov_26.375475	441	521	4	35	80	0.4375000
NODE_4382_length_1151_cov_26.375475	494	574	4	80	80	1.0000000
NODE_4382_length_1151_cov_26.375475	570	650	0	71	80	0.8875000
NODE_4382_length_1151_cov_26.375475	570	650	4	9	80	0.1125000
NODE_4382_length_1151_cov_26.375475	623	703	0	80	80	1.0000000
NODE_4383_length_1151_cov_23.614068	590	670	0	8	80	0.1000000
NODE_4383_length_1151_cov_23.614068	590	670	2	72	80	0.9000000
NODE_4383_length_1151_cov_23.614068	643	721	0	52	78	0.6666667
NODE_4383_length_1151_cov_23.614068	643	721	2	26	78	0.3333333
NODE_4384_length_1151_cov_18.693916	355	435	0	20	80	0.2500000
NODE_4384_length_1151_cov_18.693916	355	435	6	12	80	0.1500000
NODE_4384_length_1151_cov_18.693916	355	435	12	48	80	0.6000000
NODE_4384_length_1151_cov_18.693916	408	491	6	31	83	0.3734940
NODE_4384_length_1151_cov_18.693916	408	491	12	52	83	0.6265060
NODE_4385_length_1151_cov_16.093156	474	554	0	80	80	1.0000000
NODE_4385_length_1151_cov_16.093156	527	607	0	80	80	1.0000000
NODE_4386_length_1151_cov_13.782319	400	482	0	82	82	1.0000000
NODE_4386_length_1151_cov_13.782319	450	535	0	85	85	1.0000000
NODE_4392_length_1150_cov_38.601332	563	643	2	47	80	0.5875000
NODE_4392_length_1150_cov_38.601332	563	643	3	15	80	0.1875000
NODE_4392_length_1150_cov_38.601332	563	643	4	18	80	0.2250000
NODE_4392_length_1150_cov_38.601332	616	696	2	20	80	0.2500000
NODE_4392_length_1150_cov_38.601332	616	696	3	51	80	0.6375000
NODE_4392_length_1150_cov_38.601332	616	696	4	9	80	0.1125000
NODE_4392_length_1150_cov_38.601332	692	772	1	15	80	0.1875000
NODE_4392_length_1150_cov_38.601332	692	772	2	14	80	0.1750000
NODE_4392_length_1150_cov_38.601332	692	772	3	51	80	0.6375000
NODE_4392_length_1150_cov_38.601332	745	825	0	12	80	0.1500000
NODE_4392_length_1150_cov_38.601332	745	825	1	56	80	0.7000000
NODE_4392_length_1150_cov_38.601332	745	825	2	12	80	0.1500000
NODE_4393_length_1150_cov_15.741199	497	578	5	16	81	0.1975309
NODE_4393_length_1150_cov_15.741199	497	578	7	7	81	0.0864198
NODE_4393_length_1150_cov_15.741199	497	578	8	26	81	0.3209876
NODE_4393_length_1150_cov_15.741199	497	578	12	32	81	0.3950617
NODE_4393_length_1150_cov_15.741199	550	631	5	1	81	0.0123457
NODE_4393_length_1150_cov_15.741199	550	631	6	35	81	0.4320988
NODE_4393_length_1150_cov_15.741199	550	631	7	3	81	0.0370370
NODE_4393_length_1150_cov_15.741199	550	631	8	19	81	0.2345679
NODE_4393_length_1150_cov_15.741199	550	631	12	23	81	0.2839506
NODE_4394_length_1150_cov_11.132255	795	875	0	18	80	0.2250000
NODE_4394_length_1150_cov_11.132255	795	875	1	25	80	0.3125000
NODE_4394_length_1150_cov_11.132255	795	875	2	37	80	0.4625000
NODE_4394_length_1150_cov_11.132255	848	928	0	71	80	0.8875000
NODE_4394_length_1150_cov_11.132255	848	928	1	9	80	0.1125000
NODE_4395_length_1150_cov_9.253092	583	663	0	75	80	0.9375000
NODE_4395_length_1150_cov_9.253092	583	663	2	5	80	0.0625000
NODE_4395_length_1150_cov_9.253092	636	716	0	22	80	0.2750000
NODE_4395_length_1150_cov_9.253092	636	716	2	58	80	0.7250000
NODE_4398_length_1149_cov_17.289524	644	695	0	51	51	1.0000000
NODE_4399_length_1149_cov_13.805714	584	664	0	80	80	1.0000000
NODE_4399_length_1149_cov_13.805714	637	717	0	80	80	1.0000000
NODE_4399_length_1149_cov_13.805714	713	793	0	80	80	1.0000000
NODE_4399_length_1149_cov_13.805714	766	846	0	80	80	1.0000000
NODE_4407_length_1148_cov_27.674929	387	467	0	12	80	0.1500000
NODE_4407_length_1148_cov_27.674929	387	467	4	68	80	0.8500000
NODE_4407_length_1148_cov_27.674929	440	520	0	41	80	0.5125000
NODE_4407_length_1148_cov_27.674929	440	520	4	39	80	0.4875000
NODE_4408_length_1148_cov_13.275500	136	216	8	22	80	0.2750000
NODE_4408_length_1148_cov_13.275500	136	216	9	8	80	0.1000000
NODE_4408_length_1148_cov_13.275500	136	216	10	50	80	0.6250000
NODE_4408_length_1148_cov_13.275500	189	268	6	31	79	0.3924051
NODE_4408_length_1148_cov_13.275500	189	268	8	9	79	0.1139240
NODE_4408_length_1148_cov_13.275500	189	268	9	1	79	0.0126582
NODE_4408_length_1148_cov_13.275500	189	268	10	38	79	0.4810127
NODE_4409_length_1148_cov_10.613918	506	586	0	32	80	0.4000000
NODE_4409_length_1148_cov_10.613918	506	586	2	48	80	0.6000000
NODE_4409_length_1148_cov_10.613918	559	639	0	2	80	0.0250000
NODE_4409_length_1148_cov_10.613918	559	639	2	78	80	0.9750000
NODE_4415_length_1147_cov_33.543893	378	458	0	50	80	0.6250000
NODE_4415_length_1147_cov_33.543893	378	458	2	22	80	0.2750000
NODE_4415_length_1147_cov_33.543893	378	458	4	8	80	0.1000000
NODE_4415_length_1147_cov_33.543893	431	511	0	3	80	0.0375000
NODE_4415_length_1147_cov_33.543893	431	511	2	34	80	0.4250000
NODE_4415_length_1147_cov_33.543893	431	511	4	43	80	0.5375000
NODE_4416_length_1147_cov_26.858779	254	334	0	80	80	1.0000000
NODE_4416_length_1147_cov_26.858779	307	387	0	80	80	1.0000000
NODE_4416_length_1147_cov_26.858779	383	463	0	80	80	1.0000000
NODE_4416_length_1147_cov_26.858779	436	516	0	80	80	1.0000000
NODE_4417_length_1147_cov_24.227099	606	686	0	80	80	1.0000000
NODE_4417_length_1147_cov_24.227099	659	739	0	80	80	1.0000000
NODE_4417_length_1147_cov_24.227099	735	815	0	80	80	1.0000000
NODE_4417_length_1147_cov_24.227099	788	868	0	80	80	1.0000000
NODE_4418_length_1147_cov_16.559160	417	497	0	80	80	1.0000000
NODE_4418_length_1147_cov_16.559160	470	550	0	80	80	1.0000000
NODE_4428_length_1146_cov_52.393505	411	491	1	9	80	0.1125000
NODE_4428_length_1146_cov_52.393505	411	491	2	71	80	0.8875000
NODE_4428_length_1146_cov_52.393505	464	544	0	3	80	0.0375000
NODE_4428_length_1146_cov_52.393505	464	544	1	59	80	0.7375000
NODE_4428_length_1146_cov_52.393505	464	544	2	18	80	0.2250000
NODE_4428_length_1146_cov_52.393505	540	620	0	56	80	0.7000000
NODE_4428_length_1146_cov_52.393505	540	620	1	1	80	0.0125000
NODE_4428_length_1146_cov_52.393505	540	620	6	23	80	0.2875000
NODE_4428_length_1146_cov_52.393505	593	673	0	4	80	0.0500000
NODE_4428_length_1146_cov_52.393505	593	673	6	76	80	0.9500000
NODE_4429_length_1146_cov_46.364852	233	313	0	80	80	1.0000000
NODE_4429_length_1146_cov_46.364852	286	366	0	80	80	1.0000000
NODE_4430_length_1146_cov_26.159503	476	556	0	80	80	1.0000000
NODE_4430_length_1146_cov_26.159503	529	609	0	80	80	1.0000000
NODE_4430_length_1146_cov_26.159503	605	685	0	56	80	0.7000000
NODE_4430_length_1146_cov_26.159503	605	685	2	24	80	0.3000000
NODE_4430_length_1146_cov_26.159503	658	738	0	3	80	0.0375000
NODE_4430_length_1146_cov_26.159503	658	738	2	56	80	0.7000000
NODE_4430_length_1146_cov_26.159503	658	738	4	21	80	0.2625000
NODE_4431_length_1146_cov_14.210124	343	423	0	80	80	1.0000000
NODE_4431_length_1146_cov_14.210124	396	476	0	80	80	1.0000000
NODE_4432_length_1146_cov_13.479465	425	501	0	4	76	0.0526316
NODE_4432_length_1146_cov_13.479465	425	501	2	72	76	0.9473684
NODE_4432_length_1146_cov_13.479465	505	565	2	60	60	1.0000000
NODE_4432_length_1146_cov_13.479465	561	641	0	46	80	0.5750000
NODE_4432_length_1146_cov_13.479465	561	641	2	4	80	0.0500000
NODE_4432_length_1146_cov_13.479465	561	641	6	30	80	0.3750000
NODE_4432_length_1146_cov_13.479465	614	694	6	80	80	1.0000000
NODE_4438_length_1145_cov_49.566922	395	470	0	57	75	0.7600000
NODE_4438_length_1145_cov_49.566922	395	470	2	18	75	0.2400000
NODE_4438_length_1145_cov_49.566922	443	523	0	9	80	0.1125000
NODE_4438_length_1145_cov_49.566922	443	523	2	71	80	0.8875000
NODE_4439_length_1145_cov_38.191205	497	576	0	73	79	0.9240506
NODE_4439_length_1145_cov_38.191205	497	576	4	6	79	0.0759494
NODE_4439_length_1145_cov_38.191205	549	629	0	21	80	0.2625000
NODE_4439_length_1145_cov_38.191205	549	629	4	59	80	0.7375000
NODE_4440_length_1145_cov_26.929254	468	548	0	80	80	1.0000000
NODE_4440_length_1145_cov_26.929254	521	601	0	32	80	0.4000000
NODE_4440_length_1145_cov_26.929254	521	601	2	48	80	0.6000000
NODE_4441_length_1145_cov_20.121415	508	588	0	67	80	0.8375000
NODE_4441_length_1145_cov_20.121415	508	588	4	13	80	0.1625000
NODE_4441_length_1145_cov_20.121415	561	641	0	14	80	0.1750000
NODE_4441_length_1145_cov_20.121415	561	641	4	66	80	0.8250000
NODE_4442_length_1145_cov_11.753346	527	605	0	22	78	0.2820513
NODE_4442_length_1145_cov_11.753346	527	605	2	15	78	0.1923077
NODE_4442_length_1145_cov_11.753346	527	605	4	41	78	0.5256410
NODE_4442_length_1145_cov_11.753346	578	659	0	76	81	0.9382716
NODE_4442_length_1145_cov_11.753346	578	659	2	5	81	0.0617284
NODE_4443_length_1145_cov_9.571702	93	173	0	80	80	1.0000000
NODE_4443_length_1145_cov_9.571702	146	226	0	80	80	1.0000000
NODE_4455_length_1143_cov_42.255747	380	460	0	80	80	1.0000000
NODE_4455_length_1143_cov_42.255747	433	513	0	80	80	1.0000000
NODE_4455_length_1143_cov_42.255747	509	589	0	6	80	0.0750000
NODE_4455_length_1143_cov_42.255747	509	589	11	2	80	0.0250000
NODE_4455_length_1143_cov_42.255747	509	589	12	4	80	0.0500000
NODE_4455_length_1143_cov_42.255747	509	589	14	68	80	0.8500000
NODE_4455_length_1143_cov_42.255747	562	642	2	2	80	0.0250000
NODE_4455_length_1143_cov_42.255747	562	642	4	17	80	0.2125000
NODE_4455_length_1143_cov_42.255747	562	642	13	6	80	0.0750000
NODE_4455_length_1143_cov_42.255747	562	642	14	55	80	0.6875000
NODE_4456_length_1143_cov_22.076628	526	606	4	72	80	0.9000000
NODE_4456_length_1143_cov_22.076628	526	606	6	8	80	0.1000000
NODE_4456_length_1143_cov_22.076628	579	659	0	12	80	0.1500000
NODE_4456_length_1143_cov_22.076628	579	659	3	1	80	0.0125000
NODE_4456_length_1143_cov_22.076628	579	659	4	67	80	0.8375000
NODE_4457_length_1143_cov_19.106322	565	645	0	80	80	1.0000000
NODE_4457_length_1143_cov_19.106322	618	698	0	80	80	1.0000000
NODE_4458_length_1143_cov_16.223180	638	719	4	81	81	1.0000000
NODE_4458_length_1143_cov_16.223180	692	772	0	42	80	0.5250000
NODE_4458_length_1143_cov_16.223180	692	772	2	9	80	0.1125000
NODE_4458_length_1143_cov_16.223180	692	772	4	29	80	0.3625000
NODE_4459_length_1143_cov_13.961686	634	714	0	9	80	0.1125000
NODE_4459_length_1143_cov_13.961686	634	714	2	45	80	0.5625000
NODE_4459_length_1143_cov_13.961686	634	714	4	26	80	0.3250000
NODE_4459_length_1143_cov_13.961686	687	767	0	3	80	0.0375000
NODE_4459_length_1143_cov_13.961686	687	767	2	33	80	0.4125000
NODE_4459_length_1143_cov_13.961686	687	767	10	37	80	0.4625000
NODE_4459_length_1143_cov_13.961686	687	767	12	7	80	0.0875000
NODE_4459_length_1143_cov_13.961686	763	843	10	24	80	0.3000000
NODE_4459_length_1143_cov_13.961686	763	843	12	56	80	0.7000000
NODE_4459_length_1143_cov_13.961686	816	896	0	8	80	0.1000000
NODE_4459_length_1143_cov_13.961686	816	896	2	43	80	0.5375000
NODE_4459_length_1143_cov_13.961686	816	896	4	2	80	0.0250000
NODE_4459_length_1143_cov_13.961686	816	896	10	15	80	0.1875000
NODE_4459_length_1143_cov_13.961686	816	896	12	12	80	0.1500000
NODE_4460_length_1143_cov_12.782567	328	409	2	81	81	1.0000000
NODE_4460_length_1143_cov_12.782567	381	462	0	46	81	0.5679013
NODE_4460_length_1143_cov_12.782567	381	462	2	35	81	0.4320988
NODE_4460_length_1143_cov_12.782567	458	538	0	65	80	0.8125000
NODE_4460_length_1143_cov_12.782567	458	538	2	15	80	0.1875000
NODE_4460_length_1143_cov_12.782567	511	591	0	12	80	0.1500000
NODE_4460_length_1143_cov_12.782567	511	591	2	68	80	0.8500000
NODE_4461_length_1143_cov_8.287356	692	772	0	80	80	1.0000000
NODE_4461_length_1143_cov_8.287356	745	825	0	69	80	0.8625000
NODE_4461_length_1143_cov_8.287356	745	825	6	11	80	0.1375000
NODE_4463_length_1143_cov_2.197318	988	1057	18	21	69	0.3043478
NODE_4463_length_1143_cov_2.197318	988	1057	20	5	69	0.0724638
NODE_4463_length_1143_cov_2.197318	988	1057	22	3	69	0.0434783
NODE_4463_length_1143_cov_2.197318	988	1057	24	2	69	0.0289855
NODE_4463_length_1143_cov_2.197318	988	1057	28	1	69	0.0144928
NODE_4463_length_1143_cov_2.197318	988	1057	30	3	69	0.0434783
NODE_4463_length_1143_cov_2.197318	988	1057	32	5	69	0.0724638
NODE_4463_length_1143_cov_2.197318	988	1057	36	5	69	0.0724638
NODE_4463_length_1143_cov_2.197318	988	1057	38	1	69	0.0144928
NODE_4463_length_1143_cov_2.197318	988	1057	40	23	69	0.3333333
NODE_4466_length_1142_cov_28.364334	613	693	0	36	80	0.4500000
NODE_4466_length_1142_cov_28.364334	613	693	2	21	80	0.2625000
NODE_4466_length_1142_cov_28.364334	613	693	4	23	80	0.2875000
NODE_4466_length_1142_cov_28.364334	666	746	2	5	80	0.0625000
NODE_4466_length_1142_cov_28.364334	666	746	4	75	80	0.9375000
NODE_4467_length_1142_cov_21.669223	518	598	0	19	80	0.2375000
NODE_4467_length_1142_cov_21.669223	518	598	2	61	80	0.7625000
NODE_4467_length_1142_cov_21.669223	571	651	0	44	80	0.5500000
NODE_4467_length_1142_cov_21.669223	571	651	2	36	80	0.4500000
NODE_4468_length_1142_cov_19.007670	411	491	0	5	80	0.0625000
NODE_4468_length_1142_cov_19.007670	411	491	7	46	80	0.5750000
NODE_4468_length_1142_cov_19.007670	411	491	8	29	80	0.3625000
NODE_4468_length_1142_cov_19.007670	464	544	0	47	80	0.5875000
NODE_4468_length_1142_cov_19.007670	464	544	8	33	80	0.4125000
NODE_4474_length_1141_cov_12.500960	17	97	4	3	80	0.0375000
NODE_4474_length_1141_cov_12.500960	17	97	8	10	80	0.1250000
NODE_4474_length_1141_cov_12.500960	17	97	10	3	80	0.0375000
NODE_4474_length_1141_cov_12.500960	17	97	12	26	80	0.3250000
NODE_4474_length_1141_cov_12.500960	17	97	14	38	80	0.4750000
NODE_4474_length_1141_cov_12.500960	17	97	4	3	80	0.0375000
NODE_4474_length_1141_cov_12.500960	17	97	8	10	80	0.1250000
NODE_4474_length_1141_cov_12.500960	17	97	10	3	80	0.0375000
NODE_4474_length_1141_cov_12.500960	17	97	12	26	80	0.3250000
NODE_4474_length_1141_cov_12.500960	17	97	14	38	80	0.4750000
NODE_4474_length_1141_cov_12.500960	17	97	4	3	80	0.0375000
NODE_4474_length_1141_cov_12.500960	17	97	8	10	80	0.1250000
NODE_4474_length_1141_cov_12.500960	17	97	10	3	80	0.0375000
NODE_4474_length_1141_cov_12.500960	17	97	12	26	80	0.3250000
NODE_4474_length_1141_cov_12.500960	17	97	14	38	80	0.4750000
NODE_4474_length_1141_cov_12.500960	17	97	4	3	80	0.0375000
NODE_4474_length_1141_cov_12.500960	17	97	8	10	80	0.1250000
NODE_4474_length_1141_cov_12.500960	17	97	10	3	80	0.0375000
NODE_4474_length_1141_cov_12.500960	17	97	12	26	80	0.3250000
NODE_4474_length_1141_cov_12.500960	17	97	14	38	80	0.4750000
NODE_4474_length_1141_cov_12.500960	70	132	2	4	62	0.0645161
NODE_4474_length_1141_cov_12.500960	70	132	4	6	62	0.0967742
NODE_4474_length_1141_cov_12.500960	70	132	5	1	62	0.0161290
NODE_4474_length_1141_cov_12.500960	70	132	6	3	62	0.0483871
NODE_4474_length_1141_cov_12.500960	70	132	10	9	62	0.1451613
NODE_4474_length_1141_cov_12.500960	70	132	14	39	62	0.6290323
NODE_4474_length_1141_cov_12.500960	70	132	2	4	62	0.0645161
NODE_4474_length_1141_cov_12.500960	70	132	4	6	62	0.0967742
NODE_4474_length_1141_cov_12.500960	70	132	5	1	62	0.0161290
NODE_4474_length_1141_cov_12.500960	70	132	6	3	62	0.0483871
NODE_4474_length_1141_cov_12.500960	70	132	10	9	62	0.1451613
NODE_4474_length_1141_cov_12.500960	70	132	14	39	62	0.6290323
NODE_4474_length_1141_cov_12.500960	70	132	2	4	62	0.0645161
NODE_4474_length_1141_cov_12.500960	70	132	4	6	62	0.0967742
NODE_4474_length_1141_cov_12.500960	70	132	5	1	62	0.0161290
NODE_4474_length_1141_cov_12.500960	70	132	6	3	62	0.0483871
NODE_4474_length_1141_cov_12.500960	70	132	10	9	62	0.1451613
NODE_4474_length_1141_cov_12.500960	70	132	14	39	62	0.6290323
NODE_4474_length_1141_cov_12.500960	70	132	2	4	62	0.0645161
NODE_4474_length_1141_cov_12.500960	70	132	4	6	62	0.0967742
NODE_4474_length_1141_cov_12.500960	70	132	5	1	62	0.0161290
NODE_4474_length_1141_cov_12.500960	70	132	6	3	62	0.0483871
NODE_4474_length_1141_cov_12.500960	70	132	10	9	62	0.1451613
NODE_4474_length_1141_cov_12.500960	70	132	14	39	62	0.6290323
NODE_4475_length_1141_cov_7.197697	54	134	0	80	80	1.0000000
NODE_4475_length_1141_cov_7.197697	107	187	0	80	80	1.0000000
NODE_4475_length_1141_cov_7.197697	573	653	0	80	80	1.0000000
NODE_4475_length_1141_cov_7.197697	626	707	0	81	81	1.0000000
NODE_4476_length_1141_cov_5.428023	411	491	0	80	80	1.0000000
NODE_4476_length_1141_cov_5.428023	464	544	0	80	80	1.0000000
NODE_4482_length_1140_cov_39.383285	451	531	2	23	80	0.2875000
NODE_4482_length_1140_cov_39.383285	451	531	4	57	80	0.7125000
NODE_4482_length_1140_cov_39.383285	504	584	2	44	80	0.5500000
NODE_4482_length_1140_cov_39.383285	504	584	4	36	80	0.4500000
NODE_4482_length_1140_cov_39.383285	580	660	0	68	80	0.8500000
NODE_4482_length_1140_cov_39.383285	580	660	2	12	80	0.1500000
NODE_4482_length_1140_cov_39.383285	633	713	0	80	80	1.0000000
NODE_4483_length_1140_cov_19.493756	543	623	2	59	80	0.7375000
NODE_4483_length_1140_cov_19.493756	543	623	4	21	80	0.2625000
NODE_4483_length_1140_cov_19.493756	596	676	2	68	80	0.8500000
NODE_4483_length_1140_cov_19.493756	596	676	4	12	80	0.1500000
NODE_4484_length_1140_cov_18.341018	347	427	0	80	80	1.0000000
NODE_4484_length_1140_cov_18.341018	400	480	0	80	80	1.0000000
NODE_4484_length_1140_cov_18.341018	476	556	0	8	80	0.1000000
NODE_4484_length_1140_cov_18.341018	476	556	2	72	80	0.9000000
NODE_4484_length_1140_cov_18.341018	529	609	2	80	80	1.0000000
NODE_4494_length_1139_cov_26.812500	410	490	0	16	80	0.2000000
NODE_4494_length_1139_cov_26.812500	410	490	4	64	80	0.8000000
NODE_4494_length_1139_cov_26.812500	463	543	0	27	80	0.3375000
NODE_4494_length_1139_cov_26.812500	463	543	4	53	80	0.6625000
NODE_4494_length_1139_cov_26.812500	539	619	0	54	80	0.6750000
NODE_4494_length_1139_cov_26.812500	539	619	2	26	80	0.3250000
NODE_4494_length_1139_cov_26.812500	592	672	0	23	80	0.2875000
NODE_4494_length_1139_cov_26.812500	592	672	2	57	80	0.7125000
NODE_4495_length_1139_cov_26.323077	308	388	0	80	80	1.0000000
NODE_4495_length_1139_cov_26.323077	361	441	0	80	80	1.0000000
NODE_4495_length_1139_cov_26.323077	437	517	0	6	80	0.0750000
NODE_4495_length_1139_cov_26.323077	437	517	2	74	80	0.9250000
NODE_4495_length_1139_cov_26.323077	490	570	0	7	80	0.0875000
NODE_4495_length_1139_cov_26.323077	490	570	2	73	80	0.9125000
NODE_4496_length_1139_cov_15.223077	530	610	0	7	80	0.0875000
NODE_4496_length_1139_cov_15.223077	530	610	1	30	80	0.3750000
NODE_4496_length_1139_cov_15.223077	530	610	2	37	80	0.4625000
NODE_4496_length_1139_cov_15.223077	530	610	4	3	80	0.0375000
NODE_4496_length_1139_cov_15.223077	530	610	8	3	80	0.0375000
NODE_4496_length_1139_cov_15.223077	583	663	0	60	80	0.7500000
NODE_4496_length_1139_cov_15.223077	583	663	1	20	80	0.2500000
NODE_4505_length_1138_cov_74.599615	480	560	0	20	80	0.2500000
NODE_4505_length_1138_cov_74.599615	480	560	2	30	80	0.3750000
NODE_4505_length_1138_cov_74.599615	480	560	3	7	80	0.0875000
NODE_4505_length_1138_cov_74.599615	480	560	5	23	80	0.2875000
NODE_4505_length_1138_cov_74.599615	533	613	0	73	80	0.9125000
NODE_4505_length_1138_cov_74.599615	533	613	2	7	80	0.0875000
NODE_4505_length_1138_cov_74.599615	609	689	0	69	80	0.8625000
NODE_4505_length_1138_cov_74.599615	609	689	2	11	80	0.1375000
NODE_4505_length_1138_cov_74.599615	662	742	0	16	80	0.2000000
NODE_4505_length_1138_cov_74.599615	662	742	2	17	80	0.2125000
NODE_4505_length_1138_cov_74.599615	662	742	4	47	80	0.5875000
NODE_4506_length_1138_cov_29.407122	559	639	0	80	80	1.0000000
NODE_4506_length_1138_cov_29.407122	612	692	0	80	80	1.0000000
NODE_4506_length_1138_cov_29.407122	688	768	0	80	80	1.0000000
NODE_4506_length_1138_cov_29.407122	741	821	0	80	80	1.0000000
NODE_4507_length_1138_cov_18.326275	454	534	0	26	80	0.3250000
NODE_4507_length_1138_cov_18.326275	454	534	2	54	80	0.6750000
NODE_4507_length_1138_cov_18.326275	507	587	0	13	80	0.1625000
NODE_4507_length_1138_cov_18.326275	507	587	2	67	80	0.8375000
NODE_4507_length_1138_cov_18.326275	583	663	0	80	80	1.0000000
NODE_4507_length_1138_cov_18.326275	636	716	0	80	80	1.0000000
NODE_4509_length_1138_cov_11.834456	291	371	0	80	80	1.0000000
NODE_4509_length_1138_cov_11.834456	344	424	0	80	80	1.0000000
NODE_4510_length_1138_cov_10.923003	318	398	0	20	80	0.2500000
NODE_4510_length_1138_cov_10.923003	318	398	12	3	80	0.0375000
NODE_4510_length_1138_cov_10.923003	318	398	20	7	80	0.0875000
NODE_4510_length_1138_cov_10.923003	318	398	22	23	80	0.2875000
NODE_4510_length_1138_cov_10.923003	318	398	26	10	80	0.1250000
NODE_4510_length_1138_cov_10.923003	318	398	28	17	80	0.2125000
NODE_4510_length_1138_cov_10.923003	371	451	14	18	80	0.2250000
NODE_4510_length_1138_cov_10.923003	371	451	26	13	80	0.1625000
NODE_4510_length_1138_cov_10.923003	371	451	28	49	80	0.6125000
NODE_4517_length_1137_cov_23.983622	470	550	0	80	80	1.0000000
NODE_4517_length_1137_cov_23.983622	523	603	0	80	80	1.0000000
NODE_4517_length_1137_cov_23.983622	599	679	0	38	80	0.4750000
NODE_4517_length_1137_cov_23.983622	599	679	4	42	80	0.5250000
NODE_4517_length_1137_cov_23.983622	652	732	0	11	80	0.1375000
NODE_4517_length_1137_cov_23.983622	652	732	4	69	80	0.8625000
NODE_4518_length_1137_cov_22.877649	405	485	0	19	80	0.2375000
NODE_4518_length_1137_cov_22.877649	405	485	2	61	80	0.7625000
NODE_4518_length_1137_cov_22.877649	458	538	2	80	80	1.0000000
NODE_4518_length_1137_cov_22.877649	534	614	0	58	80	0.7250000
NODE_4518_length_1137_cov_22.877649	534	614	2	22	80	0.2750000
NODE_4518_length_1137_cov_22.877649	587	667	0	80	80	1.0000000
NODE_4519_length_1137_cov_21.570328	383	463	0	22	80	0.2750000
NODE_4519_length_1137_cov_21.570328	383	463	2	58	80	0.7250000
NODE_4519_length_1137_cov_21.570328	436	516	0	75	80	0.9375000
NODE_4519_length_1137_cov_21.570328	436	516	2	5	80	0.0625000
NODE_4520_length_1137_cov_18.560694	665	745	0	10	80	0.1250000
NODE_4520_length_1137_cov_18.560694	665	745	2	70	80	0.8750000
NODE_4520_length_1137_cov_18.560694	718	798	0	63	80	0.7875000
NODE_4520_length_1137_cov_18.560694	718	798	2	17	80	0.2125000
NODE_4521_length_1137_cov_18.505780	557	637	0	80	80	1.0000000
NODE_4521_length_1137_cov_18.505780	610	690	0	80	80	1.0000000
NODE_4521_length_1137_cov_18.505780	686	766	0	54	80	0.6750000
NODE_4521_length_1137_cov_18.505780	686	766	2	3	80	0.0375000
NODE_4521_length_1137_cov_18.505780	686	766	4	23	80	0.2875000
NODE_4521_length_1137_cov_18.505780	739	819	0	1	80	0.0125000
NODE_4521_length_1137_cov_18.505780	739	819	2	9	80	0.1125000
NODE_4521_length_1137_cov_18.505780	739	819	4	70	80	0.8750000
NODE_4523_length_1137_cov_11.866089	313	393	0	5	80	0.0625000
NODE_4523_length_1137_cov_11.866089	313	393	2	75	80	0.9375000
NODE_4523_length_1137_cov_11.866089	366	446	0	58	80	0.7250000
NODE_4523_length_1137_cov_11.866089	366	446	2	22	80	0.2750000
NODE_4523_length_1137_cov_11.866089	442	522	0	31	80	0.3875000
NODE_4523_length_1137_cov_11.866089	442	522	8	49	80	0.6125000
NODE_4523_length_1137_cov_11.866089	495	575	0	38	80	0.4750000
NODE_4523_length_1137_cov_11.866089	495	575	8	42	80	0.5250000
NODE_4524_length_1137_cov_5.594412	144	224	6	80	80	1.0000000
NODE_4524_length_1137_cov_5.594412	197	277	0	11	80	0.1375000
NODE_4524_length_1137_cov_5.594412	197	277	6	69	80	0.8625000
NODE_4532_length_1136_cov_42.827387	445	525	0	6	80	0.0750000
NODE_4532_length_1136_cov_42.827387	445	525	2	1	80	0.0125000
NODE_4532_length_1136_cov_42.827387	445	525	4	73	80	0.9125000
NODE_4532_length_1136_cov_42.827387	498	578	0	43	80	0.5375000
NODE_4532_length_1136_cov_42.827387	498	578	2	2	80	0.0250000
NODE_4532_length_1136_cov_42.827387	498	578	4	35	80	0.4375000
NODE_4532_length_1136_cov_42.827387	574	654	0	80	80	1.0000000
NODE_4532_length_1136_cov_42.827387	627	707	0	80	80	1.0000000
NODE_4533_length_1136_cov_30.940212	534	614	0	33	80	0.4125000
NODE_4533_length_1136_cov_30.940212	534	614	4	47	80	0.5875000
NODE_4533_length_1136_cov_30.940212	587	667	0	22	80	0.2750000
NODE_4533_length_1136_cov_30.940212	587	667	4	58	80	0.7250000
NODE_4533_length_1136_cov_30.940212	663	743	0	72	80	0.9000000
NODE_4533_length_1136_cov_30.940212	663	743	2	8	80	0.1000000
NODE_4533_length_1136_cov_30.940212	716	796	0	19	80	0.2375000
NODE_4533_length_1136_cov_30.940212	716	796	2	61	80	0.7625000
NODE_4534_length_1136_cov_30.797493	557	637	0	80	80	1.0000000
NODE_4534_length_1136_cov_30.797493	610	691	0	81	81	1.0000000
NODE_4534_length_1136_cov_30.797493	687	767	0	80	80	1.0000000
NODE_4534_length_1136_cov_30.797493	740	820	0	80	80	1.0000000
NODE_4535_length_1136_cov_23.142719	704	784	1	11	80	0.1375000
NODE_4535_length_1136_cov_23.142719	704	784	2	51	80	0.6375000
NODE_4535_length_1136_cov_23.142719	704	784	3	18	80	0.2250000
NODE_4535_length_1136_cov_23.142719	757	837	0	38	80	0.4750000
NODE_4535_length_1136_cov_23.142719	757	837	1	26	80	0.3250000
NODE_4535_length_1136_cov_23.142719	757	837	3	16	80	0.2000000
NODE_4536_length_1136_cov_21.798457	570	651	0	81	81	1.0000000
NODE_4536_length_1136_cov_21.798457	624	704	0	80	80	1.0000000
NODE_4537_length_1136_cov_21.109932	460	532	0	72	72	1.0000000
NODE_4537_length_1136_cov_21.109932	505	585	0	80	80	1.0000000
NODE_4538_length_1136_cov_20.528447	19	99	2	5	80	0.0625000
NODE_4538_length_1136_cov_20.528447	19	99	4	3	80	0.0375000
NODE_4538_length_1136_cov_20.528447	19	99	8	14	80	0.1750000
NODE_4538_length_1136_cov_20.528447	19	99	10	2	80	0.0250000
NODE_4538_length_1136_cov_20.528447	19	99	12	18	80	0.2250000
NODE_4538_length_1136_cov_20.528447	19	99	16	1	80	0.0125000
NODE_4538_length_1136_cov_20.528447	19	99	20	1	80	0.0125000
NODE_4538_length_1136_cov_20.528447	19	99	22	1	80	0.0125000
NODE_4538_length_1136_cov_20.528447	19	99	24	20	80	0.2500000
NODE_4538_length_1136_cov_20.528447	19	99	25	7	80	0.0875000
NODE_4538_length_1136_cov_20.528447	19	99	26	8	80	0.1000000
NODE_4538_length_1136_cov_20.528447	19	99	2	5	80	0.0625000
NODE_4538_length_1136_cov_20.528447	19	99	4	3	80	0.0375000
NODE_4538_length_1136_cov_20.528447	19	99	8	14	80	0.1750000
NODE_4538_length_1136_cov_20.528447	19	99	10	2	80	0.0250000
NODE_4538_length_1136_cov_20.528447	19	99	12	18	80	0.2250000
NODE_4538_length_1136_cov_20.528447	19	99	16	1	80	0.0125000
NODE_4538_length_1136_cov_20.528447	19	99	20	1	80	0.0125000
NODE_4538_length_1136_cov_20.528447	19	99	22	1	80	0.0125000
NODE_4538_length_1136_cov_20.528447	19	99	24	20	80	0.2500000
NODE_4538_length_1136_cov_20.528447	19	99	25	7	80	0.0875000
NODE_4538_length_1136_cov_20.528447	19	99	26	8	80	0.1000000
NODE_4538_length_1136_cov_20.528447	28	99	8	13	71	0.1830986
NODE_4538_length_1136_cov_20.528447	28	99	10	2	71	0.0281690
NODE_4538_length_1136_cov_20.528447	28	99	12	18	71	0.2535211
NODE_4538_length_1136_cov_20.528447	28	99	16	1	71	0.0140845
NODE_4538_length_1136_cov_20.528447	28	99	20	1	71	0.0140845
NODE_4538_length_1136_cov_20.528447	28	99	22	1	71	0.0140845
NODE_4538_length_1136_cov_20.528447	28	99	24	20	71	0.2816902
NODE_4538_length_1136_cov_20.528447	28	99	25	7	71	0.0985916
NODE_4538_length_1136_cov_20.528447	28	99	26	8	71	0.1126761
NODE_4538_length_1136_cov_20.528447	877	912	0	35	35	1.0000000
NODE_4538_length_1136_cov_20.528447	879	921	0	42	42	1.0000000
NODE_4539_length_1136_cov_14.921890	657	737	0	80	80	1.0000000
NODE_4539_length_1136_cov_14.921890	710	790	0	80	80	1.0000000
NODE_4556_length_1135_cov_100.121622	454	534	0	80	80	1.0000000
NODE_4556_length_1135_cov_100.121622	507	587	0	46	80	0.5750000
NODE_4556_length_1135_cov_100.121622	507	587	2	34	80	0.4250000
NODE_4556_length_1135_cov_100.121622	583	663	0	26	80	0.3250000
NODE_4556_length_1135_cov_100.121622	583	663	2	54	80	0.6750000
NODE_4556_length_1135_cov_100.121622	636	719	0	82	83	0.9879518
NODE_4556_length_1135_cov_100.121622	636	719	2	1	83	0.0120482
NODE_4557_length_1135_cov_34.523166	313	393	0	1	80	0.0125000
NODE_4557_length_1135_cov_34.523166	313	393	2	79	80	0.9875000
NODE_4557_length_1135_cov_34.523166	366	446	0	41	80	0.5125000
NODE_4557_length_1135_cov_34.523166	366	446	2	39	80	0.4875000
NODE_4558_length_1135_cov_20.735521	484	564	0	80	80	1.0000000
NODE_4558_length_1135_cov_20.735521	537	617	0	80	80	1.0000000
NODE_4558_length_1135_cov_20.735521	613	693	0	80	80	1.0000000
NODE_4558_length_1135_cov_20.735521	666	746	0	75	80	0.9375000
NODE_4558_length_1135_cov_20.735521	666	746	2	5	80	0.0625000
NODE_4559_length_1135_cov_9.644788	620	700	0	80	80	1.0000000
NODE_4559_length_1135_cov_9.644788	673	753	0	44	80	0.5500000
NODE_4559_length_1135_cov_9.644788	673	753	2	36	80	0.4500000
NODE_4562_length_1135_cov_2.990347	349	429	0	47	80	0.5875000
NODE_4562_length_1135_cov_2.990347	349	429	2	22	80	0.2750000
NODE_4562_length_1135_cov_2.990347	349	429	4	11	80	0.1375000
NODE_4562_length_1135_cov_2.990347	402	482	2	16	80	0.2000000
NODE_4562_length_1135_cov_2.990347	402	482	4	12	80	0.1500000
NODE_4562_length_1135_cov_2.990347	402	482	8	34	80	0.4250000
NODE_4562_length_1135_cov_2.990347	402	482	10	7	80	0.0875000
NODE_4562_length_1135_cov_2.990347	402	482	12	11	80	0.1375000
NODE_4571_length_1134_cov_34.784541	478	558	0	8	80	0.1000000
NODE_4571_length_1134_cov_34.784541	478	558	3	72	80	0.9000000
NODE_4571_length_1134_cov_34.784541	531	611	0	48	80	0.6000000
NODE_4571_length_1134_cov_34.784541	531	611	2	13	80	0.1625000
NODE_4571_length_1134_cov_34.784541	531	611	3	19	80	0.2375000
NODE_4571_length_1134_cov_34.784541	607	687	2	51	80	0.6375000
NODE_4571_length_1134_cov_34.784541	607	687	6	14	80	0.1750000
NODE_4571_length_1134_cov_34.784541	607	687	8	15	80	0.1875000
NODE_4571_length_1134_cov_34.784541	660	740	6	67	80	0.8375000
NODE_4571_length_1134_cov_34.784541	660	740	8	13	80	0.1625000
NODE_4572_length_1134_cov_28.524638	511	591	0	2	80	0.0250000
NODE_4572_length_1134_cov_28.524638	511	591	2	78	80	0.9750000
NODE_4572_length_1134_cov_28.524638	564	644	0	5	80	0.0625000
NODE_4572_length_1134_cov_28.524638	564	644	2	75	80	0.9375000
NODE_4572_length_1134_cov_28.524638	640	720	0	38	80	0.4750000
NODE_4572_length_1134_cov_28.524638	640	720	4	42	80	0.5250000
NODE_4572_length_1134_cov_28.524638	693	773	0	4	80	0.0500000
NODE_4572_length_1134_cov_28.524638	693	773	4	76	80	0.9500000
NODE_4576_length_1134_cov_2.619324	606	686	0	80	80	1.0000000
NODE_4576_length_1134_cov_2.619324	659	739	0	80	80	1.0000000
NODE_4584_length_1133_cov_5.563830	292	372	2	62	80	0.7750000
NODE_4584_length_1133_cov_5.563830	292	372	4	18	80	0.2250000
NODE_4584_length_1133_cov_5.563830	345	425	0	45	80	0.5625000
NODE_4584_length_1133_cov_5.563830	345	425	2	35	80	0.4375000
NODE_4584_length_1133_cov_5.563830	904	966	0	7	62	0.1129032
NODE_4584_length_1133_cov_5.563830	904	966	2	16	62	0.2580645
NODE_4584_length_1133_cov_5.563830	904	966	4	2	62	0.0322581
NODE_4584_length_1133_cov_5.563830	904	966	8	37	62	0.5967742
NODE_4592_length_1132_cov_23.121007	485	565	2	62	80	0.7750000
NODE_4592_length_1132_cov_23.121007	485	565	3	1	80	0.0125000
NODE_4592_length_1132_cov_23.121007	485	565	4	15	80	0.1875000
NODE_4592_length_1132_cov_23.121007	485	565	17	2	80	0.0250000
NODE_4592_length_1132_cov_23.121007	538	618	2	9	80	0.1125000
NODE_4592_length_1132_cov_23.121007	538	618	3	1	80	0.0125000
NODE_4592_length_1132_cov_23.121007	538	618	4	15	80	0.1875000
NODE_4592_length_1132_cov_23.121007	538	618	16	2	80	0.0250000
NODE_4592_length_1132_cov_23.121007	538	618	17	7	80	0.0875000
NODE_4592_length_1132_cov_23.121007	538	618	26	17	80	0.2125000
NODE_4592_length_1132_cov_23.121007	538	618	28	29	80	0.3625000
NODE_4592_length_1132_cov_23.121007	618	664	21	6	46	0.1304348
NODE_4592_length_1132_cov_23.121007	618	664	23	21	46	0.4565217
NODE_4592_length_1132_cov_23.121007	618	664	26	2	46	0.0434783
NODE_4592_length_1132_cov_23.121007	618	664	28	17	46	0.3695652
NODE_4592_length_1132_cov_23.121007	700	751	1	47	51	0.9215686
NODE_4592_length_1132_cov_23.121007	700	751	13	4	51	0.0784314
NODE_4593_length_1132_cov_19.377541	595	675	0	63	80	0.7875000
NODE_4593_length_1132_cov_19.377541	595	675	4	17	80	0.2125000
NODE_4593_length_1132_cov_19.377541	648	728	0	10	80	0.1250000
NODE_4593_length_1132_cov_19.377541	648	728	4	70	80	0.8750000
NODE_4594_length_1132_cov_18.872217	363	443	0	80	80	1.0000000
NODE_4594_length_1132_cov_18.872217	416	496	0	39	80	0.4875000
NODE_4594_length_1132_cov_18.872217	416	496	4	41	80	0.5125000
NODE_4595_length_1132_cov_11.242982	474	554	0	80	80	1.0000000
NODE_4595_length_1132_cov_11.242982	527	607	0	80	80	1.0000000
NODE_4596_length_1132_cov_7.356244	354	434	0	80	80	1.0000000
NODE_4596_length_1132_cov_7.356244	407	487	0	50	80	0.6250000
NODE_4596_length_1132_cov_7.356244	407	487	2	30	80	0.3750000
NODE_4597_length_1132_cov_6.214908	269	349	0	79	80	0.9875000
NODE_4597_length_1132_cov_6.214908	269	349	2	1	80	0.0125000
NODE_4597_length_1132_cov_6.214908	322	402	0	26	80	0.3250000
NODE_4597_length_1132_cov_6.214908	322	402	2	54	80	0.6750000
NODE_4606_length_1131_cov_36.161822	478	558	2	80	80	1.0000000
NODE_4606_length_1131_cov_36.161822	531	611	0	51	80	0.6375000
NODE_4606_length_1131_cov_36.161822	531	611	2	29	80	0.3625000
NODE_4606_length_1131_cov_36.161822	607	687	0	5	80	0.0625000
NODE_4606_length_1131_cov_36.161822	607	687	9	1	80	0.0125000
NODE_4606_length_1131_cov_36.161822	607	687	10	74	80	0.9250000
NODE_4606_length_1131_cov_36.161822	660	740	9	25	80	0.3125000
NODE_4606_length_1131_cov_36.161822	660	740	10	55	80	0.6875000
NODE_4607_length_1131_cov_31.907946	390	470	0	80	80	1.0000000
NODE_4607_length_1131_cov_31.907946	443	523	0	80	80	1.0000000
NODE_4607_length_1131_cov_31.907946	519	599	0	24	80	0.3000000
NODE_4607_length_1131_cov_31.907946	519	599	2	56	80	0.7000000
NODE_4607_length_1131_cov_31.907946	572	652	0	1	80	0.0125000
NODE_4607_length_1131_cov_31.907946	572	652	2	79	80	0.9875000
NODE_4608_length_1131_cov_26.827519	464	544	0	80	80	1.0000000
NODE_4608_length_1131_cov_26.827519	517	597	0	80	80	1.0000000
NODE_4609_length_1131_cov_20.441860	555	635	0	10	80	0.1250000
NODE_4609_length_1131_cov_20.441860	555	635	2	70	80	0.8750000
NODE_4609_length_1131_cov_20.441860	608	688	0	48	80	0.6000000
NODE_4609_length_1131_cov_20.441860	608	688	2	32	80	0.4000000
NODE_4610_length_1131_cov_12.517442	420	500	0	24	80	0.3000000
NODE_4610_length_1131_cov_12.517442	420	500	4	2	80	0.0250000
NODE_4610_length_1131_cov_12.517442	420	500	5	4	80	0.0500000
NODE_4610_length_1131_cov_12.517442	420	500	9	32	80	0.4000000
NODE_4610_length_1131_cov_12.517442	420	500	10	17	80	0.2125000
NODE_4610_length_1131_cov_12.517442	420	500	12	1	80	0.0125000
NODE_4610_length_1131_cov_12.517442	473	553	6	7	80	0.0875000
NODE_4610_length_1131_cov_12.517442	473	553	9	9	80	0.1125000
NODE_4610_length_1131_cov_12.517442	473	553	10	22	80	0.2750000
NODE_4610_length_1131_cov_12.517442	473	553	12	1	80	0.0125000
NODE_4610_length_1131_cov_12.517442	473	553	13	17	80	0.2125000
NODE_4610_length_1131_cov_12.517442	473	553	14	4	80	0.0500000
NODE_4610_length_1131_cov_12.517442	473	553	16	20	80	0.2500000
NODE_4611_length_1131_cov_10.912791	429	509	2	5	80	0.0625000
NODE_4611_length_1131_cov_10.912791	429	509	4	10	80	0.1250000
NODE_4611_length_1131_cov_10.912791	429	509	6	65	80	0.8125000
NODE_4611_length_1131_cov_10.912791	482	562	2	58	80	0.7250000
NODE_4611_length_1131_cov_10.912791	482	562	4	10	80	0.1250000
NODE_4611_length_1131_cov_10.912791	482	562	6	12	80	0.1500000
NODE_4620_length_1130_cov_43.354995	742	822	0	20	80	0.2500000
NODE_4620_length_1130_cov_43.354995	742	822	2	60	80	0.7500000
NODE_4620_length_1130_cov_43.354995	795	875	2	52	80	0.6500000
NODE_4620_length_1130_cov_43.354995	795	875	4	28	80	0.3500000
NODE_4621_length_1130_cov_13.097963	642	722	0	22	80	0.2750000
NODE_4621_length_1130_cov_13.097963	642	722	6	51	80	0.6375000
NODE_4621_length_1130_cov_13.097963	642	722	10	7	80	0.0875000
NODE_4621_length_1130_cov_13.097963	695	775	6	20	80	0.2500000
NODE_4621_length_1130_cov_13.097963	695	775	10	60	80	0.7500000
NODE_4626_length_1129_cov_31.088350	396	476	0	80	80	1.0000000
NODE_4626_length_1129_cov_31.088350	449	529	0	80	80	1.0000000
NODE_4627_length_1129_cov_20.591262	450	530	0	80	80	1.0000000
NODE_4627_length_1129_cov_20.591262	503	583	0	50	80	0.6250000
NODE_4627_length_1129_cov_20.591262	503	583	1	30	80	0.3750000
NODE_4628_length_1129_cov_16.934951	261	341	0	80	80	1.0000000
NODE_4628_length_1129_cov_16.934951	314	394	0	77	80	0.9625000
NODE_4628_length_1129_cov_16.934951	314	394	2	3	80	0.0375000
NODE_4629_length_1129_cov_9.441748	665	738	0	73	73	1.0000000
NODE_4629_length_1129_cov_9.441748	711	791	0	80	80	1.0000000
NODE_4630_length_1129_cov_9.260194	658	738	0	74	80	0.9250000
NODE_4630_length_1129_cov_9.260194	658	738	2	6	80	0.0750000
NODE_4630_length_1129_cov_9.260194	711	791	0	21	80	0.2625000
NODE_4630_length_1129_cov_9.260194	711	791	2	25	80	0.3125000
NODE_4630_length_1129_cov_9.260194	711	791	4	34	80	0.4250000
NODE_4631_length_1129_cov_5.055340	759	839	0	80	80	1.0000000
NODE_4638_length_1128_cov_48.099125	588	668	0	20	80	0.2500000
NODE_4638_length_1128_cov_48.099125	588	668	6	60	80	0.7500000
NODE_4638_length_1128_cov_48.099125	641	721	6	80	80	1.0000000
NODE_4640_length_1128_cov_26.230321	455	535	1	13	80	0.1625000
NODE_4640_length_1128_cov_26.230321	455	535	5	19	80	0.2375000
NODE_4640_length_1128_cov_26.230321	455	535	7	18	80	0.2250000
NODE_4640_length_1128_cov_26.230321	455	535	8	30	80	0.3750000
NODE_4640_length_1128_cov_26.230321	508	588	1	1	80	0.0125000
NODE_4640_length_1128_cov_26.230321	508	588	3	11	80	0.1375000
NODE_4640_length_1128_cov_26.230321	508	588	4	1	80	0.0125000
NODE_4640_length_1128_cov_26.230321	508	588	8	67	80	0.8375000
NODE_4640_length_1128_cov_26.230321	584	664	1	1	80	0.0125000
NODE_4640_length_1128_cov_26.230321	584	664	3	34	80	0.4250000
NODE_4640_length_1128_cov_26.230321	584	664	5	15	80	0.1875000
NODE_4640_length_1128_cov_26.230321	584	664	6	1	80	0.0125000
NODE_4640_length_1128_cov_26.230321	584	664	8	8	80	0.1000000
NODE_4640_length_1128_cov_26.230321	584	664	9	21	80	0.2625000
NODE_4640_length_1128_cov_26.230321	637	718	5	23	81	0.2839506
NODE_4640_length_1128_cov_26.230321	637	718	6	17	81	0.2098765
NODE_4640_length_1128_cov_26.230321	637	718	7	15	81	0.1851852
NODE_4640_length_1128_cov_26.230321	637	718	8	8	81	0.0987654
NODE_4640_length_1128_cov_26.230321	637	718	9	18	81	0.2222222
NODE_4641_length_1128_cov_26.031098	594	674	0	26	80	0.3250000
NODE_4641_length_1128_cov_26.031098	594	674	2	54	80	0.6750000
NODE_4641_length_1128_cov_26.031098	647	727	0	27	80	0.3375000
NODE_4641_length_1128_cov_26.031098	647	727	2	53	80	0.6625000
NODE_4642_length_1128_cov_25.869776	465	538	6	73	73	1.0000000
NODE_4642_length_1128_cov_25.869776	601	674	4	65	73	0.8904110
NODE_4642_length_1128_cov_25.869776	601	674	8	8	73	0.1095890
NODE_4642_length_1128_cov_25.869776	647	723	4	19	76	0.2500000
NODE_4642_length_1128_cov_25.869776	647	723	6	1	76	0.0131579
NODE_4642_length_1128_cov_25.869776	647	723	8	56	76	0.7368421
NODE_4643_length_1128_cov_24.185617	350	430	0	80	80	1.0000000
NODE_4643_length_1128_cov_24.185617	403	483	0	39	80	0.4875000
NODE_4643_length_1128_cov_24.185617	403	483	2	41	80	0.5125000
NODE_4644_length_1128_cov_18.537415	335	415	0	22	80	0.2750000
NODE_4644_length_1128_cov_18.537415	335	415	2	58	80	0.7250000
NODE_4644_length_1128_cov_18.537415	388	468	0	19	80	0.2375000
NODE_4644_length_1128_cov_18.537415	388	468	2	61	80	0.7625000
NODE_4645_length_1128_cov_9.345967	690	770	0	14	80	0.1750000
NODE_4645_length_1128_cov_9.345967	690	770	2	66	80	0.8250000
NODE_4645_length_1128_cov_9.345967	743	823	0	67	80	0.8375000
NODE_4645_length_1128_cov_9.345967	743	823	2	13	80	0.1625000
NODE_4647_length_1128_cov_3.920311	675	725	0	50	50	1.0000000
NODE_4647_length_1128_cov_3.920311	698	778	0	80	80	1.0000000
NODE_4648_length_1128_cov_3.631681	613	693	0	80	80	1.0000000
NODE_4648_length_1128_cov_3.631681	666	746	0	80	80	1.0000000
NODE_4650_length_1128_cov_3.091351	519	599	0	80	80	1.0000000
NODE_4650_length_1128_cov_3.091351	572	652	0	80	80	1.0000000
NODE_4660_length_1127_cov_38.932879	405	485	0	80	80	1.0000000
NODE_4660_length_1127_cov_38.932879	458	538	0	80	80	1.0000000
NODE_4660_length_1127_cov_38.932879	534	614	0	80	80	1.0000000
NODE_4660_length_1127_cov_38.932879	587	667	0	80	80	1.0000000
NODE_4661_length_1127_cov_37.721790	236	316	0	3	80	0.0375000
NODE_4661_length_1127_cov_37.721790	236	316	2	47	80	0.5875000
NODE_4661_length_1127_cov_37.721790	236	316	3	1	80	0.0125000
NODE_4661_length_1127_cov_37.721790	236	316	4	15	80	0.1875000
NODE_4661_length_1127_cov_37.721790	236	316	7	14	80	0.1750000
NODE_4661_length_1127_cov_37.721790	289	369	4	13	80	0.1625000
NODE_4661_length_1127_cov_37.721790	289	369	7	66	80	0.8250000
NODE_4661_length_1127_cov_37.721790	289	369	8	1	80	0.0125000
NODE_4661_length_1127_cov_37.721790	365	445	4	9	80	0.1125000
NODE_4661_length_1127_cov_37.721790	365	445	7	3	80	0.0375000
NODE_4661_length_1127_cov_37.721790	365	445	8	68	80	0.8500000
NODE_4661_length_1127_cov_37.721790	418	498	0	44	80	0.5500000
NODE_4661_length_1127_cov_37.721790	418	498	3	1	80	0.0125000
NODE_4661_length_1127_cov_37.721790	418	498	4	17	80	0.2125000
NODE_4661_length_1127_cov_37.721790	418	498	8	18	80	0.2250000
NODE_4662_length_1127_cov_31.866732	444	523	2	79	79	1.0000000
NODE_4662_length_1127_cov_31.866732	496	576	0	29	80	0.3625000
NODE_4662_length_1127_cov_31.866732	496	576	2	51	80	0.6375000
NODE_4662_length_1127_cov_31.866732	572	652	0	80	80	1.0000000
NODE_4662_length_1127_cov_31.866732	625	705	0	80	80	1.0000000
NODE_4663_length_1127_cov_25.616732	430	510	4	80	80	1.0000000
NODE_4663_length_1127_cov_25.616732	483	563	0	51	80	0.6375000
NODE_4663_length_1127_cov_25.616732	483	563	4	29	80	0.3625000
NODE_4664_length_1127_cov_21.838521	338	418	0	80	80	1.0000000
NODE_4664_length_1127_cov_21.838521	391	471	0	79	80	0.9875000
NODE_4664_length_1127_cov_21.838521	391	471	2	1	80	0.0125000
NODE_4664_length_1127_cov_21.838521	467	547	0	3	80	0.0375000
NODE_4664_length_1127_cov_21.838521	467	547	2	12	80	0.1500000
NODE_4664_length_1127_cov_21.838521	467	547	4	65	80	0.8125000
NODE_4664_length_1127_cov_21.838521	520	600	0	46	80	0.5750000
NODE_4664_length_1127_cov_21.838521	520	600	2	5	80	0.0625000
NODE_4664_length_1127_cov_21.838521	520	600	4	29	80	0.3625000
NODE_4665_length_1127_cov_15.024319	711	800	0	89	89	1.0000000
NODE_4665_length_1127_cov_15.024319	773	853	0	80	80	1.0000000
NODE_4667_length_1127_cov_4.786965	386	466	0	14	80	0.1750000
NODE_4667_length_1127_cov_4.786965	386	466	2	66	80	0.8250000
NODE_4667_length_1127_cov_4.786965	439	519	0	67	80	0.8375000
NODE_4667_length_1127_cov_4.786965	439	519	2	13	80	0.1625000
NODE_4672_length_1126_cov_51.699124	448	528	0	26	80	0.3250000
NODE_4672_length_1126_cov_51.699124	448	528	11	25	80	0.3125000
NODE_4672_length_1126_cov_51.699124	448	528	12	1	80	0.0125000
NODE_4672_length_1126_cov_51.699124	448	528	13	2	80	0.0250000
NODE_4672_length_1126_cov_51.699124	448	528	14	4	80	0.0500000
NODE_4672_length_1126_cov_51.699124	448	528	17	2	80	0.0250000
NODE_4672_length_1126_cov_51.699124	448	528	18	1	80	0.0125000
NODE_4672_length_1126_cov_51.699124	448	528	19	12	80	0.1500000
NODE_4672_length_1126_cov_51.699124	448	528	20	3	80	0.0375000
NODE_4672_length_1126_cov_51.699124	448	528	21	2	80	0.0250000
NODE_4672_length_1126_cov_51.699124	448	528	22	2	80	0.0250000
NODE_4672_length_1126_cov_51.699124	501	581	13	1	80	0.0125000
NODE_4672_length_1126_cov_51.699124	501	581	14	4	80	0.0500000
NODE_4672_length_1126_cov_51.699124	501	581	17	2	80	0.0250000
NODE_4672_length_1126_cov_51.699124	501	581	18	1	80	0.0125000
NODE_4672_length_1126_cov_51.699124	501	581	19	12	80	0.1500000
NODE_4672_length_1126_cov_51.699124	501	581	20	3	80	0.0375000
NODE_4672_length_1126_cov_51.699124	501	581	21	2	80	0.0250000
NODE_4672_length_1126_cov_51.699124	501	581	22	55	80	0.6875000
NODE_4673_length_1126_cov_38.135346	427	507	2	5	80	0.0625000
NODE_4673_length_1126_cov_38.135346	427	507	5	1	80	0.0125000
NODE_4673_length_1126_cov_38.135346	427	507	6	74	80	0.9250000
NODE_4673_length_1126_cov_38.135346	480	560	0	40	80	0.5000000
NODE_4673_length_1126_cov_38.135346	480	560	3	2	80	0.0250000
NODE_4673_length_1126_cov_38.135346	480	560	4	2	80	0.0250000
NODE_4673_length_1126_cov_38.135346	480	560	6	36	80	0.4500000
NODE_4673_length_1126_cov_38.135346	556	638	0	82	82	1.0000000
NODE_4673_length_1126_cov_38.135346	611	691	0	80	80	1.0000000
NODE_4674_length_1126_cov_34.637780	23	97	4	22	74	0.2972973
NODE_4674_length_1126_cov_34.637780	23	97	7	1	74	0.0135135
NODE_4674_length_1126_cov_34.637780	23	97	17	1	74	0.0135135
NODE_4674_length_1126_cov_34.637780	23	97	19	50	74	0.6756757
NODE_4674_length_1126_cov_34.637780	146	226	77	2	80	0.0250000
NODE_4674_length_1126_cov_34.637780	146	226	85	2	80	0.0250000
NODE_4674_length_1126_cov_34.637780	146	226	90	3	80	0.0375000
NODE_4674_length_1126_cov_34.637780	146	226	91	6	80	0.0750000
NODE_4674_length_1126_cov_34.637780	146	226	93	2	80	0.0250000
NODE_4674_length_1126_cov_34.637780	146	226	94	12	80	0.1500000
NODE_4674_length_1126_cov_34.637780	146	226	95	28	80	0.3500000
NODE_4674_length_1126_cov_34.637780	146	226	97	2	80	0.0250000
NODE_4674_length_1126_cov_34.637780	146	226	99	10	80	0.1250000
NODE_4674_length_1126_cov_34.637780	146	226	100	3	80	0.0375000
NODE_4674_length_1126_cov_34.637780	146	226	101	1	80	0.0125000
NODE_4674_length_1126_cov_34.637780	146	226	103	7	80	0.0875000
NODE_4674_length_1126_cov_34.637780	146	226	104	1	80	0.0125000
NODE_4674_length_1126_cov_34.637780	146	226	105	1	80	0.0125000
NODE_4674_length_1126_cov_34.637780	146	226	77	2	80	0.0250000
NODE_4674_length_1126_cov_34.637780	146	226	85	2	80	0.0250000
NODE_4674_length_1126_cov_34.637780	146	226	90	3	80	0.0375000
NODE_4674_length_1126_cov_34.637780	146	226	91	6	80	0.0750000
NODE_4674_length_1126_cov_34.637780	146	226	93	2	80	0.0250000
NODE_4674_length_1126_cov_34.637780	146	226	94	12	80	0.1500000
NODE_4674_length_1126_cov_34.637780	146	226	95	28	80	0.3500000
NODE_4674_length_1126_cov_34.637780	146	226	97	2	80	0.0250000
NODE_4674_length_1126_cov_34.637780	146	226	99	10	80	0.1250000
NODE_4674_length_1126_cov_34.637780	146	226	100	3	80	0.0375000
NODE_4674_length_1126_cov_34.637780	146	226	101	1	80	0.0125000
NODE_4674_length_1126_cov_34.637780	146	226	103	7	80	0.0875000
NODE_4674_length_1126_cov_34.637780	146	226	104	1	80	0.0125000
NODE_4674_length_1126_cov_34.637780	146	226	105	1	80	0.0125000
NODE_4674_length_1126_cov_34.637780	146	208	90	3	62	0.0483871
NODE_4674_length_1126_cov_34.637780	146	208	91	6	62	0.0967742
NODE_4674_length_1126_cov_34.637780	146	208	93	2	62	0.0322581
NODE_4674_length_1126_cov_34.637780	146	208	94	12	62	0.1935484
NODE_4674_length_1126_cov_34.637780	146	208	95	14	62	0.2258064
NODE_4674_length_1126_cov_34.637780	146	208	97	2	62	0.0322581
NODE_4674_length_1126_cov_34.637780	146	208	99	10	62	0.1612903
NODE_4674_length_1126_cov_34.637780	146	208	100	3	62	0.0483871
NODE_4674_length_1126_cov_34.637780	146	208	101	1	62	0.0161290
NODE_4674_length_1126_cov_34.637780	146	208	103	7	62	0.1129032
NODE_4674_length_1126_cov_34.637780	146	208	104	1	62	0.0161290
NODE_4674_length_1126_cov_34.637780	146	208	105	1	62	0.0161290
NODE_4674_length_1126_cov_34.637780	146	217	90	3	71	0.0422535
NODE_4674_length_1126_cov_34.637780	146	217	91	6	71	0.0845070
NODE_4674_length_1126_cov_34.637780	146	217	93	2	71	0.0281690
NODE_4674_length_1126_cov_34.637780	146	217	94	12	71	0.1690141
NODE_4674_length_1126_cov_34.637780	146	217	95	23	71	0.3239437
NODE_4674_length_1126_cov_34.637780	146	217	97	2	71	0.0281690
NODE_4674_length_1126_cov_34.637780	146	217	99	10	71	0.1408451
NODE_4674_length_1126_cov_34.637780	146	217	100	3	71	0.0422535
NODE_4674_length_1126_cov_34.637780	146	217	101	1	71	0.0140845
NODE_4674_length_1126_cov_34.637780	146	217	103	7	71	0.0985916
NODE_4674_length_1126_cov_34.637780	146	217	104	1	71	0.0140845
NODE_4674_length_1126_cov_34.637780	146	217	105	1	71	0.0140845
NODE_4675_length_1126_cov_21.360273	595	675	0	65	80	0.8125000
NODE_4675_length_1126_cov_21.360273	595	675	2	15	80	0.1875000
NODE_4675_length_1126_cov_21.360273	648	728	0	12	80	0.1500000
NODE_4675_length_1126_cov_21.360273	648	728	2	68	80	0.8500000
NODE_4676_length_1126_cov_17.420643	422	502	0	80	80	1.0000000
NODE_4676_length_1126_cov_17.420643	475	555	0	48	80	0.6000000
NODE_4676_length_1126_cov_17.420643	475	555	2	32	80	0.4000000
NODE_4677_length_1126_cov_15.896787	383	463	0	80	80	1.0000000
NODE_4677_length_1126_cov_15.896787	436	516	0	80	80	1.0000000
NODE_4678_length_1126_cov_8.525803	174	254	0	80	80	1.0000000
NODE_4678_length_1126_cov_8.525803	227	307	0	55	80	0.6875000
NODE_4678_length_1126_cov_8.525803	227	307	2	25	80	0.3125000
NODE_4679_length_1126_cov_5.805258	463	543	1	1	80	0.0125000
NODE_4679_length_1126_cov_5.805258	463	543	2	79	80	0.9875000
NODE_4679_length_1126_cov_5.805258	516	596	0	53	80	0.6625000
NODE_4679_length_1126_cov_5.805258	516	596	1	1	80	0.0125000
NODE_4679_length_1126_cov_5.805258	516	596	2	26	80	0.3250000
NODE_4685_length_1126_cov_1.502434	6	86	2	9	80	0.1125000
NODE_4685_length_1126_cov_1.502434	6	86	5	1	80	0.0125000
NODE_4685_length_1126_cov_1.502434	6	86	7	1	80	0.0125000
NODE_4685_length_1126_cov_1.502434	6	86	8	25	80	0.3125000
NODE_4685_length_1126_cov_1.502434	6	86	10	44	80	0.5500000
NODE_4685_length_1126_cov_1.502434	59	108	8	1	49	0.0204082
NODE_4685_length_1126_cov_1.502434	59	108	10	48	49	0.9795918
NODE_4689_length_1125_cov_34.314815	405	485	0	80	80	1.0000000
NODE_4689_length_1125_cov_34.314815	458	538	0	80	80	1.0000000
NODE_4689_length_1125_cov_34.314815	534	614	0	42	80	0.5250000
NODE_4689_length_1125_cov_34.314815	534	614	2	38	80	0.4750000
NODE_4689_length_1125_cov_34.314815	587	667	2	80	80	1.0000000
NODE_4690_length_1125_cov_33.553606	458	538	0	80	80	1.0000000
NODE_4690_length_1125_cov_33.553606	511	591	0	80	80	1.0000000
NODE_4690_length_1125_cov_33.553606	587	667	0	80	80	1.0000000
NODE_4690_length_1125_cov_33.553606	640	720	0	80	80	1.0000000
NODE_4691_length_1125_cov_33.371345	408	488	0	61	80	0.7625000
NODE_4691_length_1125_cov_33.371345	408	488	2	19	80	0.2375000
NODE_4691_length_1125_cov_33.371345	461	541	0	80	80	1.0000000
NODE_4691_length_1125_cov_33.371345	537	617	0	62	80	0.7750000
NODE_4691_length_1125_cov_33.371345	537	617	4	18	80	0.2250000
NODE_4691_length_1125_cov_33.371345	590	670	0	9	80	0.1125000
NODE_4691_length_1125_cov_33.371345	590	670	4	66	80	0.8250000
NODE_4691_length_1125_cov_33.371345	590	670	6	5	80	0.0625000
NODE_4692_length_1125_cov_22.580897	279	359	4	80	80	1.0000000
NODE_4692_length_1125_cov_22.580897	332	412	0	42	80	0.5250000
NODE_4692_length_1125_cov_22.580897	332	412	4	38	80	0.4750000
NODE_4692_length_1125_cov_22.580897	408	488	0	60	80	0.7500000
NODE_4692_length_1125_cov_22.580897	408	488	2	20	80	0.2500000
NODE_4692_length_1125_cov_22.580897	461	541	0	7	80	0.0875000
NODE_4692_length_1125_cov_22.580897	461	541	2	47	80	0.5875000
NODE_4692_length_1125_cov_22.580897	461	541	4	26	80	0.3250000
NODE_4705_length_1124_cov_52.278049	616	696	0	80	80	1.0000000
NODE_4705_length_1124_cov_52.278049	669	749	0	80	80	1.0000000
NODE_4706_length_1124_cov_25.280000	444	524	0	80	80	1.0000000
NODE_4706_length_1124_cov_25.280000	497	577	0	80	80	1.0000000
NODE_4706_length_1124_cov_25.280000	573	653	0	80	80	1.0000000
NODE_4706_length_1124_cov_25.280000	626	706	0	80	80	1.0000000
NODE_4707_length_1124_cov_18.700488	114	194	0	80	80	1.0000000
NODE_4707_length_1124_cov_18.700488	167	247	0	80	80	1.0000000
NODE_4717_length_1123_cov_26.445312	388	468	0	80	80	1.0000000
NODE_4717_length_1123_cov_26.445312	441	521	0	80	80	1.0000000
NODE_4717_length_1123_cov_26.445312	517	597	0	80	80	1.0000000
NODE_4717_length_1123_cov_26.445312	570	650	0	80	80	1.0000000
NODE_4718_length_1123_cov_18.677734	522	602	0	80	80	1.0000000
NODE_4718_length_1123_cov_18.677734	575	655	0	80	80	1.0000000
NODE_4718_length_1123_cov_18.677734	651	731	0	40	80	0.5000000
NODE_4718_length_1123_cov_18.677734	651	731	2	40	80	0.5000000
NODE_4718_length_1123_cov_18.677734	704	784	2	65	80	0.8125000
NODE_4718_length_1123_cov_18.677734	704	784	4	15	80	0.1875000
NODE_4728_length_1122_cov_38.688172	295	375	0	80	80	1.0000000
NODE_4728_length_1122_cov_38.688172	348	428	0	80	80	1.0000000
NODE_4728_length_1122_cov_38.688172	424	504	0	12	80	0.1500000
NODE_4728_length_1122_cov_38.688172	424	504	2	68	80	0.8500000
NODE_4728_length_1122_cov_38.688172	477	557	2	33	80	0.4125000
NODE_4728_length_1122_cov_38.688172	477	557	4	3	80	0.0375000
NODE_4728_length_1122_cov_38.688172	477	557	5	16	80	0.2000000
NODE_4728_length_1122_cov_38.688172	477	557	7	1	80	0.0125000
NODE_4728_length_1122_cov_38.688172	477	557	8	27	80	0.3375000
NODE_4729_length_1122_cov_32.827957	232	312	0	80	80	1.0000000
NODE_4729_length_1122_cov_32.827957	285	365	0	75	80	0.9375000
NODE_4729_length_1122_cov_32.827957	285	365	5	2	80	0.0250000
NODE_4729_length_1122_cov_32.827957	285	365	6	3	80	0.0375000
NODE_4729_length_1122_cov_32.827957	361	441	5	1	80	0.0125000
NODE_4729_length_1122_cov_32.827957	361	441	6	79	80	0.9875000
NODE_4729_length_1122_cov_32.827957	414	494	0	38	80	0.4750000
NODE_4729_length_1122_cov_32.827957	414	494	5	1	80	0.0125000
NODE_4729_length_1122_cov_32.827957	414	494	6	41	80	0.5125000
NODE_4730_length_1122_cov_12.574780	396	476	0	12	80	0.1500000
NODE_4730_length_1122_cov_12.574780	396	476	2	68	80	0.8500000
NODE_4730_length_1122_cov_12.574780	449	529	0	32	80	0.4000000
NODE_4730_length_1122_cov_12.574780	449	529	2	48	80	0.6000000
NODE_4730_length_1122_cov_12.574780	525	605	0	80	80	1.0000000
NODE_4730_length_1122_cov_12.574780	578	658	0	80	80	1.0000000
NODE_4731_length_1122_cov_8.582600	586	666	0	25	80	0.3125000
NODE_4731_length_1122_cov_8.582600	586	666	2	55	80	0.6875000
NODE_4731_length_1122_cov_8.582600	639	719	0	8	80	0.1000000
NODE_4731_length_1122_cov_8.582600	639	719	2	72	80	0.9000000
NODE_4733_length_1122_cov_3.714565	284	364	0	80	80	1.0000000
NODE_4733_length_1122_cov_3.714565	337	417	0	80	80	1.0000000
NODE_4738_length_1122_cov_1.757576	25	87	0	62	62	1.0000000
NODE_4742_length_1121_cov_39.595890	507	587	0	20	80	0.2500000
NODE_4742_length_1121_cov_39.595890	507	587	4	60	80	0.7500000
NODE_4742_length_1121_cov_39.595890	560	640	0	73	80	0.9125000
NODE_4742_length_1121_cov_39.595890	560	640	4	7	80	0.0875000
NODE_4742_length_1121_cov_39.595890	636	716	0	80	80	1.0000000
NODE_4742_length_1121_cov_39.595890	689	769	0	80	80	1.0000000
NODE_4743_length_1121_cov_23.832681	525	605	0	23	80	0.2875000
NODE_4743_length_1121_cov_23.832681	525	605	2	57	80	0.7125000
NODE_4743_length_1121_cov_23.832681	578	658	2	80	80	1.0000000
NODE_4744_length_1121_cov_18.033268	1	42	0	41	41	1.0000000
NODE_4744_length_1121_cov_18.033268	671	751	0	80	80	1.0000000
NODE_4744_length_1121_cov_18.033268	724	804	0	62	80	0.7750000
NODE_4744_length_1121_cov_18.033268	724	804	2	18	80	0.2250000
NODE_4745_length_1121_cov_8.633072	610	690	0	80	80	1.0000000
NODE_4745_length_1121_cov_8.633072	663	743	0	80	80	1.0000000
NODE_4751_length_1120_cov_34.281097	377	457	0	16	80	0.2000000
NODE_4751_length_1120_cov_34.281097	377	457	2	27	80	0.3375000
NODE_4751_length_1120_cov_34.281097	377	457	4	2	80	0.0250000
NODE_4751_length_1120_cov_34.281097	377	457	8	10	80	0.1250000
NODE_4751_length_1120_cov_34.281097	377	457	10	11	80	0.1375000
NODE_4751_length_1120_cov_34.281097	377	457	14	14	80	0.1750000
NODE_4751_length_1120_cov_34.281097	430	510	8	2	80	0.0250000
NODE_4751_length_1120_cov_34.281097	430	510	10	11	80	0.1375000
NODE_4751_length_1120_cov_34.281097	430	510	12	25	80	0.3125000
NODE_4751_length_1120_cov_34.281097	430	510	14	42	80	0.5250000
NODE_4751_length_1120_cov_34.281097	506	586	0	12	80	0.1500000
NODE_4751_length_1120_cov_34.281097	506	586	2	38	80	0.4750000
NODE_4751_length_1120_cov_34.281097	506	586	4	8	80	0.1000000
NODE_4751_length_1120_cov_34.281097	506	586	10	5	80	0.0625000
NODE_4751_length_1120_cov_34.281097	506	586	12	17	80	0.2125000
NODE_4751_length_1120_cov_34.281097	559	639	0	17	80	0.2125000
NODE_4751_length_1120_cov_34.281097	559	639	2	63	80	0.7875000
NODE_4752_length_1120_cov_31.468168	401	481	0	35	80	0.4375000
NODE_4752_length_1120_cov_31.468168	401	481	2	45	80	0.5625000
NODE_4752_length_1120_cov_31.468168	454	534	0	80	80	1.0000000
NODE_4752_length_1120_cov_31.468168	530	610	0	21	80	0.2625000
NODE_4752_length_1120_cov_31.468168	530	610	2	47	80	0.5875000
NODE_4752_length_1120_cov_31.468168	530	610	6	12	80	0.1500000
NODE_4752_length_1120_cov_31.468168	583	663	2	15	80	0.1875000
NODE_4752_length_1120_cov_31.468168	583	663	6	65	80	0.8125000
NODE_4753_length_1120_cov_28.182174	418	498	0	26	80	0.3250000
NODE_4753_length_1120_cov_28.182174	418	498	1	52	80	0.6500000
NODE_4753_length_1120_cov_28.182174	418	498	3	2	80	0.0250000
NODE_4753_length_1120_cov_28.182174	471	551	0	75	80	0.9375000
NODE_4753_length_1120_cov_28.182174	471	551	1	1	80	0.0125000
NODE_4753_length_1120_cov_28.182174	471	551	2	4	80	0.0500000
NODE_4754_length_1120_cov_25.423115	405	485	0	80	80	1.0000000
NODE_4754_length_1120_cov_25.423115	458	538	0	80	80	1.0000000
NODE_4754_length_1120_cov_25.423115	534	614	0	36	80	0.4500000
NODE_4754_length_1120_cov_25.423115	534	614	2	44	80	0.5500000
NODE_4754_length_1120_cov_25.423115	587	667	0	27	80	0.3375000
NODE_4754_length_1120_cov_25.423115	587	667	2	53	80	0.6625000
NODE_4755_length_1120_cov_24.441724	589	662	0	17	73	0.2328767
NODE_4755_length_1120_cov_24.441724	589	662	4	10	73	0.1369863
NODE_4755_length_1120_cov_24.441724	589	662	12	46	73	0.6301370
NODE_4755_length_1120_cov_24.441724	636	716	6	3	80	0.0375000
NODE_4755_length_1120_cov_24.441724	636	716	12	42	80	0.5250000
NODE_4755_length_1120_cov_24.441724	636	716	14	35	80	0.4375000
NODE_4756_length_1120_cov_18.966699	406	486	0	80	80	1.0000000
NODE_4756_length_1120_cov_18.966699	459	539	0	80	80	1.0000000
NODE_4757_length_1120_cov_16.136141	508	588	0	80	80	1.0000000
NODE_4757_length_1120_cov_16.136141	561	641	0	80	80	1.0000000
NODE_4758_length_1120_cov_15.492654	460	540	0	80	80	1.0000000
NODE_4758_length_1120_cov_15.492654	460	540	0	80	80	1.0000000
NODE_4758_length_1120_cov_15.492654	513	593	0	80	80	1.0000000
NODE_4759_length_1120_cov_8.696376	646	726	0	80	80	1.0000000
NODE_4759_length_1120_cov_8.696376	699	779	0	80	80	1.0000000
NODE_4760_length_1120_cov_7.916748	304	384	0	80	80	1.0000000
NODE_4760_length_1120_cov_7.916748	357	437	0	42	80	0.5250000
NODE_4760_length_1120_cov_7.916748	357	437	2	38	80	0.4750000
NODE_4772_length_1119_cov_32.617647	425	505	0	42	80	0.5250000
NODE_4772_length_1119_cov_32.617647	425	505	1	1	80	0.0125000
NODE_4772_length_1119_cov_32.617647	425	505	4	37	80	0.4625000
NODE_4772_length_1119_cov_32.617647	478	558	0	24	80	0.3000000
NODE_4772_length_1119_cov_32.617647	478	558	4	56	80	0.7000000
NODE_4773_length_1119_cov_24.944118	455	535	8	25	80	0.3125000
NODE_4773_length_1119_cov_24.944118	455	535	10	55	80	0.6875000
NODE_4773_length_1119_cov_24.944118	508	588	0	28	80	0.3500000
NODE_4773_length_1119_cov_24.944118	508	588	8	50	80	0.6250000
NODE_4773_length_1119_cov_24.944118	508	588	10	2	80	0.0250000
NODE_4774_length_1119_cov_22.214706	614	694	2	16	80	0.2000000
NODE_4774_length_1119_cov_22.214706	614	694	4	64	80	0.8000000
NODE_4774_length_1119_cov_22.214706	667	747	0	40	80	0.5000000
NODE_4774_length_1119_cov_22.214706	667	747	2	5	80	0.0625000
NODE_4774_length_1119_cov_22.214706	667	747	4	35	80	0.4375000
NODE_4775_length_1119_cov_21.115686	431	511	0	80	80	1.0000000
NODE_4775_length_1119_cov_21.115686	484	564	0	80	80	1.0000000
NODE_4777_length_1119_cov_11.895098	565	645	0	80	80	1.0000000
NODE_4777_length_1119_cov_11.895098	618	698	0	80	80	1.0000000
NODE_4782_length_1119_cov_2.783333	37	99	0	28	62	0.4516129
NODE_4782_length_1119_cov_2.783333	37	99	3	34	62	0.5483871
NODE_4789_length_1118_cov_35.214917	555	635	0	80	80	1.0000000
NODE_4789_length_1118_cov_35.214917	608	688	0	80	80	1.0000000
NODE_4789_length_1118_cov_35.214917	684	764	0	5	80	0.0625000
NODE_4789_length_1118_cov_35.214917	684	764	5	1	80	0.0125000
NODE_4789_length_1118_cov_35.214917	684	764	16	17	80	0.2125000
NODE_4789_length_1118_cov_35.214917	684	764	17	57	80	0.7125000
NODE_4789_length_1118_cov_35.214917	737	817	4	10	80	0.1250000
NODE_4789_length_1118_cov_35.214917	737	817	8	1	80	0.0125000
NODE_4789_length_1118_cov_35.214917	737	817	9	9	80	0.1125000
NODE_4789_length_1118_cov_35.214917	737	817	16	12	80	0.1500000
NODE_4789_length_1118_cov_35.214917	737	817	17	30	80	0.3750000
NODE_4789_length_1118_cov_35.214917	737	817	19	18	80	0.2250000
NODE_4790_length_1118_cov_23.114818	602	682	0	12	80	0.1500000
NODE_4790_length_1118_cov_23.114818	602	682	2	42	80	0.5250000
NODE_4790_length_1118_cov_23.114818	602	682	6	26	80	0.3250000
NODE_4790_length_1118_cov_23.114818	655	735	2	1	80	0.0125000
NODE_4790_length_1118_cov_23.114818	655	735	6	31	80	0.3875000
NODE_4790_length_1118_cov_23.114818	655	735	8	38	80	0.4750000
NODE_4790_length_1118_cov_23.114818	655	735	10	10	80	0.1250000
NODE_4790_length_1118_cov_23.114818	731	811	8	8	80	0.1000000
NODE_4790_length_1118_cov_23.114818	731	811	12	5	80	0.0625000
NODE_4790_length_1118_cov_23.114818	731	811	14	61	80	0.7625000
NODE_4790_length_1118_cov_23.114818	731	811	16	6	80	0.0750000
NODE_4790_length_1118_cov_23.114818	784	864	4	22	80	0.2750000
NODE_4790_length_1118_cov_23.114818	784	864	10	5	80	0.0625000
NODE_4790_length_1118_cov_23.114818	784	864	12	9	80	0.1125000
NODE_4790_length_1118_cov_23.114818	784	864	14	38	80	0.4750000
NODE_4790_length_1118_cov_23.114818	784	864	16	6	80	0.0750000
NODE_4791_length_1118_cov_18.293425	388	463	0	75	75	1.0000000
NODE_4791_length_1118_cov_18.293425	436	516	0	80	80	1.0000000
NODE_4791_length_1118_cov_18.293425	512	592	0	80	80	1.0000000
NODE_4791_length_1118_cov_18.293425	565	645	0	47	80	0.5875000
NODE_4791_length_1118_cov_18.293425	565	645	2	33	80	0.4125000
NODE_4792_length_1118_cov_17.228656	480	560	0	9	80	0.1125000
NODE_4792_length_1118_cov_17.228656	480	560	5	1	80	0.0125000
NODE_4792_length_1118_cov_17.228656	480	560	6	70	80	0.8750000
NODE_4792_length_1118_cov_17.228656	533	613	0	32	80	0.4000000
NODE_4792_length_1118_cov_17.228656	533	613	6	48	80	0.6000000
NODE_4794_length_1118_cov_14.299313	468	548	2	80	80	1.0000000
NODE_4794_length_1118_cov_14.299313	521	601	1	3	80	0.0375000
NODE_4794_length_1118_cov_14.299313	521	601	2	77	80	0.9625000
NODE_4795_length_1118_cov_10.203140	306	386	0	80	80	1.0000000
NODE_4795_length_1118_cov_10.203140	359	439	0	80	80	1.0000000
NODE_4795_length_1118_cov_10.203140	435	515	0	80	80	1.0000000
NODE_4795_length_1118_cov_10.203140	488	568	0	80	80	1.0000000
NODE_4796_length_1118_cov_2.885182	471	551	0	80	80	1.0000000
NODE_4796_length_1118_cov_2.885182	524	604	0	80	80	1.0000000
NODE_4805_length_1117_cov_19.425344	541	621	0	15	80	0.1875000
NODE_4805_length_1117_cov_19.425344	541	621	4	65	80	0.8125000
NODE_4805_length_1117_cov_19.425344	594	674	0	43	80	0.5375000
NODE_4805_length_1117_cov_19.425344	594	674	4	37	80	0.4625000
NODE_4806_length_1117_cov_16.386051	385	465	0	80	80	1.0000000
NODE_4806_length_1117_cov_16.386051	438	518	0	80	80	1.0000000
NODE_4807_length_1117_cov_10.353635	294	374	0	73	80	0.9125000
NODE_4807_length_1117_cov_10.353635	294	374	2	7	80	0.0875000
NODE_4807_length_1117_cov_10.353635	347	427	0	20	80	0.2500000
NODE_4807_length_1117_cov_10.353635	347	427	2	60	80	0.7500000
NODE_4808_length_1117_cov_7.492141	417	497	0	80	80	1.0000000
NODE_4808_length_1117_cov_7.492141	470	550	0	80	80	1.0000000
NODE_4812_length_1117_cov_3.225933	666	728	0	24	62	0.3870968
NODE_4812_length_1117_cov_3.225933	666	728	2	3	62	0.0483871
NODE_4812_length_1117_cov_3.225933	666	728	4	35	62	0.5645161
NODE_4819_length_1116_cov_30.106195	457	537	0	21	80	0.2625000
NODE_4819_length_1116_cov_30.106195	457	537	2	59	80	0.7375000
NODE_4819_length_1116_cov_30.106195	510	590	2	80	80	1.0000000
NODE_4820_length_1116_cov_25.518191	831	911	0	80	80	1.0000000
NODE_4820_length_1116_cov_25.518191	884	964	0	80	80	1.0000000
NODE_4821_length_1116_cov_20.629302	500	580	0	25	80	0.3125000
NODE_4821_length_1116_cov_20.629302	500	580	2	19	80	0.2375000
NODE_4821_length_1116_cov_20.629302	500	580	4	36	80	0.4500000
NODE_4821_length_1116_cov_20.629302	553	633	0	78	80	0.9750000
NODE_4821_length_1116_cov_20.629302	553	633	2	2	80	0.0250000
NODE_4822_length_1116_cov_16.723697	345	425	0	53	80	0.6625000
NODE_4822_length_1116_cov_16.723697	345	425	2	27	80	0.3375000
NODE_4822_length_1116_cov_16.723697	398	478	0	24	80	0.3000000
NODE_4822_length_1116_cov_16.723697	398	478	2	56	80	0.7000000
NODE_4823_length_1116_cov_16.046214	735	815	6	32	80	0.4000000
NODE_4823_length_1116_cov_16.046214	735	815	8	19	80	0.2375000
NODE_4823_length_1116_cov_16.046214	735	815	10	18	80	0.2250000
NODE_4823_length_1116_cov_16.046214	735	815	12	11	80	0.1375000
NODE_4823_length_1116_cov_16.046214	788	868	0	1	80	0.0125000
NODE_4823_length_1116_cov_16.046214	788	868	6	68	80	0.8500000
NODE_4823_length_1116_cov_16.046214	788	868	10	11	80	0.1375000
NODE_4828_length_1116_cov_1.379548	800	880	0	80	80	1.0000000
NODE_4828_length_1116_cov_1.379548	853	933	0	80	80	1.0000000
NODE_4832_length_1115_cov_30.584646	549	629	0	66	80	0.8250000
NODE_4832_length_1115_cov_30.584646	549	629	2	14	80	0.1750000
NODE_4832_length_1115_cov_30.584646	602	682	0	21	80	0.2625000
NODE_4832_length_1115_cov_30.584646	602	682	2	59	80	0.7375000
NODE_4833_length_1115_cov_15.871063	454	534	4	54	80	0.6750000
NODE_4833_length_1115_cov_15.871063	454	534	10	26	80	0.3250000
NODE_4833_length_1115_cov_15.871063	507	587	0	16	80	0.2000000
NODE_4833_length_1115_cov_15.871063	507	587	4	1	80	0.0125000
NODE_4833_length_1115_cov_15.871063	507	587	6	23	80	0.2875000
NODE_4833_length_1115_cov_15.871063	507	587	10	40	80	0.5000000
NODE_4833_length_1115_cov_15.871063	583	663	0	25	80	0.3125000
NODE_4833_length_1115_cov_15.871063	583	663	2	55	80	0.6875000
NODE_4833_length_1115_cov_15.871063	636	716	0	2	80	0.0250000
NODE_4833_length_1115_cov_15.871063	636	716	2	78	80	0.9750000
NODE_4840_length_1114_cov_20.633498	1034	1114	0	75	80	0.9375000
NODE_4840_length_1114_cov_20.633498	1034	1114	2	5	80	0.0625000
NODE_4840_length_1114_cov_20.633498	1034	1114	0	75	80	0.9375000
NODE_4840_length_1114_cov_20.633498	1034	1114	2	5	80	0.0625000
NODE_4840_length_1114_cov_20.633498	1034	1114	0	75	80	0.9375000
NODE_4840_length_1114_cov_20.633498	1034	1114	2	5	80	0.0625000
NODE_4840_length_1114_cov_20.633498	1034	1114	0	75	80	0.9375000
NODE_4840_length_1114_cov_20.633498	1034	1114	2	5	80	0.0625000
NODE_4840_length_1114_cov_20.633498	1034	1114	0	75	80	0.9375000
NODE_4840_length_1114_cov_20.633498	1034	1114	2	5	80	0.0625000
NODE_4840_length_1114_cov_20.633498	1043	1114	0	71	71	1.0000000
NODE_4841_length_1114_cov_17.383251	516	601	0	4	85	0.0470588
NODE_4841_length_1114_cov_17.383251	516	601	4	81	85	0.9529412
NODE_4841_length_1114_cov_17.383251	574	653	0	11	79	0.1392405
NODE_4841_length_1114_cov_17.383251	574	653	3	25	79	0.3164557
NODE_4841_length_1114_cov_17.383251	574	653	4	43	79	0.5443038
NODE_4841_length_1114_cov_17.383251	649	729	0	80	80	1.0000000
NODE_4841_length_1114_cov_17.383251	702	782	0	80	80	1.0000000
NODE_4842_length_1114_cov_5.562562	563	643	0	80	80	1.0000000
NODE_4842_length_1114_cov_5.562562	616	696	0	80	80	1.0000000
NODE_4847_length_1113_cov_51.988166	343	423	2	54	80	0.6750000
NODE_4847_length_1113_cov_51.988166	343	423	4	26	80	0.3250000
NODE_4847_length_1113_cov_51.988166	396	476	0	13	80	0.1625000
NODE_4847_length_1113_cov_51.988166	396	476	2	56	80	0.7000000
NODE_4847_length_1113_cov_51.988166	396	476	4	11	80	0.1375000
NODE_4847_length_1113_cov_51.988166	472	552	0	42	80	0.5250000
NODE_4847_length_1113_cov_51.988166	472	552	4	38	80	0.4750000
NODE_4847_length_1113_cov_51.988166	525	605	0	21	80	0.2625000
NODE_4847_length_1113_cov_51.988166	525	605	4	59	80	0.7375000
NODE_4848_length_1113_cov_35.005917	359	439	0	78	80	0.9750000
NODE_4848_length_1113_cov_35.005917	359	439	2	2	80	0.0250000
NODE_4848_length_1113_cov_35.005917	412	492	0	80	80	1.0000000
NODE_4849_length_1113_cov_28.106509	570	650	0	80	80	1.0000000
NODE_4849_length_1113_cov_28.106509	623	703	0	80	80	1.0000000
NODE_4849_length_1113_cov_28.106509	699	779	0	28	80	0.3500000
NODE_4849_length_1113_cov_28.106509	699	779	2	52	80	0.6500000
NODE_4849_length_1113_cov_28.106509	752	832	0	5	80	0.0625000
NODE_4849_length_1113_cov_28.106509	752	832	2	75	80	0.9375000
NODE_4850_length_1113_cov_18.636095	512	592	0	13	80	0.1625000
NODE_4850_length_1113_cov_18.636095	512	592	2	42	80	0.5250000
NODE_4850_length_1113_cov_18.636095	512	592	4	9	80	0.1125000
NODE_4850_length_1113_cov_18.636095	512	592	5	12	80	0.1500000
NODE_4850_length_1113_cov_18.636095	512	592	6	4	80	0.0500000
NODE_4850_length_1113_cov_18.636095	565	645	2	2	80	0.0250000
NODE_4850_length_1113_cov_18.636095	565	645	4	9	80	0.1125000
NODE_4850_length_1113_cov_18.636095	565	645	5	12	80	0.1500000
NODE_4850_length_1113_cov_18.636095	565	645	6	57	80	0.7125000
NODE_4851_length_1113_cov_16.664694	352	432	0	78	80	0.9750000
NODE_4851_length_1113_cov_16.664694	352	432	1	2	80	0.0250000
NODE_4851_length_1113_cov_16.664694	405	485	0	47	80	0.5875000
NODE_4851_length_1113_cov_16.664694	405	485	2	33	80	0.4125000
NODE_4851_length_1113_cov_16.664694	481	561	2	80	80	1.0000000
NODE_4851_length_1113_cov_16.664694	534	614	0	34	80	0.4250000
NODE_4851_length_1113_cov_16.664694	534	614	2	46	80	0.5750000
NODE_4852_length_1113_cov_14.155819	454	512	0	58	58	1.0000000
NODE_4852_length_1113_cov_14.155819	511	575	0	64	64	1.0000000
NODE_4853_length_1113_cov_10.185404	494	574	0	35	80	0.4375000
NODE_4853_length_1113_cov_10.185404	494	574	4	45	80	0.5625000
NODE_4853_length_1113_cov_10.185404	547	627	0	35	80	0.4375000
NODE_4853_length_1113_cov_10.185404	547	627	2	1	80	0.0125000
NODE_4853_length_1113_cov_10.185404	547	627	4	44	80	0.5500000
NODE_4855_length_1113_cov_4.005917	700	780	0	59	80	0.7375000
NODE_4855_length_1113_cov_4.005917	700	780	2	21	80	0.2625000
NODE_4855_length_1113_cov_4.005917	753	833	0	80	80	1.0000000
NODE_4866_length_1112_cov_14.961500	427	507	0	40	80	0.5000000
NODE_4866_length_1112_cov_14.961500	427	507	2	40	80	0.5000000
NODE_4866_length_1112_cov_14.961500	480	560	0	80	80	1.0000000
NODE_4866_length_1112_cov_14.961500	556	636	0	80	80	1.0000000
NODE_4866_length_1112_cov_14.961500	609	689	0	80	80	1.0000000
NODE_4875_length_1112_cov_1.655479	45	123	0	78	78	1.0000000
NODE_4875_length_1112_cov_1.655479	98	166	0	67	68	0.9852941
NODE_4875_length_1112_cov_1.655479	98	166	2	1	68	0.0147059
NODE_4880_length_1111_cov_37.999012	473	553	0	80	80	1.0000000
NODE_4880_length_1111_cov_37.999012	526	606	0	80	80	1.0000000
NODE_4880_length_1111_cov_37.999012	602	682	0	80	80	1.0000000
NODE_4880_length_1111_cov_37.999012	655	735	0	80	80	1.0000000
NODE_4881_length_1111_cov_24.394269	644	724	0	80	80	1.0000000
NODE_4881_length_1111_cov_24.394269	697	777	0	80	80	1.0000000
NODE_4882_length_1111_cov_23.676877	374	454	4	80	80	1.0000000
NODE_4882_length_1111_cov_23.676877	427	507	0	17	80	0.2125000
NODE_4882_length_1111_cov_23.676877	427	507	4	63	80	0.7875000
NODE_4883_length_1111_cov_17.522727	383	463	0	44	80	0.5500000
NODE_4883_length_1111_cov_17.522727	383	463	1	7	80	0.0875000
NODE_4883_length_1111_cov_17.522727	383	463	2	29	80	0.3625000
NODE_4883_length_1111_cov_17.522727	436	516	0	27	80	0.3375000
NODE_4883_length_1111_cov_17.522727	436	516	2	53	80	0.6625000
NODE_4884_length_1111_cov_16.495059	388	468	0	80	80	1.0000000
NODE_4884_length_1111_cov_16.495059	441	521	0	80	80	1.0000000
NODE_4885_length_1111_cov_15.366601	555	635	0	80	80	1.0000000
NODE_4885_length_1111_cov_15.366601	608	688	0	80	80	1.0000000
NODE_4886_length_1111_cov_15.314229	809	889	0	80	80	1.0000000
NODE_4886_length_1111_cov_15.314229	862	942	0	80	80	1.0000000
NODE_4887_length_1111_cov_9.732213	443	523	0	23	80	0.2875000
NODE_4887_length_1111_cov_9.732213	443	523	4	43	80	0.5375000
NODE_4887_length_1111_cov_9.732213	443	523	6	9	80	0.1125000
NODE_4887_length_1111_cov_9.732213	443	523	8	5	80	0.0625000
NODE_4887_length_1111_cov_9.732213	496	576	0	76	80	0.9500000
NODE_4887_length_1111_cov_9.732213	496	576	4	4	80	0.0500000
NODE_4888_length_1111_cov_4.907115	606	686	0	80	80	1.0000000
NODE_4888_length_1111_cov_4.907115	659	739	0	80	80	1.0000000
NODE_4892_length_1110_cov_23.012859	453	533	0	59	80	0.7375000
NODE_4892_length_1110_cov_23.012859	453	533	1	21	80	0.2625000
NODE_4892_length_1110_cov_23.012859	506	586	0	6	80	0.0750000
NODE_4892_length_1110_cov_23.012859	506	586	1	30	80	0.3750000
NODE_4892_length_1110_cov_23.012859	506	586	2	44	80	0.5500000
NODE_4892_length_1110_cov_23.012859	582	662	0	47	80	0.5875000
NODE_4892_length_1110_cov_23.012859	582	662	1	2	80	0.0250000
NODE_4892_length_1110_cov_23.012859	582	662	2	31	80	0.3875000
NODE_4892_length_1110_cov_23.012859	635	715	0	80	80	1.0000000
NODE_4895_length_1110_cov_5.305638	754	834	0	80	80	1.0000000
NODE_4895_length_1110_cov_5.305638	807	887	0	80	80	1.0000000
NODE_4896_length_1110_cov_3.698318	642	685	19	42	43	0.9767442
NODE_4896_length_1110_cov_3.698318	642	685	20	1	43	0.0232558
NODE_4899_length_1110_cov_1.871414	15	86	0	61	71	0.8591549
NODE_4899_length_1110_cov_1.871414	15	86	13	3	71	0.0422535
NODE_4899_length_1110_cov_1.871414	15	86	16	5	71	0.0704225
NODE_4899_length_1110_cov_1.871414	15	86	18	2	71	0.0281690
NODE_4903_length_1109_cov_35.307921	413	493	0	45	80	0.5625000
NODE_4903_length_1109_cov_35.307921	413	493	3	1	80	0.0125000
NODE_4903_length_1109_cov_35.307921	413	493	4	34	80	0.4250000
NODE_4903_length_1109_cov_35.307921	466	546	4	80	80	1.0000000
NODE_4903_length_1109_cov_35.307921	542	622	0	61	80	0.7625000
NODE_4903_length_1109_cov_35.307921	542	622	4	19	80	0.2375000
NODE_4903_length_1109_cov_35.307921	595	675	0	80	80	1.0000000
NODE_4904_length_1109_cov_27.880198	501	581	0	80	80	1.0000000
NODE_4904_length_1109_cov_27.880198	554	634	0	80	80	1.0000000
NODE_4904_length_1109_cov_27.880198	630	710	0	80	80	1.0000000
NODE_4904_length_1109_cov_27.880198	683	763	0	80	80	1.0000000
NODE_4905_length_1109_cov_21.858416	571	651	0	64	80	0.8000000
NODE_4905_length_1109_cov_21.858416	571	651	2	13	80	0.1625000
NODE_4905_length_1109_cov_21.858416	571	651	6	3	80	0.0375000
NODE_4905_length_1109_cov_21.858416	624	704	0	11	80	0.1375000
NODE_4905_length_1109_cov_21.858416	624	704	2	13	80	0.1625000
NODE_4905_length_1109_cov_21.858416	624	704	6	56	80	0.7000000
NODE_4912_length_1108_cov_59.921705	386	466	0	71	80	0.8875000
NODE_4912_length_1108_cov_59.921705	386	466	6	9	80	0.1125000
NODE_4912_length_1108_cov_59.921705	439	519	0	18	80	0.2250000
NODE_4912_length_1108_cov_59.921705	439	519	6	62	80	0.7750000
NODE_4912_length_1108_cov_59.921705	515	595	0	20	80	0.2500000
NODE_4912_length_1108_cov_59.921705	515	595	6	60	80	0.7500000
NODE_4912_length_1108_cov_59.921705	568	648	0	73	80	0.9125000
NODE_4912_length_1108_cov_59.921705	568	648	6	7	80	0.0875000
NODE_4914_length_1108_cov_16.069376	513	593	2	80	80	1.0000000
NODE_4914_length_1108_cov_16.069376	566	646	0	52	80	0.6500000
NODE_4914_length_1108_cov_16.069376	566	646	2	28	80	0.3500000
NODE_4916_length_1108_cov_11.656095	333	413	0	11	80	0.1375000
NODE_4916_length_1108_cov_11.656095	333	413	2	22	80	0.2750000
NODE_4916_length_1108_cov_11.656095	333	413	4	47	80	0.5875000
NODE_4916_length_1108_cov_11.656095	386	466	2	14	80	0.1750000
NODE_4916_length_1108_cov_11.656095	386	466	4	66	80	0.8250000
NODE_4917_length_1108_cov_10.266601	431	511	0	47	80	0.5875000
NODE_4917_length_1108_cov_10.266601	431	511	2	18	80	0.2250000
NODE_4917_length_1108_cov_10.266601	431	511	4	15	80	0.1875000
NODE_4917_length_1108_cov_10.266601	484	564	0	6	80	0.0750000
NODE_4917_length_1108_cov_10.266601	484	564	2	17	80	0.2125000
NODE_4917_length_1108_cov_10.266601	484	564	4	57	80	0.7125000
NODE_4918_length_1108_cov_8.895937	635	715	0	72	80	0.9000000
NODE_4918_length_1108_cov_8.895937	635	715	2	2	80	0.0250000
NODE_4918_length_1108_cov_8.895937	635	715	4	6	80	0.0750000
NODE_4918_length_1108_cov_8.895937	688	768	0	80	80	1.0000000
NODE_4920_length_1108_cov_5.682854	577	657	0	8	80	0.1000000
NODE_4920_length_1108_cov_5.682854	577	657	4	72	80	0.9000000
NODE_4920_length_1108_cov_5.682854	630	710	0	7	80	0.0875000
NODE_4920_length_1108_cov_5.682854	630	710	4	73	80	0.9125000
NODE_4927_length_1107_cov_35.050595	423	503	0	80	80	1.0000000
NODE_4927_length_1107_cov_35.050595	476	556	0	80	80	1.0000000
NODE_4927_length_1107_cov_35.050595	552	632	0	21	80	0.2625000
NODE_4927_length_1107_cov_35.050595	552	632	6	59	80	0.7375000
NODE_4927_length_1107_cov_35.050595	605	685	0	16	80	0.2000000
NODE_4927_length_1107_cov_35.050595	605	685	6	64	80	0.8000000
NODE_4928_length_1107_cov_31.386905	422	502	0	80	80	1.0000000
NODE_4928_length_1107_cov_31.386905	475	555	0	56	80	0.7000000
NODE_4928_length_1107_cov_31.386905	475	555	2	24	80	0.3000000
NODE_4929_length_1107_cov_29.178571	577	657	0	3	80	0.0375000
NODE_4929_length_1107_cov_29.178571	577	657	7	1	80	0.0125000
NODE_4929_length_1107_cov_29.178571	577	657	8	76	80	0.9500000
NODE_4929_length_1107_cov_29.178571	630	710	0	15	80	0.1875000
NODE_4929_length_1107_cov_29.178571	630	710	7	19	80	0.2375000
NODE_4929_length_1107_cov_29.178571	630	710	8	46	80	0.5750000
NODE_4929_length_1107_cov_29.178571	934	1000	6	7	66	0.1060606
NODE_4929_length_1107_cov_29.178571	934	1000	8	36	66	0.5454546
NODE_4929_length_1107_cov_29.178571	934	1000	10	23	66	0.3484848
NODE_4929_length_1107_cov_29.178571	934	1005	6	7	71	0.0985916
NODE_4929_length_1107_cov_29.178571	934	1005	8	36	71	0.5070422
NODE_4929_length_1107_cov_29.178571	934	1005	10	28	71	0.3943662
NODE_4930_length_1107_cov_16.038690	574	654	0	42	80	0.5250000
NODE_4930_length_1107_cov_16.038690	574	654	2	38	80	0.4750000
NODE_4930_length_1107_cov_16.038690	627	707	0	2	80	0.0250000
NODE_4930_length_1107_cov_16.038690	627	707	2	78	80	0.9750000
NODE_4931_length_1107_cov_15.472222	78	158	87	1	80	0.0125000
NODE_4931_length_1107_cov_15.472222	78	158	90	1	80	0.0125000
NODE_4931_length_1107_cov_15.472222	78	158	92	1	80	0.0125000
NODE_4931_length_1107_cov_15.472222	78	158	94	1	80	0.0125000
NODE_4931_length_1107_cov_15.472222	78	158	100	1	80	0.0125000
NODE_4931_length_1107_cov_15.472222	78	158	108	1	80	0.0125000
NODE_4931_length_1107_cov_15.472222	78	158	110	3	80	0.0375000
NODE_4931_length_1107_cov_15.472222	78	158	116	1	80	0.0125000
NODE_4931_length_1107_cov_15.472222	78	158	118	3	80	0.0375000
NODE_4931_length_1107_cov_15.472222	78	158	120	1	80	0.0125000
NODE_4931_length_1107_cov_15.472222	78	158	134	1	80	0.0125000
NODE_4931_length_1107_cov_15.472222	78	158	136	3	80	0.0375000
NODE_4931_length_1107_cov_15.472222	78	158	138	3	80	0.0375000
NODE_4931_length_1107_cov_15.472222	78	158	140	4	80	0.0500000
NODE_4931_length_1107_cov_15.472222	78	158	144	2	80	0.0250000
NODE_4931_length_1107_cov_15.472222	78	158	146	2	80	0.0250000
NODE_4931_length_1107_cov_15.472222	78	158	150	2	80	0.0250000
NODE_4931_length_1107_cov_15.472222	78	158	152	1	80	0.0125000
NODE_4931_length_1107_cov_15.472222	78	158	153	1	80	0.0125000
NODE_4931_length_1107_cov_15.472222	78	158	155	1	80	0.0125000
NODE_4931_length_1107_cov_15.472222	78	158	156	1	80	0.0125000
NODE_4931_length_1107_cov_15.472222	78	158	158	6	80	0.0750000
NODE_4931_length_1107_cov_15.472222	78	158	160	3	80	0.0375000
NODE_4931_length_1107_cov_15.472222	78	158	162	3	80	0.0375000
NODE_4931_length_1107_cov_15.472222	78	158	166	2	80	0.0250000
NODE_4931_length_1107_cov_15.472222	78	158	168	2	80	0.0250000
NODE_4931_length_1107_cov_15.472222	78	158	171	1	80	0.0125000
NODE_4931_length_1107_cov_15.472222	78	158	172	1	80	0.0125000
NODE_4931_length_1107_cov_15.472222	78	158	173	1	80	0.0125000
NODE_4931_length_1107_cov_15.472222	78	158	174	9	80	0.1125000
NODE_4931_length_1107_cov_15.472222	78	158	176	17	80	0.2125000
NODE_4931_length_1107_cov_15.472222	131	194	16	1	63	0.0158730
NODE_4931_length_1107_cov_15.472222	131	194	17	3	63	0.0476190
NODE_4931_length_1107_cov_15.472222	131	194	18	1	63	0.0158730
NODE_4931_length_1107_cov_15.472222	131	194	21	4	63	0.0634921
NODE_4931_length_1107_cov_15.472222	131	194	27	2	63	0.0317460
NODE_4931_length_1107_cov_15.472222	131	194	31	1	63	0.0158730
NODE_4931_length_1107_cov_15.472222	131	194	39	1	63	0.0158730
NODE_4931_length_1107_cov_15.472222	131	194	41	1	63	0.0158730
NODE_4931_length_1107_cov_15.472222	131	194	45	5	63	0.0793651
NODE_4931_length_1107_cov_15.472222	131	194	47	2	63	0.0317460
NODE_4931_length_1107_cov_15.472222	131	194	54	1	63	0.0158730
NODE_4931_length_1107_cov_15.472222	131	194	65	1	63	0.0158730
NODE_4931_length_1107_cov_15.472222	131	194	70	5	63	0.0793651
NODE_4931_length_1107_cov_15.472222	131	194	74	1	63	0.0158730
NODE_4931_length_1107_cov_15.472222	131	194	76	2	63	0.0317460
NODE_4931_length_1107_cov_15.472222	131	194	82	4	63	0.0634921
NODE_4931_length_1107_cov_15.472222	131	194	84	1	63	0.0158730
NODE_4931_length_1107_cov_15.472222	131	194	87	1	63	0.0158730
NODE_4931_length_1107_cov_15.472222	131	194	90	1	63	0.0158730
NODE_4931_length_1107_cov_15.472222	131	194	92	1	63	0.0158730
NODE_4931_length_1107_cov_15.472222	131	194	94	1	63	0.0158730
NODE_4931_length_1107_cov_15.472222	131	194	100	1	63	0.0158730
NODE_4931_length_1107_cov_15.472222	131	194	108	1	63	0.0158730
NODE_4931_length_1107_cov_15.472222	131	194	110	3	63	0.0476190
NODE_4931_length_1107_cov_15.472222	131	194	116	1	63	0.0158730
NODE_4931_length_1107_cov_15.472222	131	194	118	3	63	0.0476190
NODE_4931_length_1107_cov_15.472222	131	194	120	1	63	0.0158730
NODE_4931_length_1107_cov_15.472222	131	194	134	1	63	0.0158730
NODE_4931_length_1107_cov_15.472222	131	194	136	3	63	0.0476190
NODE_4931_length_1107_cov_15.472222	131	194	138	3	63	0.0476190
NODE_4931_length_1107_cov_15.472222	131	194	140	4	63	0.0634921
NODE_4931_length_1107_cov_15.472222	131	194	144	2	63	0.0317460
NODE_4931_length_1107_cov_15.472222	952	995	2	9	43	0.2093023
NODE_4931_length_1107_cov_15.472222	952	995	3	4	43	0.0930233
NODE_4931_length_1107_cov_15.472222	952	995	4	3	43	0.0697674
NODE_4931_length_1107_cov_15.472222	952	995	7	4	43	0.0930233
NODE_4931_length_1107_cov_15.472222	952	995	8	7	43	0.1627907
NODE_4931_length_1107_cov_15.472222	952	995	10	12	43	0.2790698
NODE_4931_length_1107_cov_15.472222	952	995	12	2	43	0.0465116
NODE_4931_length_1107_cov_15.472222	952	995	14	2	43	0.0465116
NODE_4931_length_1107_cov_15.472222	968	1052	7	4	84	0.0476190
NODE_4931_length_1107_cov_15.472222	968	1052	8	7	84	0.0833333
NODE_4931_length_1107_cov_15.472222	968	1052	10	12	84	0.1428571
NODE_4931_length_1107_cov_15.472222	968	1052	12	2	84	0.0238095
NODE_4931_length_1107_cov_15.472222	968	1052	14	59	84	0.7023810
NODE_4932_length_1107_cov_13.911706	502	582	2	80	80	1.0000000
NODE_4932_length_1107_cov_13.911706	555	635	0	46	80	0.5750000
NODE_4932_length_1107_cov_13.911706	555	635	2	34	80	0.4250000
NODE_4933_length_1107_cov_11.701389	520	600	0	14	80	0.1750000
NODE_4933_length_1107_cov_11.701389	520	600	4	66	80	0.8250000
NODE_4933_length_1107_cov_11.701389	573	653	0	13	80	0.1625000
NODE_4933_length_1107_cov_11.701389	573	653	4	67	80	0.8375000
NODE_4944_length_1106_cov_59.617676	452	532	0	80	80	1.0000000
NODE_4944_length_1106_cov_59.617676	505	585	0	57	80	0.7125000
NODE_4944_length_1106_cov_59.617676	505	585	2	22	80	0.2750000
NODE_4944_length_1106_cov_59.617676	505	585	4	1	80	0.0125000
NODE_4944_length_1106_cov_59.617676	581	661	2	23	80	0.2875000
NODE_4944_length_1106_cov_59.617676	581	661	4	57	80	0.7125000
NODE_4944_length_1106_cov_59.617676	634	714	0	27	80	0.3375000
NODE_4944_length_1106_cov_59.617676	634	714	2	46	80	0.5750000
NODE_4944_length_1106_cov_59.617676	634	714	4	7	80	0.0875000
NODE_4945_length_1106_cov_40.808342	439	504	0	65	65	1.0000000
NODE_4945_length_1106_cov_40.808342	471	511	0	40	40	1.0000000
NODE_4945_length_1106_cov_40.808342	503	569	0	66	66	1.0000000
NODE_4945_length_1106_cov_40.808342	536	601	0	65	65	1.0000000
NODE_4945_length_1106_cov_40.808342	568	648	0	46	80	0.5750000
NODE_4945_length_1106_cov_40.808342	568	648	2	34	80	0.4250000
NODE_4945_length_1106_cov_40.808342	621	682	2	61	61	1.0000000
NODE_4946_length_1106_cov_23.186693	560	640	0	80	80	1.0000000
NODE_4946_length_1106_cov_23.186693	613	693	0	51	80	0.6375000
NODE_4946_length_1106_cov_23.186693	613	693	1	13	80	0.1625000
NODE_4946_length_1106_cov_23.186693	613	693	2	16	80	0.2000000
NODE_4947_length_1106_cov_14.570010	466	546	0	26	80	0.3250000
NODE_4947_length_1106_cov_14.570010	466	546	2	54	80	0.6750000
NODE_4947_length_1106_cov_14.570010	519	599	0	79	80	0.9875000
NODE_4947_length_1106_cov_14.570010	519	599	2	1	80	0.0125000
NODE_4948_length_1106_cov_14.039722	487	567	0	20	80	0.2500000
NODE_4948_length_1106_cov_14.039722	487	567	2	60	80	0.7500000
NODE_4948_length_1106_cov_14.039722	540	620	0	16	80	0.2000000
NODE_4948_length_1106_cov_14.039722	540	620	2	64	80	0.8000000
NODE_4949_length_1106_cov_8.872890	328	408	0	30	80	0.3750000
NODE_4949_length_1106_cov_8.872890	328	408	1	4	80	0.0500000
NODE_4949_length_1106_cov_8.872890	328	408	2	6	80	0.0750000
NODE_4949_length_1106_cov_8.872890	328	408	4	40	80	0.5000000
NODE_4949_length_1106_cov_8.872890	381	461	0	11	80	0.1375000
NODE_4949_length_1106_cov_8.872890	381	461	2	24	80	0.3000000
NODE_4949_length_1106_cov_8.872890	381	461	4	45	80	0.5625000
NODE_4950_length_1106_cov_7.157895	332	412	0	19	80	0.2375000
NODE_4950_length_1106_cov_7.157895	332	412	2	61	80	0.7625000
NODE_4950_length_1106_cov_7.157895	385	465	0	48	80	0.6000000
NODE_4950_length_1106_cov_7.157895	385	465	2	32	80	0.4000000
NODE_4951_length_1106_cov_6.530288	513	593	6	19	80	0.2375000
NODE_4951_length_1106_cov_6.530288	513	593	8	14	80	0.1750000
NODE_4951_length_1106_cov_6.530288	513	593	10	47	80	0.5875000
NODE_4951_length_1106_cov_6.530288	566	646	0	30	80	0.3750000
NODE_4951_length_1106_cov_6.530288	566	646	4	18	80	0.2250000
NODE_4951_length_1106_cov_6.530288	566	646	8	19	80	0.2375000
NODE_4951_length_1106_cov_6.530288	566	646	10	13	80	0.1625000
NODE_4959_length_1105_cov_28.126243	253	333	0	62	80	0.7750000
NODE_4959_length_1105_cov_28.126243	253	333	2	18	80	0.2250000
NODE_4959_length_1105_cov_28.126243	306	386	0	9	80	0.1125000
NODE_4959_length_1105_cov_28.126243	306	386	2	71	80	0.8875000
NODE_4960_length_1105_cov_24.994036	549	629	2	80	80	1.0000000
NODE_4960_length_1105_cov_24.994036	602	682	0	51	80	0.6375000
NODE_4960_length_1105_cov_24.994036	602	682	2	29	80	0.3625000
NODE_4961_length_1105_cov_17.635189	442	522	0	7	80	0.0875000
NODE_4961_length_1105_cov_17.635189	442	522	2	12	80	0.1500000
NODE_4961_length_1105_cov_17.635189	442	522	4	10	80	0.1250000
NODE_4961_length_1105_cov_17.635189	442	522	5	1	80	0.0125000
NODE_4961_length_1105_cov_17.635189	442	522	6	50	80	0.6250000
NODE_4961_length_1105_cov_17.635189	495	575	0	60	80	0.7500000
NODE_4961_length_1105_cov_17.635189	495	575	4	10	80	0.1250000
NODE_4961_length_1105_cov_17.635189	495	575	5	1	80	0.0125000
NODE_4961_length_1105_cov_17.635189	495	575	6	9	80	0.1125000
NODE_4963_length_1105_cov_10.114314	438	518	0	20	80	0.2500000
NODE_4963_length_1105_cov_10.114314	438	518	2	60	80	0.7500000
NODE_4963_length_1105_cov_10.114314	491	571	0	73	80	0.9125000
NODE_4963_length_1105_cov_10.114314	491	571	2	7	80	0.0875000
NODE_4964_length_1105_cov_8.403579	507	587	0	80	80	1.0000000
NODE_4964_length_1105_cov_8.403579	560	640	0	80	80	1.0000000
NODE_4966_length_1105_cov_6.682903	467	547	2	15	80	0.1875000
NODE_4966_length_1105_cov_6.682903	467	547	4	65	80	0.8125000
NODE_4966_length_1105_cov_6.682903	520	600	0	24	80	0.3000000
NODE_4966_length_1105_cov_6.682903	520	600	2	36	80	0.4500000
NODE_4966_length_1105_cov_6.682903	520	600	4	20	80	0.2500000
NODE_4966_length_1105_cov_6.682903	596	676	0	28	80	0.3500000
NODE_4966_length_1105_cov_6.682903	596	676	4	37	80	0.4625000
NODE_4966_length_1105_cov_6.682903	596	676	6	15	80	0.1875000
NODE_4966_length_1105_cov_6.682903	649	729	4	12	80	0.1500000
NODE_4966_length_1105_cov_6.682903	649	729	6	68	80	0.8500000
NODE_4974_length_1104_cov_27.599005	388	468	0	80	80	1.0000000
NODE_4974_length_1104_cov_27.599005	441	521	0	33	80	0.4125000
NODE_4974_length_1104_cov_27.599005	441	521	2	47	80	0.5875000
NODE_4984_length_1103_cov_2.787849	620	682	0	48	62	0.7741935
NODE_4984_length_1103_cov_2.787849	620	682	1	7	62	0.1129032
NODE_4984_length_1103_cov_2.787849	620	682	2	7	62	0.1129032
NODE_4986_length_1102_cov_34.484546	667	747	11	9	80	0.1125000
NODE_4986_length_1102_cov_34.484546	667	747	20	20	80	0.2500000
NODE_4986_length_1102_cov_34.484546	667	747	22	16	80	0.2000000
NODE_4986_length_1102_cov_34.484546	667	747	23	35	80	0.4375000
NODE_4986_length_1102_cov_34.484546	720	800	0	22	80	0.2750000
NODE_4986_length_1102_cov_34.484546	720	800	12	16	80	0.2000000
NODE_4986_length_1102_cov_34.484546	720	800	20	35	80	0.4375000
NODE_4986_length_1102_cov_34.484546	720	800	22	1	80	0.0125000
NODE_4986_length_1102_cov_34.484546	720	800	23	6	80	0.0750000
NODE_4987_length_1102_cov_17.631107	511	587	0	30	76	0.3947369
NODE_4987_length_1102_cov_17.631107	511	587	4	46	76	0.6052632
NODE_4987_length_1102_cov_17.631107	560	640	0	37	80	0.4625000
NODE_4987_length_1102_cov_17.631107	560	640	4	43	80	0.5375000
NODE_4998_length_1101_cov_35.638723	414	491	0	3	77	0.0389610
NODE_4998_length_1101_cov_35.638723	414	491	2	7	77	0.0909091
NODE_4998_length_1101_cov_35.638723	414	491	12	21	77	0.2727273
NODE_4998_length_1101_cov_35.638723	414	491	14	2	77	0.0259740
NODE_4998_length_1101_cov_35.638723	414	491	15	8	77	0.1038961
NODE_4998_length_1101_cov_35.638723	414	491	16	36	77	0.4675325
NODE_4998_length_1101_cov_35.638723	414	491	0	3	77	0.0389610
NODE_4998_length_1101_cov_35.638723	414	491	2	7	77	0.0909091
NODE_4998_length_1101_cov_35.638723	414	491	12	21	77	0.2727273
NODE_4998_length_1101_cov_35.638723	414	491	14	2	77	0.0259740
NODE_4998_length_1101_cov_35.638723	414	491	15	8	77	0.1038961
NODE_4998_length_1101_cov_35.638723	414	491	16	36	77	0.4675325
NODE_4998_length_1101_cov_35.638723	488	544	0	4	56	0.0714286
NODE_4998_length_1101_cov_35.638723	488	544	2	2	56	0.0357143
NODE_4998_length_1101_cov_35.638723	488	544	4	50	56	0.8928571
NODE_4998_length_1101_cov_35.638723	752	832	4	80	80	1.0000000
NODE_4998_length_1101_cov_35.638723	805	885	1	3	80	0.0375000
NODE_4998_length_1101_cov_35.638723	805	885	2	2	80	0.0250000
NODE_4998_length_1101_cov_35.638723	805	885	4	50	80	0.6250000
NODE_4998_length_1101_cov_35.638723	805	885	5	25	80	0.3125000
NODE_4998_length_1101_cov_35.638723	881	961	4	29	80	0.3625000
NODE_4998_length_1101_cov_35.638723	881	961	5	1	80	0.0125000
NODE_4998_length_1101_cov_35.638723	881	961	6	14	80	0.1750000
NODE_4998_length_1101_cov_35.638723	881	961	8	19	80	0.2375000
NODE_4998_length_1101_cov_35.638723	881	961	9	1	80	0.0125000
NODE_4998_length_1101_cov_35.638723	881	961	10	1	80	0.0125000
NODE_4998_length_1101_cov_35.638723	881	961	12	8	80	0.1000000
NODE_4998_length_1101_cov_35.638723	881	961	14	7	80	0.0875000
NODE_4998_length_1101_cov_35.638723	934	1014	8	10	80	0.1250000
NODE_4998_length_1101_cov_35.638723	934	1014	9	1	80	0.0125000
NODE_4998_length_1101_cov_35.638723	934	1014	10	1	80	0.0125000
NODE_4998_length_1101_cov_35.638723	934	1014	12	18	80	0.2250000
NODE_4998_length_1101_cov_35.638723	934	1014	14	15	80	0.1875000
NODE_4998_length_1101_cov_35.638723	934	1014	16	15	80	0.1875000
NODE_4998_length_1101_cov_35.638723	934	1014	18	17	80	0.2125000
NODE_4998_length_1101_cov_35.638723	934	1014	19	3	80	0.0375000
NODE_4999_length_1101_cov_28.366267	452	532	0	8	80	0.1000000
NODE_4999_length_1101_cov_28.366267	452	532	2	11	80	0.1375000
NODE_4999_length_1101_cov_28.366267	452	532	6	61	80	0.7625000
NODE_4999_length_1101_cov_28.366267	505	585	2	4	80	0.0500000
NODE_4999_length_1101_cov_28.366267	505	585	4	22	80	0.2750000
NODE_4999_length_1101_cov_28.366267	505	585	6	54	80	0.6750000
NODE_5000_length_1101_cov_24.513972	475	555	0	80	80	1.0000000
NODE_5000_length_1101_cov_24.513972	528	608	0	42	80	0.5250000
NODE_5000_length_1101_cov_24.513972	528	608	2	38	80	0.4750000
NODE_5001_length_1101_cov_22.315369	335	415	0	9	80	0.1125000
NODE_5001_length_1101_cov_22.315369	335	415	2	45	80	0.5625000
NODE_5001_length_1101_cov_22.315369	335	415	6	26	80	0.3250000
NODE_5001_length_1101_cov_22.315369	388	468	2	1	80	0.0125000
NODE_5001_length_1101_cov_22.315369	388	468	4	29	80	0.3625000
NODE_5001_length_1101_cov_22.315369	388	468	5	14	80	0.1750000
NODE_5001_length_1101_cov_22.315369	388	468	6	36	80	0.4500000
NODE_5001_length_1101_cov_22.315369	464	544	2	7	80	0.0875000
NODE_5001_length_1101_cov_22.315369	464	544	6	68	80	0.8500000
NODE_5001_length_1101_cov_22.315369	464	544	10	5	80	0.0625000
NODE_5001_length_1101_cov_22.315369	517	597	6	22	80	0.2750000
NODE_5001_length_1101_cov_22.315369	517	597	10	58	80	0.7250000
NODE_5002_length_1101_cov_22.070858	419	499	0	21	80	0.2625000
NODE_5002_length_1101_cov_22.070858	419	499	4	12	80	0.1500000
NODE_5002_length_1101_cov_22.070858	419	499	6	47	80	0.5875000
NODE_5002_length_1101_cov_22.070858	472	552	4	4	80	0.0500000
NODE_5002_length_1101_cov_22.070858	472	552	6	76	80	0.9500000
NODE_5002_length_1101_cov_22.070858	548	628	0	53	80	0.6625000
NODE_5002_length_1101_cov_22.070858	548	628	3	13	80	0.1625000
NODE_5002_length_1101_cov_22.070858	548	628	4	14	80	0.1750000
NODE_5002_length_1101_cov_22.070858	601	681	0	80	80	1.0000000
NODE_5003_length_1101_cov_18.821357	469	549	2	80	80	1.0000000
NODE_5003_length_1101_cov_18.821357	522	602	0	40	80	0.5000000
NODE_5003_length_1101_cov_18.821357	522	602	1	2	80	0.0250000
NODE_5003_length_1101_cov_18.821357	522	602	2	38	80	0.4750000
NODE_5004_length_1101_cov_17.151697	502	582	2	14	80	0.1750000
NODE_5004_length_1101_cov_17.151697	502	582	6	14	80	0.1750000
NODE_5004_length_1101_cov_17.151697	502	582	8	8	80	0.1000000
NODE_5004_length_1101_cov_17.151697	502	582	10	44	80	0.5500000
NODE_5004_length_1101_cov_17.151697	555	635	0	18	80	0.2250000
NODE_5004_length_1101_cov_17.151697	555	635	2	1	80	0.0125000
NODE_5004_length_1101_cov_17.151697	555	635	6	1	80	0.0125000
NODE_5004_length_1101_cov_17.151697	555	635	8	10	80	0.1250000
NODE_5004_length_1101_cov_17.151697	555	635	9	3	80	0.0375000
NODE_5004_length_1101_cov_17.151697	555	635	10	47	80	0.5875000
NODE_5005_length_1101_cov_8.371257	968	1048	30	1	80	0.0125000
NODE_5005_length_1101_cov_8.371257	968	1048	34	4	80	0.0500000
NODE_5005_length_1101_cov_8.371257	968	1048	36	1	80	0.0125000
NODE_5005_length_1101_cov_8.371257	968	1048	38	3	80	0.0375000
NODE_5005_length_1101_cov_8.371257	968	1048	42	2	80	0.0250000
NODE_5005_length_1101_cov_8.371257	968	1048	44	4	80	0.0500000
NODE_5005_length_1101_cov_8.371257	968	1048	46	2	80	0.0250000
NODE_5005_length_1101_cov_8.371257	968	1048	52	2	80	0.0250000
NODE_5005_length_1101_cov_8.371257	968	1048	54	2	80	0.0250000
NODE_5005_length_1101_cov_8.371257	968	1048	56	1	80	0.0125000
NODE_5005_length_1101_cov_8.371257	968	1048	60	3	80	0.0375000
NODE_5005_length_1101_cov_8.371257	968	1048	62	55	80	0.6875000
NODE_5010_length_1100_cov_42.528472	582	662	1	12	80	0.1500000
NODE_5010_length_1100_cov_42.528472	582	662	3	1	80	0.0125000
NODE_5010_length_1100_cov_42.528472	582	662	4	4	80	0.0500000
NODE_5010_length_1100_cov_42.528472	582	662	5	6	80	0.0750000
NODE_5010_length_1100_cov_42.528472	582	662	6	6	80	0.0750000
NODE_5010_length_1100_cov_42.528472	582	662	11	37	80	0.4625000
NODE_5010_length_1100_cov_42.528472	582	662	14	14	80	0.1750000
NODE_5010_length_1100_cov_42.528472	635	715	1	65	80	0.8125000
NODE_5010_length_1100_cov_42.528472	635	715	3	1	80	0.0125000
NODE_5010_length_1100_cov_42.528472	635	715	4	4	80	0.0500000
NODE_5010_length_1100_cov_42.528472	635	715	5	4	80	0.0500000
NODE_5010_length_1100_cov_42.528472	635	715	6	6	80	0.0750000
NODE_5010_length_1100_cov_42.528472	711	791	0	4	80	0.0500000
NODE_5010_length_1100_cov_42.528472	711	791	1	76	80	0.9500000
NODE_5010_length_1100_cov_42.528472	764	844	0	57	80	0.7125000
NODE_5010_length_1100_cov_42.528472	764	844	1	23	80	0.2875000
NODE_5011_length_1100_cov_40.883117	324	404	0	80	80	1.0000000
NODE_5011_length_1100_cov_40.883117	377	457	0	80	80	1.0000000
NODE_5011_length_1100_cov_40.883117	453	533	0	80	80	1.0000000
NODE_5011_length_1100_cov_40.883117	506	586	0	51	80	0.6375000
NODE_5011_length_1100_cov_40.883117	506	586	2	1	80	0.0125000
NODE_5011_length_1100_cov_40.883117	506	586	3	28	80	0.3500000
NODE_5012_length_1100_cov_23.160839	524	604	0	37	80	0.4625000
NODE_5012_length_1100_cov_23.160839	524	604	2	43	80	0.5375000
NODE_5012_length_1100_cov_23.160839	577	657	0	80	80	1.0000000
NODE_5012_length_1100_cov_23.160839	653	733	0	80	80	1.0000000
NODE_5012_length_1100_cov_23.160839	706	786	0	80	80	1.0000000
NODE_5013_length_1100_cov_22.200799	485	565	0	70	80	0.8750000
NODE_5013_length_1100_cov_22.200799	485	565	2	10	80	0.1250000
NODE_5013_length_1100_cov_22.200799	538	618	0	80	80	1.0000000
NODE_5013_length_1100_cov_22.200799	614	694	0	34	80	0.4250000
NODE_5013_length_1100_cov_22.200799	614	694	4	46	80	0.5750000
NODE_5013_length_1100_cov_22.200799	667	745	4	78	78	1.0000000
NODE_5014_length_1100_cov_15.353646	472	552	0	80	80	1.0000000
NODE_5014_length_1100_cov_15.353646	525	605	0	80	80	1.0000000
NODE_5015_length_1100_cov_14.584416	673	753	0	1	80	0.0125000
NODE_5015_length_1100_cov_14.584416	673	753	4	40	80	0.5000000
NODE_5015_length_1100_cov_14.584416	673	753	6	39	80	0.4875000
NODE_5015_length_1100_cov_14.584416	726	806	0	24	80	0.3000000
NODE_5015_length_1100_cov_14.584416	726	806	2	9	80	0.1125000
NODE_5015_length_1100_cov_14.584416	726	806	6	47	80	0.5875000
NODE_5029_length_1099_cov_85.893000	464	544	0	80	80	1.0000000
NODE_5029_length_1099_cov_85.893000	517	597	0	80	80	1.0000000
NODE_5029_length_1099_cov_85.893000	593	673	0	80	80	1.0000000
NODE_5029_length_1099_cov_85.893000	646	726	0	80	80	1.0000000
NODE_5030_length_1099_cov_45.874000	521	601	0	39	80	0.4875000
NODE_5030_length_1099_cov_45.874000	521	601	2	41	80	0.5125000
NODE_5030_length_1099_cov_45.874000	574	654	0	20	80	0.2500000
NODE_5030_length_1099_cov_45.874000	574	654	2	60	80	0.7500000
NODE_5030_length_1099_cov_45.874000	650	730	0	6	80	0.0750000
NODE_5030_length_1099_cov_45.874000	650	730	7	9	80	0.1125000
NODE_5030_length_1099_cov_45.874000	650	730	14	65	80	0.8125000
NODE_5030_length_1099_cov_45.874000	703	783	14	80	80	1.0000000
NODE_5031_length_1099_cov_25.192000	526	606	2	80	80	1.0000000
NODE_5031_length_1099_cov_25.192000	579	659	0	32	80	0.4000000
NODE_5031_length_1099_cov_25.192000	579	659	2	48	80	0.6000000
NODE_5032_length_1099_cov_11.846000	565	645	2	22	80	0.2750000
NODE_5032_length_1099_cov_11.846000	565	645	4	46	80	0.5750000
NODE_5032_length_1099_cov_11.846000	565	645	6	12	80	0.1500000
NODE_5032_length_1099_cov_11.846000	618	698	4	65	80	0.8125000
NODE_5032_length_1099_cov_11.846000	618	698	6	15	80	0.1875000
NODE_5033_length_1099_cov_9.527000	495	575	4	24	80	0.3000000
NODE_5033_length_1099_cov_9.527000	495	575	6	50	80	0.6250000
NODE_5033_length_1099_cov_9.527000	495	575	8	6	80	0.0750000
NODE_5033_length_1099_cov_9.527000	548	628	0	26	80	0.3250000
NODE_5033_length_1099_cov_9.527000	548	628	2	13	80	0.1625000
NODE_5033_length_1099_cov_9.527000	548	628	4	27	80	0.3375000
NODE_5033_length_1099_cov_9.527000	548	628	6	14	80	0.1750000
NODE_5034_length_1099_cov_8.993000	464	544	4	80	80	1.0000000
NODE_5034_length_1099_cov_8.993000	517	597	0	46	80	0.5750000
NODE_5034_length_1099_cov_8.993000	517	597	4	34	80	0.4250000
NODE_5039_length_1099_cov_2.286000	273	353	0	80	80	1.0000000
NODE_5045_length_1098_cov_44.988989	360	440	2	80	80	1.0000000
NODE_5045_length_1098_cov_44.988989	413	493	0	22	80	0.2750000
NODE_5045_length_1098_cov_44.988989	413	493	1	1	80	0.0125000
NODE_5045_length_1098_cov_44.988989	413	493	2	57	80	0.7125000
NODE_5046_length_1098_cov_35.192192	452	532	0	80	80	1.0000000
NODE_5046_length_1098_cov_35.192192	505	585	0	80	80	1.0000000
NODE_5046_length_1098_cov_35.192192	581	661	0	23	80	0.2875000
NODE_5046_length_1098_cov_35.192192	581	661	2	57	80	0.7125000
NODE_5046_length_1098_cov_35.192192	634	714	0	34	80	0.4250000
NODE_5046_length_1098_cov_35.192192	634	714	2	46	80	0.5750000
NODE_5047_length_1098_cov_28.743744	449	529	0	80	80	1.0000000
NODE_5047_length_1098_cov_28.743744	502	582	0	45	80	0.5625000
NODE_5047_length_1098_cov_28.743744	502	582	1	35	80	0.4375000
NODE_5047_length_1098_cov_28.743744	578	658	1	53	80	0.6625000
NODE_5047_length_1098_cov_28.743744	578	658	2	27	80	0.3375000
NODE_5047_length_1098_cov_28.743744	631	711	1	14	80	0.1750000
NODE_5047_length_1098_cov_28.743744	631	711	2	66	80	0.8250000
NODE_5048_length_1098_cov_28.230230	477	557	0	19	80	0.2375000
NODE_5048_length_1098_cov_28.230230	477	557	2	31	80	0.3875000
NODE_5048_length_1098_cov_28.230230	477	557	4	30	80	0.3750000
NODE_5048_length_1098_cov_28.230230	530	610	0	7	80	0.0875000
NODE_5048_length_1098_cov_28.230230	530	610	2	73	80	0.9125000
NODE_5048_length_1098_cov_28.230230	606	686	0	9	80	0.1125000
NODE_5048_length_1098_cov_28.230230	606	686	2	56	80	0.7000000
NODE_5048_length_1098_cov_28.230230	606	686	6	15	80	0.1875000
NODE_5048_length_1098_cov_28.230230	659	739	2	12	80	0.1500000
NODE_5048_length_1098_cov_28.230230	659	739	4	15	80	0.1875000
NODE_5048_length_1098_cov_28.230230	659	739	6	53	80	0.6625000
NODE_5049_length_1098_cov_26.131131	494	574	0	80	80	1.0000000
NODE_5049_length_1098_cov_26.131131	547	627	0	80	80	1.0000000
NODE_5050_length_1098_cov_21.355355	599	679	6	19	80	0.2375000
NODE_5050_length_1098_cov_21.355355	599	679	10	61	80	0.7625000
NODE_5050_length_1098_cov_21.355355	652	732	0	12	80	0.1500000
NODE_5050_length_1098_cov_21.355355	652	732	4	12	80	0.1500000
NODE_5050_length_1098_cov_21.355355	652	732	9	1	80	0.0125000
NODE_5050_length_1098_cov_21.355355	652	732	10	55	80	0.6875000
NODE_5051_length_1098_cov_17.087087	541	621	0	15	80	0.1875000
NODE_5051_length_1098_cov_17.087087	541	621	2	65	80	0.8125000
NODE_5051_length_1098_cov_17.087087	594	674	0	25	80	0.3125000
NODE_5051_length_1098_cov_17.087087	594	674	2	55	80	0.6875000
NODE_5051_length_1098_cov_17.087087	670	750	0	4	80	0.0500000
NODE_5051_length_1098_cov_17.087087	670	750	2	76	80	0.9500000
NODE_5051_length_1098_cov_17.087087	723	803	0	42	80	0.5250000
NODE_5051_length_1098_cov_17.087087	723	803	2	38	80	0.4750000
NODE_5052_length_1098_cov_15.455455	545	625	0	52	80	0.6500000
NODE_5052_length_1098_cov_15.455455	545	625	1	13	80	0.1625000
NODE_5052_length_1098_cov_15.455455	545	625	2	15	80	0.1875000
NODE_5052_length_1098_cov_15.455455	598	678	1	12	80	0.1500000
NODE_5052_length_1098_cov_15.455455	598	678	2	68	80	0.8500000
NODE_5052_length_1098_cov_15.455455	674	754	1	10	80	0.1250000
NODE_5052_length_1098_cov_15.455455	674	754	2	70	80	0.8750000
NODE_5052_length_1098_cov_15.455455	727	807	0	47	80	0.5875000
NODE_5052_length_1098_cov_15.455455	727	807	1	16	80	0.2000000
NODE_5052_length_1098_cov_15.455455	727	807	2	17	80	0.2125000
NODE_5054_length_1097_cov_37.103206	438	518	6	14	80	0.1750000
NODE_5054_length_1097_cov_37.103206	438	518	8	28	80	0.3500000
NODE_5054_length_1097_cov_37.103206	438	518	10	38	80	0.4750000
NODE_5054_length_1097_cov_37.103206	491	571	0	24	80	0.3000000
NODE_5054_length_1097_cov_37.103206	491	571	2	15	80	0.1875000
NODE_5054_length_1097_cov_37.103206	491	571	6	28	80	0.3500000
NODE_5054_length_1097_cov_37.103206	491	571	10	13	80	0.1625000
NODE_5054_length_1097_cov_37.103206	567	647	0	41	80	0.5125000
NODE_5054_length_1097_cov_37.103206	567	647	2	39	80	0.4875000
NODE_5054_length_1097_cov_37.103206	620	700	0	2	80	0.0250000
NODE_5054_length_1097_cov_37.103206	620	700	2	78	80	0.9750000
NODE_5055_length_1097_cov_32.624248	501	581	2	15	80	0.1875000
NODE_5055_length_1097_cov_32.624248	501	581	5	2	80	0.0250000
NODE_5055_length_1097_cov_32.624248	501	581	6	63	80	0.7875000
NODE_5055_length_1097_cov_32.624248	554	634	0	7	80	0.0875000
NODE_5055_length_1097_cov_32.624248	554	634	1	41	80	0.5125000
NODE_5055_length_1097_cov_32.624248	554	634	5	7	80	0.0875000
NODE_5055_length_1097_cov_32.624248	554	634	6	25	80	0.3125000
NODE_5056_length_1097_cov_25.240481	401	480	0	79	79	1.0000000
NODE_5056_length_1097_cov_25.240481	453	533	0	80	80	1.0000000
NODE_5056_length_1097_cov_25.240481	529	609	0	80	80	1.0000000
NODE_5056_length_1097_cov_25.240481	582	662	0	80	80	1.0000000
NODE_5057_length_1097_cov_21.221443	484	564	0	13	80	0.1625000
NODE_5057_length_1097_cov_21.221443	484	564	2	67	80	0.8375000
NODE_5057_length_1097_cov_21.221443	537	617	0	66	80	0.8250000
NODE_5057_length_1097_cov_21.221443	537	617	2	14	80	0.1750000
NODE_5057_length_1097_cov_21.221443	613	693	0	33	80	0.4125000
NODE_5057_length_1097_cov_21.221443	613	693	2	47	80	0.5875000
NODE_5057_length_1097_cov_21.221443	666	746	0	28	80	0.3500000
NODE_5057_length_1097_cov_21.221443	666	746	2	52	80	0.6500000
NODE_5058_length_1097_cov_20.968938	515	595	0	80	80	1.0000000
NODE_5058_length_1097_cov_20.968938	568	648	0	80	80	1.0000000
NODE_5059_length_1097_cov_13.136273	697	779	0	82	82	1.0000000
NODE_5059_length_1097_cov_13.136273	752	832	0	80	80	1.0000000
NODE_5060_length_1097_cov_6.376754	442	522	0	80	80	1.0000000
NODE_5060_length_1097_cov_6.376754	495	575	0	80	80	1.0000000
NODE_5061_length_1097_cov_6.068136	299	379	0	80	80	1.0000000
NODE_5061_length_1097_cov_6.068136	352	432	0	80	80	1.0000000
NODE_5072_length_1096_cov_55.816449	430	510	0	55	80	0.6875000
NODE_5072_length_1096_cov_55.816449	430	510	2	25	80	0.3125000
NODE_5072_length_1096_cov_55.816449	483	563	0	14	80	0.1750000
NODE_5072_length_1096_cov_55.816449	483	563	2	66	80	0.8250000
NODE_5072_length_1096_cov_55.816449	559	639	0	17	80	0.2125000
NODE_5072_length_1096_cov_55.816449	559	639	2	63	80	0.7875000
NODE_5072_length_1096_cov_55.816449	612	692	0	56	80	0.7000000
NODE_5072_length_1096_cov_55.816449	612	692	2	24	80	0.3000000
NODE_5073_length_1096_cov_24.672016	431	511	0	33	80	0.4125000
NODE_5073_length_1096_cov_24.672016	431	511	6	47	80	0.5875000
NODE_5073_length_1096_cov_24.672016	484	564	6	80	80	1.0000000
NODE_5073_length_1096_cov_24.672016	560	640	0	35	80	0.4375000
NODE_5073_length_1096_cov_24.672016	560	640	5	1	80	0.0125000
NODE_5073_length_1096_cov_24.672016	560	640	6	44	80	0.5500000
NODE_5073_length_1096_cov_24.672016	613	693	0	80	80	1.0000000
NODE_5074_length_1096_cov_22.980943	372	452	4	80	80	1.0000000
NODE_5074_length_1096_cov_22.980943	425	505	0	22	80	0.2750000
NODE_5074_length_1096_cov_22.980943	425	505	2	23	80	0.2875000
NODE_5074_length_1096_cov_22.980943	425	505	4	35	80	0.4375000
NODE_5075_length_1096_cov_16.649950	486	566	0	22	80	0.2750000
NODE_5075_length_1096_cov_16.649950	486	566	4	54	80	0.6750000
NODE_5075_length_1096_cov_16.649950	486	566	6	4	80	0.0500000
NODE_5075_length_1096_cov_16.649950	539	619	2	21	80	0.2625000
NODE_5075_length_1096_cov_16.649950	539	619	4	23	80	0.2875000
NODE_5075_length_1096_cov_16.649950	539	619	6	36	80	0.4500000
NODE_5076_length_1096_cov_16.433300	443	523	0	12	80	0.1500000
NODE_5076_length_1096_cov_16.433300	443	523	4	5	80	0.0625000
NODE_5076_length_1096_cov_16.433300	443	523	6	63	80	0.7875000
NODE_5076_length_1096_cov_16.433300	496	576	0	19	80	0.2375000
NODE_5076_length_1096_cov_16.433300	496	576	6	61	80	0.7625000
NODE_5076_length_1096_cov_16.433300	886	966	0	47	80	0.5875000
NODE_5076_length_1096_cov_16.433300	886	966	2	33	80	0.4125000
NODE_5076_length_1096_cov_16.433300	939	1018	0	33	79	0.4177215
NODE_5076_length_1096_cov_16.433300	939	1018	2	46	79	0.5822785
NODE_5077_length_1096_cov_13.398195	670	750	2	22	80	0.2750000
NODE_5077_length_1096_cov_13.398195	670	750	4	58	80	0.7250000
NODE_5077_length_1096_cov_13.398195	723	803	0	40	80	0.5000000
NODE_5077_length_1096_cov_13.398195	723	803	2	35	80	0.4375000
NODE_5077_length_1096_cov_13.398195	723	803	4	5	80	0.0625000
NODE_5080_length_1095_cov_25.390562	520	600	2	80	80	1.0000000
NODE_5080_length_1095_cov_25.390562	573	653	2	68	80	0.8500000
NODE_5080_length_1095_cov_25.390562	573	653	4	4	80	0.0500000
NODE_5080_length_1095_cov_25.390562	573	653	5	1	80	0.0125000
NODE_5080_length_1095_cov_25.390562	573	653	6	7	80	0.0875000
NODE_5080_length_1095_cov_25.390562	649	729	4	27	80	0.3375000
NODE_5080_length_1095_cov_25.390562	649	729	8	15	80	0.1875000
NODE_5080_length_1095_cov_25.390562	649	729	10	28	80	0.3500000
NODE_5080_length_1095_cov_25.390562	649	729	12	10	80	0.1250000
NODE_5080_length_1095_cov_25.390562	702	782	6	9	80	0.1125000
NODE_5080_length_1095_cov_25.390562	702	782	8	31	80	0.3875000
NODE_5080_length_1095_cov_25.390562	702	782	10	18	80	0.2250000
NODE_5080_length_1095_cov_25.390562	702	782	11	3	80	0.0375000
NODE_5080_length_1095_cov_25.390562	702	782	12	19	80	0.2375000
NODE_5081_length_1095_cov_13.832329	549	629	0	80	80	1.0000000
NODE_5081_length_1095_cov_13.832329	602	682	0	80	80	1.0000000
NODE_5082_length_1095_cov_13.017068	497	577	0	80	80	1.0000000
NODE_5082_length_1095_cov_13.017068	550	630	0	80	80	1.0000000
NODE_5083_length_1095_cov_7.640562	627	707	0	3	80	0.0375000
NODE_5083_length_1095_cov_7.640562	627	707	4	77	80	0.9625000
NODE_5083_length_1095_cov_7.640562	680	760	0	56	80	0.7000000
NODE_5083_length_1095_cov_7.640562	680	760	4	24	80	0.3000000
NODE_5085_length_1095_cov_4.664659	307	387	0	80	80	1.0000000
NODE_5089_length_1094_cov_35.850251	409	489	0	80	80	1.0000000
NODE_5089_length_1094_cov_35.850251	462	542	0	80	80	1.0000000
NODE_5089_length_1094_cov_35.850251	538	618	0	80	80	1.0000000
NODE_5089_length_1094_cov_35.850251	591	671	0	80	80	1.0000000
NODE_5090_length_1094_cov_27.197990	462	542	0	40	80	0.5000000
NODE_5090_length_1094_cov_27.197990	462	542	2	40	80	0.5000000
NODE_5090_length_1094_cov_27.197990	515	595	0	80	80	1.0000000
NODE_5091_length_1094_cov_19.282412	451	531	0	6	80	0.0750000
NODE_5091_length_1094_cov_19.282412	451	531	2	9	80	0.1125000
NODE_5091_length_1094_cov_19.282412	451	531	4	9	80	0.1125000
NODE_5091_length_1094_cov_19.282412	451	531	6	41	80	0.5125000
NODE_5091_length_1094_cov_19.282412	451	531	8	15	80	0.1875000
NODE_5091_length_1094_cov_19.282412	504	584	4	13	80	0.1625000
NODE_5091_length_1094_cov_19.282412	504	584	6	51	80	0.6375000
NODE_5091_length_1094_cov_19.282412	504	584	8	16	80	0.2000000
NODE_5092_length_1094_cov_16.084422	558	614	0	56	56	1.0000000
NODE_5092_length_1094_cov_16.084422	587	667	0	80	80	1.0000000
NODE_5093_length_1094_cov_11.335678	384	464	10	1	80	0.0125000
NODE_5093_length_1094_cov_11.335678	384	464	12	79	80	0.9875000
NODE_5093_length_1094_cov_11.335678	437	517	2	33	80	0.4125000
NODE_5093_length_1094_cov_11.335678	437	517	8	12	80	0.1500000
NODE_5093_length_1094_cov_11.335678	437	517	12	35	80	0.4375000
NODE_5094_length_1094_cov_10.767839	396	476	0	80	80	1.0000000
NODE_5094_length_1094_cov_10.767839	449	529	0	80	80	1.0000000
NODE_5095_length_1094_cov_9.527638	579	659	0	11	80	0.1375000
NODE_5095_length_1094_cov_9.527638	579	659	2	69	80	0.8625000
NODE_5095_length_1094_cov_9.527638	632	712	0	49	80	0.6125000
NODE_5095_length_1094_cov_9.527638	632	712	2	31	80	0.3875000
NODE_5096_length_1094_cov_9.166834	527	607	0	80	80	1.0000000
NODE_5096_length_1094_cov_9.166834	580	660	0	80	80	1.0000000
NODE_5097_length_1094_cov_5.632161	708	768	0	60	60	1.0000000
NODE_5097_length_1094_cov_5.632161	761	821	0	60	60	1.0000000
NODE_5108_length_1093_cov_28.531187	374	454	2	9	80	0.1125000
NODE_5108_length_1093_cov_28.531187	374	454	4	6	80	0.0750000
NODE_5108_length_1093_cov_28.531187	374	454	6	56	80	0.7000000
NODE_5108_length_1093_cov_28.531187	374	454	8	9	80	0.1125000
NODE_5108_length_1093_cov_28.531187	427	507	0	1	80	0.0125000
NODE_5108_length_1093_cov_28.531187	427	507	2	18	80	0.2250000
NODE_5108_length_1093_cov_28.531187	427	507	6	61	80	0.7625000
NODE_5109_length_1093_cov_22.744467	516	596	0	19	80	0.2375000
NODE_5109_length_1093_cov_22.744467	516	596	2	57	80	0.7125000
NODE_5109_length_1093_cov_22.744467	516	596	4	4	80	0.0500000
NODE_5109_length_1093_cov_22.744467	569	649	2	60	80	0.7500000
NODE_5109_length_1093_cov_22.744467	569	649	4	20	80	0.2500000
NODE_5109_length_1093_cov_22.744467	645	725	0	6	80	0.0750000
NODE_5109_length_1093_cov_22.744467	645	725	2	21	80	0.2625000
NODE_5109_length_1093_cov_22.744467	645	725	4	53	80	0.6625000
NODE_5109_length_1093_cov_22.744467	698	778	0	9	80	0.1125000
NODE_5109_length_1093_cov_22.744467	698	778	2	46	80	0.5750000
NODE_5109_length_1093_cov_22.744467	698	778	4	25	80	0.3125000
NODE_5110_length_1093_cov_11.637827	282	362	0	11	80	0.1375000
NODE_5110_length_1093_cov_11.637827	282	362	4	69	80	0.8625000
NODE_5110_length_1093_cov_11.637827	335	415	0	63	80	0.7875000
NODE_5110_length_1093_cov_11.637827	335	415	4	17	80	0.2125000
NODE_5111_length_1093_cov_9.047284	660	740	0	80	80	1.0000000
NODE_5111_length_1093_cov_9.047284	713	793	0	80	80	1.0000000
NODE_5112_length_1093_cov_6.857143	658	738	0	80	80	1.0000000
NODE_5112_length_1093_cov_6.857143	711	791	0	80	80	1.0000000
NODE_5113_length_1093_cov_5.311871	587	667	0	80	80	1.0000000
NODE_5113_length_1093_cov_5.311871	640	720	0	80	80	1.0000000
NODE_5118_length_1092_cov_105.542800	682	768	3	8	86	0.0930233
NODE_5118_length_1092_cov_105.542800	682	768	5	5	86	0.0581395
NODE_5118_length_1092_cov_105.542800	682	768	27	40	86	0.4651163
NODE_5118_length_1092_cov_105.542800	682	768	28	7	86	0.0813954
NODE_5118_length_1092_cov_105.542800	682	768	29	26	86	0.3023256
NODE_5118_length_1092_cov_105.542800	745	807	0	1	62	0.0161290
NODE_5118_length_1092_cov_105.542800	745	807	23	12	62	0.1935484
NODE_5118_length_1092_cov_105.542800	745	807	25	16	62	0.2580645
NODE_5118_length_1092_cov_105.542800	745	807	26	8	62	0.1290323
NODE_5118_length_1092_cov_105.542800	745	807	27	8	62	0.1290323
NODE_5118_length_1092_cov_105.542800	745	807	29	17	62	0.2741936
NODE_5119_length_1092_cov_30.957704	610	690	0	80	80	1.0000000
NODE_5119_length_1092_cov_30.957704	663	743	0	80	80	1.0000000
NODE_5121_length_1092_cov_16.737160	725	805	0	80	80	1.0000000
NODE_5121_length_1092_cov_16.737160	778	858	0	80	80	1.0000000
NODE_5123_length_1092_cov_11.193353	335	415	0	13	80	0.1625000
NODE_5123_length_1092_cov_11.193353	335	415	2	67	80	0.8375000
NODE_5123_length_1092_cov_11.193353	388	468	0	66	80	0.8250000
NODE_5123_length_1092_cov_11.193353	388	468	2	14	80	0.1750000
NODE_5124_length_1092_cov_9.348439	489	569	0	3	80	0.0375000
NODE_5124_length_1092_cov_9.348439	489	569	2	77	80	0.9625000
NODE_5124_length_1092_cov_9.348439	542	622	0	56	80	0.7000000
NODE_5124_length_1092_cov_9.348439	542	622	2	24	80	0.3000000
NODE_5125_length_1092_cov_7.533736	243	323	0	3	80	0.0375000
NODE_5125_length_1092_cov_7.533736	243	323	4	77	80	0.9625000
NODE_5125_length_1092_cov_7.533736	296	376	0	25	80	0.3125000
NODE_5125_length_1092_cov_7.533736	296	376	2	5	80	0.0625000
NODE_5125_length_1092_cov_7.533736	296	376	3	20	80	0.2500000
NODE_5125_length_1092_cov_7.533736	296	376	4	30	80	0.3750000
NODE_5126_length_1092_cov_6.968781	470	550	2	80	80	1.0000000
NODE_5126_length_1092_cov_6.968781	523	603	0	38	80	0.4750000
NODE_5126_length_1092_cov_6.968781	523	603	2	42	80	0.5250000
NODE_5134_length_1091_cov_54.234879	417	497	4	24	80	0.3000000
NODE_5134_length_1091_cov_54.234879	417	497	6	56	80	0.7000000
NODE_5134_length_1091_cov_54.234879	470	550	0	10	80	0.1250000
NODE_5134_length_1091_cov_54.234879	470	550	4	67	80	0.8375000
NODE_5134_length_1091_cov_54.234879	470	550	6	3	80	0.0375000
NODE_5134_length_1091_cov_54.234879	546	626	0	26	80	0.3250000
NODE_5134_length_1091_cov_54.234879	546	626	3	1	80	0.0125000
NODE_5134_length_1091_cov_54.234879	546	626	4	37	80	0.4625000
NODE_5134_length_1091_cov_54.234879	546	626	6	16	80	0.2000000
NODE_5134_length_1091_cov_54.234879	599	679	2	9	80	0.1125000
NODE_5134_length_1091_cov_54.234879	599	679	4	28	80	0.3500000
NODE_5134_length_1091_cov_54.234879	599	679	6	34	80	0.4250000
NODE_5134_length_1091_cov_54.234879	599	679	8	9	80	0.1125000
NODE_5135_length_1091_cov_35.045363	384	464	4	25	80	0.3125000
NODE_5135_length_1091_cov_35.045363	384	464	12	55	80	0.6875000
NODE_5135_length_1091_cov_35.045363	437	517	4	78	80	0.9750000
NODE_5135_length_1091_cov_35.045363	437	517	12	2	80	0.0250000
NODE_5135_length_1091_cov_35.045363	513	593	0	7	80	0.0875000
NODE_5135_length_1091_cov_35.045363	513	593	2	1	80	0.0125000
NODE_5135_length_1091_cov_35.045363	513	593	4	9	80	0.1125000
NODE_5135_length_1091_cov_35.045363	513	593	8	1	80	0.0125000
NODE_5135_length_1091_cov_35.045363	513	593	9	62	80	0.7750000
NODE_5135_length_1091_cov_35.045363	566	646	9	47	80	0.5875000
NODE_5135_length_1091_cov_35.045363	566	646	10	33	80	0.4125000
NODE_5136_length_1091_cov_28.490927	329	409	0	26	80	0.3250000
NODE_5136_length_1091_cov_28.490927	329	409	2	54	80	0.6750000
NODE_5136_length_1091_cov_28.490927	382	462	0	79	80	0.9875000
NODE_5136_length_1091_cov_28.490927	382	462	2	1	80	0.0125000
NODE_5136_length_1091_cov_28.490927	618	698	0	80	80	1.0000000
NODE_5136_length_1091_cov_28.490927	671	751	0	80	80	1.0000000
NODE_5137_length_1091_cov_23.733871	514	594	2	33	80	0.4125000
NODE_5137_length_1091_cov_23.733871	514	594	8	1	80	0.0125000
NODE_5137_length_1091_cov_23.733871	514	594	17	7	80	0.0875000
NODE_5137_length_1091_cov_23.733871	514	594	18	37	80	0.4625000
NODE_5137_length_1091_cov_23.733871	514	594	19	2	80	0.0250000
NODE_5137_length_1091_cov_23.733871	567	647	16	21	80	0.2625000
NODE_5137_length_1091_cov_23.733871	567	647	17	39	80	0.4875000
NODE_5137_length_1091_cov_23.733871	567	647	18	18	80	0.2250000
NODE_5137_length_1091_cov_23.733871	567	647	19	2	80	0.0250000
NODE_5138_length_1091_cov_13.065524	444	524	0	80	80	1.0000000
NODE_5138_length_1091_cov_13.065524	497	577	0	80	80	1.0000000
NODE_5139_length_1091_cov_10.961694	582	646	0	20	64	0.3125000
NODE_5139_length_1091_cov_10.961694	582	646	1	5	64	0.0781250
NODE_5139_length_1091_cov_10.961694	582	646	2	39	64	0.6093750
NODE_5140_length_1091_cov_8.166331	299	379	0	80	80	1.0000000
NODE_5140_length_1091_cov_8.166331	352	432	0	80	80	1.0000000
NODE_5141_length_1091_cov_7.006048	617	697	0	9	80	0.1125000
NODE_5141_length_1091_cov_7.006048	617	697	4	71	80	0.8875000
NODE_5141_length_1091_cov_7.006048	670	750	0	62	80	0.7750000
NODE_5141_length_1091_cov_7.006048	670	750	4	18	80	0.2250000
NODE_5151_length_1090_cov_73.781029	352	432	0	80	80	1.0000000
NODE_5151_length_1090_cov_73.781029	405	485	0	80	80	1.0000000
NODE_5151_length_1090_cov_73.781029	481	567	0	86	86	1.0000000
NODE_5151_length_1090_cov_73.781029	540	620	0	51	80	0.6375000
NODE_5151_length_1090_cov_73.781029	540	620	2	29	80	0.3625000
NODE_5152_length_1090_cov_42.394551	530	610	0	3	80	0.0375000
NODE_5152_length_1090_cov_42.394551	530	610	2	77	80	0.9625000
NODE_5152_length_1090_cov_42.394551	583	663	0	47	80	0.5875000
NODE_5152_length_1090_cov_42.394551	583	663	2	33	80	0.4125000
NODE_5153_length_1090_cov_37.643794	436	516	4	4	80	0.0500000
NODE_5153_length_1090_cov_37.643794	436	516	6	5	80	0.0625000
NODE_5153_length_1090_cov_37.643794	436	516	8	71	80	0.8875000
NODE_5153_length_1090_cov_37.643794	489	569	1	12	80	0.1500000
NODE_5153_length_1090_cov_37.643794	489	569	2	31	80	0.3875000
NODE_5153_length_1090_cov_37.643794	489	569	4	12	80	0.1500000
NODE_5153_length_1090_cov_37.643794	489	569	5	2	80	0.0250000
NODE_5153_length_1090_cov_37.643794	489	569	6	5	80	0.0625000
NODE_5153_length_1090_cov_37.643794	489	569	8	18	80	0.2250000
NODE_5153_length_1090_cov_37.643794	565	645	2	80	80	1.0000000
NODE_5153_length_1090_cov_37.643794	618	698	0	11	80	0.1375000
NODE_5153_length_1090_cov_37.643794	618	698	1	13	80	0.1625000
NODE_5153_length_1090_cov_37.643794	618	698	2	56	80	0.7000000
NODE_5154_length_1090_cov_32.876892	487	567	0	50	80	0.6250000
NODE_5154_length_1090_cov_32.876892	487	567	4	30	80	0.3750000
NODE_5154_length_1090_cov_32.876892	540	620	0	80	80	1.0000000
NODE_5155_length_1090_cov_25.373360	486	566	0	43	80	0.5375000
NODE_5155_length_1090_cov_25.373360	486	566	4	37	80	0.4625000
NODE_5155_length_1090_cov_25.373360	539	619	4	80	80	1.0000000
NODE_5156_length_1090_cov_21.290616	422	502	0	41	80	0.5125000
NODE_5156_length_1090_cov_21.290616	422	502	1	22	80	0.2750000
NODE_5156_length_1090_cov_21.290616	422	502	2	17	80	0.2125000
NODE_5156_length_1090_cov_21.290616	475	555	1	10	80	0.1250000
NODE_5156_length_1090_cov_21.290616	475	555	2	70	80	0.8750000
NODE_5156_length_1090_cov_21.290616	551	631	1	18	80	0.2250000
NODE_5156_length_1090_cov_21.290616	551	631	2	62	80	0.7750000
NODE_5156_length_1090_cov_21.290616	604	684	0	21	80	0.2625000
NODE_5156_length_1090_cov_21.290616	604	684	1	50	80	0.6250000
NODE_5156_length_1090_cov_21.290616	604	684	2	9	80	0.1125000
NODE_5157_length_1090_cov_16.040363	666	746	0	28	80	0.3500000
NODE_5157_length_1090_cov_16.040363	666	746	2	2	80	0.0250000
NODE_5157_length_1090_cov_16.040363	666	746	6	50	80	0.6250000
NODE_5157_length_1090_cov_16.040363	719	799	4	39	80	0.4875000
NODE_5157_length_1090_cov_16.040363	719	799	6	41	80	0.5125000
NODE_5158_length_1090_cov_14.826438	393	473	0	55	80	0.6875000
NODE_5158_length_1090_cov_14.826438	393	473	5	23	80	0.2875000
NODE_5158_length_1090_cov_14.826438	393	473	9	2	80	0.0250000
NODE_5158_length_1090_cov_14.826438	446	526	0	2	80	0.0250000
NODE_5158_length_1090_cov_14.826438	446	526	5	23	80	0.2875000
NODE_5158_length_1090_cov_14.826438	446	526	9	33	80	0.4125000
NODE_5158_length_1090_cov_14.826438	446	526	10	22	80	0.2750000
NODE_5159_length_1090_cov_13.721493	498	578	0	80	80	1.0000000
NODE_5159_length_1090_cov_13.721493	551	631	0	80	80	1.0000000
NODE_5160_length_1090_cov_12.365288	386	467	0	81	81	1.0000000
NODE_5160_length_1090_cov_12.365288	440	520	0	80	80	1.0000000
NODE_5160_length_1090_cov_12.365288	516	596	0	80	80	1.0000000
NODE_5160_length_1090_cov_12.365288	569	649	0	80	80	1.0000000
NODE_5161_length_1090_cov_5.348133	0	80	0	26	80	0.3250000
NODE_5161_length_1090_cov_5.348133	0	80	2	22	80	0.2750000
NODE_5161_length_1090_cov_5.348133	0	80	4	4	80	0.0500000
NODE_5161_length_1090_cov_5.348133	0	80	6	28	80	0.3500000
NODE_5161_length_1090_cov_5.348133	53	99	6	46	46	1.0000000
NODE_5163_length_1090_cov_3.598385	300	340	47	2	40	0.0500000
NODE_5163_length_1090_cov_3.598385	300	340	50	3	40	0.0750000
NODE_5163_length_1090_cov_3.598385	300	340	52	6	40	0.1500000
NODE_5163_length_1090_cov_3.598385	300	340	53	1	40	0.0250000
NODE_5163_length_1090_cov_3.598385	300	340	59	2	40	0.0500000
NODE_5163_length_1090_cov_3.598385	300	340	62	2	40	0.0500000
NODE_5163_length_1090_cov_3.598385	300	340	63	3	40	0.0750000
NODE_5163_length_1090_cov_3.598385	300	340	64	6	40	0.1500000
NODE_5163_length_1090_cov_3.598385	300	340	79	1	40	0.0250000
NODE_5163_length_1090_cov_3.598385	300	340	83	5	40	0.1250000
NODE_5163_length_1090_cov_3.598385	300	340	84	2	40	0.0500000
NODE_5163_length_1090_cov_3.598385	300	340	86	2	40	0.0500000
NODE_5163_length_1090_cov_3.598385	300	340	87	2	40	0.0500000
NODE_5163_length_1090_cov_3.598385	300	340	88	3	40	0.0750000
NODE_5170_length_1089_cov_55.374747	515	594	0	79	79	1.0000000
NODE_5170_length_1089_cov_55.374747	567	647	0	80	80	1.0000000
NODE_5170_length_1089_cov_55.374747	643	723	0	32	80	0.4000000
NODE_5170_length_1089_cov_55.374747	643	723	2	45	80	0.5625000
NODE_5170_length_1089_cov_55.374747	643	723	4	3	80	0.0375000
NODE_5170_length_1089_cov_55.374747	696	776	2	34	80	0.4250000
NODE_5170_length_1089_cov_55.374747	696	776	4	46	80	0.5750000
NODE_5171_length_1089_cov_38.506061	458	538	0	80	80	1.0000000
NODE_5171_length_1089_cov_38.506061	511	591	0	60	80	0.7500000
NODE_5171_length_1089_cov_38.506061	511	591	1	15	80	0.1875000
NODE_5171_length_1089_cov_38.506061	511	591	2	5	80	0.0625000
NODE_5171_length_1089_cov_38.506061	587	667	2	80	80	1.0000000
NODE_5171_length_1089_cov_38.506061	640	720	2	80	80	1.0000000
NODE_5172_length_1089_cov_22.657576	379	459	2	24	80	0.3000000
NODE_5172_length_1089_cov_22.657576	379	459	4	36	80	0.4500000
NODE_5172_length_1089_cov_22.657576	379	459	6	20	80	0.2500000
NODE_5172_length_1089_cov_22.657576	432	512	0	37	80	0.4625000
NODE_5172_length_1089_cov_22.657576	432	512	2	40	80	0.5000000
NODE_5172_length_1089_cov_22.657576	432	512	6	3	80	0.0375000
NODE_5173_length_1089_cov_21.180808	547	627	8	42	80	0.5250000
NODE_5173_length_1089_cov_21.180808	547	627	13	1	80	0.0125000
NODE_5173_length_1089_cov_21.180808	547	627	14	12	80	0.1500000
NODE_5173_length_1089_cov_21.180808	547	627	16	25	80	0.3125000
NODE_5173_length_1089_cov_21.180808	600	680	6	5	80	0.0625000
NODE_5173_length_1089_cov_21.180808	600	680	8	30	80	0.3750000
NODE_5173_length_1089_cov_21.180808	600	680	14	2	80	0.0250000
NODE_5173_length_1089_cov_21.180808	600	680	16	43	80	0.5375000
NODE_5174_length_1089_cov_18.713131	431	511	2	80	80	1.0000000
NODE_5174_length_1089_cov_18.713131	484	564	0	35	80	0.4375000
NODE_5174_length_1089_cov_18.713131	484	564	2	45	80	0.5625000
NODE_5174_length_1089_cov_18.713131	560	640	0	58	80	0.7250000
NODE_5174_length_1089_cov_18.713131	560	640	2	22	80	0.2750000
NODE_5174_length_1089_cov_18.713131	613	693	0	5	80	0.0625000
NODE_5174_length_1089_cov_18.713131	613	693	2	53	80	0.6625000
NODE_5174_length_1089_cov_18.713131	613	693	4	22	80	0.2750000
NODE_5175_length_1089_cov_17.382828	376	456	0	80	80	1.0000000
NODE_5175_length_1089_cov_17.382828	429	509	0	80	80	1.0000000
NODE_5175_length_1089_cov_17.382828	505	585	0	80	80	1.0000000
NODE_5175_length_1089_cov_17.382828	558	638	0	80	80	1.0000000
NODE_5176_length_1089_cov_14.540404	610	690	2	26	80	0.3250000
NODE_5176_length_1089_cov_14.540404	610	690	4	39	80	0.4875000
NODE_5176_length_1089_cov_14.540404	610	690	6	15	80	0.1875000
NODE_5176_length_1089_cov_14.540404	663	743	0	30	80	0.3750000
NODE_5176_length_1089_cov_14.540404	663	743	2	49	80	0.6125000
NODE_5176_length_1089_cov_14.540404	663	743	6	1	80	0.0125000
NODE_5182_length_1088_cov_10.603640	504	584	2	80	80	1.0000000
NODE_5182_length_1088_cov_10.603640	557	632	0	28	75	0.3733333
NODE_5182_length_1088_cov_10.603640	557	632	2	47	75	0.6266667
NODE_5194_length_1088_cov_0.759353	0	59	0	59	59	1.0000000
NODE_5194_length_1088_cov_0.759353	32	97	0	65	65	1.0000000
NODE_5195_length_1087_cov_51.676113	457	537	2	17	80	0.2125000
NODE_5195_length_1087_cov_51.676113	457	537	4	29	80	0.3625000
NODE_5195_length_1087_cov_51.676113	457	537	5	1	80	0.0125000
NODE_5195_length_1087_cov_51.676113	457	537	8	27	80	0.3375000
NODE_5195_length_1087_cov_51.676113	457	537	10	6	80	0.0750000
NODE_5195_length_1087_cov_51.676113	510	590	4	34	80	0.4250000
NODE_5195_length_1087_cov_51.676113	510	590	5	3	80	0.0375000
NODE_5195_length_1087_cov_51.676113	510	590	6	35	80	0.4375000
NODE_5195_length_1087_cov_51.676113	510	590	8	8	80	0.1000000
NODE_5195_length_1087_cov_51.676113	586	666	0	19	80	0.2375000
NODE_5195_length_1087_cov_51.676113	586	666	2	38	80	0.4750000
NODE_5195_length_1087_cov_51.676113	586	666	4	23	80	0.2875000
NODE_5195_length_1087_cov_51.676113	639	719	0	72	80	0.9000000
NODE_5195_length_1087_cov_51.676113	639	719	2	8	80	0.1000000
NODE_5196_length_1087_cov_47.144737	214	276	65	4	62	0.0645161
NODE_5196_length_1087_cov_47.144737	214	276	69	1	62	0.0161290
NODE_5196_length_1087_cov_47.144737	214	276	70	1	62	0.0161290
NODE_5196_length_1087_cov_47.144737	214	276	76	4	62	0.0645161
NODE_5196_length_1087_cov_47.144737	214	276	78	1	62	0.0161290
NODE_5196_length_1087_cov_47.144737	214	276	80	1	62	0.0161290
NODE_5196_length_1087_cov_47.144737	214	276	84	1	62	0.0161290
NODE_5196_length_1087_cov_47.144737	214	276	92	2	62	0.0322581
NODE_5196_length_1087_cov_47.144737	214	276	98	4	62	0.0645161
NODE_5196_length_1087_cov_47.144737	214	276	100	1	62	0.0161290
NODE_5196_length_1087_cov_47.144737	214	276	102	3	62	0.0483871
NODE_5196_length_1087_cov_47.144737	214	276	106	2	62	0.0322581
NODE_5196_length_1087_cov_47.144737	214	276	107	5	62	0.0806452
NODE_5196_length_1087_cov_47.144737	214	276	112	2	62	0.0322581
NODE_5196_length_1087_cov_47.144737	214	276	114	1	62	0.0161290
NODE_5196_length_1087_cov_47.144737	214	276	116	1	62	0.0161290
NODE_5196_length_1087_cov_47.144737	214	276	118	6	62	0.0967742
NODE_5196_length_1087_cov_47.144737	214	276	120	4	62	0.0645161
NODE_5196_length_1087_cov_47.144737	214	276	123	1	62	0.0161290
NODE_5196_length_1087_cov_47.144737	214	276	127	2	62	0.0322581
NODE_5196_length_1087_cov_47.144737	214	276	128	9	62	0.1451613
NODE_5196_length_1087_cov_47.144737	214	276	130	6	62	0.0967742
NODE_5196_length_1087_cov_47.144737	630	710	0	80	80	1.0000000
NODE_5196_length_1087_cov_47.144737	683	763	0	80	80	1.0000000
NODE_5197_length_1087_cov_46.633603	871	951	0	80	80	1.0000000
NODE_5197_length_1087_cov_46.633603	924	999	0	75	75	1.0000000
NODE_5198_length_1087_cov_30.577935	528	608	8	13	80	0.1625000
NODE_5198_length_1087_cov_30.577935	528	608	11	20	80	0.2500000
NODE_5198_length_1087_cov_30.577935	528	608	12	47	80	0.5875000
NODE_5198_length_1087_cov_30.577935	581	661	0	39	80	0.4875000
NODE_5198_length_1087_cov_30.577935	581	661	8	27	80	0.3375000
NODE_5198_length_1087_cov_30.577935	581	661	11	14	80	0.1750000
NODE_5199_length_1087_cov_30.205466	515	591	0	37	76	0.4868421
NODE_5199_length_1087_cov_30.205466	515	591	2	39	76	0.5131579
NODE_5199_length_1087_cov_30.205466	564	644	0	17	80	0.2125000
NODE_5199_length_1087_cov_30.205466	564	644	2	63	80	0.7875000
NODE_5200_length_1087_cov_29.595142	568	648	0	80	80	1.0000000
NODE_5200_length_1087_cov_29.595142	621	701	0	80	80	1.0000000
NODE_5201_length_1087_cov_11.600202	374	454	0	14	80	0.1750000
NODE_5201_length_1087_cov_11.600202	374	454	6	54	80	0.6750000
NODE_5201_length_1087_cov_11.600202	374	454	7	2	80	0.0250000
NODE_5201_length_1087_cov_11.600202	374	454	10	10	80	0.1250000
NODE_5201_length_1087_cov_11.600202	427	507	0	25	80	0.3125000
NODE_5201_length_1087_cov_11.600202	427	507	6	15	80	0.1875000
NODE_5201_length_1087_cov_11.600202	427	507	7	2	80	0.0250000
NODE_5201_length_1087_cov_11.600202	427	507	10	38	80	0.4750000
NODE_5202_length_1087_cov_7.746964	436	516	0	80	80	1.0000000
NODE_5202_length_1087_cov_7.746964	489	569	0	80	80	1.0000000
NODE_5211_length_1086_cov_35.748734	406	486	23	3	80	0.0375000
NODE_5211_length_1086_cov_35.748734	406	486	24	1	80	0.0125000
NODE_5211_length_1086_cov_35.748734	406	486	25	35	80	0.4375000
NODE_5211_length_1086_cov_35.748734	406	486	31	7	80	0.0875000
NODE_5211_length_1086_cov_35.748734	406	486	32	34	80	0.4250000
NODE_5211_length_1086_cov_35.748734	459	539	0	45	80	0.5625000
NODE_5211_length_1086_cov_35.748734	459	539	21	1	80	0.0125000
NODE_5211_length_1086_cov_35.748734	459	539	23	10	80	0.1250000
NODE_5211_length_1086_cov_35.748734	459	539	24	1	80	0.0125000
NODE_5211_length_1086_cov_35.748734	459	539	25	23	80	0.2875000
NODE_5212_length_1086_cov_18.445795	325	405	0	80	80	1.0000000
NODE_5212_length_1086_cov_18.445795	378	458	0	80	80	1.0000000
NODE_5213_length_1086_cov_16.878419	528	608	0	80	80	1.0000000
NODE_5213_length_1086_cov_16.878419	581	661	0	62	80	0.7750000
NODE_5213_length_1086_cov_16.878419	581	661	3	18	80	0.2250000
NODE_5214_length_1086_cov_10.700101	498	578	0	55	80	0.6875000
NODE_5214_length_1086_cov_10.700101	498	578	1	6	80	0.0750000
NODE_5214_length_1086_cov_10.700101	498	578	2	19	80	0.2375000
NODE_5214_length_1086_cov_10.700101	551	631	0	80	80	1.0000000
NODE_5215_length_1086_cov_10.656535	277	357	0	80	80	1.0000000
NODE_5215_length_1086_cov_10.656535	330	410	0	80	80	1.0000000
NODE_5216_length_1086_cov_6.873354	374	454	0	80	80	1.0000000
NODE_5216_length_1086_cov_6.873354	427	507	0	80	80	1.0000000
NODE_5217_length_1086_cov_5.225937	869	949	0	80	80	1.0000000
NODE_5217_length_1086_cov_5.225937	922	1002	0	80	80	1.0000000
NODE_5229_length_1085_cov_30.599391	515	595	0	2	80	0.0250000
NODE_5229_length_1085_cov_30.599391	515	595	2	55	80	0.6875000
NODE_5229_length_1085_cov_30.599391	515	595	5	6	80	0.0750000
NODE_5229_length_1085_cov_30.599391	515	595	7	14	80	0.1750000
NODE_5229_length_1085_cov_30.599391	515	595	9	3	80	0.0375000
NODE_5229_length_1085_cov_30.599391	568	648	2	4	80	0.0500000
NODE_5229_length_1085_cov_30.599391	568	648	5	6	80	0.0750000
NODE_5229_length_1085_cov_30.599391	568	648	7	14	80	0.1750000
NODE_5229_length_1085_cov_30.599391	568	648	9	38	80	0.4750000
NODE_5229_length_1085_cov_30.599391	568	648	10	18	80	0.2250000
NODE_5231_length_1085_cov_13.723124	558	638	0	75	80	0.9375000
NODE_5231_length_1085_cov_13.723124	558	638	4	5	80	0.0625000
NODE_5231_length_1085_cov_13.723124	611	691	0	22	80	0.2750000
NODE_5231_length_1085_cov_13.723124	611	691	4	58	80	0.7250000
NODE_5232_length_1085_cov_12.481744	576	656	0	37	80	0.4625000
NODE_5232_length_1085_cov_12.481744	576	656	2	43	80	0.5375000
NODE_5232_length_1085_cov_12.481744	629	709	0	80	80	1.0000000
NODE_5233_length_1085_cov_11.570994	553	633	0	62	80	0.7750000
NODE_5233_length_1085_cov_11.570994	553	633	2	18	80	0.2250000
NODE_5233_length_1085_cov_11.570994	606	686	0	9	80	0.1125000
NODE_5233_length_1085_cov_11.570994	606	686	2	71	80	0.8875000
NODE_5234_length_1085_cov_10.730223	273	353	0	16	80	0.2000000
NODE_5234_length_1085_cov_10.730223	273	353	2	27	80	0.3375000
NODE_5234_length_1085_cov_10.730223	273	353	4	37	80	0.4625000
NODE_5234_length_1085_cov_10.730223	326	406	2	26	80	0.3250000
NODE_5234_length_1085_cov_10.730223	326	406	4	54	80	0.6750000
NODE_5234_length_1085_cov_10.730223	402	482	0	23	80	0.2875000
NODE_5234_length_1085_cov_10.730223	402	482	2	10	80	0.1250000
NODE_5234_length_1085_cov_10.730223	402	482	3	31	80	0.3875000
NODE_5234_length_1085_cov_10.730223	402	482	4	16	80	0.2000000
NODE_5234_length_1085_cov_10.730223	455	535	0	76	80	0.9500000
NODE_5234_length_1085_cov_10.730223	455	535	2	4	80	0.0500000
NODE_5234_length_1085_cov_10.730223	832	908	8	1	76	0.0131579
NODE_5234_length_1085_cov_10.730223	832	908	10	2	76	0.0263158
NODE_5234_length_1085_cov_10.730223	832	908	14	1	76	0.0131579
NODE_5234_length_1085_cov_10.730223	832	908	16	1	76	0.0131579
NODE_5234_length_1085_cov_10.730223	832	908	17	1	76	0.0131579
NODE_5234_length_1085_cov_10.730223	832	908	18	2	76	0.0263158
NODE_5234_length_1085_cov_10.730223	832	908	24	5	76	0.0657895
NODE_5234_length_1085_cov_10.730223	832	908	26	17	76	0.2236842
NODE_5234_length_1085_cov_10.730223	832	908	28	1	76	0.0131579
NODE_5234_length_1085_cov_10.730223	832	908	30	2	76	0.0263158
NODE_5234_length_1085_cov_10.730223	832	908	32	1	76	0.0131579
NODE_5234_length_1085_cov_10.730223	832	908	36	2	76	0.0263158
NODE_5234_length_1085_cov_10.730223	832	908	38	1	76	0.0131579
NODE_5234_length_1085_cov_10.730223	832	908	39	4	76	0.0526316
NODE_5234_length_1085_cov_10.730223	832	908	40	18	76	0.2368421
NODE_5234_length_1085_cov_10.730223	832	908	41	3	76	0.0394737
NODE_5234_length_1085_cov_10.730223	832	908	42	3	76	0.0394737
NODE_5234_length_1085_cov_10.730223	832	908	44	11	76	0.1447368
NODE_5236_length_1085_cov_8.309331	400	480	0	30	80	0.3750000
NODE_5236_length_1085_cov_8.309331	400	480	2	50	80	0.6250000
NODE_5236_length_1085_cov_8.309331	453	533	0	80	80	1.0000000
NODE_5248_length_1084_cov_60.255838	446	524	0	78	78	1.0000000
NODE_5248_length_1084_cov_60.255838	497	577	0	80	80	1.0000000
NODE_5249_length_1084_cov_33.332995	445	525	0	32	80	0.4000000
NODE_5249_length_1084_cov_33.332995	445	525	2	48	80	0.6000000
NODE_5249_length_1084_cov_33.332995	498	578	0	19	80	0.2375000
NODE_5249_length_1084_cov_33.332995	498	578	2	61	80	0.7625000
NODE_5250_length_1084_cov_11.004061	757	837	0	56	80	0.7000000
NODE_5250_length_1084_cov_11.004061	757	837	2	24	80	0.3000000
NODE_5250_length_1084_cov_11.004061	810	890	0	46	80	0.5750000
NODE_5250_length_1084_cov_11.004061	810	890	2	34	80	0.4250000
NODE_5258_length_1083_cov_42.182927	451	531	0	13	80	0.1625000
NODE_5258_length_1083_cov_42.182927	451	531	1	67	80	0.8375000
NODE_5258_length_1083_cov_42.182927	504	584	1	56	80	0.7000000
NODE_5258_length_1083_cov_42.182927	504	584	3	24	80	0.3000000
NODE_5258_length_1083_cov_42.182927	580	660	2	46	80	0.5750000
NODE_5258_length_1083_cov_42.182927	580	660	3	34	80	0.4250000
NODE_5258_length_1083_cov_42.182927	633	713	0	31	80	0.3875000
NODE_5258_length_1083_cov_42.182927	633	713	2	49	80	0.6125000
NODE_5259_length_1083_cov_41.163618	275	355	0	80	80	1.0000000
NODE_5259_length_1083_cov_41.163618	328	408	0	80	80	1.0000000
NODE_5259_length_1083_cov_41.163618	404	484	0	15	80	0.1875000
NODE_5259_length_1083_cov_41.163618	404	484	4	65	80	0.8125000
NODE_5259_length_1083_cov_41.163618	457	537	0	34	80	0.4250000
NODE_5259_length_1083_cov_41.163618	457	537	4	46	80	0.5750000
NODE_5260_length_1083_cov_39.798780	527	607	0	2	80	0.0250000
NODE_5260_length_1083_cov_39.798780	527	607	1	19	80	0.2375000
NODE_5260_length_1083_cov_39.798780	527	607	2	7	80	0.0875000
NODE_5260_length_1083_cov_39.798780	527	607	4	52	80	0.6500000
NODE_5260_length_1083_cov_39.798780	580	660	0	55	80	0.6875000
NODE_5260_length_1083_cov_39.798780	580	660	1	19	80	0.2375000
NODE_5260_length_1083_cov_39.798780	580	660	2	6	80	0.0750000
NODE_5261_length_1083_cov_34.261179	475	555	0	45	80	0.5625000
NODE_5261_length_1083_cov_34.261179	475	555	2	32	80	0.4000000
NODE_5261_length_1083_cov_34.261179	475	555	4	3	80	0.0375000
NODE_5261_length_1083_cov_34.261179	528	608	0	30	80	0.3750000
NODE_5261_length_1083_cov_34.261179	528	608	4	50	80	0.6250000
NODE_5262_length_1083_cov_33.573171	486	566	2	70	80	0.8750000
NODE_5262_length_1083_cov_33.573171	486	566	4	10	80	0.1250000
NODE_5262_length_1083_cov_33.573171	539	619	2	70	80	0.8750000
NODE_5262_length_1083_cov_33.573171	539	619	4	10	80	0.1250000
NODE_5262_length_1083_cov_33.573171	615	695	0	59	80	0.7375000
NODE_5262_length_1083_cov_33.573171	615	695	1	1	80	0.0125000
NODE_5262_length_1083_cov_33.573171	615	695	2	20	80	0.2500000
NODE_5262_length_1083_cov_33.573171	668	748	0	80	80	1.0000000
NODE_5263_length_1083_cov_33.091463	452	532	8	80	80	1.0000000
NODE_5263_length_1083_cov_33.091463	505	585	0	39	80	0.4875000
NODE_5263_length_1083_cov_33.091463	505	585	7	1	80	0.0125000
NODE_5263_length_1083_cov_33.091463	505	585	8	40	80	0.5000000
NODE_5264_length_1083_cov_30.982724	550	630	2	66	80	0.8250000
NODE_5264_length_1083_cov_30.982724	550	630	4	14	80	0.1750000
NODE_5264_length_1083_cov_30.982724	603	683	0	13	80	0.1625000
NODE_5264_length_1083_cov_30.982724	603	683	2	67	80	0.8375000
NODE_5265_length_1083_cov_18.819106	586	666	0	37	80	0.4625000
NODE_5265_length_1083_cov_18.819106	586	666	2	8	80	0.1000000
NODE_5265_length_1083_cov_18.819106	586	666	4	35	80	0.4375000
NODE_5265_length_1083_cov_18.819106	639	719	2	29	80	0.3625000
NODE_5265_length_1083_cov_18.819106	639	719	4	51	80	0.6375000
NODE_5266_length_1083_cov_17.278455	408	488	3	80	80	1.0000000
NODE_5266_length_1083_cov_17.278455	461	541	2	27	80	0.3375000
NODE_5266_length_1083_cov_17.278455	461	541	3	47	80	0.5875000
NODE_5266_length_1083_cov_17.278455	461	541	4	6	80	0.0750000
NODE_5267_length_1083_cov_13.862805	481	561	0	19	80	0.2375000
NODE_5267_length_1083_cov_13.862805	481	561	2	61	80	0.7625000
NODE_5267_length_1083_cov_13.862805	534	614	0	72	80	0.9000000
NODE_5267_length_1083_cov_13.862805	534	614	2	8	80	0.1000000
NODE_5268_length_1083_cov_13.083333	522	602	0	29	80	0.3625000
NODE_5268_length_1083_cov_13.083333	522	602	2	13	80	0.1625000
NODE_5268_length_1083_cov_13.083333	522	602	6	15	80	0.1875000
NODE_5268_length_1083_cov_13.083333	522	602	10	8	80	0.1000000
NODE_5268_length_1083_cov_13.083333	522	602	16	15	80	0.1875000
NODE_5268_length_1083_cov_13.083333	575	655	6	4	80	0.0500000
NODE_5268_length_1083_cov_13.083333	575	655	10	12	80	0.1500000
NODE_5268_length_1083_cov_13.083333	575	655	12	20	80	0.2500000
NODE_5268_length_1083_cov_13.083333	575	655	16	44	80	0.5500000
NODE_5269_length_1083_cov_11.824187	242	322	0	5	80	0.0625000
NODE_5269_length_1083_cov_11.824187	242	322	2	75	80	0.9375000
NODE_5269_length_1083_cov_11.824187	295	375	0	52	80	0.6500000
NODE_5269_length_1083_cov_11.824187	295	375	2	28	80	0.3500000
NODE_5271_length_1083_cov_3.025407	359	439	0	80	80	1.0000000
NODE_5271_length_1083_cov_3.025407	412	489	0	77	77	1.0000000
NODE_5277_length_1082_cov_34.664293	461	541	0	80	80	1.0000000
NODE_5277_length_1082_cov_34.664293	514	594	0	80	80	1.0000000
NODE_5278_length_1082_cov_17.422177	406	486	0	4	80	0.0500000
NODE_5278_length_1082_cov_17.422177	406	486	4	1	80	0.0125000
NODE_5278_length_1082_cov_17.422177	406	486	5	15	80	0.1875000
NODE_5278_length_1082_cov_17.422177	406	486	8	3	80	0.0375000
NODE_5278_length_1082_cov_17.422177	406	486	9	57	80	0.7125000
NODE_5278_length_1082_cov_17.422177	459	539	0	21	80	0.2625000
NODE_5278_length_1082_cov_17.422177	459	539	4	8	80	0.1000000
NODE_5278_length_1082_cov_17.422177	459	539	8	1	80	0.0125000
NODE_5278_length_1082_cov_17.422177	459	539	9	50	80	0.6250000
NODE_5279_length_1082_cov_15.906409	442	522	5	11	80	0.1375000
NODE_5279_length_1082_cov_15.906409	442	522	6	1	80	0.0125000
NODE_5279_length_1082_cov_15.906409	442	522	10	68	80	0.8500000
NODE_5279_length_1082_cov_15.906409	495	575	5	25	80	0.3125000
NODE_5279_length_1082_cov_15.906409	495	575	9	1	80	0.0125000
NODE_5279_length_1082_cov_15.906409	495	575	10	54	80	0.6750000
NODE_5280_length_1082_cov_13.703967	324	404	0	21	80	0.2625000
NODE_5280_length_1082_cov_13.703967	324	404	2	59	80	0.7375000
NODE_5280_length_1082_cov_13.703967	377	457	0	8	80	0.1000000
NODE_5280_length_1082_cov_13.703967	377	457	2	72	80	0.9000000
NODE_5281_length_1082_cov_6.478128	159	205	4	6	46	0.1304348
NODE_5281_length_1082_cov_6.478128	159	205	6	1	46	0.0217391
NODE_5281_length_1082_cov_6.478128	159	205	8	16	46	0.3478261
NODE_5281_length_1082_cov_6.478128	159	205	10	17	46	0.3695652
NODE_5281_length_1082_cov_6.478128	159	205	12	3	46	0.0652174
NODE_5281_length_1082_cov_6.478128	159	205	15	3	46	0.0652174
NODE_5281_length_1082_cov_6.478128	203	283	4	9	80	0.1125000
NODE_5281_length_1082_cov_6.478128	203	283	6	44	80	0.5500000
NODE_5281_length_1082_cov_6.478128	203	283	8	27	80	0.3375000
NODE_5281_length_1082_cov_6.478128	256	336	0	6	80	0.0750000
NODE_5281_length_1082_cov_6.478128	256	336	2	25	80	0.3125000
NODE_5281_length_1082_cov_6.478128	256	336	4	11	80	0.1375000
NODE_5281_length_1082_cov_6.478128	256	336	6	4	80	0.0500000
NODE_5281_length_1082_cov_6.478128	256	336	8	34	80	0.4250000
NODE_5281_length_1082_cov_6.478128	861	941	0	80	80	1.0000000
NODE_5282_length_1082_cov_4.218718	982	1062	116	1	80	0.0125000
NODE_5282_length_1082_cov_4.218718	982	1062	118	1	80	0.0125000
NODE_5282_length_1082_cov_4.218718	982	1062	126	1	80	0.0125000
NODE_5282_length_1082_cov_4.218718	982	1062	132	1	80	0.0125000
NODE_5282_length_1082_cov_4.218718	982	1062	140	1	80	0.0125000
NODE_5282_length_1082_cov_4.218718	982	1062	148	1	80	0.0125000
NODE_5282_length_1082_cov_4.218718	982	1062	152	2	80	0.0250000
NODE_5282_length_1082_cov_4.218718	982	1062	154	1	80	0.0125000
NODE_5282_length_1082_cov_4.218718	982	1062	155	1	80	0.0125000
NODE_5282_length_1082_cov_4.218718	982	1062	157	1	80	0.0125000
NODE_5282_length_1082_cov_4.218718	982	1062	161	3	80	0.0375000
NODE_5282_length_1082_cov_4.218718	982	1062	165	1	80	0.0125000
NODE_5282_length_1082_cov_4.218718	982	1062	171	1	80	0.0125000
NODE_5282_length_1082_cov_4.218718	982	1062	184	1	80	0.0125000
NODE_5282_length_1082_cov_4.218718	982	1062	186	1	80	0.0125000
NODE_5282_length_1082_cov_4.218718	982	1062	195	1	80	0.0125000
NODE_5282_length_1082_cov_4.218718	982	1062	197	1	80	0.0125000
NODE_5282_length_1082_cov_4.218718	982	1062	201	1	80	0.0125000
NODE_5282_length_1082_cov_4.218718	982	1062	219	1	80	0.0125000
NODE_5282_length_1082_cov_4.218718	982	1062	220	1	80	0.0125000
NODE_5282_length_1082_cov_4.218718	982	1062	224	1	80	0.0125000
NODE_5282_length_1082_cov_4.218718	982	1062	230	1	80	0.0125000
NODE_5282_length_1082_cov_4.218718	982	1062	243	1	80	0.0125000
NODE_5282_length_1082_cov_4.218718	982	1062	245	1	80	0.0125000
NODE_5282_length_1082_cov_4.218718	982	1062	247	2	80	0.0250000
NODE_5282_length_1082_cov_4.218718	982	1062	250	2	80	0.0250000
NODE_5282_length_1082_cov_4.218718	982	1062	251	1	80	0.0125000
NODE_5282_length_1082_cov_4.218718	982	1062	252	1	80	0.0125000
NODE_5282_length_1082_cov_4.218718	982	1062	253	1	80	0.0125000
NODE_5282_length_1082_cov_4.218718	982	1062	261	1	80	0.0125000
NODE_5282_length_1082_cov_4.218718	982	1062	269	1	80	0.0125000
NODE_5282_length_1082_cov_4.218718	982	1062	276	2	80	0.0250000
NODE_5282_length_1082_cov_4.218718	982	1062	280	1	80	0.0125000
NODE_5282_length_1082_cov_4.218718	982	1062	286	1	80	0.0125000
NODE_5282_length_1082_cov_4.218718	982	1062	295	1	80	0.0125000
NODE_5282_length_1082_cov_4.218718	982	1062	299	1	80	0.0125000
NODE_5282_length_1082_cov_4.218718	982	1062	300	1	80	0.0125000
NODE_5282_length_1082_cov_4.218718	982	1062	306	1	80	0.0125000
NODE_5282_length_1082_cov_4.218718	982	1062	310	1	80	0.0125000
NODE_5282_length_1082_cov_4.218718	982	1062	314	1	80	0.0125000
NODE_5282_length_1082_cov_4.218718	982	1062	324	1	80	0.0125000
NODE_5282_length_1082_cov_4.218718	982	1062	326	1	80	0.0125000
NODE_5282_length_1082_cov_4.218718	982	1062	330	2	80	0.0250000
NODE_5282_length_1082_cov_4.218718	982	1062	333	2	80	0.0250000
NODE_5282_length_1082_cov_4.218718	982	1062	340	5	80	0.0625000
NODE_5282_length_1082_cov_4.218718	982	1062	342	1	80	0.0125000
NODE_5282_length_1082_cov_4.218718	982	1062	352	1	80	0.0125000
NODE_5282_length_1082_cov_4.218718	982	1062	356	1	80	0.0125000
NODE_5282_length_1082_cov_4.218718	982	1062	357	2	80	0.0250000
NODE_5282_length_1082_cov_4.218718	982	1062	369	1	80	0.0125000
NODE_5282_length_1082_cov_4.218718	982	1062	372	1	80	0.0125000
NODE_5282_length_1082_cov_4.218718	982	1062	374	1	80	0.0125000
NODE_5282_length_1082_cov_4.218718	982	1062	380	2	80	0.0250000
NODE_5282_length_1082_cov_4.218718	982	1062	382	1	80	0.0125000
NODE_5282_length_1082_cov_4.218718	982	1062	384	1	80	0.0125000
NODE_5282_length_1082_cov_4.218718	982	1062	390	2	80	0.0250000
NODE_5282_length_1082_cov_4.218718	982	1062	394	1	80	0.0125000
NODE_5282_length_1082_cov_4.218718	982	1062	395	1	80	0.0125000
NODE_5282_length_1082_cov_4.218718	982	1062	397	1	80	0.0125000
NODE_5282_length_1082_cov_4.218718	982	1062	398	1	80	0.0125000
NODE_5282_length_1082_cov_4.218718	982	1062	400	1	80	0.0125000
NODE_5282_length_1082_cov_4.218718	982	1062	402	1	80	0.0125000
NODE_5282_length_1082_cov_4.218718	982	1062	404	2	80	0.0250000
NODE_5282_length_1082_cov_4.218718	982	1062	406	1	80	0.0125000
NODE_5291_length_1081_cov_45.308554	510	590	6	61	80	0.7625000
NODE_5291_length_1081_cov_45.308554	510	590	7	19	80	0.2375000
NODE_5291_length_1081_cov_45.308554	563	643	2	53	80	0.6625000
NODE_5291_length_1081_cov_45.308554	563	643	6	8	80	0.1000000
NODE_5291_length_1081_cov_45.308554	563	643	7	19	80	0.2375000
NODE_5292_length_1081_cov_39.581466	476	556	24	7	80	0.0875000
NODE_5292_length_1081_cov_39.581466	476	556	36	52	80	0.6500000
NODE_5292_length_1081_cov_39.581466	476	556	37	11	80	0.1375000
NODE_5292_length_1081_cov_39.581466	476	556	38	10	80	0.1250000
NODE_5292_length_1081_cov_39.581466	529	609	2	10	80	0.1250000
NODE_5292_length_1081_cov_39.581466	529	609	10	33	80	0.4125000
NODE_5292_length_1081_cov_39.581466	529	609	16	3	80	0.0375000
NODE_5292_length_1081_cov_39.581466	529	609	24	14	80	0.1750000
NODE_5292_length_1081_cov_39.581466	529	609	37	11	80	0.1375000
NODE_5292_length_1081_cov_39.581466	529	609	38	9	80	0.1125000
NODE_5292_length_1081_cov_39.581466	605	685	0	15	80	0.1875000
NODE_5292_length_1081_cov_39.581466	605	685	2	65	80	0.8125000
NODE_5292_length_1081_cov_39.581466	658	738	0	68	80	0.8500000
NODE_5292_length_1081_cov_39.581466	658	738	2	12	80	0.1500000
NODE_5293_length_1081_cov_39.457230	373	453	0	80	80	1.0000000
NODE_5293_length_1081_cov_39.457230	426	506	0	80	80	1.0000000
NODE_5294_length_1081_cov_20.415479	376	451	0	75	75	1.0000000
NODE_5294_length_1081_cov_20.415479	436	511	0	75	75	1.0000000
NODE_5294_length_1081_cov_20.415479	496	571	0	75	75	1.0000000
NODE_5294_length_1081_cov_20.415479	544	624	0	80	80	1.0000000
NODE_5295_length_1081_cov_19.985743	378	458	0	80	80	1.0000000
NODE_5295_length_1081_cov_19.985743	431	511	0	80	80	1.0000000
NODE_5295_length_1081_cov_19.985743	507	587	0	80	80	1.0000000
NODE_5295_length_1081_cov_19.985743	560	640	0	80	80	1.0000000
NODE_5296_length_1081_cov_12.658859	468	548	0	2	80	0.0250000
NODE_5296_length_1081_cov_12.658859	468	548	2	78	80	0.9750000
NODE_5296_length_1081_cov_12.658859	521	601	0	55	80	0.6875000
NODE_5296_length_1081_cov_12.658859	521	601	2	25	80	0.3125000
NODE_5299_length_1081_cov_2.586558	7	44	0	37	37	1.0000000
NODE_5304_length_1080_cov_27.857288	261	341	0	79	80	0.9875000
NODE_5304_length_1080_cov_27.857288	261	341	6	1	80	0.0125000
NODE_5304_length_1080_cov_27.857288	314	394	0	36	80	0.4500000
NODE_5304_length_1080_cov_27.857288	314	394	5	10	80	0.1250000
NODE_5304_length_1080_cov_27.857288	314	394	6	34	80	0.4250000
NODE_5305_length_1080_cov_24.258919	321	401	0	80	80	1.0000000
NODE_5305_length_1080_cov_24.258919	374	454	0	47	80	0.5875000
NODE_5305_length_1080_cov_24.258919	374	454	4	33	80	0.4125000
NODE_5305_length_1080_cov_24.258919	450	530	0	2	80	0.0250000
NODE_5305_length_1080_cov_24.258919	450	530	4	78	80	0.9750000
NODE_5305_length_1080_cov_24.258919	503	583	0	55	80	0.6875000
NODE_5305_length_1080_cov_24.258919	503	583	4	25	80	0.3125000
NODE_5306_length_1080_cov_22.589195	446	526	0	80	80	1.0000000
NODE_5306_length_1080_cov_22.589195	499	579	0	80	80	1.0000000
NODE_5306_length_1080_cov_22.589195	575	655	0	49	80	0.6125000
NODE_5306_length_1080_cov_22.589195	575	655	4	31	80	0.3875000
NODE_5306_length_1080_cov_22.589195	628	708	3	4	80	0.0500000
NODE_5306_length_1080_cov_22.589195	628	708	4	31	80	0.3875000
NODE_5306_length_1080_cov_22.589195	628	708	5	7	80	0.0875000
NODE_5306_length_1080_cov_22.589195	628	708	7	21	80	0.2625000
NODE_5306_length_1080_cov_22.589195	628	708	9	17	80	0.2125000
NODE_5307_length_1080_cov_15.544343	599	679	0	6	80	0.0750000
NODE_5307_length_1080_cov_15.544343	599	679	2	2	80	0.0250000
NODE_5307_length_1080_cov_15.544343	599	679	4	37	80	0.4625000
NODE_5307_length_1080_cov_15.544343	599	679	6	35	80	0.4375000
NODE_5307_length_1080_cov_15.544343	652	732	2	40	80	0.5000000
NODE_5307_length_1080_cov_15.544343	652	732	4	2	80	0.0250000
NODE_5307_length_1080_cov_15.544343	652	732	6	38	80	0.4750000
NODE_5308_length_1080_cov_10.416922	321	401	0	44	80	0.5500000
NODE_5308_length_1080_cov_10.416922	321	401	2	17	80	0.2125000
NODE_5308_length_1080_cov_10.416922	321	401	4	19	80	0.2375000
NODE_5308_length_1080_cov_10.416922	374	454	2	8	80	0.1000000
NODE_5308_length_1080_cov_10.416922	374	454	4	19	80	0.2375000
NODE_5308_length_1080_cov_10.416922	374	454	6	3	80	0.0375000
NODE_5308_length_1080_cov_10.416922	374	454	8	3	80	0.0375000
NODE_5308_length_1080_cov_10.416922	374	454	10	8	80	0.1000000
NODE_5308_length_1080_cov_10.416922	374	454	12	39	80	0.4875000
NODE_5315_length_1079_cov_55.352041	367	447	0	60	80	0.7500000
NODE_5315_length_1079_cov_55.352041	367	447	2	20	80	0.2500000
NODE_5315_length_1079_cov_55.352041	420	500	0	80	80	1.0000000
NODE_5315_length_1079_cov_55.352041	496	576	0	80	80	1.0000000
NODE_5315_length_1079_cov_55.352041	549	629	0	80	80	1.0000000
NODE_5316_length_1079_cov_46.879592	444	524	0	80	80	1.0000000
NODE_5316_length_1079_cov_46.879592	497	577	0	80	80	1.0000000
NODE_5316_length_1079_cov_46.879592	573	652	0	79	79	1.0000000
NODE_5316_length_1079_cov_46.879592	625	703	0	78	78	1.0000000
NODE_5317_length_1079_cov_13.708163	611	691	0	24	80	0.3000000
NODE_5317_length_1079_cov_13.708163	611	691	2	56	80	0.7000000
NODE_5317_length_1079_cov_13.708163	664	744	0	27	80	0.3375000
NODE_5317_length_1079_cov_13.708163	664	744	2	53	80	0.6625000
NODE_5318_length_1079_cov_8.632653	416	496	0	36	80	0.4500000
NODE_5318_length_1079_cov_8.632653	416	496	2	44	80	0.5500000
NODE_5318_length_1079_cov_8.632653	469	549	0	14	80	0.1750000
NODE_5318_length_1079_cov_8.632653	469	549	2	66	80	0.8250000
NODE_5325_length_1078_cov_27.804903	357	437	6	69	80	0.8625000
NODE_5325_length_1078_cov_27.804903	357	437	8	11	80	0.1375000
NODE_5325_length_1078_cov_27.804903	410	490	2	40	80	0.5000000
NODE_5325_length_1078_cov_27.804903	410	490	6	29	80	0.3625000
NODE_5325_length_1078_cov_27.804903	410	490	8	11	80	0.1375000
NODE_5326_length_1078_cov_26.071502	459	539	0	80	80	1.0000000
NODE_5326_length_1078_cov_26.071502	512	592	0	80	80	1.0000000
NODE_5326_length_1078_cov_26.071502	588	668	0	80	80	1.0000000
NODE_5326_length_1078_cov_26.071502	641	718	0	77	77	1.0000000
NODE_5327_length_1078_cov_14.985700	495	575	0	79	80	0.9875000
NODE_5327_length_1078_cov_14.985700	495	575	2	1	80	0.0125000
NODE_5327_length_1078_cov_14.985700	548	628	0	26	80	0.3250000
NODE_5327_length_1078_cov_14.985700	548	628	2	3	80	0.0375000
NODE_5327_length_1078_cov_14.985700	548	628	4	51	80	0.6375000
NODE_5333_length_1077_cov_23.876278	546	626	0	80	80	1.0000000
NODE_5333_length_1077_cov_23.876278	599	679	0	80	80	1.0000000
NODE_5334_length_1077_cov_16.067485	532	612	0	80	80	1.0000000
NODE_5334_length_1077_cov_16.067485	585	665	0	80	80	1.0000000
NODE_5335_length_1077_cov_14.568507	556	636	0	29	80	0.3625000
NODE_5335_length_1077_cov_14.568507	556	636	4	51	80	0.6375000
NODE_5335_length_1077_cov_14.568507	609	689	4	80	80	1.0000000
NODE_5336_length_1077_cov_9.507157	496	576	0	80	80	1.0000000
NODE_5336_length_1077_cov_9.507157	549	629	0	80	80	1.0000000
NODE_5342_length_1077_cov_1.781186	252	274	0	22	22	1.0000000
NODE_5345_length_1076_cov_20.592631	534	614	0	29	80	0.3625000
NODE_5345_length_1076_cov_20.592631	534	614	2	14	80	0.1750000
NODE_5345_length_1076_cov_20.592631	534	614	3	8	80	0.1000000
NODE_5345_length_1076_cov_20.592631	534	614	4	29	80	0.3625000
NODE_5345_length_1076_cov_20.592631	587	667	2	13	80	0.1625000
NODE_5345_length_1076_cov_20.592631	587	667	4	67	80	0.8375000
NODE_5346_length_1076_cov_14.788127	427	507	0	80	80	1.0000000
NODE_5346_length_1076_cov_14.788127	480	560	0	80	80	1.0000000
NODE_5348_length_1076_cov_6.306039	883	961	0	78	78	1.0000000
NODE_5348_length_1076_cov_6.306039	936	1014	0	78	78	1.0000000
NODE_5357_length_1075_cov_37.941598	550	630	0	15	80	0.1875000
NODE_5357_length_1075_cov_37.941598	550	630	2	65	80	0.8125000
NODE_5357_length_1075_cov_37.941598	603	685	2	71	82	0.8658537
NODE_5357_length_1075_cov_37.941598	603	685	4	11	82	0.1341463
NODE_5357_length_1075_cov_37.941598	681	761	2	80	80	1.0000000
NODE_5357_length_1075_cov_37.941598	734	814	0	53	80	0.6625000
NODE_5357_length_1075_cov_37.941598	734	814	2	27	80	0.3375000
NODE_5358_length_1075_cov_32.224385	397	477	0	80	80	1.0000000
NODE_5358_length_1075_cov_32.224385	450	530	0	80	80	1.0000000
NODE_5359_length_1075_cov_9.626025	440	520	0	24	80	0.3000000
NODE_5359_length_1075_cov_9.626025	440	520	2	56	80	0.7000000
NODE_5359_length_1075_cov_9.626025	493	573	0	11	80	0.1375000
NODE_5359_length_1075_cov_9.626025	493	573	2	69	80	0.8625000
NODE_5362_length_1075_cov_2.926230	38	99	0	61	61	1.0000000
NODE_5372_length_1074_cov_19.034872	568	648	6	80	80	1.0000000
NODE_5372_length_1074_cov_19.034872	621	701	0	45	80	0.5625000
NODE_5372_length_1074_cov_19.034872	621	701	6	35	80	0.4375000
NODE_5372_length_1074_cov_19.034872	697	777	0	80	80	1.0000000
NODE_5372_length_1074_cov_19.034872	750	830	0	80	80	1.0000000
NODE_5373_length_1074_cov_9.450256	577	657	0	38	80	0.4750000
NODE_5373_length_1074_cov_9.450256	577	657	4	42	80	0.5250000
NODE_5373_length_1074_cov_9.450256	630	710	4	80	80	1.0000000
NODE_5374_length_1074_cov_9.155897	526	606	0	80	80	1.0000000
NODE_5374_length_1074_cov_9.155897	579	659	0	80	80	1.0000000
NODE_5374_length_1074_cov_9.155897	655	735	0	80	80	1.0000000
NODE_5374_length_1074_cov_9.155897	708	788	0	80	80	1.0000000
NODE_5375_length_1074_cov_4.600000	606	686	0	63	80	0.7875000
NODE_5375_length_1074_cov_4.600000	606	686	2	17	80	0.2125000
NODE_5375_length_1074_cov_4.600000	659	739	0	10	80	0.1250000
NODE_5375_length_1074_cov_4.600000	659	739	2	70	80	0.8750000
NODE_5376_length_1074_cov_4.328205	32	112	6	5	80	0.0625000
NODE_5376_length_1074_cov_4.328205	32	112	14	25	80	0.3125000
NODE_5376_length_1074_cov_4.328205	32	112	16	23	80	0.2875000
NODE_5376_length_1074_cov_4.328205	32	112	18	6	80	0.0750000
NODE_5376_length_1074_cov_4.328205	32	112	20	21	80	0.2625000
NODE_5380_length_1073_cov_60.012320	448	528	0	80	80	1.0000000
NODE_5380_length_1073_cov_60.012320	501	581	0	80	80	1.0000000
NODE_5382_length_1073_cov_26.415811	529	609	9	27	80	0.3375000
NODE_5382_length_1073_cov_26.415811	529	609	14	1	80	0.0125000
NODE_5382_length_1073_cov_26.415811	529	609	15	52	80	0.6500000
NODE_5382_length_1073_cov_26.415811	582	662	0	9	80	0.1125000
NODE_5382_length_1073_cov_26.415811	582	662	8	31	80	0.3875000
NODE_5382_length_1073_cov_26.415811	582	662	9	40	80	0.5000000
NODE_5383_length_1073_cov_19.062628	571	651	1	80	80	1.0000000
NODE_5383_length_1073_cov_19.062628	624	704	0	4	80	0.0500000
NODE_5383_length_1073_cov_19.062628	624	704	1	76	80	0.9500000
NODE_5384_length_1073_cov_18.536961	447	527	2	10	80	0.1250000
NODE_5384_length_1073_cov_18.536961	447	527	3	18	80	0.2250000
NODE_5384_length_1073_cov_18.536961	447	527	5	52	80	0.6500000
NODE_5384_length_1073_cov_18.536961	500	580	3	28	80	0.3500000
NODE_5384_length_1073_cov_18.536961	500	580	5	52	80	0.6500000
NODE_5384_length_1073_cov_18.536961	576	656	3	22	80	0.2750000
NODE_5384_length_1073_cov_18.536961	576	656	5	34	80	0.4250000
NODE_5384_length_1073_cov_18.536961	576	656	6	1	80	0.0125000
NODE_5384_length_1073_cov_18.536961	576	656	7	23	80	0.2875000
NODE_5384_length_1073_cov_18.536961	629	709	1	33	80	0.4125000
NODE_5384_length_1073_cov_18.536961	629	709	3	2	80	0.0250000
NODE_5384_length_1073_cov_18.536961	629	709	5	28	80	0.3500000
NODE_5384_length_1073_cov_18.536961	629	709	7	17	80	0.2125000
NODE_5385_length_1073_cov_15.318275	712	792	2	41	80	0.5125000
NODE_5385_length_1073_cov_15.318275	712	792	4	39	80	0.4875000
NODE_5385_length_1073_cov_15.318275	765	845	2	48	80	0.6000000
NODE_5385_length_1073_cov_15.318275	765	845	4	32	80	0.4000000
NODE_5386_length_1073_cov_8.376797	287	367	0	80	80	1.0000000
NODE_5386_length_1073_cov_8.376797	340	420	0	80	80	1.0000000
NODE_5387_length_1073_cov_5.749487	257	337	0	80	80	1.0000000
NODE_5387_length_1073_cov_5.749487	310	390	0	80	80	1.0000000
NODE_5388_length_1073_cov_5.156057	408	444	0	36	36	1.0000000
NODE_5390_length_1073_cov_3.019507	1	69	0	31	68	0.4558823
NODE_5390_length_1073_cov_3.019507	1	69	4	37	68	0.5441176
NODE_5390_length_1073_cov_3.019507	42	122	4	80	80	1.0000000
NODE_5399_length_1072_cov_62.729702	351	431	0	42	80	0.5250000
NODE_5399_length_1072_cov_62.729702	351	431	33	1	80	0.0125000
NODE_5399_length_1072_cov_62.729702	351	431	34	2	80	0.0250000
NODE_5399_length_1072_cov_62.729702	351	431	35	14	80	0.1750000
NODE_5399_length_1072_cov_62.729702	351	431	36	7	80	0.0875000
NODE_5399_length_1072_cov_62.729702	351	431	38	3	80	0.0375000
NODE_5399_length_1072_cov_62.729702	351	431	39	6	80	0.0750000
NODE_5399_length_1072_cov_62.729702	351	431	41	5	80	0.0625000
NODE_5399_length_1072_cov_62.729702	404	484	35	6	80	0.0750000
NODE_5399_length_1072_cov_62.729702	404	484	36	7	80	0.0875000
NODE_5399_length_1072_cov_62.729702	404	484	38	3	80	0.0375000
NODE_5399_length_1072_cov_62.729702	404	484	39	6	80	0.0750000
NODE_5399_length_1072_cov_62.729702	404	484	41	9	80	0.1125000
NODE_5399_length_1072_cov_62.729702	404	484	42	3	80	0.0375000
NODE_5399_length_1072_cov_62.729702	404	484	43	36	80	0.4500000
NODE_5399_length_1072_cov_62.729702	404	484	44	10	80	0.1250000
NODE_5399_length_1072_cov_62.729702	480	560	4	31	80	0.3875000
NODE_5399_length_1072_cov_62.729702	480	560	40	1	80	0.0125000
NODE_5399_length_1072_cov_62.729702	480	560	41	5	80	0.0625000
NODE_5399_length_1072_cov_62.729702	480	560	42	26	80	0.3250000
NODE_5399_length_1072_cov_62.729702	480	560	43	17	80	0.2125000
NODE_5399_length_1072_cov_62.729702	533	613	0	30	80	0.3750000
NODE_5399_length_1072_cov_62.729702	533	613	2	19	80	0.2375000
NODE_5399_length_1072_cov_62.729702	533	613	4	31	80	0.3875000
NODE_5400_length_1072_cov_34.045221	430	510	0	33	80	0.4125000
NODE_5400_length_1072_cov_34.045221	430	510	2	47	80	0.5875000
NODE_5400_length_1072_cov_34.045221	483	563	0	80	80	1.0000000
NODE_5401_length_1072_cov_34.006166	342	423	1	2	81	0.0246914
NODE_5401_length_1072_cov_34.006166	342	423	2	48	81	0.5925926
NODE_5401_length_1072_cov_34.006166	342	423	3	13	81	0.1604938
NODE_5401_length_1072_cov_34.006166	342	423	4	18	81	0.2222222
NODE_5401_length_1072_cov_34.006166	396	476	2	41	80	0.5125000
NODE_5401_length_1072_cov_34.006166	396	476	4	39	80	0.4875000
NODE_5401_length_1072_cov_34.006166	472	552	0	50	80	0.6250000
NODE_5401_length_1072_cov_34.006166	472	552	2	30	80	0.3750000
NODE_5401_length_1072_cov_34.006166	525	605	0	15	80	0.1875000
NODE_5401_length_1072_cov_34.006166	525	605	2	65	80	0.8125000
NODE_5403_length_1072_cov_21.852004	300	380	0	80	80	1.0000000
NODE_5403_length_1072_cov_21.852004	353	433	0	80	80	1.0000000
NODE_5404_length_1072_cov_21.532374	476	556	0	80	80	1.0000000
NODE_5404_length_1072_cov_21.532374	529	609	0	80	80	1.0000000
NODE_5405_length_1072_cov_17.018499	415	495	0	80	80	1.0000000
NODE_5405_length_1072_cov_17.018499	468	548	0	80	80	1.0000000
NODE_5410_length_1072_cov_3.302158	388	449	0	61	61	1.0000000
NODE_5410_length_1072_cov_3.302158	422	502	0	80	80	1.0000000
NODE_5414_length_1072_cov_1.773895	114	176	2	2	62	0.0322581
NODE_5414_length_1072_cov_1.773895	114	176	4	9	62	0.1451613
NODE_5414_length_1072_cov_1.773895	114	176	5	3	62	0.0483871
NODE_5414_length_1072_cov_1.773895	114	176	7	1	62	0.0161290
NODE_5414_length_1072_cov_1.773895	114	176	9	6	62	0.0967742
NODE_5414_length_1072_cov_1.773895	114	176	10	8	62	0.1290323
NODE_5414_length_1072_cov_1.773895	114	176	12	6	62	0.0967742
NODE_5414_length_1072_cov_1.773895	114	176	14	1	62	0.0161290
NODE_5414_length_1072_cov_1.773895	114	176	16	5	62	0.0806452
NODE_5414_length_1072_cov_1.773895	114	176	18	3	62	0.0483871
NODE_5414_length_1072_cov_1.773895	114	176	20	2	62	0.0322581
NODE_5414_length_1072_cov_1.773895	114	176	24	2	62	0.0322581
NODE_5414_length_1072_cov_1.773895	114	176	26	3	62	0.0483871
NODE_5414_length_1072_cov_1.773895	114	176	28	9	62	0.1451613
NODE_5414_length_1072_cov_1.773895	114	176	30	2	62	0.0322581
NODE_5417_length_1071_cov_27.565844	312	392	1	16	80	0.2000000
NODE_5417_length_1071_cov_27.565844	312	392	2	47	80	0.5875000
NODE_5417_length_1071_cov_27.565844	312	392	6	17	80	0.2125000
NODE_5417_length_1071_cov_27.565844	365	445	1	69	80	0.8625000
NODE_5417_length_1071_cov_27.565844	365	445	2	11	80	0.1375000
NODE_5419_length_1071_cov_12.666667	480	560	0	80	80	1.0000000
NODE_5419_length_1071_cov_12.666667	533	613	0	80	80	1.0000000
NODE_5421_length_1071_cov_8.942387	418	498	0	69	80	0.8625000
NODE_5421_length_1071_cov_8.942387	418	498	2	11	80	0.1375000
NODE_5421_length_1071_cov_8.942387	471	551	0	16	80	0.2000000
NODE_5421_length_1071_cov_8.942387	471	551	2	64	80	0.8000000
NODE_5427_length_1070_cov_39.255407	591	671	0	53	80	0.6625000
NODE_5427_length_1070_cov_39.255407	591	671	2	27	80	0.3375000
NODE_5427_length_1070_cov_39.255407	644	724	2	80	80	1.0000000
NODE_5428_length_1070_cov_21.903193	430	510	2	50	80	0.6250000
NODE_5428_length_1070_cov_21.903193	430	510	4	30	80	0.3750000
NODE_5428_length_1070_cov_21.903193	483	563	0	9	80	0.1125000
NODE_5428_length_1070_cov_21.903193	483	563	1	38	80	0.4750000
NODE_5428_length_1070_cov_21.903193	483	563	2	33	80	0.4125000
NODE_5428_length_1070_cov_21.903193	559	639	0	46	80	0.5750000
NODE_5428_length_1070_cov_21.903193	559	639	6	34	80	0.4250000
NODE_5428_length_1070_cov_21.903193	612	692	6	80	80	1.0000000
NODE_5429_length_1070_cov_8.963955	871	900	2	2	29	0.0689655
NODE_5429_length_1070_cov_8.963955	871	900	5	3	29	0.1034483
NODE_5429_length_1070_cov_8.963955	871	900	7	5	29	0.1724138
NODE_5429_length_1070_cov_8.963955	871	900	11	2	29	0.0689655
NODE_5429_length_1070_cov_8.963955	871	900	13	5	29	0.1724138
NODE_5429_length_1070_cov_8.963955	871	900	21	1	29	0.0344828
NODE_5429_length_1070_cov_8.963955	871	900	23	1	29	0.0344828
NODE_5429_length_1070_cov_8.963955	871	900	27	2	29	0.0689655
NODE_5429_length_1070_cov_8.963955	871	900	29	2	29	0.0689655
NODE_5429_length_1070_cov_8.963955	871	900	31	1	29	0.0344828
NODE_5429_length_1070_cov_8.963955	871	900	33	1	29	0.0344828
NODE_5429_length_1070_cov_8.963955	871	900	35	1	29	0.0344828
NODE_5429_length_1070_cov_8.963955	871	900	36	1	29	0.0344828
NODE_5429_length_1070_cov_8.963955	871	900	46	1	29	0.0344828
NODE_5429_length_1070_cov_8.963955	871	900	59	1	29	0.0344828
NODE_5429_length_1070_cov_8.963955	873	953	5	3	80	0.0375000
NODE_5429_length_1070_cov_8.963955	873	953	7	5	80	0.0625000
NODE_5429_length_1070_cov_8.963955	873	953	11	2	80	0.0250000
NODE_5429_length_1070_cov_8.963955	873	953	13	5	80	0.0625000
NODE_5429_length_1070_cov_8.963955	873	953	21	1	80	0.0125000
NODE_5429_length_1070_cov_8.963955	873	953	23	1	80	0.0125000
NODE_5429_length_1070_cov_8.963955	873	953	27	2	80	0.0250000
NODE_5429_length_1070_cov_8.963955	873	953	29	2	80	0.0250000
NODE_5429_length_1070_cov_8.963955	873	953	31	1	80	0.0125000
NODE_5429_length_1070_cov_8.963955	873	953	33	1	80	0.0125000
NODE_5429_length_1070_cov_8.963955	873	953	35	1	80	0.0125000
NODE_5429_length_1070_cov_8.963955	873	953	36	1	80	0.0125000
NODE_5429_length_1070_cov_8.963955	873	953	46	1	80	0.0125000
NODE_5429_length_1070_cov_8.963955	873	953	59	2	80	0.0250000
NODE_5429_length_1070_cov_8.963955	873	953	65	1	80	0.0125000
NODE_5429_length_1070_cov_8.963955	873	953	67	2	80	0.0250000
NODE_5429_length_1070_cov_8.963955	873	953	68	1	80	0.0125000
NODE_5429_length_1070_cov_8.963955	873	953	72	2	80	0.0250000
NODE_5429_length_1070_cov_8.963955	873	953	77	2	80	0.0250000
NODE_5429_length_1070_cov_8.963955	873	953	79	2	80	0.0250000
NODE_5429_length_1070_cov_8.963955	873	953	83	1	80	0.0125000
NODE_5429_length_1070_cov_8.963955	873	953	85	1	80	0.0125000
NODE_5429_length_1070_cov_8.963955	873	953	90	1	80	0.0125000
NODE_5429_length_1070_cov_8.963955	873	953	96	5	80	0.0625000
NODE_5429_length_1070_cov_8.963955	873	953	100	5	80	0.0625000
NODE_5429_length_1070_cov_8.963955	873	953	103	1	80	0.0125000
NODE_5429_length_1070_cov_8.963955	873	953	104	4	80	0.0500000
NODE_5429_length_1070_cov_8.963955	873	953	105	1	80	0.0125000
NODE_5429_length_1070_cov_8.963955	873	953	109	2	80	0.0250000
NODE_5429_length_1070_cov_8.963955	873	953	111	1	80	0.0125000
NODE_5429_length_1070_cov_8.963955	873	953	114	1	80	0.0125000
NODE_5429_length_1070_cov_8.963955	873	953	116	1	80	0.0125000
NODE_5429_length_1070_cov_8.963955	873	953	120	1	80	0.0125000
NODE_5429_length_1070_cov_8.963955	873	953	122	14	80	0.1750000
NODE_5429_length_1070_cov_8.963955	873	953	124	3	80	0.0375000
NODE_5433_length_1070_cov_1.659114	1027	1046	0	19	19	1.0000000
NODE_5439_length_1069_cov_40.277320	451	531	0	80	80	1.0000000
NODE_5439_length_1069_cov_40.277320	504	584	0	80	80	1.0000000
NODE_5440_length_1069_cov_23.571134	274	354	4	20	80	0.2500000
NODE_5440_length_1069_cov_23.571134	274	354	8	45	80	0.5625000
NODE_5440_length_1069_cov_23.571134	274	354	10	14	80	0.1750000
NODE_5440_length_1069_cov_23.571134	274	354	12	1	80	0.0125000
NODE_5440_length_1069_cov_23.571134	327	407	0	12	80	0.1500000
NODE_5440_length_1069_cov_23.571134	327	407	4	61	80	0.7625000
NODE_5440_length_1069_cov_23.571134	327	407	10	7	80	0.0875000
NODE_5441_length_1069_cov_22.436082	185	265	0	80	80	1.0000000
NODE_5441_length_1069_cov_22.436082	238	318	0	80	80	1.0000000
NODE_5442_length_1069_cov_18.207216	436	516	0	8	80	0.1000000
NODE_5442_length_1069_cov_18.207216	436	516	2	39	80	0.4875000
NODE_5442_length_1069_cov_18.207216	436	516	4	33	80	0.4125000
NODE_5442_length_1069_cov_18.207216	489	569	2	31	80	0.3875000
NODE_5442_length_1069_cov_18.207216	489	569	4	49	80	0.6125000
NODE_5443_length_1069_cov_17.601031	596	676	0	40	80	0.5000000
NODE_5443_length_1069_cov_17.601031	596	676	2	40	80	0.5000000
NODE_5443_length_1069_cov_17.601031	649	729	0	6	80	0.0750000
NODE_5443_length_1069_cov_17.601031	649	729	2	74	80	0.9250000
NODE_5444_length_1069_cov_16.318557	353	433	0	24	80	0.3000000
NODE_5444_length_1069_cov_16.318557	353	433	10	56	80	0.7000000
NODE_5444_length_1069_cov_16.318557	406	486	10	80	80	1.0000000
NODE_5444_length_1069_cov_16.318557	482	562	0	32	80	0.4000000
NODE_5444_length_1069_cov_16.318557	482	562	1	24	80	0.3000000
NODE_5444_length_1069_cov_16.318557	482	562	10	5	80	0.0625000
NODE_5444_length_1069_cov_16.318557	482	562	11	19	80	0.2375000
NODE_5444_length_1069_cov_16.318557	535	615	0	47	80	0.5875000
NODE_5444_length_1069_cov_16.318557	535	615	1	33	80	0.4125000
NODE_5445_length_1069_cov_13.349485	471	551	0	80	80	1.0000000
NODE_5445_length_1069_cov_13.349485	524	604	0	78	80	0.9750000
NODE_5445_length_1069_cov_13.349485	524	604	2	2	80	0.0250000
NODE_5446_length_1069_cov_13.050515	314	394	0	37	80	0.4625000
NODE_5446_length_1069_cov_13.050515	314	394	2	43	80	0.5375000
NODE_5446_length_1069_cov_13.050515	367	447	0	80	80	1.0000000
NODE_5447_length_1069_cov_12.818557	240	320	0	80	80	1.0000000
NODE_5447_length_1069_cov_12.818557	293	373	0	80	80	1.0000000
NODE_5448_length_1069_cov_11.985567	554	634	0	80	80	1.0000000
NODE_5448_length_1069_cov_11.985567	607	687	0	80	80	1.0000000
NODE_5449_length_1069_cov_10.812371	366	446	5	31	80	0.3875000
NODE_5449_length_1069_cov_10.812371	366	446	6	49	80	0.6125000
NODE_5449_length_1069_cov_10.812371	419	499	0	44	80	0.5500000
NODE_5449_length_1069_cov_10.812371	419	499	5	36	80	0.4500000
NODE_5450_length_1069_cov_7.729897	482	562	2	80	80	1.0000000
NODE_5450_length_1069_cov_7.729897	535	615	2	80	80	1.0000000
NODE_5456_length_1068_cov_31.692466	314	394	0	42	80	0.5250000
NODE_5456_length_1068_cov_31.692466	314	394	1	38	80	0.4750000
NODE_5456_length_1068_cov_31.692466	367	447	0	80	80	1.0000000
NODE_5456_length_1068_cov_31.692466	443	523	0	80	80	1.0000000
NODE_5456_length_1068_cov_31.692466	496	576	0	80	80	1.0000000
NODE_5457_length_1068_cov_29.579979	347	427	0	80	80	1.0000000
NODE_5457_length_1068_cov_29.579979	400	480	0	80	80	1.0000000
NODE_5459_length_1068_cov_23.020640	476	556	0	80	80	1.0000000
NODE_5459_length_1068_cov_23.020640	529	609	0	80	80	1.0000000
NODE_5460_length_1068_cov_15.272446	546	626	0	80	80	1.0000000
NODE_5460_length_1068_cov_15.272446	599	679	0	80	80	1.0000000
NODE_5461_length_1068_cov_13.557276	674	754	0	80	80	1.0000000
NODE_5461_length_1068_cov_13.557276	727	807	0	80	80	1.0000000
NODE_5479_length_1067_cov_48.282025	429	509	0	80	80	1.0000000
NODE_5479_length_1067_cov_48.282025	482	562	0	80	80	1.0000000
NODE_5480_length_1067_cov_41.111570	460	540	0	24	80	0.3000000
NODE_5480_length_1067_cov_41.111570	460	540	1	1	80	0.0125000
NODE_5480_length_1067_cov_41.111570	460	540	13	2	80	0.0250000
NODE_5480_length_1067_cov_41.111570	460	540	17	9	80	0.1125000
NODE_5480_length_1067_cov_41.111570	460	540	18	44	80	0.5500000
NODE_5480_length_1067_cov_41.111570	513	593	17	14	80	0.1750000
NODE_5480_length_1067_cov_41.111570	513	593	18	18	80	0.2250000
NODE_5480_length_1067_cov_41.111570	513	593	19	48	80	0.6000000
NODE_5481_length_1067_cov_39.109504	295	375	0	4	80	0.0500000
NODE_5481_length_1067_cov_39.109504	295	375	2	76	80	0.9500000
NODE_5481_length_1067_cov_39.109504	348	428	2	80	80	1.0000000
NODE_5481_length_1067_cov_39.109504	424	504	0	68	80	0.8500000
NODE_5481_length_1067_cov_39.109504	424	504	2	12	80	0.1500000
NODE_5481_length_1067_cov_39.109504	477	557	0	80	80	1.0000000
NODE_5482_length_1067_cov_35.426653	252	332	2	24	80	0.3000000
NODE_5482_length_1067_cov_35.426653	252	332	4	56	80	0.7000000
NODE_5482_length_1067_cov_35.426653	305	385	0	28	80	0.3500000
NODE_5482_length_1067_cov_35.426653	305	385	2	15	80	0.1875000
NODE_5482_length_1067_cov_35.426653	305	385	4	37	80	0.4625000
NODE_5483_length_1067_cov_29.467975	412	492	0	27	80	0.3375000
NODE_5483_length_1067_cov_29.467975	412	492	6	53	80	0.6625000
NODE_5483_length_1067_cov_29.467975	465	545	0	24	80	0.3000000
NODE_5483_length_1067_cov_29.467975	465	545	2	5	80	0.0625000
NODE_5483_length_1067_cov_29.467975	465	545	6	51	80	0.6375000
NODE_5484_length_1067_cov_20.738636	579	645	40	6	66	0.0909091
NODE_5484_length_1067_cov_20.738636	579	645	42	4	66	0.0606061
NODE_5484_length_1067_cov_20.738636	579	645	44	2	66	0.0303030
NODE_5484_length_1067_cov_20.738636	579	645	50	6	66	0.0909091
NODE_5484_length_1067_cov_20.738636	579	645	52	4	66	0.0606061
NODE_5484_length_1067_cov_20.738636	579	645	53	2	66	0.0303030
NODE_5484_length_1067_cov_20.738636	579	645	55	6	66	0.0909091
NODE_5484_length_1067_cov_20.738636	579	645	57	1	66	0.0151515
NODE_5484_length_1067_cov_20.738636	579	645	59	1	66	0.0151515
NODE_5484_length_1067_cov_20.738636	579	645	65	4	66	0.0606061
NODE_5484_length_1067_cov_20.738636	579	645	67	5	66	0.0757576
NODE_5484_length_1067_cov_20.738636	579	645	68	3	66	0.0454545
NODE_5484_length_1067_cov_20.738636	579	645	70	1	66	0.0151515
NODE_5484_length_1067_cov_20.738636	579	645	71	2	66	0.0303030
NODE_5484_length_1067_cov_20.738636	579	645	72	1	66	0.0151515
NODE_5484_length_1067_cov_20.738636	579	645	73	3	66	0.0454545
NODE_5484_length_1067_cov_20.738636	579	645	74	3	66	0.0454545
NODE_5484_length_1067_cov_20.738636	579	645	76	5	66	0.0757576
NODE_5484_length_1067_cov_20.738636	579	645	78	7	66	0.1060606
NODE_5484_length_1067_cov_20.738636	618	698	67	4	80	0.0500000
NODE_5484_length_1067_cov_20.738636	618	698	68	2	80	0.0250000
NODE_5484_length_1067_cov_20.738636	618	698	70	4	80	0.0500000
NODE_5484_length_1067_cov_20.738636	618	698	71	6	80	0.0750000
NODE_5484_length_1067_cov_20.738636	618	698	72	4	80	0.0500000
NODE_5484_length_1067_cov_20.738636	618	698	73	9	80	0.1125000
NODE_5484_length_1067_cov_20.738636	618	698	74	3	80	0.0375000
NODE_5484_length_1067_cov_20.738636	618	698	75	5	80	0.0625000
NODE_5484_length_1067_cov_20.738636	618	698	76	9	80	0.1125000
NODE_5484_length_1067_cov_20.738636	618	698	77	13	80	0.1625000
NODE_5484_length_1067_cov_20.738636	618	698	78	10	80	0.1250000
NODE_5484_length_1067_cov_20.738636	618	698	79	8	80	0.1000000
NODE_5484_length_1067_cov_20.738636	618	698	80	2	80	0.0250000
NODE_5484_length_1067_cov_20.738636	618	698	81	1	80	0.0125000
NODE_5485_length_1067_cov_15.280992	538	617	0	79	79	1.0000000
NODE_5485_length_1067_cov_15.280992	590	670	0	54	80	0.6750000
NODE_5485_length_1067_cov_15.280992	590	670	2	26	80	0.3250000
NODE_5486_length_1067_cov_13.708678	478	558	0	80	80	1.0000000
NODE_5486_length_1067_cov_13.708678	531	611	0	80	80	1.0000000
NODE_5488_length_1067_cov_9.070248	625	705	0	1	80	0.0125000
NODE_5488_length_1067_cov_9.070248	625	705	2	39	80	0.4875000
NODE_5488_length_1067_cov_9.070248	625	705	4	40	80	0.5000000
NODE_5488_length_1067_cov_9.070248	678	758	0	42	80	0.5250000
NODE_5488_length_1067_cov_9.070248	678	758	2	8	80	0.1000000
NODE_5488_length_1067_cov_9.070248	678	758	4	30	80	0.3750000
NODE_5494_length_1067_cov_1.946281	765	812	0	47	47	1.0000000
NODE_5501_length_1066_cov_54.227508	395	475	0	31	80	0.3875000
NODE_5501_length_1066_cov_54.227508	395	475	4	12	80	0.1500000
NODE_5501_length_1066_cov_54.227508	395	475	6	37	80	0.4625000
NODE_5501_length_1066_cov_54.227508	448	528	2	11	80	0.1375000
NODE_5501_length_1066_cov_54.227508	448	528	6	69	80	0.8625000
NODE_5502_length_1066_cov_33.501551	357	437	0	78	80	0.9750000
NODE_5502_length_1066_cov_33.501551	357	437	2	2	80	0.0250000
NODE_5502_length_1066_cov_33.501551	410	490	0	25	80	0.3125000
NODE_5502_length_1066_cov_33.501551	410	490	2	55	80	0.6875000
NODE_5503_length_1066_cov_33.115822	397	477	4	1	80	0.0125000
NODE_5503_length_1066_cov_33.115822	397	477	6	12	80	0.1500000
NODE_5503_length_1066_cov_33.115822	397	477	8	20	80	0.2500000
NODE_5503_length_1066_cov_33.115822	397	477	11	1	80	0.0125000
NODE_5503_length_1066_cov_33.115822	397	477	12	46	80	0.5750000
NODE_5503_length_1066_cov_33.115822	450	530	2	36	80	0.4500000
NODE_5503_length_1066_cov_33.115822	450	530	4	1	80	0.0125000
NODE_5503_length_1066_cov_33.115822	450	530	6	29	80	0.3625000
NODE_5503_length_1066_cov_33.115822	450	530	11	1	80	0.0125000
NODE_5503_length_1066_cov_33.115822	450	530	12	13	80	0.1625000
NODE_5504_length_1066_cov_26.517063	215	285	150	1	70	0.0142857
NODE_5504_length_1066_cov_26.517063	215	285	151	1	70	0.0142857
NODE_5504_length_1066_cov_26.517063	215	285	152	1	70	0.0142857
NODE_5504_length_1066_cov_26.517063	215	285	153	1	70	0.0142857
NODE_5504_length_1066_cov_26.517063	215	285	155	2	70	0.0285714
NODE_5504_length_1066_cov_26.517063	215	285	156	1	70	0.0142857
NODE_5504_length_1066_cov_26.517063	215	285	158	1	70	0.0142857
NODE_5504_length_1066_cov_26.517063	215	285	159	1	70	0.0142857
NODE_5504_length_1066_cov_26.517063	215	285	166	1	70	0.0142857
NODE_5504_length_1066_cov_26.517063	215	285	167	1	70	0.0142857
NODE_5504_length_1066_cov_26.517063	215	285	168	1	70	0.0142857
NODE_5504_length_1066_cov_26.517063	215	285	169	1	70	0.0142857
NODE_5504_length_1066_cov_26.517063	215	285	170	2	70	0.0285714
NODE_5504_length_1066_cov_26.517063	215	285	172	1	70	0.0142857
NODE_5504_length_1066_cov_26.517063	215	285	180	1	70	0.0142857
NODE_5504_length_1066_cov_26.517063	215	285	186	1	70	0.0142857
NODE_5504_length_1066_cov_26.517063	215	285	188	1	70	0.0142857
NODE_5504_length_1066_cov_26.517063	215	285	194	1	70	0.0142857
NODE_5504_length_1066_cov_26.517063	215	285	203	1	70	0.0142857
NODE_5504_length_1066_cov_26.517063	215	285	205	1	70	0.0142857
NODE_5504_length_1066_cov_26.517063	215	285	206	1	70	0.0142857
NODE_5504_length_1066_cov_26.517063	215	285	207	1	70	0.0142857
NODE_5504_length_1066_cov_26.517063	215	285	210	1	70	0.0142857
NODE_5504_length_1066_cov_26.517063	215	285	212	1	70	0.0142857
NODE_5504_length_1066_cov_26.517063	215	285	216	1	70	0.0142857
NODE_5504_length_1066_cov_26.517063	215	285	217	2	70	0.0285714
NODE_5504_length_1066_cov_26.517063	215	285	218	2	70	0.0285714
NODE_5504_length_1066_cov_26.517063	215	285	219	3	70	0.0428571
NODE_5504_length_1066_cov_26.517063	215	285	221	3	70	0.0428571
NODE_5504_length_1066_cov_26.517063	215	285	222	1	70	0.0142857
NODE_5504_length_1066_cov_26.517063	215	285	228	1	70	0.0142857
NODE_5504_length_1066_cov_26.517063	215	285	246	1	70	0.0142857
NODE_5504_length_1066_cov_26.517063	215	285	253	1	70	0.0142857
NODE_5504_length_1066_cov_26.517063	215	285	264	1	70	0.0142857
NODE_5504_length_1066_cov_26.517063	215	285	266	1	70	0.0142857
NODE_5504_length_1066_cov_26.517063	215	285	269	1	70	0.0142857
NODE_5504_length_1066_cov_26.517063	215	285	271	1	70	0.0142857
NODE_5504_length_1066_cov_26.517063	215	285	277	1	70	0.0142857
NODE_5504_length_1066_cov_26.517063	215	285	279	2	70	0.0285714
NODE_5504_length_1066_cov_26.517063	215	285	280	2	70	0.0285714
NODE_5504_length_1066_cov_26.517063	215	285	281	1	70	0.0142857
NODE_5504_length_1066_cov_26.517063	215	285	282	1	70	0.0142857
NODE_5504_length_1066_cov_26.517063	215	285	283	2	70	0.0285714
NODE_5504_length_1066_cov_26.517063	215	285	284	4	70	0.0571429
NODE_5504_length_1066_cov_26.517063	215	285	286	2	70	0.0285714
NODE_5504_length_1066_cov_26.517063	215	285	287	3	70	0.0428571
NODE_5504_length_1066_cov_26.517063	215	285	289	2	70	0.0285714
NODE_5504_length_1066_cov_26.517063	215	285	290	2	70	0.0285714
NODE_5504_length_1066_cov_26.517063	215	285	291	1	70	0.0142857
NODE_5504_length_1066_cov_26.517063	215	285	292	1	70	0.0142857
NODE_5504_length_1066_cov_26.517063	215	285	308	1	70	0.0142857
NODE_5505_length_1066_cov_16.906929	526	606	2	57	80	0.7125000
NODE_5505_length_1066_cov_16.906929	526	606	4	1	80	0.0125000
NODE_5505_length_1066_cov_16.906929	526	606	6	22	80	0.2750000
NODE_5505_length_1066_cov_16.906929	579	659	2	4	80	0.0500000
NODE_5505_length_1066_cov_16.906929	579	659	4	30	80	0.3750000
NODE_5505_length_1066_cov_16.906929	579	659	6	46	80	0.5750000
NODE_5506_length_1066_cov_16.190279	298	378	0	80	80	1.0000000
NODE_5506_length_1066_cov_16.190279	351	432	0	81	81	1.0000000
NODE_5507_length_1066_cov_15.444674	582	662	0	16	80	0.2000000
NODE_5507_length_1066_cov_15.444674	582	662	6	36	80	0.4500000
NODE_5507_length_1066_cov_15.444674	582	662	8	28	80	0.3500000
NODE_5507_length_1066_cov_15.444674	635	715	0	69	80	0.8625000
NODE_5507_length_1066_cov_15.444674	635	715	6	11	80	0.1375000
NODE_5516_length_1065_cov_51.693582	480	560	0	80	80	1.0000000
NODE_5516_length_1065_cov_51.693582	533	613	0	36	80	0.4500000
NODE_5516_length_1065_cov_51.693582	533	613	4	44	80	0.5500000
NODE_5517_length_1065_cov_33.428571	422	502	0	80	80	1.0000000
NODE_5517_length_1065_cov_33.428571	422	502	0	80	80	1.0000000
NODE_5517_length_1065_cov_33.428571	422	502	0	80	80	1.0000000
NODE_5517_length_1065_cov_33.428571	475	555	0	80	80	1.0000000
NODE_5517_length_1065_cov_33.428571	475	555	0	80	80	1.0000000
NODE_5517_length_1065_cov_33.428571	551	631	0	30	80	0.3750000
NODE_5517_length_1065_cov_33.428571	551	631	2	50	80	0.6250000
NODE_5517_length_1065_cov_33.428571	551	631	0	30	80	0.3750000
NODE_5517_length_1065_cov_33.428571	551	631	2	50	80	0.6250000
NODE_5517_length_1065_cov_33.428571	551	572	0	21	21	1.0000000
NODE_5517_length_1065_cov_33.428571	604	666	2	58	62	0.9354839
NODE_5517_length_1065_cov_33.428571	604	666	6	4	62	0.0645161
NODE_5517_length_1065_cov_33.428571	604	684	2	58	80	0.7250000
NODE_5517_length_1065_cov_33.428571	604	684	4	14	80	0.1750000
NODE_5517_length_1065_cov_33.428571	604	684	5	1	80	0.0125000
NODE_5517_length_1065_cov_33.428571	604	684	6	7	80	0.0875000
NODE_5518_length_1065_cov_31.874741	255	335	2	65	80	0.8125000
NODE_5518_length_1065_cov_31.874741	255	335	5	9	80	0.1125000
NODE_5518_length_1065_cov_31.874741	255	335	6	6	80	0.0750000
NODE_5518_length_1065_cov_31.874741	308	388	2	12	80	0.1500000
NODE_5518_length_1065_cov_31.874741	308	388	4	22	80	0.2750000
NODE_5518_length_1065_cov_31.874741	308	388	5	17	80	0.2125000
NODE_5518_length_1065_cov_31.874741	308	388	6	29	80	0.3625000
NODE_5519_length_1065_cov_21.762940	234	314	0	80	80	1.0000000
NODE_5519_length_1065_cov_21.762940	287	367	0	28	80	0.3500000
NODE_5519_length_1065_cov_21.762940	287	367	4	52	80	0.6500000
NODE_5520_length_1065_cov_19.947205	447	527	0	24	80	0.3000000
NODE_5520_length_1065_cov_19.947205	447	527	2	56	80	0.7000000
NODE_5520_length_1065_cov_19.947205	500	580	0	27	80	0.3375000
NODE_5520_length_1065_cov_19.947205	500	580	2	53	80	0.6625000
NODE_5521_length_1065_cov_14.590062	343	423	4	3	80	0.0375000
NODE_5521_length_1065_cov_14.590062	343	423	6	19	80	0.2375000
NODE_5521_length_1065_cov_14.590062	343	423	8	58	80	0.7250000
NODE_5521_length_1065_cov_14.590062	396	476	0	48	80	0.6000000
NODE_5521_length_1065_cov_14.590062	396	476	4	8	80	0.1000000
NODE_5521_length_1065_cov_14.590062	396	476	6	15	80	0.1875000
NODE_5521_length_1065_cov_14.590062	396	476	8	9	80	0.1125000
NODE_5522_length_1065_cov_13.232919	243	323	0	80	80	1.0000000
NODE_5522_length_1065_cov_13.232919	296	376	0	80	80	1.0000000
NODE_5523_length_1065_cov_10.670807	481	561	0	80	80	1.0000000
NODE_5523_length_1065_cov_10.670807	534	614	0	52	80	0.6500000
NODE_5523_length_1065_cov_10.670807	534	614	2	28	80	0.3500000
NODE_5524_length_1065_cov_10.473085	496	576	0	80	80	1.0000000
NODE_5524_length_1065_cov_10.473085	549	629	0	80	80	1.0000000
NODE_5525_length_1065_cov_9.711180	286	360	0	74	74	1.0000000
NODE_5525_length_1065_cov_9.711180	339	419	0	80	80	1.0000000
NODE_5534_length_1064_cov_59.929534	457	537	6	3	80	0.0375000
NODE_5534_length_1064_cov_59.929534	457	537	7	24	80	0.3000000
NODE_5534_length_1064_cov_59.929534	457	537	10	10	80	0.1250000
NODE_5534_length_1064_cov_59.929534	457	537	12	3	80	0.0375000
NODE_5534_length_1064_cov_59.929534	457	537	13	40	80	0.5000000
NODE_5534_length_1064_cov_59.929534	510	590	6	43	80	0.5375000
NODE_5534_length_1064_cov_59.929534	510	590	8	8	80	0.1000000
NODE_5534_length_1064_cov_59.929534	510	590	11	2	80	0.0250000
NODE_5534_length_1064_cov_59.929534	510	590	12	1	80	0.0125000
NODE_5534_length_1064_cov_59.929534	510	590	13	26	80	0.3250000
NODE_5534_length_1064_cov_59.929534	586	666	8	18	80	0.2250000
NODE_5534_length_1064_cov_59.929534	586	666	14	44	80	0.5500000
NODE_5534_length_1064_cov_59.929534	586	666	16	8	80	0.1000000
NODE_5534_length_1064_cov_59.929534	586	666	18	10	80	0.1250000
NODE_5534_length_1064_cov_59.929534	639	719	13	1	80	0.0125000
NODE_5534_length_1064_cov_59.929534	639	719	14	17	80	0.2125000
NODE_5534_length_1064_cov_59.929534	639	719	15	1	80	0.0125000
NODE_5534_length_1064_cov_59.929534	639	719	16	26	80	0.3250000
NODE_5534_length_1064_cov_59.929534	639	719	18	28	80	0.3500000
NODE_5534_length_1064_cov_59.929534	639	719	21	1	80	0.0125000
NODE_5534_length_1064_cov_59.929534	639	719	22	6	80	0.0750000
NODE_5535_length_1064_cov_36.480829	367	447	0	37	80	0.4625000
NODE_5535_length_1064_cov_36.480829	367	447	2	43	80	0.5375000
NODE_5535_length_1064_cov_36.480829	420	500	0	29	80	0.3625000
NODE_5535_length_1064_cov_36.480829	420	500	2	51	80	0.6375000
NODE_5535_length_1064_cov_36.480829	496	576	0	44	80	0.5500000
NODE_5535_length_1064_cov_36.480829	496	576	2	10	80	0.1250000
NODE_5535_length_1064_cov_36.480829	496	576	4	26	80	0.3250000
NODE_5535_length_1064_cov_36.480829	549	629	2	23	80	0.2875000
NODE_5535_length_1064_cov_36.480829	549	629	4	57	80	0.7125000
NODE_5536_length_1064_cov_32.307772	547	627	2	23	80	0.2875000
NODE_5536_length_1064_cov_32.307772	547	627	4	30	80	0.3750000
NODE_5536_length_1064_cov_32.307772	547	627	18	1	80	0.0125000
NODE_5536_length_1064_cov_32.307772	547	627	20	10	80	0.1250000
NODE_5536_length_1064_cov_32.307772	547	627	22	4	80	0.0500000
NODE_5536_length_1064_cov_32.307772	547	627	24	2	80	0.0250000
NODE_5536_length_1064_cov_32.307772	547	627	25	10	80	0.1250000
NODE_5536_length_1064_cov_32.307772	600	680	18	1	80	0.0125000
NODE_5536_length_1064_cov_32.307772	600	680	20	10	80	0.1250000
NODE_5536_length_1064_cov_32.307772	600	680	22	4	80	0.0500000
NODE_5536_length_1064_cov_32.307772	600	680	24	2	80	0.0250000
NODE_5536_length_1064_cov_32.307772	600	680	25	12	80	0.1500000
NODE_5536_length_1064_cov_32.307772	600	680	27	1	80	0.0125000
NODE_5536_length_1064_cov_32.307772	600	680	29	49	80	0.6125000
NODE_5536_length_1064_cov_32.307772	600	680	30	1	80	0.0125000
NODE_5537_length_1064_cov_25.255959	462	542	0	80	80	1.0000000
NODE_5537_length_1064_cov_25.255959	515	595	0	80	80	1.0000000
NODE_5537_length_1064_cov_25.255959	591	671	0	80	80	1.0000000
NODE_5537_length_1064_cov_25.255959	644	724	0	80	80	1.0000000
NODE_5538_length_1064_cov_23.053886	343	423	0	80	80	1.0000000
NODE_5538_length_1064_cov_23.053886	396	476	0	80	80	1.0000000
NODE_5538_length_1064_cov_23.053886	472	552	0	80	80	1.0000000
NODE_5538_length_1064_cov_23.053886	525	605	0	80	80	1.0000000
NODE_5539_length_1064_cov_22.018653	479	559	0	25	80	0.3125000
NODE_5539_length_1064_cov_22.018653	479	559	1	24	80	0.3000000
NODE_5539_length_1064_cov_22.018653	479	559	2	31	80	0.3875000
NODE_5539_length_1064_cov_22.018653	532	612	0	78	80	0.9750000
NODE_5539_length_1064_cov_22.018653	532	612	1	2	80	0.0250000
NODE_5540_length_1064_cov_12.868394	424	504	0	80	80	1.0000000
NODE_5540_length_1064_cov_12.868394	477	557	0	43	80	0.5375000
NODE_5540_length_1064_cov_12.868394	477	557	2	37	80	0.4625000
NODE_5541_length_1064_cov_10.098446	467	547	0	80	80	1.0000000
NODE_5541_length_1064_cov_10.098446	520	600	0	41	80	0.5125000
NODE_5541_length_1064_cov_10.098446	520	600	4	39	80	0.4875000
NODE_5543_length_1064_cov_2.925389	173	245	2	9	72	0.1250000
NODE_5543_length_1064_cov_2.925389	173	245	4	1	72	0.0138889
NODE_5543_length_1064_cov_2.925389	173	245	10	28	72	0.3888889
NODE_5543_length_1064_cov_2.925389	173	245	12	22	72	0.3055556
NODE_5543_length_1064_cov_2.925389	173	245	14	8	72	0.1111111
NODE_5543_length_1064_cov_2.925389	173	245	16	4	72	0.0555556
NODE_5551_length_1063_cov_104.615145	504	584	0	3	80	0.0375000
NODE_5551_length_1063_cov_104.615145	504	584	2	54	80	0.6750000
NODE_5551_length_1063_cov_104.615145	504	584	7	2	80	0.0250000
NODE_5551_length_1063_cov_104.615145	504	584	8	21	80	0.2625000
NODE_5551_length_1063_cov_104.615145	557	637	2	4	80	0.0500000
NODE_5551_length_1063_cov_104.615145	557	637	6	48	80	0.6000000
NODE_5551_length_1063_cov_104.615145	557	637	7	2	80	0.0250000
NODE_5551_length_1063_cov_104.615145	557	637	8	26	80	0.3250000
NODE_5552_length_1063_cov_36.515560	482	562	2	80	80	1.0000000
NODE_5552_length_1063_cov_36.515560	535	615	0	50	80	0.6250000
NODE_5552_length_1063_cov_36.515560	535	615	2	30	80	0.3750000
NODE_5552_length_1063_cov_36.515560	611	691	0	80	80	1.0000000
NODE_5552_length_1063_cov_36.515560	664	744	0	80	80	1.0000000
NODE_5553_length_1063_cov_30.700207	470	550	0	80	80	1.0000000
NODE_5553_length_1063_cov_30.700207	523	603	0	80	80	1.0000000
NODE_5553_length_1063_cov_30.700207	599	679	0	37	80	0.4625000
NODE_5553_length_1063_cov_30.700207	599	679	1	43	80	0.5375000
NODE_5553_length_1063_cov_30.700207	652	732	0	24	80	0.3000000
NODE_5553_length_1063_cov_30.700207	652	732	1	56	80	0.7000000
NODE_5554_length_1063_cov_24.552905	362	442	6	17	80	0.2125000
NODE_5554_length_1063_cov_24.552905	362	442	8	63	80	0.7875000
NODE_5554_length_1063_cov_24.552905	415	495	1	8	80	0.1000000
NODE_5554_length_1063_cov_24.552905	415	495	2	3	80	0.0375000
NODE_5554_length_1063_cov_24.552905	415	495	6	32	80	0.4000000
NODE_5554_length_1063_cov_24.552905	415	495	8	37	80	0.4625000
NODE_5555_length_1063_cov_21.985477	407	487	0	40	80	0.5000000
NODE_5555_length_1063_cov_21.985477	407	487	2	40	80	0.5000000
NODE_5555_length_1063_cov_21.985477	460	540	2	80	80	1.0000000
NODE_5555_length_1063_cov_21.985477	536	616	0	39	80	0.4875000
NODE_5555_length_1063_cov_21.985477	536	616	2	12	80	0.1500000
NODE_5555_length_1063_cov_21.985477	536	616	10	29	80	0.3625000
NODE_5555_length_1063_cov_21.985477	589	670	10	81	81	1.0000000
NODE_5557_length_1063_cov_15.400415	685	765	0	80	80	1.0000000
NODE_5557_length_1063_cov_15.400415	738	818	0	80	80	1.0000000
NODE_5558_length_1063_cov_13.282158	510	590	0	80	80	1.0000000
NODE_5558_length_1063_cov_13.282158	563	643	0	80	80	1.0000000
NODE_5559_length_1063_cov_12.970954	417	495	0	15	78	0.1923077
NODE_5559_length_1063_cov_12.970954	417	495	2	63	78	0.8076923
NODE_5559_length_1063_cov_12.970954	468	548	0	35	80	0.4375000
NODE_5559_length_1063_cov_12.970954	468	548	2	45	80	0.5625000
NODE_5560_length_1063_cov_7.917012	639	719	0	7	80	0.0875000
NODE_5560_length_1063_cov_7.917012	639	719	2	50	80	0.6250000
NODE_5560_length_1063_cov_7.917012	639	719	6	23	80	0.2875000
NODE_5560_length_1063_cov_7.917012	692	772	2	4	80	0.0500000
NODE_5560_length_1063_cov_7.917012	692	772	4	42	80	0.5250000
NODE_5560_length_1063_cov_7.917012	692	772	6	34	80	0.4250000
NODE_5569_length_1063_cov_1.695021	893	947	6	1	54	0.0185185
NODE_5569_length_1063_cov_1.695021	893	947	20	1	54	0.0185185
NODE_5569_length_1063_cov_1.695021	893	947	24	7	54	0.1296296
NODE_5569_length_1063_cov_1.695021	893	947	26	6	54	0.1111111
NODE_5569_length_1063_cov_1.695021	893	947	28	5	54	0.0925926
NODE_5569_length_1063_cov_1.695021	893	947	32	34	54	0.6296296
NODE_5574_length_1062_cov_43.399792	272	352	0	33	80	0.4125000
NODE_5574_length_1062_cov_43.399792	272	352	2	9	80	0.1125000
NODE_5574_length_1062_cov_43.399792	272	352	4	38	80	0.4750000
NODE_5574_length_1062_cov_43.399792	325	405	0	13	80	0.1625000
NODE_5574_length_1062_cov_43.399792	325	405	2	1	80	0.0125000
NODE_5574_length_1062_cov_43.399792	325	405	3	1	80	0.0125000
NODE_5574_length_1062_cov_43.399792	325	405	4	65	80	0.8125000
NODE_5576_length_1062_cov_19.778816	401	481	8	1	80	0.0125000
NODE_5576_length_1062_cov_19.778816	401	481	9	12	80	0.1500000
NODE_5576_length_1062_cov_19.778816	401	481	10	7	80	0.0875000
NODE_5576_length_1062_cov_19.778816	401	481	14	2	80	0.0250000
NODE_5576_length_1062_cov_19.778816	401	481	17	54	80	0.6750000
NODE_5576_length_1062_cov_19.778816	401	481	18	4	80	0.0500000
NODE_5576_length_1062_cov_19.778816	454	534	2	18	80	0.2250000
NODE_5576_length_1062_cov_19.778816	454	534	6	4	80	0.0500000
NODE_5576_length_1062_cov_19.778816	454	534	7	3	80	0.0375000
NODE_5576_length_1062_cov_19.778816	454	534	12	4	80	0.0500000
NODE_5576_length_1062_cov_19.778816	454	534	17	51	80	0.6375000
NODE_5577_length_1062_cov_16.034268	628	708	1	13	80	0.1625000
NODE_5577_length_1062_cov_16.034268	628	708	7	16	80	0.2000000
NODE_5577_length_1062_cov_16.034268	628	708	8	10	80	0.1250000
NODE_5577_length_1062_cov_16.034268	628	708	10	41	80	0.5125000
NODE_5577_length_1062_cov_16.034268	681	761	0	20	80	0.2500000
NODE_5577_length_1062_cov_16.034268	681	761	1	46	80	0.5750000
NODE_5577_length_1062_cov_16.034268	681	761	7	14	80	0.1750000
NODE_5578_length_1062_cov_13.346833	623	703	0	41	80	0.5125000
NODE_5578_length_1062_cov_13.346833	623	703	2	39	80	0.4875000
NODE_5578_length_1062_cov_13.346833	676	756	0	6	80	0.0750000
NODE_5578_length_1062_cov_13.346833	676	756	2	74	80	0.9250000
NODE_5579_length_1062_cov_9.886812	670	750	0	80	80	1.0000000
NODE_5579_length_1062_cov_9.886812	723	803	0	80	80	1.0000000
NODE_5580_length_1062_cov_9.078920	525	604	0	12	79	0.1518987
NODE_5580_length_1062_cov_9.078920	525	604	2	67	79	0.8481013
NODE_5580_length_1062_cov_9.078920	577	657	0	65	80	0.8125000
NODE_5580_length_1062_cov_9.078920	577	657	2	15	80	0.1875000
NODE_5581_length_1062_cov_8.934579	203	283	0	80	80	1.0000000
NODE_5581_length_1062_cov_8.934579	256	336	0	80	80	1.0000000
NODE_5588_length_1061_cov_22.637214	418	498	0	80	80	1.0000000
NODE_5588_length_1061_cov_22.637214	471	551	0	80	80	1.0000000
NODE_5589_length_1061_cov_22.338877	479	559	0	80	80	1.0000000
NODE_5589_length_1061_cov_22.338877	532	612	0	80	80	1.0000000
NODE_5597_length_1060_cov_31.595213	394	473	0	20	79	0.2531646
NODE_5597_length_1060_cov_31.595213	394	473	2	59	79	0.7468355
NODE_5597_length_1060_cov_31.595213	446	526	0	73	80	0.9125000
NODE_5597_length_1060_cov_31.595213	446	526	2	7	80	0.0875000
NODE_5597_length_1060_cov_31.595213	522	602	0	6	80	0.0750000
NODE_5597_length_1060_cov_31.595213	522	602	4	74	80	0.9250000
NODE_5597_length_1060_cov_31.595213	575	655	0	34	80	0.4250000
NODE_5597_length_1060_cov_31.595213	575	655	3	2	80	0.0250000
NODE_5597_length_1060_cov_31.595213	575	655	4	44	80	0.5500000
NODE_5598_length_1060_cov_26.136316	486	566	0	3	80	0.0375000
NODE_5598_length_1060_cov_26.136316	486	566	2	1	80	0.0125000
NODE_5598_length_1060_cov_26.136316	486	566	6	76	80	0.9500000
NODE_5598_length_1060_cov_26.136316	539	619	0	29	80	0.3625000
NODE_5598_length_1060_cov_26.136316	539	619	6	51	80	0.6375000
NODE_5598_length_1060_cov_26.136316	615	695	0	43	80	0.5375000
NODE_5598_length_1060_cov_26.136316	615	695	6	37	80	0.4625000
NODE_5598_length_1060_cov_26.136316	668	748	0	7	80	0.0875000
NODE_5598_length_1060_cov_26.136316	668	748	6	73	80	0.9125000
NODE_5599_length_1060_cov_25.329865	370	450	0	8	80	0.1000000
NODE_5599_length_1060_cov_25.329865	370	450	2	21	80	0.2625000
NODE_5599_length_1060_cov_25.329865	370	450	4	51	80	0.6375000
NODE_5599_length_1060_cov_25.329865	423	503	0	61	80	0.7625000
NODE_5599_length_1060_cov_25.329865	423	503	2	19	80	0.2375000
NODE_5600_length_1060_cov_16.881374	539	611	2	72	72	1.0000000
NODE_5601_length_1060_cov_14.789802	406	486	0	80	80	1.0000000
NODE_5601_length_1060_cov_14.789802	459	539	0	80	80	1.0000000
NODE_5603_length_1060_cov_5.900104	517	597	0	80	80	1.0000000
NODE_5603_length_1060_cov_5.900104	570	650	0	80	80	1.0000000
NODE_5611_length_1059_cov_16.630208	412	492	4	80	80	1.0000000
NODE_5611_length_1059_cov_16.630208	465	552	0	17	87	0.1954023
NODE_5611_length_1059_cov_16.630208	465	552	2	26	87	0.2988506
NODE_5611_length_1059_cov_16.630208	465	552	4	44	87	0.5057471
NODE_5611_length_1059_cov_16.630208	548	628	0	15	80	0.1875000
NODE_5611_length_1059_cov_16.630208	548	628	2	65	80	0.8125000
NODE_5611_length_1059_cov_16.630208	601	681	0	15	80	0.1875000
NODE_5611_length_1059_cov_16.630208	601	681	2	12	80	0.1500000
NODE_5611_length_1059_cov_16.630208	601	681	4	53	80	0.6625000
NODE_5621_length_1058_cov_60.155370	395	475	2	50	80	0.6250000
NODE_5621_length_1058_cov_60.155370	395	475	4	30	80	0.3750000
NODE_5621_length_1058_cov_60.155370	448	528	2	63	80	0.7875000
NODE_5621_length_1058_cov_60.155370	448	528	4	17	80	0.2125000
NODE_5621_length_1058_cov_60.155370	524	604	4	15	80	0.1875000
NODE_5621_length_1058_cov_60.155370	524	604	8	51	80	0.6375000
NODE_5621_length_1058_cov_60.155370	524	604	10	14	80	0.1750000
NODE_5621_length_1058_cov_60.155370	577	657	4	18	80	0.2250000
NODE_5621_length_1058_cov_60.155370	577	657	8	60	80	0.7500000
NODE_5621_length_1058_cov_60.155370	577	657	10	2	80	0.0250000
NODE_5622_length_1058_cov_31.253389	475	555	2	10	80	0.1250000
NODE_5622_length_1058_cov_31.253389	475	555	7	1	80	0.0125000
NODE_5622_length_1058_cov_31.253389	475	555	8	4	80	0.0500000
NODE_5622_length_1058_cov_31.253389	475	555	10	5	80	0.0625000
NODE_5622_length_1058_cov_31.253389	475	555	18	4	80	0.0500000
NODE_5622_length_1058_cov_31.253389	475	555	20	1	80	0.0125000
NODE_5622_length_1058_cov_31.253389	475	555	22	55	80	0.6875000
NODE_5622_length_1058_cov_31.253389	475	555	2	10	80	0.1250000
NODE_5622_length_1058_cov_31.253389	475	555	7	1	80	0.0125000
NODE_5622_length_1058_cov_31.253389	475	555	8	4	80	0.0500000
NODE_5622_length_1058_cov_31.253389	475	555	10	5	80	0.0625000
NODE_5622_length_1058_cov_31.253389	475	555	18	4	80	0.0500000
NODE_5622_length_1058_cov_31.253389	475	555	20	1	80	0.0125000
NODE_5622_length_1058_cov_31.253389	475	555	22	55	80	0.6875000
NODE_5622_length_1058_cov_31.253389	528	608	0	32	80	0.4000000
NODE_5622_length_1058_cov_31.253389	528	608	2	31	80	0.3875000
NODE_5622_length_1058_cov_31.253389	528	608	7	1	80	0.0125000
NODE_5622_length_1058_cov_31.253389	528	608	8	4	80	0.0500000
NODE_5622_length_1058_cov_31.253389	528	608	10	5	80	0.0625000
NODE_5622_length_1058_cov_31.253389	528	608	22	7	80	0.0875000
NODE_5622_length_1058_cov_31.253389	533	608	0	32	75	0.4266667
NODE_5622_length_1058_cov_31.253389	533	608	2	31	75	0.4133333
NODE_5622_length_1058_cov_31.253389	533	608	7	1	75	0.0133333
NODE_5622_length_1058_cov_31.253389	533	608	8	4	75	0.0533333
NODE_5622_length_1058_cov_31.253389	533	608	10	5	75	0.0666667
NODE_5622_length_1058_cov_31.253389	533	608	22	2	75	0.0266667
NODE_5623_length_1058_cov_24.520334	264	344	4	4	80	0.0500000
NODE_5623_length_1058_cov_24.520334	264	344	9	1	80	0.0125000
NODE_5623_length_1058_cov_24.520334	264	344	10	75	80	0.9375000
NODE_5623_length_1058_cov_24.520334	317	397	7	1	80	0.0125000
NODE_5623_length_1058_cov_24.520334	317	397	8	35	80	0.4375000
NODE_5623_length_1058_cov_24.520334	317	397	10	44	80	0.5500000
NODE_5624_length_1058_cov_24.211679	297	377	6	21	80	0.2625000
NODE_5624_length_1058_cov_24.211679	297	377	8	59	80	0.7375000
NODE_5624_length_1058_cov_24.211679	350	430	0	21	80	0.2625000
NODE_5624_length_1058_cov_24.211679	350	430	3	22	80	0.2750000
NODE_5624_length_1058_cov_24.211679	350	430	6	31	80	0.3875000
NODE_5624_length_1058_cov_24.211679	350	430	8	6	80	0.0750000
NODE_5625_length_1058_cov_18.100104	454	534	0	11	80	0.1375000
NODE_5625_length_1058_cov_18.100104	454	534	2	38	80	0.4750000
NODE_5625_length_1058_cov_18.100104	454	534	4	31	80	0.3875000
NODE_5625_length_1058_cov_18.100104	507	587	0	9	80	0.1125000
NODE_5625_length_1058_cov_18.100104	507	587	2	24	80	0.3000000
NODE_5625_length_1058_cov_18.100104	507	587	4	47	80	0.5875000
NODE_5626_length_1058_cov_11.645464	476	556	0	80	80	1.0000000
NODE_5626_length_1058_cov_11.645464	529	609	0	80	80	1.0000000
NODE_5627_length_1058_cov_9.953076	621	712	0	91	91	1.0000000
NODE_5627_length_1058_cov_9.953076	685	765	0	80	80	1.0000000
NODE_5628_length_1058_cov_6.294056	819	899	1	2	80	0.0250000
NODE_5628_length_1058_cov_6.294056	819	899	2	1	80	0.0125000
NODE_5628_length_1058_cov_6.294056	819	899	3	28	80	0.3500000
NODE_5628_length_1058_cov_6.294056	819	899	7	19	80	0.2375000
NODE_5628_length_1058_cov_6.294056	819	899	9	4	80	0.0500000
NODE_5628_length_1058_cov_6.294056	819	899	11	16	80	0.2000000
NODE_5628_length_1058_cov_6.294056	819	899	12	10	80	0.1250000
NODE_5628_length_1058_cov_6.294056	875	952	8	7	77	0.0909091
NODE_5628_length_1058_cov_6.294056	875	952	11	14	77	0.1818182
NODE_5628_length_1058_cov_6.294056	875	952	12	56	77	0.7272727
NODE_5637_length_1057_cov_43.191023	413	493	2	47	80	0.5875000
NODE_5637_length_1057_cov_43.191023	413	493	4	33	80	0.4125000
NODE_5637_length_1057_cov_43.191023	466	546	2	29	80	0.3625000
NODE_5637_length_1057_cov_43.191023	466	546	4	51	80	0.6375000
NODE_5637_length_1057_cov_43.191023	542	622	0	39	80	0.4875000
NODE_5637_length_1057_cov_43.191023	542	622	2	41	80	0.5125000
NODE_5637_length_1057_cov_43.191023	595	675	0	80	80	1.0000000
NODE_5638_length_1057_cov_27.387265	486	566	2	32	80	0.4000000
NODE_5638_length_1057_cov_27.387265	486	566	3	3	80	0.0375000
NODE_5638_length_1057_cov_27.387265	486	566	4	45	80	0.5625000
NODE_5638_length_1057_cov_27.387265	539	619	0	17	80	0.2125000
NODE_5638_length_1057_cov_27.387265	539	619	2	37	80	0.4625000
NODE_5638_length_1057_cov_27.387265	539	619	4	26	80	0.3250000
NODE_5639_length_1057_cov_16.489562	416	496	0	80	80	1.0000000
NODE_5639_length_1057_cov_16.489562	469	549	0	80	80	1.0000000
NODE_5640_length_1057_cov_13.605428	631	711	0	23	80	0.2875000
NODE_5640_length_1057_cov_13.605428	631	711	2	57	80	0.7125000
NODE_5640_length_1057_cov_13.605428	684	764	0	74	80	0.9250000
NODE_5640_length_1057_cov_13.605428	684	764	2	6	80	0.0750000
NODE_5641_length_1057_cov_12.768267	518	598	0	80	80	1.0000000
NODE_5641_length_1057_cov_12.768267	571	651	0	80	80	1.0000000
NODE_5644_length_1057_cov_7.692067	706	786	2	41	80	0.5125000
NODE_5644_length_1057_cov_7.692067	706	786	4	39	80	0.4875000
NODE_5644_length_1057_cov_7.692067	759	839	0	7	80	0.0875000
NODE_5644_length_1057_cov_7.692067	759	839	2	17	80	0.2125000
NODE_5644_length_1057_cov_7.692067	759	839	4	56	80	0.7000000
NODE_5645_length_1057_cov_6.697286	561	641	0	39	80	0.4875000
NODE_5645_length_1057_cov_6.697286	561	641	2	41	80	0.5125000
NODE_5645_length_1057_cov_6.697286	614	694	0	80	80	1.0000000
NODE_5654_length_1056_cov_57.539185	462	542	0	73	80	0.9125000
NODE_5654_length_1056_cov_57.539185	462	542	2	7	80	0.0875000
NODE_5654_length_1056_cov_57.539185	515	595	0	80	80	1.0000000
NODE_5655_length_1056_cov_35.751306	421	501	0	80	80	1.0000000
NODE_5655_length_1056_cov_35.751306	474	554	0	80	80	1.0000000
NODE_5656_length_1056_cov_29.749216	415	490	0	43	75	0.5733333
NODE_5656_length_1056_cov_29.749216	415	490	2	32	75	0.4266667
NODE_5656_length_1056_cov_29.749216	416	495	0	48	79	0.6075949
NODE_5656_length_1056_cov_29.749216	416	495	2	31	79	0.3924051
NODE_5656_length_1056_cov_29.749216	448	495	0	47	47	1.0000000
NODE_5656_length_1056_cov_29.749216	468	548	0	80	80	1.0000000
NODE_5656_length_1056_cov_29.749216	468	548	0	80	80	1.0000000
NODE_5656_length_1056_cov_29.749216	468	548	0	80	80	1.0000000
NODE_5657_length_1056_cov_25.342738	297	377	0	69	80	0.8625000
NODE_5657_length_1056_cov_25.342738	297	377	4	10	80	0.1250000
NODE_5657_length_1056_cov_25.342738	297	377	6	1	80	0.0125000
NODE_5657_length_1056_cov_25.342738	350	430	0	16	80	0.2000000
NODE_5657_length_1056_cov_25.342738	350	430	4	10	80	0.1250000
NODE_5657_length_1056_cov_25.342738	350	430	6	54	80	0.6750000
NODE_5657_length_1056_cov_25.342738	426	506	0	22	80	0.2750000
NODE_5657_length_1056_cov_25.342738	426	506	2	50	80	0.6250000
NODE_5657_length_1056_cov_25.342738	426	506	6	8	80	0.1000000
NODE_5657_length_1056_cov_25.342738	479	559	0	30	80	0.3750000
NODE_5657_length_1056_cov_25.342738	479	559	2	50	80	0.6250000
NODE_5658_length_1056_cov_24.094044	535	615	6	18	80	0.2250000
NODE_5658_length_1056_cov_24.094044	535	615	13	1	80	0.0125000
NODE_5658_length_1056_cov_24.094044	535	615	16	11	80	0.1375000
NODE_5658_length_1056_cov_24.094044	535	615	18	5	80	0.0625000
NODE_5658_length_1056_cov_24.094044	535	615	19	13	80	0.1625000
NODE_5658_length_1056_cov_24.094044	535	615	20	32	80	0.4000000
NODE_5658_length_1056_cov_24.094044	588	668	0	40	80	0.5000000
NODE_5658_length_1056_cov_24.094044	588	668	6	31	80	0.3875000
NODE_5658_length_1056_cov_24.094044	588	668	16	9	80	0.1125000
NODE_5659_length_1056_cov_20.700104	570	650	0	80	80	1.0000000
NODE_5659_length_1056_cov_20.700104	623	703	0	80	80	1.0000000
NODE_5660_length_1056_cov_14.215256	349	429	0	80	80	1.0000000
NODE_5660_length_1056_cov_14.215256	402	482	0	80	80	1.0000000
NODE_5660_length_1056_cov_14.215256	478	558	0	80	80	1.0000000
NODE_5660_length_1056_cov_14.215256	531	611	0	80	80	1.0000000
NODE_5661_length_1056_cov_13.782654	563	643	0	80	80	1.0000000
NODE_5661_length_1056_cov_13.782654	616	696	0	80	80	1.0000000
NODE_5663_length_1056_cov_9.298851	373	453	0	12	80	0.1500000
NODE_5663_length_1056_cov_9.298851	373	453	3	68	80	0.8500000
NODE_5663_length_1056_cov_9.298851	426	503	0	62	77	0.8051948
NODE_5663_length_1056_cov_9.298851	426	503	3	15	77	0.1948052
NODE_5665_length_1056_cov_6.157785	396	476	0	4	80	0.0500000
NODE_5665_length_1056_cov_6.157785	396	476	4	76	80	0.9500000
NODE_5665_length_1056_cov_6.157785	449	529	0	34	80	0.4250000
NODE_5665_length_1056_cov_6.157785	449	529	3	1	80	0.0125000
NODE_5665_length_1056_cov_6.157785	449	529	4	45	80	0.5625000
NODE_5666_length_1056_cov_6.034483	287	367	0	80	80	1.0000000
NODE_5666_length_1056_cov_6.034483	340	420	0	80	80	1.0000000
NODE_5667_length_1056_cov_3.259143	371	410	0	39	39	1.0000000
NODE_5667_length_1056_cov_3.259143	424	463	0	39	39	1.0000000
NODE_5668_length_1056_cov_2.362591	234	314	4	1	80	0.0125000
NODE_5668_length_1056_cov_2.362591	234	314	5	7	80	0.0875000
NODE_5668_length_1056_cov_2.362591	234	314	6	35	80	0.4375000
NODE_5668_length_1056_cov_2.362591	234	314	8	37	80	0.4625000
NODE_5672_length_1055_cov_36.460251	468	548	0	80	80	1.0000000
NODE_5672_length_1055_cov_36.460251	521	601	0	31	80	0.3875000
NODE_5672_length_1055_cov_36.460251	521	601	2	49	80	0.6125000
NODE_5673_length_1055_cov_31.235356	502	582	0	17	80	0.2125000
NODE_5673_length_1055_cov_31.235356	502	582	2	27	80	0.3375000
NODE_5673_length_1055_cov_31.235356	502	582	4	36	80	0.4500000
NODE_5673_length_1055_cov_31.235356	555	635	0	11	80	0.1375000
NODE_5673_length_1055_cov_31.235356	555	635	4	69	80	0.8625000
NODE_5674_length_1055_cov_23.330544	403	483	0	80	80	1.0000000
NODE_5674_length_1055_cov_23.330544	456	536	0	80	80	1.0000000
NODE_5674_length_1055_cov_23.330544	532	612	0	50	80	0.6250000
NODE_5674_length_1055_cov_23.330544	532	612	2	30	80	0.3750000
NODE_5674_length_1055_cov_23.330544	585	665	0	12	80	0.1500000
NODE_5674_length_1055_cov_23.330544	585	665	2	68	80	0.8500000
NODE_5675_length_1055_cov_19.541841	321	401	0	75	80	0.9375000
NODE_5675_length_1055_cov_19.541841	321	401	1	4	80	0.0500000
NODE_5675_length_1055_cov_19.541841	321	401	2	1	80	0.0125000
NODE_5675_length_1055_cov_19.541841	374	454	0	22	80	0.2750000
NODE_5675_length_1055_cov_19.541841	374	454	1	4	80	0.0500000
NODE_5675_length_1055_cov_19.541841	374	454	2	7	80	0.0875000
NODE_5675_length_1055_cov_19.541841	374	454	4	47	80	0.5875000
NODE_5676_length_1055_cov_15.744770	525	605	0	80	80	1.0000000
NODE_5676_length_1055_cov_15.744770	578	658	0	80	80	1.0000000
NODE_5677_length_1055_cov_10.729079	335	415	0	20	80	0.2500000
NODE_5677_length_1055_cov_10.729079	335	415	2	60	80	0.7500000
NODE_5677_length_1055_cov_10.729079	388	468	0	73	80	0.9125000
NODE_5677_length_1055_cov_10.729079	388	468	2	7	80	0.0875000
NODE_5678_length_1055_cov_7.525105	575	655	0	2	80	0.0250000
NODE_5678_length_1055_cov_7.525105	575	655	2	8	80	0.1000000
NODE_5678_length_1055_cov_7.525105	575	655	4	70	80	0.8750000
NODE_5678_length_1055_cov_7.525105	628	708	2	15	80	0.1875000
NODE_5678_length_1055_cov_7.525105	628	708	4	65	80	0.8125000
NODE_5688_length_1054_cov_45.920419	371	451	0	80	80	1.0000000
NODE_5688_length_1054_cov_45.920419	424	505	0	81	81	1.0000000
NODE_5689_length_1054_cov_30.545550	499	578	0	23	79	0.2911392
NODE_5689_length_1054_cov_30.545550	499	578	4	56	79	0.7088608
NODE_5689_length_1054_cov_30.545550	552	631	4	79	79	1.0000000
NODE_5689_length_1054_cov_30.545550	627	707	0	46	80	0.5750000
NODE_5689_length_1054_cov_30.545550	627	707	4	34	80	0.4250000
NODE_5689_length_1054_cov_30.545550	680	760	0	80	80	1.0000000
NODE_5690_length_1054_cov_16.606283	347	427	0	80	80	1.0000000
NODE_5690_length_1054_cov_16.606283	400	480	0	80	80	1.0000000
NODE_5691_length_1054_cov_11.637696	244	316	0	72	72	1.0000000
NODE_5691_length_1054_cov_11.637696	312	392	0	80	80	1.0000000
NODE_5691_length_1054_cov_11.637696	365	445	0	80	80	1.0000000
NODE_5692_length_1054_cov_10.381152	493	573	0	80	80	1.0000000
NODE_5692_length_1054_cov_10.381152	546	626	0	80	80	1.0000000
NODE_5703_length_1053_cov_57.660377	445	527	2	82	82	1.0000000
NODE_5703_length_1053_cov_57.660377	500	580	0	23	80	0.2875000
NODE_5703_length_1053_cov_57.660377	500	580	1	24	80	0.3000000
NODE_5703_length_1053_cov_57.660377	500	580	2	33	80	0.4125000
NODE_5704_length_1053_cov_33.518868	329	409	0	80	80	1.0000000
NODE_5704_length_1053_cov_33.518868	382	462	0	80	80	1.0000000
NODE_5704_length_1053_cov_33.518868	458	538	0	80	80	1.0000000
NODE_5704_length_1053_cov_33.518868	511	591	0	80	80	1.0000000
NODE_5705_length_1053_cov_32.412998	375	455	0	80	80	1.0000000
NODE_5705_length_1053_cov_32.412998	428	508	0	80	80	1.0000000
NODE_5705_length_1053_cov_32.412998	504	584	0	80	80	1.0000000
NODE_5705_length_1053_cov_32.412998	557	637	0	80	80	1.0000000
NODE_5706_length_1053_cov_26.545073	456	536	0	80	80	1.0000000
NODE_5706_length_1053_cov_26.545073	509	589	0	70	80	0.8750000
NODE_5706_length_1053_cov_26.545073	509	589	2	10	80	0.1250000
NODE_5706_length_1053_cov_26.545073	585	665	0	4	80	0.0500000
NODE_5706_length_1053_cov_26.545073	585	665	2	76	80	0.9500000
NODE_5706_length_1053_cov_26.545073	638	718	0	57	80	0.7125000
NODE_5706_length_1053_cov_26.545073	638	718	2	23	80	0.2875000
NODE_5707_length_1053_cov_20.346960	543	623	0	80	80	1.0000000
NODE_5707_length_1053_cov_20.346960	596	677	0	49	81	0.6049383
NODE_5707_length_1053_cov_20.346960	596	677	2	32	81	0.3950617
NODE_5708_length_1053_cov_11.655136	393	473	0	14	80	0.1750000
NODE_5708_length_1053_cov_11.655136	393	473	2	66	80	0.8250000
NODE_5708_length_1053_cov_11.655136	446	526	0	35	80	0.4375000
NODE_5708_length_1053_cov_11.655136	446	526	2	45	80	0.5625000
NODE_5710_length_1053_cov_4.771488	84	149	5	5	65	0.0769231
NODE_5710_length_1053_cov_4.771488	84	149	7	16	65	0.2461538
NODE_5710_length_1053_cov_4.771488	84	149	11	6	65	0.0923077
NODE_5710_length_1053_cov_4.771488	84	149	15	7	65	0.1076923
NODE_5710_length_1053_cov_4.771488	84	149	21	31	65	0.4769231
NODE_5718_length_1052_cov_18.469045	448	528	0	80	80	1.0000000
NODE_5718_length_1052_cov_18.469045	501	581	0	55	80	0.6875000
NODE_5718_length_1052_cov_18.469045	501	581	4	25	80	0.3125000
NODE_5719_length_1052_cov_13.136411	425	505	0	80	80	1.0000000
NODE_5719_length_1052_cov_13.136411	478	558	0	80	80	1.0000000
NODE_5722_length_1052_cov_3.082896	607	687	0	7	80	0.0875000
NODE_5722_length_1052_cov_3.082896	607	687	2	73	80	0.9125000
NODE_5722_length_1052_cov_3.082896	660	740	0	47	80	0.5875000
NODE_5722_length_1052_cov_3.082896	660	740	2	33	80	0.4125000
NODE_5729_length_1051_cov_34.868697	472	552	0	63	80	0.7875000
NODE_5729_length_1051_cov_34.868697	472	552	2	13	80	0.1625000
NODE_5729_length_1051_cov_34.868697	472	552	3	4	80	0.0500000
NODE_5729_length_1051_cov_34.868697	525	605	0	10	80	0.1250000
NODE_5729_length_1051_cov_34.868697	525	605	2	13	80	0.1625000
NODE_5729_length_1051_cov_34.868697	525	605	3	6	80	0.0750000
NODE_5729_length_1051_cov_34.868697	525	605	4	6	80	0.0750000
NODE_5729_length_1051_cov_34.868697	525	605	5	5	80	0.0625000
NODE_5729_length_1051_cov_34.868697	525	605	6	40	80	0.5000000
NODE_5730_length_1051_cov_19.446429	549	629	0	27	80	0.3375000
NODE_5730_length_1051_cov_19.446429	549	629	2	53	80	0.6625000
NODE_5730_length_1051_cov_19.446429	602	682	0	80	80	1.0000000
NODE_5731_length_1051_cov_4.022059	600	680	2	80	80	1.0000000
NODE_5736_length_1050_cov_31.556257	429	509	0	40	80	0.5000000
NODE_5736_length_1050_cov_31.556257	429	509	2	40	80	0.5000000
NODE_5736_length_1050_cov_31.556257	482	562	2	61	80	0.7625000
NODE_5736_length_1050_cov_31.556257	482	562	4	19	80	0.2375000
NODE_5736_length_1050_cov_31.556257	558	638	0	11	80	0.1375000
NODE_5736_length_1050_cov_31.556257	558	638	2	69	80	0.8625000
NODE_5736_length_1050_cov_31.556257	611	691	0	64	80	0.8000000
NODE_5736_length_1050_cov_31.556257	611	691	2	16	80	0.2000000
NODE_5737_length_1050_cov_16.337539	398	478	0	2	80	0.0250000
NODE_5737_length_1050_cov_16.337539	398	478	4	78	80	0.9750000
NODE_5737_length_1050_cov_16.337539	451	531	0	55	80	0.6875000
NODE_5737_length_1050_cov_16.337539	451	531	4	25	80	0.3125000
NODE_5738_length_1050_cov_13.290221	507	587	2	7	80	0.0875000
NODE_5738_length_1050_cov_13.290221	507	587	10	15	80	0.1875000
NODE_5738_length_1050_cov_13.290221	507	587	11	28	80	0.3500000
NODE_5738_length_1050_cov_13.290221	507	587	12	30	80	0.3750000
NODE_5738_length_1050_cov_13.290221	560	640	6	15	80	0.1875000
NODE_5738_length_1050_cov_13.290221	560	640	10	13	80	0.1625000
NODE_5738_length_1050_cov_13.290221	560	640	11	27	80	0.3375000
NODE_5738_length_1050_cov_13.290221	560	640	12	21	80	0.2625000
NODE_5738_length_1050_cov_13.290221	560	640	15	4	80	0.0500000
NODE_5739_length_1050_cov_11.389064	532	612	0	29	80	0.3625000
NODE_5739_length_1050_cov_11.389064	532	612	2	51	80	0.6375000
NODE_5739_length_1050_cov_11.389064	585	665	0	11	80	0.1375000
NODE_5739_length_1050_cov_11.389064	585	665	2	69	80	0.8625000
NODE_5740_length_1050_cov_11.091483	259	321	0	38	62	0.6129032
NODE_5740_length_1050_cov_11.091483	259	321	2	24	62	0.3870968
NODE_5740_length_1050_cov_11.091483	294	374	0	80	80	1.0000000
NODE_5740_length_1050_cov_11.091483	370	450	0	27	80	0.3375000
NODE_5740_length_1050_cov_11.091483	370	450	4	53	80	0.6625000
NODE_5740_length_1050_cov_11.091483	423	503	4	80	80	1.0000000
NODE_5742_length_1050_cov_2.201893	928	990	0	62	62	1.0000000
NODE_5742_length_1050_cov_2.201893	981	1043	0	62	62	1.0000000
NODE_5748_length_1050_cov_1.241851	935	990	12	4	55	0.0727273
NODE_5748_length_1050_cov_1.241851	935	990	18	5	55	0.0909091
NODE_5748_length_1050_cov_1.241851	935	990	26	3	55	0.0545455
NODE_5748_length_1050_cov_1.241851	935	990	28	2	55	0.0363636
NODE_5748_length_1050_cov_1.241851	935	990	30	9	55	0.1636364
NODE_5748_length_1050_cov_1.241851	935	990	32	2	55	0.0363636
NODE_5748_length_1050_cov_1.241851	935	990	34	4	55	0.0727273
NODE_5748_length_1050_cov_1.241851	935	990	36	5	55	0.0909091
NODE_5748_length_1050_cov_1.241851	935	990	38	9	55	0.1636364
NODE_5748_length_1050_cov_1.241851	935	990	40	12	55	0.2181818
NODE_5748_length_1050_cov_1.241851	956	1036	18	3	80	0.0375000
NODE_5748_length_1050_cov_1.241851	956	1036	21	1	80	0.0125000
NODE_5748_length_1050_cov_1.241851	956	1036	26	2	80	0.0250000
NODE_5748_length_1050_cov_1.241851	956	1036	28	2	80	0.0250000
NODE_5748_length_1050_cov_1.241851	956	1036	30	3	80	0.0375000
NODE_5748_length_1050_cov_1.241851	956	1036	32	2	80	0.0250000
NODE_5748_length_1050_cov_1.241851	956	1036	34	15	80	0.1875000
NODE_5748_length_1050_cov_1.241851	956	1036	36	9	80	0.1125000
NODE_5748_length_1050_cov_1.241851	956	1036	38	9	80	0.1125000
NODE_5748_length_1050_cov_1.241851	956	1036	40	34	80	0.4250000
NODE_5752_length_1049_cov_28.174737	446	526	0	80	80	1.0000000
NODE_5752_length_1049_cov_28.174737	499	579	0	80	80	1.0000000
NODE_5753_length_1049_cov_23.186316	389	469	0	80	80	1.0000000
NODE_5753_length_1049_cov_23.186316	442	522	0	80	80	1.0000000
NODE_5753_length_1049_cov_23.186316	518	595	0	77	77	1.0000000
NODE_5753_length_1049_cov_23.186316	568	648	0	80	80	1.0000000
NODE_5754_length_1049_cov_21.097895	532	612	0	35	80	0.4375000
NODE_5754_length_1049_cov_21.097895	532	612	2	45	80	0.5625000
NODE_5754_length_1049_cov_21.097895	585	665	0	80	80	1.0000000
NODE_5755_length_1049_cov_18.964211	375	466	0	15	91	0.1648352
NODE_5755_length_1049_cov_18.964211	375	466	2	37	91	0.4065934
NODE_5755_length_1049_cov_18.964211	375	466	4	39	91	0.4285714
NODE_5755_length_1049_cov_18.964211	439	519	0	55	80	0.6875000
NODE_5755_length_1049_cov_18.964211	439	519	2	12	80	0.1500000
NODE_5755_length_1049_cov_18.964211	439	519	4	13	80	0.1625000
NODE_5755_length_1049_cov_18.964211	515	595	4	80	80	1.0000000
NODE_5755_length_1049_cov_18.964211	568	648	0	48	80	0.6000000
NODE_5755_length_1049_cov_18.964211	568	648	4	32	80	0.4000000
NODE_5756_length_1049_cov_18.075789	437	517	0	4	80	0.0500000
NODE_5756_length_1049_cov_18.075789	437	517	1	1	80	0.0125000
NODE_5756_length_1049_cov_18.075789	437	517	2	20	80	0.2500000
NODE_5756_length_1049_cov_18.075789	437	517	4	28	80	0.3500000
NODE_5756_length_1049_cov_18.075789	437	517	8	27	80	0.3375000
NODE_5756_length_1049_cov_18.075789	490	570	8	80	80	1.0000000
NODE_5756_length_1049_cov_18.075789	566	644	0	52	78	0.6666667
NODE_5756_length_1049_cov_18.075789	566	644	1	1	78	0.0128205
NODE_5756_length_1049_cov_18.075789	566	644	2	5	78	0.0641026
NODE_5756_length_1049_cov_18.075789	566	644	8	20	78	0.2564103
NODE_5756_length_1049_cov_18.075789	620	695	0	75	75	1.0000000
NODE_5757_length_1049_cov_16.194737	569	650	0	23	81	0.2839506
NODE_5757_length_1049_cov_16.194737	569	650	2	4	81	0.0493827
NODE_5757_length_1049_cov_16.194737	569	650	4	54	81	0.6666667
NODE_5757_length_1049_cov_16.194737	623	703	0	76	80	0.9500000
NODE_5757_length_1049_cov_16.194737	623	703	2	4	80	0.0500000
NODE_5757_length_1049_cov_16.194737	699	779	0	80	80	1.0000000
NODE_5757_length_1049_cov_16.194737	752	832	0	80	80	1.0000000
NODE_5759_length_1049_cov_6.323158	588	668	0	80	80	1.0000000
NODE_5759_length_1049_cov_6.323158	641	721	0	80	80	1.0000000
NODE_5770_length_1048_cov_73.887250	535	615	0	80	80	1.0000000
NODE_5770_length_1048_cov_73.887250	588	668	0	80	80	1.0000000
NODE_5770_length_1048_cov_73.887250	664	744	0	80	80	1.0000000
NODE_5770_length_1048_cov_73.887250	717	797	0	80	80	1.0000000
NODE_5770_length_1048_cov_73.887250	899	979	0	42	80	0.5250000
NODE_5770_length_1048_cov_73.887250	899	979	2	38	80	0.4750000
NODE_5771_length_1048_cov_48.242360	407	487	0	80	80	1.0000000
NODE_5771_length_1048_cov_48.242360	460	540	0	63	80	0.7875000
NODE_5771_length_1048_cov_48.242360	460	540	2	17	80	0.2125000
NODE_5771_length_1048_cov_48.242360	536	616	2	18	80	0.2250000
NODE_5771_length_1048_cov_48.242360	536	616	4	62	80	0.7750000
NODE_5771_length_1048_cov_48.242360	589	669	0	39	80	0.4875000
NODE_5771_length_1048_cov_48.242360	589	669	2	26	80	0.3250000
NODE_5771_length_1048_cov_48.242360	589	669	4	15	80	0.1875000
NODE_5772_length_1048_cov_38.430980	352	432	0	8	80	0.1000000
NODE_5772_length_1048_cov_38.430980	352	432	6	40	80	0.5000000
NODE_5772_length_1048_cov_38.430980	352	432	18	1	80	0.0125000
NODE_5772_length_1048_cov_38.430980	352	432	20	10	80	0.1250000
NODE_5772_length_1048_cov_38.430980	352	432	33	1	80	0.0125000
NODE_5772_length_1048_cov_38.430980	352	432	34	20	80	0.2500000
NODE_5772_length_1048_cov_38.430980	405	485	20	6	80	0.0750000
NODE_5772_length_1048_cov_38.430980	405	485	27	29	80	0.3625000
NODE_5772_length_1048_cov_38.430980	405	485	28	2	80	0.0250000
NODE_5772_length_1048_cov_38.430980	405	485	33	1	80	0.0125000
NODE_5772_length_1048_cov_38.430980	405	485	34	42	80	0.5250000
NODE_5773_length_1048_cov_28.179136	548	628	0	80	80	1.0000000
NODE_5773_length_1048_cov_28.179136	601	681	0	80	80	1.0000000
NODE_5773_length_1048_cov_28.179136	677	757	0	20	80	0.2500000
NODE_5773_length_1048_cov_28.179136	677	757	2	60	80	0.7500000
NODE_5773_length_1048_cov_28.179136	730	810	0	66	80	0.8250000
NODE_5773_length_1048_cov_28.179136	730	810	2	14	80	0.1750000
NODE_5774_length_1048_cov_22.985248	409	489	0	14	80	0.1750000
NODE_5774_length_1048_cov_22.985248	409	489	4	66	80	0.8250000
NODE_5774_length_1048_cov_22.985248	462	542	0	67	80	0.8375000
NODE_5774_length_1048_cov_22.985248	462	542	4	13	80	0.1625000
NODE_5774_length_1048_cov_22.985248	538	618	0	80	80	1.0000000
NODE_5774_length_1048_cov_22.985248	591	671	0	30	80	0.3750000
NODE_5774_length_1048_cov_22.985248	591	671	2	50	80	0.6250000
NODE_5775_length_1048_cov_17.883035	500	580	0	40	80	0.5000000
NODE_5775_length_1048_cov_17.883035	500	580	2	40	80	0.5000000
NODE_5775_length_1048_cov_17.883035	553	633	0	80	80	1.0000000
NODE_5776_length_1048_cov_17.444679	377	457	0	20	80	0.2500000
NODE_5776_length_1048_cov_17.444679	377	457	1	31	80	0.3875000
NODE_5776_length_1048_cov_17.444679	377	457	2	29	80	0.3625000
NODE_5776_length_1048_cov_17.444679	430	510	0	20	80	0.2500000
NODE_5776_length_1048_cov_17.444679	430	510	2	60	80	0.7500000
NODE_5777_length_1048_cov_13.387777	518	598	0	80	80	1.0000000
NODE_5777_length_1048_cov_13.387777	571	651	0	80	80	1.0000000
NODE_5778_length_1048_cov_12.934668	716	796	0	80	80	1.0000000
NODE_5778_length_1048_cov_12.934668	769	849	0	80	80	1.0000000
NODE_5778_length_1048_cov_12.934668	845	925	0	29	80	0.3625000
NODE_5778_length_1048_cov_12.934668	845	925	4	51	80	0.6375000
NODE_5778_length_1048_cov_12.934668	898	975	4	77	77	1.0000000
NODE_5779_length_1048_cov_12.712329	330	410	0	80	80	1.0000000
NODE_5779_length_1048_cov_12.712329	384	463	0	79	79	1.0000000
NODE_5779_length_1048_cov_12.712329	459	539	0	42	80	0.5250000
NODE_5779_length_1048_cov_12.712329	459	539	2	28	80	0.3500000
NODE_5779_length_1048_cov_12.712329	459	539	4	10	80	0.1250000
NODE_5779_length_1048_cov_12.712329	512	592	2	17	80	0.2125000
NODE_5779_length_1048_cov_12.712329	512	592	4	63	80	0.7875000
NODE_5780_length_1048_cov_9.232877	305	355	0	50	50	1.0000000
NODE_5786_length_1047_cov_79.917722	540	620	0	35	80	0.4375000
NODE_5786_length_1047_cov_79.917722	540	620	2	45	80	0.5625000
NODE_5786_length_1047_cov_79.917722	593	673	2	80	80	1.0000000
NODE_5787_length_1047_cov_28.527426	582	662	5	13	80	0.1625000
NODE_5787_length_1047_cov_28.527426	582	662	6	23	80	0.2875000
NODE_5787_length_1047_cov_28.527426	582	662	10	44	80	0.5500000
NODE_5787_length_1047_cov_28.527426	635	715	2	15	80	0.1875000
NODE_5787_length_1047_cov_28.527426	635	715	6	22	80	0.2750000
NODE_5787_length_1047_cov_28.527426	635	715	10	43	80	0.5375000
NODE_5788_length_1047_cov_26.068565	372	452	0	80	80	1.0000000
NODE_5788_length_1047_cov_26.068565	425	505	0	80	80	1.0000000
NODE_5789_length_1047_cov_25.946203	424	504	0	26	80	0.3250000
NODE_5789_length_1047_cov_25.946203	424	504	2	54	80	0.6750000
NODE_5789_length_1047_cov_25.946203	477	557	0	79	80	0.9875000
NODE_5789_length_1047_cov_25.946203	477	557	2	1	80	0.0125000
NODE_5790_length_1047_cov_19.255274	458	538	0	80	80	1.0000000
NODE_5790_length_1047_cov_19.255274	511	591	0	72	80	0.9000000
NODE_5790_length_1047_cov_19.255274	511	591	4	8	80	0.1000000
NODE_5791_length_1047_cov_16.618143	467	547	2	80	80	1.0000000
NODE_5791_length_1047_cov_16.618143	520	600	0	10	80	0.1250000
NODE_5791_length_1047_cov_16.618143	520	600	2	70	80	0.8750000
NODE_5792_length_1047_cov_14.246835	643	723	0	80	80	1.0000000
NODE_5792_length_1047_cov_14.246835	696	776	0	80	80	1.0000000
NODE_5793_length_1047_cov_9.869198	414	494	0	80	80	1.0000000
NODE_5793_length_1047_cov_9.869198	467	547	0	80	80	1.0000000
NODE_5794_length_1047_cov_8.513713	300	380	0	80	80	1.0000000
NODE_5794_length_1047_cov_8.513713	353	433	0	80	80	1.0000000
NODE_5795_length_1047_cov_7.412447	442	522	2	80	80	1.0000000
NODE_5795_length_1047_cov_7.412447	495	575	0	51	80	0.6375000
NODE_5795_length_1047_cov_7.412447	495	575	2	29	80	0.3625000
NODE_5803_length_1046_cov_41.392819	587	667	0	80	80	1.0000000
NODE_5803_length_1046_cov_41.392819	640	720	0	80	80	1.0000000
NODE_5804_length_1046_cov_30.317846	382	462	2	80	80	1.0000000
NODE_5804_length_1046_cov_30.317846	435	515	1	46	80	0.5750000
NODE_5804_length_1046_cov_30.317846	435	515	2	34	80	0.4250000
NODE_5805_length_1046_cov_28.184794	346	426	6	3	80	0.0375000
NODE_5805_length_1046_cov_28.184794	346	426	12	32	80	0.4000000
NODE_5805_length_1046_cov_28.184794	346	426	17	1	80	0.0125000
NODE_5805_length_1046_cov_28.184794	346	426	18	44	80	0.5500000
NODE_5805_length_1046_cov_28.184794	399	479	0	11	80	0.1375000
NODE_5805_length_1046_cov_28.184794	399	479	6	26	80	0.3250000
NODE_5805_length_1046_cov_28.184794	399	479	12	28	80	0.3500000
NODE_5805_length_1046_cov_28.184794	399	479	17	1	80	0.0125000
NODE_5805_length_1046_cov_28.184794	399	479	18	14	80	0.1750000
NODE_5806_length_1046_cov_24.595565	501	581	0	80	80	1.0000000
NODE_5806_length_1046_cov_24.595565	554	634	0	48	80	0.6000000
NODE_5806_length_1046_cov_24.595565	554	634	2	32	80	0.4000000
NODE_5807_length_1046_cov_17.958817	447	527	0	80	80	1.0000000
NODE_5807_length_1046_cov_17.958817	500	580	0	80	80	1.0000000
NODE_5808_length_1046_cov_15.494192	385	465	0	16	80	0.2000000
NODE_5808_length_1046_cov_15.494192	385	465	1	9	80	0.1125000
NODE_5808_length_1046_cov_15.494192	385	465	2	13	80	0.1625000
NODE_5808_length_1046_cov_15.494192	385	465	4	42	80	0.5250000
NODE_5808_length_1046_cov_15.494192	438	518	4	80	80	1.0000000
NODE_5809_length_1046_cov_12.639916	554	634	0	80	80	1.0000000
NODE_5809_length_1046_cov_12.639916	607	687	0	80	80	1.0000000
NODE_5810_length_1046_cov_11.238648	471	551	0	30	80	0.3750000
NODE_5810_length_1046_cov_11.238648	471	551	4	6	80	0.0750000
NODE_5810_length_1046_cov_11.238648	471	551	6	44	80	0.5500000
NODE_5810_length_1046_cov_11.238648	524	604	4	16	80	0.2000000
NODE_5810_length_1046_cov_11.238648	524	604	6	64	80	0.8000000
NODE_5811_length_1046_cov_10.744456	459	539	0	80	80	1.0000000
NODE_5811_length_1046_cov_10.744456	512	592	0	80	80	1.0000000
NODE_5812_length_1046_cov_8.689546	302	382	0	80	80	1.0000000
NODE_5812_length_1046_cov_8.689546	355	435	0	80	80	1.0000000
NODE_5823_length_1045_cov_75.975687	359	440	0	48	81	0.5925926
NODE_5823_length_1045_cov_75.975687	359	440	1	7	81	0.0864198
NODE_5823_length_1045_cov_75.975687	359	440	2	26	81	0.3209876
NODE_5823_length_1045_cov_75.975687	412	493	1	2	81	0.0246914
NODE_5823_length_1045_cov_75.975687	412	493	2	79	81	0.9753087
NODE_5823_length_1045_cov_75.975687	489	569	0	56	80	0.7000000
NODE_5823_length_1045_cov_75.975687	489	569	2	24	80	0.3000000
NODE_5823_length_1045_cov_75.975687	542	622	0	80	80	1.0000000
NODE_5824_length_1045_cov_54.419662	434	514	0	80	80	1.0000000
NODE_5824_length_1045_cov_54.419662	487	567	0	80	80	1.0000000
NODE_5824_length_1045_cov_54.419662	563	639	0	61	76	0.8026316
NODE_5824_length_1045_cov_54.419662	563	639	4	15	76	0.1973684
NODE_5824_length_1045_cov_54.419662	616	696	0	8	80	0.1000000
NODE_5824_length_1045_cov_54.419662	616	696	4	20	80	0.2500000
NODE_5824_length_1045_cov_54.419662	616	696	6	52	80	0.6500000
NODE_5825_length_1045_cov_23.188161	395	475	0	80	80	1.0000000
NODE_5825_length_1045_cov_23.188161	448	528	0	80	80	1.0000000
NODE_5826_length_1045_cov_19.686047	571	651	2	16	80	0.2000000
NODE_5826_length_1045_cov_19.686047	571	651	3	1	80	0.0125000
NODE_5826_length_1045_cov_19.686047	571	651	4	63	80	0.7875000
NODE_5826_length_1045_cov_19.686047	624	704	2	44	80	0.5500000
NODE_5826_length_1045_cov_19.686047	624	704	4	36	80	0.4500000
NODE_5827_length_1045_cov_19.378436	478	558	0	80	80	1.0000000
NODE_5827_length_1045_cov_19.378436	531	611	0	80	80	1.0000000
NODE_5828_length_1045_cov_17.601480	359	439	0	80	80	1.0000000
NODE_5828_length_1045_cov_17.601480	412	492	0	80	80	1.0000000
NODE_5829_length_1045_cov_17.372093	633	713	0	2	80	0.0250000
NODE_5829_length_1045_cov_17.372093	633	713	6	78	80	0.9750000
NODE_5829_length_1045_cov_17.372093	686	766	0	33	80	0.4125000
NODE_5829_length_1045_cov_17.372093	686	766	6	47	80	0.5875000
NODE_5830_length_1045_cov_14.828753	433	513	0	80	80	1.0000000
NODE_5830_length_1045_cov_14.828753	486	566	0	80	80	1.0000000
NODE_5831_length_1045_cov_11.673362	664	744	2	38	80	0.4750000
NODE_5831_length_1045_cov_11.673362	664	744	4	42	80	0.5250000
NODE_5831_length_1045_cov_11.673362	717	797	0	22	80	0.2750000
NODE_5831_length_1045_cov_11.673362	717	797	2	16	80	0.2000000
NODE_5831_length_1045_cov_11.673362	717	797	4	42	80	0.5250000
NODE_5843_length_1044_cov_42.600000	344	424	0	21	80	0.2625000
NODE_5843_length_1044_cov_42.600000	344	424	2	59	80	0.7375000
NODE_5843_length_1044_cov_42.600000	397	477	0	10	80	0.1250000
NODE_5843_length_1044_cov_42.600000	397	477	2	70	80	0.8750000
NODE_5844_length_1044_cov_27.653968	454	534	0	36	80	0.4500000
NODE_5844_length_1044_cov_27.653968	454	534	2	44	80	0.5500000
NODE_5844_length_1044_cov_27.653968	507	587	0	4	80	0.0500000
NODE_5844_length_1044_cov_27.653968	507	587	2	76	80	0.9500000
NODE_5845_length_1044_cov_24.561905	297	375	0	46	78	0.5897436
NODE_5845_length_1044_cov_24.561905	297	375	2	32	78	0.4102564
NODE_5845_length_1044_cov_24.561905	348	428	0	80	80	1.0000000
NODE_5845_length_1044_cov_24.561905	424	504	0	80	80	1.0000000
NODE_5845_length_1044_cov_24.561905	477	557	0	80	80	1.0000000
NODE_5846_length_1044_cov_23.720635	294	374	2	40	80	0.5000000
NODE_5846_length_1044_cov_23.720635	294	374	4	6	80	0.0750000
NODE_5846_length_1044_cov_23.720635	294	374	6	15	80	0.1875000
NODE_5846_length_1044_cov_23.720635	294	374	8	19	80	0.2375000
NODE_5846_length_1044_cov_23.720635	347	427	4	6	80	0.0750000
NODE_5846_length_1044_cov_23.720635	347	427	6	2	80	0.0250000
NODE_5846_length_1044_cov_23.720635	347	427	8	72	80	0.9000000
NODE_5846_length_1044_cov_23.720635	423	503	6	45	80	0.5625000
NODE_5846_length_1044_cov_23.720635	423	503	8	9	80	0.1125000
NODE_5846_length_1044_cov_23.720635	423	503	10	16	80	0.2000000
NODE_5846_length_1044_cov_23.720635	423	503	12	10	80	0.1250000
NODE_5846_length_1044_cov_23.720635	476	556	0	10	80	0.1250000
NODE_5846_length_1044_cov_23.720635	476	556	2	25	80	0.3125000
NODE_5846_length_1044_cov_23.720635	476	556	4	2	80	0.0250000
NODE_5846_length_1044_cov_23.720635	476	556	6	43	80	0.5375000
NODE_5847_length_1044_cov_20.871958	462	542	0	80	80	1.0000000
NODE_5847_length_1044_cov_20.871958	515	595	0	80	80	1.0000000
NODE_5847_length_1044_cov_20.871958	591	671	0	80	80	1.0000000
NODE_5847_length_1044_cov_20.871958	644	724	0	29	80	0.3625000
NODE_5847_length_1044_cov_20.871958	644	724	2	51	80	0.6375000
NODE_5848_length_1044_cov_18.596825	433	513	0	80	80	1.0000000
NODE_5848_length_1044_cov_18.596825	486	566	0	80	80	1.0000000
NODE_5849_length_1044_cov_16.102646	414	494	0	80	80	1.0000000
NODE_5849_length_1044_cov_16.102646	467	547	0	80	80	1.0000000
NODE_5850_length_1044_cov_12.156614	578	658	0	41	80	0.5125000
NODE_5850_length_1044_cov_12.156614	578	658	2	19	80	0.2375000
NODE_5850_length_1044_cov_12.156614	578	658	16	1	80	0.0125000
NODE_5850_length_1044_cov_12.156614	578	658	20	1	80	0.0125000
NODE_5850_length_1044_cov_12.156614	578	658	23	18	80	0.2250000
NODE_5850_length_1044_cov_12.156614	631	711	2	7	80	0.0875000
NODE_5850_length_1044_cov_12.156614	631	711	16	1	80	0.0125000
NODE_5850_length_1044_cov_12.156614	631	711	20	1	80	0.0125000
NODE_5850_length_1044_cov_12.156614	631	711	21	8	80	0.1000000
NODE_5850_length_1044_cov_12.156614	631	711	23	63	80	0.7875000
NODE_5851_length_1044_cov_10.661376	506	586	1	80	80	1.0000000
NODE_5851_length_1044_cov_10.661376	559	639	0	27	80	0.3375000
NODE_5851_length_1044_cov_10.661376	559	639	1	53	80	0.6625000
NODE_5852_length_1044_cov_9.534392	461	541	0	68	80	0.8500000
NODE_5852_length_1044_cov_9.534392	461	541	2	12	80	0.1500000
NODE_5852_length_1044_cov_9.534392	514	594	0	15	80	0.1875000
NODE_5852_length_1044_cov_9.534392	514	594	2	65	80	0.8125000
NODE_5853_length_1044_cov_5.517460	434	514	0	80	80	1.0000000
NODE_5853_length_1044_cov_5.517460	487	567	0	80	80	1.0000000
NODE_5856_length_1044_cov_1.502646	769	845	2	55	76	0.7236842
NODE_5856_length_1044_cov_1.502646	769	845	4	21	76	0.2763158
NODE_5860_length_1043_cov_42.288136	452	532	0	29	80	0.3625000
NODE_5860_length_1043_cov_42.288136	452	532	2	7	80	0.0875000
NODE_5860_length_1043_cov_42.288136	452	532	4	44	80	0.5500000
NODE_5860_length_1043_cov_42.288136	505	585	4	29	80	0.3625000
NODE_5860_length_1043_cov_42.288136	505	585	8	51	80	0.6375000
NODE_5861_length_1043_cov_25.987288	350	430	2	36	80	0.4500000
NODE_5861_length_1043_cov_25.987288	350	430	4	2	80	0.0250000
NODE_5861_length_1043_cov_25.987288	350	430	8	5	80	0.0625000
NODE_5861_length_1043_cov_25.987288	350	430	12	2	80	0.0250000
NODE_5861_length_1043_cov_25.987288	350	430	18	5	80	0.0625000
NODE_5861_length_1043_cov_25.987288	350	430	19	15	80	0.1875000
NODE_5861_length_1043_cov_25.987288	350	430	23	15	80	0.1875000
NODE_5861_length_1043_cov_25.987288	403	483	14	4	80	0.0500000
NODE_5861_length_1043_cov_25.987288	403	483	16	5	80	0.0625000
NODE_5861_length_1043_cov_25.987288	403	483	18	12	80	0.1500000
NODE_5861_length_1043_cov_25.987288	403	483	19	12	80	0.1500000
NODE_5861_length_1043_cov_25.987288	403	483	23	20	80	0.2500000
NODE_5861_length_1043_cov_25.987288	403	483	24	12	80	0.1500000
NODE_5861_length_1043_cov_25.987288	403	483	25	3	80	0.0375000
NODE_5861_length_1043_cov_25.987288	403	483	26	12	80	0.1500000
NODE_5861_length_1043_cov_25.987288	479	559	10	16	80	0.2000000
NODE_5861_length_1043_cov_25.987288	479	559	12	3	80	0.0375000
NODE_5861_length_1043_cov_25.987288	479	559	14	6	80	0.0750000
NODE_5861_length_1043_cov_25.987288	479	559	15	20	80	0.2500000
NODE_5861_length_1043_cov_25.987288	479	559	16	9	80	0.1125000
NODE_5861_length_1043_cov_25.987288	479	559	17	11	80	0.1375000
NODE_5861_length_1043_cov_25.987288	479	559	19	3	80	0.0375000
NODE_5861_length_1043_cov_25.987288	479	559	20	5	80	0.0625000
NODE_5861_length_1043_cov_25.987288	479	559	21	7	80	0.0875000
NODE_5861_length_1043_cov_25.987288	532	612	16	4	80	0.0500000
NODE_5861_length_1043_cov_25.987288	532	612	17	11	80	0.1375000
NODE_5861_length_1043_cov_25.987288	532	612	19	25	80	0.3125000
NODE_5861_length_1043_cov_25.987288	532	612	20	33	80	0.4125000
NODE_5861_length_1043_cov_25.987288	532	612	21	7	80	0.0875000
NODE_5862_length_1043_cov_20.838983	561	641	0	38	80	0.4750000
NODE_5862_length_1043_cov_20.838983	561	641	2	42	80	0.5250000
NODE_5862_length_1043_cov_20.838983	614	694	0	4	80	0.0500000
NODE_5862_length_1043_cov_20.838983	614	694	2	76	80	0.9500000
NODE_5863_length_1043_cov_20.312500	489	569	0	79	80	0.9875000
NODE_5863_length_1043_cov_20.312500	489	569	4	1	80	0.0125000
NODE_5863_length_1043_cov_20.312500	542	622	0	26	80	0.3250000
NODE_5863_length_1043_cov_20.312500	542	622	4	54	80	0.6750000
NODE_5864_length_1043_cov_16.320975	569	649	4	80	80	1.0000000
NODE_5864_length_1043_cov_16.320975	622	702	0	26	80	0.3250000
NODE_5864_length_1043_cov_16.320975	622	702	3	1	80	0.0125000
NODE_5864_length_1043_cov_16.320975	622	702	4	53	80	0.6625000
NODE_5865_length_1043_cov_11.176907	521	601	0	18	80	0.2250000
NODE_5865_length_1043_cov_11.176907	521	601	2	8	80	0.1000000
NODE_5865_length_1043_cov_11.176907	521	601	4	54	80	0.6750000
NODE_5865_length_1043_cov_11.176907	574	654	4	80	80	1.0000000
NODE_5866_length_1043_cov_8.146186	530	596	0	66	66	1.0000000
NODE_5866_length_1043_cov_8.146186	569	649	0	44	80	0.5500000
NODE_5866_length_1043_cov_8.146186	569	649	1	36	80	0.4500000
NODE_5868_length_1043_cov_5.347458	646	726	0	80	80	1.0000000
NODE_5868_length_1043_cov_5.347458	699	779	0	80	80	1.0000000
NODE_5879_length_1042_cov_242.728526	820	900	451	1	80	0.0125000
NODE_5879_length_1042_cov_242.728526	820	900	452	1	80	0.0125000
NODE_5879_length_1042_cov_242.728526	820	900	453	1	80	0.0125000
NODE_5879_length_1042_cov_242.728526	820	900	454	1	80	0.0125000
NODE_5879_length_1042_cov_242.728526	820	900	461	1	80	0.0125000
NODE_5879_length_1042_cov_242.728526	820	900	464	1	80	0.0125000
NODE_5879_length_1042_cov_242.728526	820	900	475	1	80	0.0125000
NODE_5879_length_1042_cov_242.728526	820	900	499	1	80	0.0125000
NODE_5879_length_1042_cov_242.728526	820	900	540	1	80	0.0125000
NODE_5879_length_1042_cov_242.728526	820	900	556	1	80	0.0125000
NODE_5879_length_1042_cov_242.728526	820	900	583	1	80	0.0125000
NODE_5879_length_1042_cov_242.728526	820	900	597	1	80	0.0125000
NODE_5879_length_1042_cov_242.728526	820	900	616	1	80	0.0125000
NODE_5879_length_1042_cov_242.728526	820	900	631	1	80	0.0125000
NODE_5879_length_1042_cov_242.728526	820	900	642	1	80	0.0125000
NODE_5879_length_1042_cov_242.728526	820	900	661	1	80	0.0125000
NODE_5879_length_1042_cov_242.728526	820	900	672	1	80	0.0125000
NODE_5879_length_1042_cov_242.728526	820	900	682	1	80	0.0125000
NODE_5879_length_1042_cov_242.728526	820	900	694	1	80	0.0125000
NODE_5879_length_1042_cov_242.728526	820	900	725	1	80	0.0125000
NODE_5879_length_1042_cov_242.728526	820	900	726	1	80	0.0125000
NODE_5879_length_1042_cov_242.728526	820	900	736	1	80	0.0125000
NODE_5879_length_1042_cov_242.728526	820	900	740	1	80	0.0125000
NODE_5879_length_1042_cov_242.728526	820	900	743	1	80	0.0125000
NODE_5879_length_1042_cov_242.728526	820	900	772	1	80	0.0125000
NODE_5879_length_1042_cov_242.728526	820	900	774	1	80	0.0125000
NODE_5879_length_1042_cov_242.728526	820	900	780	1	80	0.0125000
NODE_5879_length_1042_cov_242.728526	820	900	792	1	80	0.0125000
NODE_5879_length_1042_cov_242.728526	820	900	801	1	80	0.0125000
NODE_5879_length_1042_cov_242.728526	820	900	804	1	80	0.0125000
NODE_5879_length_1042_cov_242.728526	820	900	807	2	80	0.0250000
NODE_5879_length_1042_cov_242.728526	820	900	814	1	80	0.0125000
NODE_5879_length_1042_cov_242.728526	820	900	822	1	80	0.0125000
NODE_5879_length_1042_cov_242.728526	820	900	839	1	80	0.0125000
NODE_5879_length_1042_cov_242.728526	820	900	851	1	80	0.0125000
NODE_5879_length_1042_cov_242.728526	820	900	858	1	80	0.0125000
NODE_5879_length_1042_cov_242.728526	820	900	864	1	80	0.0125000
NODE_5879_length_1042_cov_242.728526	820	900	865	1	80	0.0125000
NODE_5879_length_1042_cov_242.728526	820	900	866	1	80	0.0125000
NODE_5879_length_1042_cov_242.728526	820	900	883	1	80	0.0125000
NODE_5879_length_1042_cov_242.728526	820	900	891	1	80	0.0125000
NODE_5879_length_1042_cov_242.728526	820	900	899	1	80	0.0125000
NODE_5879_length_1042_cov_242.728526	820	900	914	1	80	0.0125000
NODE_5879_length_1042_cov_242.728526	820	900	919	1	80	0.0125000
NODE_5879_length_1042_cov_242.728526	820	900	932	2	80	0.0250000
NODE_5879_length_1042_cov_242.728526	820	900	940	1	80	0.0125000
NODE_5879_length_1042_cov_242.728526	820	900	942	1	80	0.0125000
NODE_5879_length_1042_cov_242.728526	820	900	945	1	80	0.0125000
NODE_5879_length_1042_cov_242.728526	820	900	952	1	80	0.0125000
NODE_5879_length_1042_cov_242.728526	820	900	956	1	80	0.0125000
NODE_5879_length_1042_cov_242.728526	820	900	960	1	80	0.0125000
NODE_5879_length_1042_cov_242.728526	820	900	968	1	80	0.0125000
NODE_5879_length_1042_cov_242.728526	820	900	975	1	80	0.0125000
NODE_5879_length_1042_cov_242.728526	820	900	990	1	80	0.0125000
NODE_5879_length_1042_cov_242.728526	820	900	991	1	80	0.0125000
NODE_5879_length_1042_cov_242.728526	820	900	996	1	80	0.0125000
NODE_5879_length_1042_cov_242.728526	820	900	1019	1	80	0.0125000
NODE_5879_length_1042_cov_242.728526	820	900	1023	1	80	0.0125000
NODE_5879_length_1042_cov_242.728526	820	900	1032	1	80	0.0125000
NODE_5879_length_1042_cov_242.728526	820	900	1046	1	80	0.0125000
NODE_5879_length_1042_cov_242.728526	820	900	1058	1	80	0.0125000
NODE_5879_length_1042_cov_242.728526	820	900	1062	1	80	0.0125000
NODE_5879_length_1042_cov_242.728526	820	900	1066	1	80	0.0125000
NODE_5879_length_1042_cov_242.728526	820	900	1070	1	80	0.0125000
NODE_5879_length_1042_cov_242.728526	820	900	1074	1	80	0.0125000
NODE_5879_length_1042_cov_242.728526	820	900	1076	1	80	0.0125000
NODE_5879_length_1042_cov_242.728526	820	900	1081	1	80	0.0125000
NODE_5879_length_1042_cov_242.728526	820	900	1091	1	80	0.0125000
NODE_5879_length_1042_cov_242.728526	820	900	1104	1	80	0.0125000
NODE_5879_length_1042_cov_242.728526	820	900	1105	2	80	0.0250000
NODE_5879_length_1042_cov_242.728526	820	900	1110	1	80	0.0125000
NODE_5879_length_1042_cov_242.728526	820	900	1112	1	80	0.0125000
NODE_5879_length_1042_cov_242.728526	820	900	1116	1	80	0.0125000
NODE_5879_length_1042_cov_242.728526	820	900	1118	1	80	0.0125000
NODE_5879_length_1042_cov_242.728526	820	900	1121	1	80	0.0125000
NODE_5879_length_1042_cov_242.728526	820	900	1122	1	80	0.0125000
NODE_5879_length_1042_cov_242.728526	820	900	1127	1	80	0.0125000
NODE_5879_length_1042_cov_242.728526	873	903	968	1	30	0.0333333
NODE_5879_length_1042_cov_242.728526	873	903	975	1	30	0.0333333
NODE_5879_length_1042_cov_242.728526	873	903	990	1	30	0.0333333
NODE_5879_length_1042_cov_242.728526	873	903	991	1	30	0.0333333
NODE_5879_length_1042_cov_242.728526	873	903	996	1	30	0.0333333
NODE_5879_length_1042_cov_242.728526	873	903	1019	1	30	0.0333333
NODE_5879_length_1042_cov_242.728526	873	903	1023	1	30	0.0333333
NODE_5879_length_1042_cov_242.728526	873	903	1032	1	30	0.0333333
NODE_5879_length_1042_cov_242.728526	873	903	1046	1	30	0.0333333
NODE_5879_length_1042_cov_242.728526	873	903	1058	1	30	0.0333333
NODE_5879_length_1042_cov_242.728526	873	903	1062	1	30	0.0333333
NODE_5879_length_1042_cov_242.728526	873	903	1066	1	30	0.0333333
NODE_5879_length_1042_cov_242.728526	873	903	1070	1	30	0.0333333
NODE_5879_length_1042_cov_242.728526	873	903	1074	1	30	0.0333333
NODE_5879_length_1042_cov_242.728526	873	903	1076	1	30	0.0333333
NODE_5879_length_1042_cov_242.728526	873	903	1081	1	30	0.0333333
NODE_5879_length_1042_cov_242.728526	873	903	1091	1	30	0.0333333
NODE_5879_length_1042_cov_242.728526	873	903	1104	1	30	0.0333333
NODE_5879_length_1042_cov_242.728526	873	903	1105	2	30	0.0666667
NODE_5879_length_1042_cov_242.728526	873	903	1110	1	30	0.0333333
NODE_5879_length_1042_cov_242.728526	873	903	1112	1	30	0.0333333
NODE_5879_length_1042_cov_242.728526	873	903	1116	1	30	0.0333333
NODE_5879_length_1042_cov_242.728526	873	903	1118	1	30	0.0333333
NODE_5879_length_1042_cov_242.728526	873	903	1121	1	30	0.0333333
NODE_5879_length_1042_cov_242.728526	873	903	1122	1	30	0.0333333
NODE_5879_length_1042_cov_242.728526	873	903	1127	1	30	0.0333333
NODE_5879_length_1042_cov_242.728526	873	903	1129	1	30	0.0333333
NODE_5879_length_1042_cov_242.728526	873	903	1134	1	30	0.0333333
NODE_5879_length_1042_cov_242.728526	873	903	1135	1	30	0.0333333
NODE_5880_length_1042_cov_63.214210	355	435	0	56	80	0.7000000
NODE_5880_length_1042_cov_63.214210	355	435	2	24	80	0.3000000
NODE_5880_length_1042_cov_63.214210	408	488	0	3	80	0.0375000
NODE_5880_length_1042_cov_63.214210	408	488	2	77	80	0.9625000
NODE_5881_length_1042_cov_29.581124	497	577	0	80	80	1.0000000
NODE_5881_length_1042_cov_29.581124	550	630	0	80	80	1.0000000
NODE_5882_length_1042_cov_23.861082	519	599	0	80	80	1.0000000
NODE_5882_length_1042_cov_23.861082	572	652	0	80	80	1.0000000
NODE_5882_length_1042_cov_23.861082	648	728	0	77	80	0.9625000
NODE_5882_length_1042_cov_23.861082	648	728	4	3	80	0.0375000
NODE_5882_length_1042_cov_23.861082	701	781	0	24	80	0.3000000
NODE_5882_length_1042_cov_23.861082	701	781	4	56	80	0.7000000
NODE_5883_length_1042_cov_22.247084	555	635	0	50	80	0.6250000
NODE_5883_length_1042_cov_22.247084	555	635	2	30	80	0.3750000
NODE_5883_length_1042_cov_22.247084	608	688	2	80	80	1.0000000
NODE_5884_length_1042_cov_22.117709	335	415	2	80	80	1.0000000
NODE_5884_length_1042_cov_22.117709	388	468	0	52	80	0.6500000
NODE_5884_length_1042_cov_22.117709	388	468	2	28	80	0.3500000
NODE_5884_length_1042_cov_22.117709	464	544	0	30	80	0.3750000
NODE_5884_length_1042_cov_22.117709	464	544	2	1	80	0.0125000
NODE_5884_length_1042_cov_22.117709	464	544	6	49	80	0.6125000
NODE_5884_length_1042_cov_22.117709	517	597	0	2	80	0.0250000
NODE_5884_length_1042_cov_22.117709	517	597	2	10	80	0.1250000
NODE_5884_length_1042_cov_22.117709	517	597	4	16	80	0.2000000
NODE_5884_length_1042_cov_22.117709	517	597	6	52	80	0.6500000
NODE_5885_length_1042_cov_16.831389	27	97	6	1	70	0.0142857
NODE_5885_length_1042_cov_16.831389	27	97	8	6	70	0.0857143
NODE_5885_length_1042_cov_16.831389	27	97	10	25	70	0.3571429
NODE_5885_length_1042_cov_16.831389	27	97	14	10	70	0.1428571
NODE_5885_length_1042_cov_16.831389	27	97	16	12	70	0.1714286
NODE_5885_length_1042_cov_16.831389	27	97	18	16	70	0.2285714
NODE_5885_length_1042_cov_16.831389	372	452	0	80	80	1.0000000
NODE_5885_length_1042_cov_16.831389	425	505	0	80	80	1.0000000
NODE_5886_length_1042_cov_16.662778	416	496	2	13	80	0.1625000
NODE_5886_length_1042_cov_16.662778	416	496	4	43	80	0.5375000
NODE_5886_length_1042_cov_16.662778	416	496	6	24	80	0.3000000
NODE_5886_length_1042_cov_16.662778	469	549	0	53	80	0.6625000
NODE_5886_length_1042_cov_16.662778	469	549	2	13	80	0.1625000
NODE_5886_length_1042_cov_16.662778	469	549	4	14	80	0.1750000
NODE_5887_length_1042_cov_9.474019	361	441	5	25	80	0.3125000
NODE_5887_length_1042_cov_9.474019	361	441	7	55	80	0.6875000
NODE_5887_length_1042_cov_9.474019	414	494	6	32	80	0.4000000
NODE_5887_length_1042_cov_9.474019	414	494	7	38	80	0.4750000
NODE_5887_length_1042_cov_9.474019	414	494	8	10	80	0.1250000
NODE_5888_length_1042_cov_6.725345	356	419	0	63	63	1.0000000
NODE_5888_length_1042_cov_6.725345	392	472	0	80	80	1.0000000
NODE_5896_length_1041_cov_42.960722	335	415	0	21	80	0.2625000
NODE_5896_length_1041_cov_42.960722	335	415	2	59	80	0.7375000
NODE_5896_length_1041_cov_42.960722	388	468	0	74	80	0.9250000
NODE_5896_length_1041_cov_42.960722	388	468	2	6	80	0.0750000
NODE_5896_length_1041_cov_42.960722	464	544	0	53	80	0.6625000
NODE_5896_length_1041_cov_42.960722	464	544	4	27	80	0.3375000
NODE_5896_length_1041_cov_42.960722	517	597	4	80	80	1.0000000
NODE_5897_length_1041_cov_37.331210	513	593	2	33	80	0.4125000
NODE_5897_length_1041_cov_37.331210	513	593	4	47	80	0.5875000
NODE_5897_length_1041_cov_37.331210	566	646	0	20	80	0.2500000
NODE_5897_length_1041_cov_37.331210	566	646	2	6	80	0.0750000
NODE_5897_length_1041_cov_37.331210	566	646	4	54	80	0.6750000
NODE_5897_length_1041_cov_37.331210	642	722	0	80	80	1.0000000
NODE_5897_length_1041_cov_37.331210	695	775	0	80	80	1.0000000
NODE_5898_length_1041_cov_36.477707	455	535	0	80	80	1.0000000
NODE_5898_length_1041_cov_36.477707	508	588	0	80	80	1.0000000
NODE_5898_length_1041_cov_36.477707	584	664	0	80	80	1.0000000
NODE_5898_length_1041_cov_36.477707	637	717	0	80	80	1.0000000
NODE_5898_length_1041_cov_36.477707	753	799	0	46	46	1.0000000
NODE_5899_length_1041_cov_19.286624	468	548	0	80	80	1.0000000
NODE_5899_length_1041_cov_19.286624	521	601	0	80	80	1.0000000
NODE_5900_length_1041_cov_17.072187	578	658	0	80	80	1.0000000
NODE_5900_length_1041_cov_17.072187	631	711	0	80	80	1.0000000
NODE_5901_length_1041_cov_11.887473	437	517	0	5	80	0.0625000
NODE_5901_length_1041_cov_11.887473	437	517	6	75	80	0.9375000
NODE_5901_length_1041_cov_11.887473	490	570	0	24	80	0.3000000
NODE_5901_length_1041_cov_11.887473	490	570	6	56	80	0.7000000
NODE_5902_length_1041_cov_6.957537	354	434	0	80	80	1.0000000
NODE_5902_length_1041_cov_6.957537	407	487	0	80	80	1.0000000
NODE_5913_length_1040_cov_34.618491	478	558	2	63	80	0.7875000
NODE_5913_length_1040_cov_34.618491	478	558	4	7	80	0.0875000
NODE_5913_length_1040_cov_34.618491	478	558	6	10	80	0.1250000
NODE_5913_length_1040_cov_34.618491	531	611	2	10	80	0.1250000
NODE_5913_length_1040_cov_34.618491	531	611	4	34	80	0.4250000
NODE_5913_length_1040_cov_34.618491	531	611	6	36	80	0.4500000
NODE_5914_length_1040_cov_33.061637	485	565	0	80	80	1.0000000
NODE_5914_length_1040_cov_33.061637	538	618	0	80	80	1.0000000
NODE_5915_length_1040_cov_27.818278	402	482	22	22	80	0.2750000
NODE_5915_length_1040_cov_27.818278	402	482	28	58	80	0.7250000
NODE_5915_length_1040_cov_27.818278	455	535	0	32	80	0.4000000
NODE_5915_length_1040_cov_27.818278	455	535	22	43	80	0.5375000
NODE_5915_length_1040_cov_27.818278	455	535	28	5	80	0.0625000
NODE_5916_length_1040_cov_17.933050	487	567	0	57	80	0.7125000
NODE_5916_length_1040_cov_17.933050	487	567	2	23	80	0.2875000
NODE_5916_length_1040_cov_17.933050	540	620	0	4	80	0.0500000
NODE_5916_length_1040_cov_17.933050	540	620	2	76	80	0.9500000
NODE_5917_length_1040_cov_14.327311	237	317	0	80	80	1.0000000
NODE_5917_length_1040_cov_14.327311	290	370	0	59	80	0.7375000
NODE_5917_length_1040_cov_14.327311	290	370	2	21	80	0.2625000
NODE_5917_length_1040_cov_14.327311	366	446	2	29	80	0.3625000
NODE_5917_length_1040_cov_14.327311	366	446	4	51	80	0.6375000
NODE_5917_length_1040_cov_14.327311	419	499	0	7	80	0.0875000
NODE_5917_length_1040_cov_14.327311	419	499	2	37	80	0.4625000
NODE_5917_length_1040_cov_14.327311	419	499	4	36	80	0.4500000
NODE_5918_length_1040_cov_11.910733	369	449	2	11	80	0.1375000
NODE_5918_length_1040_cov_11.910733	369	449	6	18	80	0.2250000
NODE_5918_length_1040_cov_11.910733	369	449	7	17	80	0.2125000
NODE_5918_length_1040_cov_11.910733	369	449	8	34	80	0.4250000
NODE_5918_length_1040_cov_11.910733	422	502	0	34	80	0.4250000
NODE_5918_length_1040_cov_11.910733	422	502	2	30	80	0.3750000
NODE_5918_length_1040_cov_11.910733	422	502	6	16	80	0.2000000
NODE_5919_length_1040_cov_11.521785	355	435	0	80	80	1.0000000
NODE_5919_length_1040_cov_11.521785	408	488	0	80	80	1.0000000
NODE_5920_length_1040_cov_9.573858	632	712	0	80	80	1.0000000
NODE_5920_length_1040_cov_9.573858	685	765	0	80	80	1.0000000
NODE_5921_length_1040_cov_8.148778	349	429	0	10	80	0.1250000
NODE_5921_length_1040_cov_8.148778	349	429	2	5	80	0.0625000
NODE_5921_length_1040_cov_8.148778	349	429	4	18	80	0.2250000
NODE_5921_length_1040_cov_8.148778	349	429	6	47	80	0.5875000
NODE_5921_length_1040_cov_8.148778	402	482	0	63	80	0.7875000
NODE_5921_length_1040_cov_8.148778	402	482	4	17	80	0.2125000
NODE_5922_length_1040_cov_7.927736	282	362	2	24	80	0.3000000
NODE_5922_length_1040_cov_7.927736	282	362	4	56	80	0.7000000
NODE_5922_length_1040_cov_7.927736	335	415	0	32	80	0.4000000
NODE_5922_length_1040_cov_7.927736	335	415	2	4	80	0.0500000
NODE_5922_length_1040_cov_7.927736	335	415	4	44	80	0.5500000
NODE_5927_length_1040_cov_2.317747	2	78	2	7	76	0.0921053
NODE_5927_length_1040_cov_2.317747	2	78	3	1	76	0.0131579
NODE_5927_length_1040_cov_2.317747	2	78	4	8	76	0.1052632
NODE_5927_length_1040_cov_2.317747	2	78	5	60	76	0.7894737
NODE_5934_length_1039_cov_40.150000	487	567	0	18	80	0.2250000
NODE_5934_length_1039_cov_40.150000	487	567	2	62	80	0.7750000
NODE_5934_length_1039_cov_40.150000	540	620	0	44	80	0.5500000
NODE_5934_length_1039_cov_40.150000	540	620	1	1	80	0.0125000
NODE_5934_length_1039_cov_40.150000	540	620	2	30	80	0.3750000
NODE_5934_length_1039_cov_40.150000	540	620	4	5	80	0.0625000
NODE_5934_length_1039_cov_40.150000	616	696	4	34	80	0.4250000
NODE_5934_length_1039_cov_40.150000	616	696	6	46	80	0.5750000
NODE_5934_length_1039_cov_40.150000	669	739	2	11	70	0.1571429
NODE_5934_length_1039_cov_40.150000	669	739	4	12	70	0.1714286
NODE_5934_length_1039_cov_40.150000	669	739	6	27	70	0.3857143
NODE_5934_length_1039_cov_40.150000	669	739	8	20	70	0.2857143
NODE_5935_length_1039_cov_37.940426	175	255	0	74	80	0.9250000
NODE_5935_length_1039_cov_37.940426	175	255	1	6	80	0.0750000
NODE_5935_length_1039_cov_37.940426	228	308	0	80	80	1.0000000
NODE_5935_length_1039_cov_37.940426	304	384	0	12	80	0.1500000
NODE_5935_length_1039_cov_37.940426	304	384	2	41	80	0.5125000
NODE_5935_length_1039_cov_37.940426	304	384	3	27	80	0.3375000
NODE_5935_length_1039_cov_37.940426	357	437	3	80	80	1.0000000
NODE_5936_length_1039_cov_24.567021	371	451	0	6	80	0.0750000
NODE_5936_length_1039_cov_24.567021	371	451	4	74	80	0.9250000
NODE_5936_length_1039_cov_24.567021	424	504	0	59	80	0.7375000
NODE_5936_length_1039_cov_24.567021	424	504	4	21	80	0.2625000
NODE_5937_length_1039_cov_15.790426	293	373	0	47	80	0.5875000
NODE_5937_length_1039_cov_15.790426	293	373	2	33	80	0.4125000
NODE_5937_length_1039_cov_15.790426	346	426	2	80	80	1.0000000
NODE_5938_length_1039_cov_14.670213	591	671	0	80	80	1.0000000
NODE_5938_length_1039_cov_14.670213	644	724	0	80	80	1.0000000
NODE_5939_length_1039_cov_11.568085	439	519	0	48	80	0.6000000
NODE_5939_length_1039_cov_11.568085	439	519	2	32	80	0.4000000
NODE_5939_length_1039_cov_11.568085	492	571	2	79	79	1.0000000
NODE_5947_length_1038_cov_17.191693	549	629	0	80	80	1.0000000
NODE_5947_length_1038_cov_17.191693	602	682	0	80	80	1.0000000
NODE_5948_length_1038_cov_13.520767	516	596	0	8	80	0.1000000
NODE_5948_length_1038_cov_13.520767	516	596	2	43	80	0.5375000
NODE_5948_length_1038_cov_13.520767	516	596	4	29	80	0.3625000
NODE_5948_length_1038_cov_13.520767	569	649	0	2	80	0.0250000
NODE_5948_length_1038_cov_13.520767	569	649	2	22	80	0.2750000
NODE_5948_length_1038_cov_13.520767	569	649	4	56	80	0.7000000
NODE_5949_length_1038_cov_10.541001	487	567	0	80	80	1.0000000
NODE_5949_length_1038_cov_10.541001	540	620	0	80	80	1.0000000
NODE_5950_length_1038_cov_8.826411	432	512	0	7	80	0.0875000
NODE_5950_length_1038_cov_8.826411	432	512	6	73	80	0.9125000
NODE_5950_length_1038_cov_8.826411	485	565	0	51	80	0.6375000
NODE_5950_length_1038_cov_8.826411	485	565	6	29	80	0.3625000
NODE_5952_length_1038_cov_2.587859	673	753	0	80	80	1.0000000
NODE_5952_length_1038_cov_2.587859	726	806	0	80	80	1.0000000
NODE_5963_length_1037_cov_66.968017	402	482	8	57	80	0.7125000
NODE_5963_length_1037_cov_66.968017	402	482	12	23	80	0.2875000
NODE_5963_length_1037_cov_66.968017	455	535	4	19	80	0.2375000
NODE_5963_length_1037_cov_66.968017	455	535	6	12	80	0.1500000
NODE_5963_length_1037_cov_66.968017	455	535	8	4	80	0.0500000
NODE_5963_length_1037_cov_66.968017	455	535	12	45	80	0.5625000
NODE_5964_length_1037_cov_53.639659	527	607	0	47	80	0.5875000
NODE_5964_length_1037_cov_53.639659	527	607	2	33	80	0.4125000
NODE_5964_length_1037_cov_53.639659	580	660	0	24	80	0.3000000
NODE_5964_length_1037_cov_53.639659	580	660	2	56	80	0.7000000
NODE_5965_length_1037_cov_45.353945	542	622	2	80	80	1.0000000
NODE_5965_length_1037_cov_45.353945	595	675	0	23	80	0.2875000
NODE_5965_length_1037_cov_45.353945	595	675	2	57	80	0.7125000
NODE_5966_length_1037_cov_31.078891	356	436	0	80	80	1.0000000
NODE_5966_length_1037_cov_31.078891	409	489	0	80	80	1.0000000
NODE_5967_length_1037_cov_25.453092	421	501	12	1	80	0.0125000
NODE_5967_length_1037_cov_25.453092	421	501	18	33	80	0.4125000
NODE_5967_length_1037_cov_25.453092	421	501	19	6	80	0.0750000
NODE_5967_length_1037_cov_25.453092	421	501	20	4	80	0.0500000
NODE_5967_length_1037_cov_25.453092	421	501	23	36	80	0.4500000
NODE_5967_length_1037_cov_25.453092	474	554	6	11	80	0.1375000
NODE_5967_length_1037_cov_25.453092	474	554	18	13	80	0.1625000
NODE_5967_length_1037_cov_25.453092	474	554	23	32	80	0.4000000
NODE_5967_length_1037_cov_25.453092	474	554	25	24	80	0.3000000
NODE_5967_length_1037_cov_25.453092	550	573	6	23	23	1.0000000
NODE_5968_length_1037_cov_13.740938	348	428	1	53	80	0.6625000
NODE_5968_length_1037_cov_13.740938	348	428	2	27	80	0.3375000
NODE_5968_length_1037_cov_13.740938	401	481	1	31	80	0.3875000
NODE_5968_length_1037_cov_13.740938	401	481	2	49	80	0.6125000
NODE_5969_length_1037_cov_12.632196	564	644	2	80	80	1.0000000
NODE_5969_length_1037_cov_12.632196	617	697	0	36	80	0.4500000
NODE_5969_length_1037_cov_12.632196	617	697	2	44	80	0.5500000
NODE_5970_length_1037_cov_8.904051	640	720	0	80	80	1.0000000
NODE_5970_length_1037_cov_8.904051	693	773	0	80	80	1.0000000
NODE_5978_length_1037_cov_1.859275	31	91	0	60	60	1.0000000
NODE_5986_length_1036_cov_52.270011	493	573	0	18	80	0.2250000
NODE_5986_length_1036_cov_52.270011	493	573	2	62	80	0.7750000
NODE_5986_length_1036_cov_52.270011	546	626	0	60	80	0.7500000
NODE_5986_length_1036_cov_52.270011	546	626	2	20	80	0.2500000
NODE_5987_length_1036_cov_24.080043	369	449	2	48	80	0.6000000
NODE_5987_length_1036_cov_24.080043	369	449	4	1	80	0.0125000
NODE_5987_length_1036_cov_24.080043	369	449	6	31	80	0.3875000
NODE_5987_length_1036_cov_24.080043	422	502	4	54	80	0.6750000
NODE_5987_length_1036_cov_24.080043	422	502	6	26	80	0.3250000
NODE_5988_length_1036_cov_20.533618	513	593	0	6	80	0.0750000
NODE_5988_length_1036_cov_20.533618	513	593	2	74	80	0.9250000
NODE_5988_length_1036_cov_20.533618	566	645	0	19	79	0.2405063
NODE_5988_length_1036_cov_20.533618	566	645	2	60	79	0.7594936
NODE_5988_length_1036_cov_20.533618	648	728	0	80	80	1.0000000
NODE_5988_length_1036_cov_20.533618	701	781	0	80	80	1.0000000
NODE_5989_length_1036_cov_19.715048	467	547	4	1	80	0.0125000
NODE_5989_length_1036_cov_19.715048	467	547	6	79	80	0.9875000
NODE_5989_length_1036_cov_19.715048	520	600	4	54	80	0.6750000
NODE_5989_length_1036_cov_19.715048	520	600	6	26	80	0.3250000
NODE_5990_length_1036_cov_19.452508	399	479	0	80	80	1.0000000
NODE_5990_length_1036_cov_19.452508	452	532	0	80	80	1.0000000
NODE_5990_length_1036_cov_19.452508	528	608	0	80	80	1.0000000
NODE_5990_length_1036_cov_19.452508	581	661	0	80	80	1.0000000
NODE_5991_length_1036_cov_13.840982	635	715	0	80	80	1.0000000
NODE_5991_length_1036_cov_13.840982	688	768	0	80	80	1.0000000
NODE_5992_length_1036_cov_6.913554	424	504	0	80	80	1.0000000
NODE_5992_length_1036_cov_6.913554	477	557	0	70	80	0.8750000
NODE_5992_length_1036_cov_6.913554	477	557	2	10	80	0.1250000
NODE_5993_length_1036_cov_5.880470	436	516	0	51	80	0.6375000
NODE_5993_length_1036_cov_5.880470	436	516	2	29	80	0.3625000
NODE_5993_length_1036_cov_5.880470	489	569	0	80	80	1.0000000
NODE_5994_length_1036_cov_4.638207	531	611	1	40	80	0.5000000
NODE_5994_length_1036_cov_4.638207	531	611	2	40	80	0.5000000
NODE_5994_length_1036_cov_4.638207	584	664	1	27	80	0.3375000
NODE_5994_length_1036_cov_4.638207	584	664	2	53	80	0.6625000
NODE_5998_length_1036_cov_1.293490	19	69	0	50	50	1.0000000
NODE_6001_length_1035_cov_31.941239	590	670	0	80	80	1.0000000
NODE_6001_length_1035_cov_31.941239	643	723	0	80	80	1.0000000
NODE_6002_length_1035_cov_14.917735	396	476	0	80	80	1.0000000
NODE_6002_length_1035_cov_14.917735	449	529	0	80	80	1.0000000
NODE_6003_length_1035_cov_12.552350	467	547	0	39	80	0.4875000
NODE_6003_length_1035_cov_12.552350	467	547	4	41	80	0.5125000
NODE_6003_length_1035_cov_12.552350	520	600	4	80	80	1.0000000
NODE_6004_length_1035_cov_12.050214	40	103	0	48	63	0.7619048
NODE_6004_length_1035_cov_12.050214	40	103	2	15	63	0.2380952
NODE_6004_length_1035_cov_12.050214	138	219	0	19	81	0.2345679
NODE_6004_length_1035_cov_12.050214	138	219	2	62	81	0.7654321
NODE_6005_length_1035_cov_7.020299	350	430	0	80	80	1.0000000
NODE_6005_length_1035_cov_7.020299	403	483	0	80	80	1.0000000
NODE_6006_length_1035_cov_4.726496	531	611	0	80	80	1.0000000
NODE_6006_length_1035_cov_4.726496	584	664	0	80	80	1.0000000
NODE_6018_length_1034_cov_26.810695	322	402	0	80	80	1.0000000
NODE_6018_length_1034_cov_26.810695	375	455	0	80	80	1.0000000
NODE_6018_length_1034_cov_26.810695	451	531	0	50	80	0.6250000
NODE_6018_length_1034_cov_26.810695	451	531	6	30	80	0.3750000
NODE_6018_length_1034_cov_26.810695	504	584	6	80	80	1.0000000
NODE_6032_length_1033_cov_42.574946	462	542	0	80	80	1.0000000
NODE_6032_length_1033_cov_42.574946	515	595	0	80	80	1.0000000
NODE_6033_length_1033_cov_17.073876	464	544	0	80	80	1.0000000
NODE_6033_length_1033_cov_17.073876	517	597	0	56	80	0.7000000
NODE_6033_length_1033_cov_17.073876	517	597	2	24	80	0.3000000
NODE_6034_length_1033_cov_15.791221	309	386	0	77	77	1.0000000
NODE_6034_length_1033_cov_15.791221	359	439	0	80	80	1.0000000
NODE_6035_length_1033_cov_11.340471	437	517	0	29	80	0.3625000
NODE_6035_length_1033_cov_11.340471	437	517	4	51	80	0.6375000
NODE_6035_length_1033_cov_11.340471	490	570	0	80	80	1.0000000
NODE_6045_length_1032_cov_56.511254	466	546	0	12	80	0.1500000
NODE_6045_length_1032_cov_56.511254	466	546	4	68	80	0.8500000
NODE_6045_length_1032_cov_56.511254	519	599	0	65	80	0.8125000
NODE_6045_length_1032_cov_56.511254	519	599	4	15	80	0.1875000
NODE_6046_length_1032_cov_20.752412	479	559	0	80	80	1.0000000
NODE_6046_length_1032_cov_20.752412	532	612	0	80	80	1.0000000
NODE_6047_length_1032_cov_8.166131	257	337	0	75	80	0.9375000
NODE_6047_length_1032_cov_8.166131	257	337	4	5	80	0.0625000
NODE_6047_length_1032_cov_8.166131	310	390	0	80	80	1.0000000
NODE_6048_length_1032_cov_7.991426	277	357	2	34	80	0.4250000
NODE_6048_length_1032_cov_7.991426	277	357	4	46	80	0.5750000
NODE_6048_length_1032_cov_7.991426	330	410	0	37	80	0.4625000
NODE_6048_length_1032_cov_7.991426	330	410	2	22	80	0.2750000
NODE_6048_length_1032_cov_7.991426	330	410	4	21	80	0.2625000
NODE_6049_length_1032_cov_5.276527	371	451	0	45	80	0.5625000
NODE_6049_length_1032_cov_5.276527	371	451	2	35	80	0.4375000
NODE_6049_length_1032_cov_5.276527	424	504	0	80	80	1.0000000
NODE_6055_length_1031_cov_71.154506	586	654	8	11	68	0.1617647
NODE_6055_length_1031_cov_71.154506	586	654	14	57	68	0.8382353
NODE_6055_length_1031_cov_71.154506	616	696	0	12	80	0.1500000
NODE_6055_length_1031_cov_71.154506	616	696	1	5	80	0.0625000
NODE_6055_length_1031_cov_71.154506	616	696	5	1	80	0.0125000
NODE_6055_length_1031_cov_71.154506	616	696	7	18	80	0.2250000
NODE_6055_length_1031_cov_71.154506	616	696	8	17	80	0.2125000
NODE_6055_length_1031_cov_71.154506	616	696	14	27	80	0.3375000
NODE_6055_length_1031_cov_71.154506	669	749	0	65	80	0.8125000
NODE_6055_length_1031_cov_71.154506	669	749	1	5	80	0.0625000
NODE_6055_length_1031_cov_71.154506	669	749	5	1	80	0.0125000
NODE_6055_length_1031_cov_71.154506	669	749	7	9	80	0.1125000
NODE_6056_length_1031_cov_70.221030	409	489	4	13	80	0.1625000
NODE_6056_length_1031_cov_70.221030	409	489	6	30	80	0.3750000
NODE_6056_length_1031_cov_70.221030	409	489	8	2	80	0.0250000
NODE_6056_length_1031_cov_70.221030	409	489	10	22	80	0.2750000
NODE_6056_length_1031_cov_70.221030	409	489	12	5	80	0.0625000
NODE_6056_length_1031_cov_70.221030	409	489	14	8	80	0.1000000
NODE_6056_length_1031_cov_70.221030	462	542	2	9	80	0.1125000
NODE_6056_length_1031_cov_70.221030	462	542	4	12	80	0.1500000
NODE_6056_length_1031_cov_70.221030	462	542	6	59	80	0.7375000
NODE_6056_length_1031_cov_70.221030	538	618	2	4	80	0.0500000
NODE_6056_length_1031_cov_70.221030	538	618	4	49	80	0.6125000
NODE_6056_length_1031_cov_70.221030	538	618	6	27	80	0.3375000
NODE_6056_length_1031_cov_70.221030	591	671	0	52	80	0.6500000
NODE_6056_length_1031_cov_70.221030	591	671	4	28	80	0.3500000
NODE_6057_length_1031_cov_43.618026	462	542	0	13	80	0.1625000
NODE_6057_length_1031_cov_43.618026	462	542	2	67	80	0.8375000
NODE_6057_length_1031_cov_43.618026	515	595	0	18	80	0.2250000
NODE_6057_length_1031_cov_43.618026	515	595	2	62	80	0.7750000
NODE_6058_length_1031_cov_43.581545	303	383	2	25	80	0.3125000
NODE_6058_length_1031_cov_43.581545	303	383	3	24	80	0.3000000
NODE_6058_length_1031_cov_43.581545	303	383	5	24	80	0.3000000
NODE_6058_length_1031_cov_43.581545	303	383	6	7	80	0.0875000
NODE_6058_length_1031_cov_43.581545	356	436	3	20	80	0.2500000
NODE_6058_length_1031_cov_43.581545	356	436	6	60	80	0.7500000
NODE_6058_length_1031_cov_43.581545	432	512	3	34	80	0.4250000
NODE_6058_length_1031_cov_43.581545	432	512	6	46	80	0.5750000
NODE_6058_length_1031_cov_43.581545	485	565	2	39	80	0.4875000
NODE_6058_length_1031_cov_43.581545	485	565	3	33	80	0.4125000
NODE_6058_length_1031_cov_43.581545	485	565	5	8	80	0.1000000
NODE_6059_length_1031_cov_22.310086	382	462	0	80	80	1.0000000
NODE_6059_length_1031_cov_22.310086	435	515	0	80	80	1.0000000
NODE_6060_length_1031_cov_11.547210	481	561	0	80	80	1.0000000
NODE_6060_length_1031_cov_11.547210	534	614	0	80	80	1.0000000
NODE_6066_length_1030_cov_54.380236	363	443	0	50	80	0.6250000
NODE_6066_length_1030_cov_54.380236	363	443	2	30	80	0.3750000
NODE_6066_length_1030_cov_54.380236	416	496	0	2	80	0.0250000
NODE_6066_length_1030_cov_54.380236	416	496	1	9	80	0.1125000
NODE_6066_length_1030_cov_54.380236	416	496	2	69	80	0.8625000
NODE_6066_length_1030_cov_54.380236	492	572	0	78	80	0.9750000
NODE_6066_length_1030_cov_54.380236	492	572	1	2	80	0.0250000
NODE_6066_length_1030_cov_54.380236	545	625	0	80	80	1.0000000
NODE_6067_length_1030_cov_45.040816	334	414	0	80	80	1.0000000
NODE_6067_length_1030_cov_45.040816	387	467	0	80	80	1.0000000
NODE_6067_length_1030_cov_45.040816	463	543	0	20	80	0.2500000
NODE_6067_length_1030_cov_45.040816	463	543	29	1	80	0.0125000
NODE_6067_length_1030_cov_45.040816	463	543	30	5	80	0.0625000
NODE_6067_length_1030_cov_45.040816	463	543	32	45	80	0.5625000
NODE_6067_length_1030_cov_45.040816	463	543	36	9	80	0.1125000
NODE_6067_length_1030_cov_45.040816	516	596	32	18	80	0.2250000
NODE_6067_length_1030_cov_45.040816	516	596	34	5	80	0.0625000
NODE_6067_length_1030_cov_45.040816	516	596	36	57	80	0.7125000
NODE_6068_length_1030_cov_20.491944	511	591	0	58	80	0.7250000
NODE_6068_length_1030_cov_20.491944	511	591	2	4	80	0.0500000
NODE_6068_length_1030_cov_20.491944	511	591	4	18	80	0.2250000
NODE_6068_length_1030_cov_20.491944	564	644	0	5	80	0.0625000
NODE_6068_length_1030_cov_20.491944	564	644	2	4	80	0.0500000
NODE_6068_length_1030_cov_20.491944	564	644	4	71	80	0.8875000
NODE_6069_length_1030_cov_17.253491	524	604	0	64	80	0.8000000
NODE_6069_length_1030_cov_17.253491	524	604	4	16	80	0.2000000
NODE_6069_length_1030_cov_17.253491	577	657	0	11	80	0.1375000
NODE_6069_length_1030_cov_17.253491	577	657	4	69	80	0.8625000
NODE_6070_length_1030_cov_14.337272	564	644	0	80	80	1.0000000
NODE_6070_length_1030_cov_14.337272	617	697	0	80	80	1.0000000
NODE_6071_length_1030_cov_5.742213	474	554	0	80	80	1.0000000
NODE_6071_length_1030_cov_5.742213	527	607	0	80	80	1.0000000
NODE_6073_length_1030_cov_5.208378	978	1030	0	12	52	0.2307692
NODE_6073_length_1030_cov_5.208378	978	1030	2	40	52	0.7692308
NODE_6077_length_1030_cov_2.146079	979	1010	0	31	31	1.0000000
NODE_6083_length_1029_cov_236.527957	584	666	20	5	82	0.0609756
NODE_6083_length_1029_cov_236.527957	584	666	22	4	82	0.0487805
NODE_6083_length_1029_cov_236.527957	584	666	32	2	82	0.0243902
NODE_6083_length_1029_cov_236.527957	584	666	33	2	82	0.0243902
NODE_6083_length_1029_cov_236.527957	584	666	37	6	82	0.0731707
NODE_6083_length_1029_cov_236.527957	584	666	41	1	82	0.0121951
NODE_6083_length_1029_cov_236.527957	584	666	45	1	82	0.0121951
NODE_6083_length_1029_cov_236.527957	584	666	49	8	82	0.0975610
NODE_6083_length_1029_cov_236.527957	584	666	53	4	82	0.0487805
NODE_6083_length_1029_cov_236.527957	584	666	55	4	82	0.0487805
NODE_6083_length_1029_cov_236.527957	584	666	57	17	82	0.2073171
NODE_6083_length_1029_cov_236.527957	584	666	59	3	82	0.0365854
NODE_6083_length_1029_cov_236.527957	584	666	66	2	82	0.0243902
NODE_6083_length_1029_cov_236.527957	584	666	67	2	82	0.0243902
NODE_6083_length_1029_cov_236.527957	584	666	69	5	82	0.0609756
NODE_6083_length_1029_cov_236.527957	584	666	74	16	82	0.1951219
NODE_6083_length_1029_cov_236.527957	639	702	38	2	63	0.0317460
NODE_6083_length_1029_cov_236.527957	639	702	40	4	63	0.0634921
NODE_6083_length_1029_cov_236.527957	639	702	42	3	63	0.0476190
NODE_6083_length_1029_cov_236.527957	639	702	44	5	63	0.0793651
NODE_6083_length_1029_cov_236.527957	639	702	54	1	63	0.0158730
NODE_6083_length_1029_cov_236.527957	639	702	57	2	63	0.0317460
NODE_6083_length_1029_cov_236.527957	639	702	58	3	63	0.0476190
NODE_6083_length_1029_cov_236.527957	639	702	62	1	63	0.0158730
NODE_6083_length_1029_cov_236.527957	639	702	64	4	63	0.0634921
NODE_6083_length_1029_cov_236.527957	639	702	66	2	63	0.0317460
NODE_6083_length_1029_cov_236.527957	639	702	67	2	63	0.0317460
NODE_6083_length_1029_cov_236.527957	639	702	69	5	63	0.0793651
NODE_6083_length_1029_cov_236.527957	639	702	70	1	63	0.0158730
NODE_6083_length_1029_cov_236.527957	639	702	72	7	63	0.1111111
NODE_6083_length_1029_cov_236.527957	639	702	74	21	63	0.3333333
NODE_6084_length_1029_cov_41.650538	364	444	0	80	80	1.0000000
NODE_6084_length_1029_cov_41.650538	417	497	0	69	80	0.8625000
NODE_6084_length_1029_cov_41.650538	417	497	4	11	80	0.1375000
NODE_6084_length_1029_cov_41.650538	493	573	0	10	80	0.1250000
NODE_6084_length_1029_cov_41.650538	493	573	4	70	80	0.8750000
NODE_6084_length_1029_cov_41.650538	546	626	0	63	80	0.7875000
NODE_6084_length_1029_cov_41.650538	546	626	4	17	80	0.2125000
NODE_6085_length_1029_cov_34.940860	314	360	0	46	46	1.0000000
NODE_6085_length_1029_cov_34.940860	371	451	0	80	80	1.0000000
NODE_6085_length_1029_cov_34.940860	424	502	0	78	78	1.0000000
NODE_6086_length_1029_cov_28.752688	255	335	0	8	80	0.1000000
NODE_6086_length_1029_cov_28.752688	255	335	2	72	80	0.9000000
NODE_6086_length_1029_cov_28.752688	308	388	0	61	80	0.7625000
NODE_6086_length_1029_cov_28.752688	308	388	2	19	80	0.2375000
NODE_6086_length_1029_cov_28.752688	384	464	0	72	80	0.9000000
NODE_6086_length_1029_cov_28.752688	384	464	2	8	80	0.1000000
NODE_6086_length_1029_cov_28.752688	437	517	0	19	80	0.2375000
NODE_6086_length_1029_cov_28.752688	437	517	2	23	80	0.2875000
NODE_6086_length_1029_cov_28.752688	437	517	4	38	80	0.4750000
NODE_6087_length_1029_cov_28.523656	409	489	0	18	80	0.2250000
NODE_6087_length_1029_cov_28.523656	409	489	6	35	80	0.4375000
NODE_6087_length_1029_cov_28.523656	409	489	12	27	80	0.3375000
NODE_6087_length_1029_cov_28.523656	462	542	6	7	80	0.0875000
NODE_6087_length_1029_cov_28.523656	462	542	12	73	80	0.9125000
NODE_6088_length_1029_cov_28.283871	281	361	0	80	80	1.0000000
NODE_6088_length_1029_cov_28.283871	334	414	0	80	80	1.0000000
NODE_6088_length_1029_cov_28.283871	410	490	0	23	80	0.2875000
NODE_6088_length_1029_cov_28.283871	410	490	4	28	80	0.3500000
NODE_6088_length_1029_cov_28.283871	410	490	14	29	80	0.3625000
NODE_6088_length_1029_cov_28.283871	463	546	10	28	83	0.3373494
NODE_6088_length_1029_cov_28.283871	463	546	14	55	83	0.6626506
NODE_6089_length_1029_cov_26.883871	434	514	0	13	80	0.1625000
NODE_6089_length_1029_cov_26.883871	434	514	2	67	80	0.8375000
NODE_6089_length_1029_cov_26.883871	487	567	0	22	80	0.2750000
NODE_6089_length_1029_cov_26.883871	487	567	2	58	80	0.7250000
NODE_6090_length_1029_cov_23.552688	305	385	0	80	80	1.0000000
NODE_6090_length_1029_cov_23.552688	358	438	0	72	80	0.9000000
NODE_6090_length_1029_cov_23.552688	358	438	2	8	80	0.1000000
NODE_6090_length_1029_cov_23.552688	434	514	2	80	80	1.0000000
NODE_6090_length_1029_cov_23.552688	487	567	0	10	80	0.1250000
NODE_6090_length_1029_cov_23.552688	487	567	2	70	80	0.8750000
NODE_6091_length_1029_cov_22.520430	434	514	0	80	80	1.0000000
NODE_6091_length_1029_cov_22.520430	487	567	0	80	80	1.0000000
NODE_6092_length_1029_cov_21.924731	335	415	0	80	80	1.0000000
NODE_6092_length_1029_cov_21.924731	388	468	0	80	80	1.0000000
NODE_6093_length_1029_cov_17.101075	501	581	4	1	80	0.0125000
NODE_6093_length_1029_cov_17.101075	501	581	6	30	80	0.3750000
NODE_6093_length_1029_cov_17.101075	501	581	8	49	80	0.6125000
NODE_6093_length_1029_cov_17.101075	554	634	0	49	80	0.6125000
NODE_6093_length_1029_cov_17.101075	554	634	4	5	80	0.0625000
NODE_6093_length_1029_cov_17.101075	554	634	6	12	80	0.1500000
NODE_6093_length_1029_cov_17.101075	554	634	8	14	80	0.1750000
NODE_6093_length_1029_cov_17.101075	630	710	0	36	80	0.4500000
NODE_6093_length_1029_cov_17.101075	630	710	2	44	80	0.5500000
NODE_6093_length_1029_cov_17.101075	683	755	0	20	72	0.2777778
NODE_6093_length_1029_cov_17.101075	683	755	2	52	72	0.7222222
NODE_6094_length_1029_cov_14.052688	405	485	0	80	80	1.0000000
NODE_6094_length_1029_cov_14.052688	458	538	0	53	80	0.6625000
NODE_6094_length_1029_cov_14.052688	458	538	2	27	80	0.3375000
NODE_6095_length_1029_cov_11.119355	291	369	0	18	78	0.2307692
NODE_6095_length_1029_cov_11.119355	291	369	2	60	78	0.7692308
NODE_6095_length_1029_cov_11.119355	342	422	0	42	80	0.5250000
NODE_6095_length_1029_cov_11.119355	342	422	2	38	80	0.4750000
NODE_6097_length_1029_cov_3.850538	231	311	0	15	80	0.1875000
NODE_6097_length_1029_cov_3.850538	231	311	6	65	80	0.8125000
NODE_6097_length_1029_cov_3.850538	284	364	0	6	80	0.0750000
NODE_6097_length_1029_cov_3.850538	284	364	6	74	80	0.9250000
NODE_6104_length_1028_cov_19.625404	495	575	0	80	80	1.0000000
NODE_6104_length_1028_cov_19.625404	548	628	0	80	80	1.0000000
NODE_6105_length_1028_cov_17.497309	533	613	0	80	80	1.0000000
NODE_6105_length_1028_cov_17.497309	586	666	0	80	80	1.0000000
NODE_6106_length_1028_cov_16.528525	497	577	0	43	80	0.5375000
NODE_6106_length_1028_cov_16.528525	497	577	4	37	80	0.4625000
NODE_6106_length_1028_cov_16.528525	550	630	0	9	80	0.1125000
NODE_6106_length_1028_cov_16.528525	550	630	1	3	80	0.0375000
NODE_6106_length_1028_cov_16.528525	550	630	3	6	80	0.0750000
NODE_6106_length_1028_cov_16.528525	550	630	4	62	80	0.7750000
NODE_6107_length_1028_cov_10.212056	463	543	0	80	80	1.0000000
NODE_6107_length_1028_cov_10.212056	516	596	0	80	80	1.0000000
NODE_6108_length_1028_cov_10.131324	399	479	0	80	80	1.0000000
NODE_6108_length_1028_cov_10.131324	452	532	0	80	80	1.0000000
NODE_6109_length_1028_cov_9.773950	482	562	0	80	80	1.0000000
NODE_6109_length_1028_cov_9.773950	535	615	0	80	80	1.0000000
NODE_6110_length_1028_cov_8.079656	399	479	0	80	80	1.0000000
NODE_6110_length_1028_cov_8.079656	452	532	0	44	80	0.5500000
NODE_6110_length_1028_cov_8.079656	452	532	2	36	80	0.4500000
NODE_6111_length_1028_cov_7.092573	439	519	0	80	80	1.0000000
NODE_6111_length_1028_cov_7.092573	492	572	0	80	80	1.0000000
NODE_6112_length_1028_cov_4.727664	416	488	1	32	72	0.4444444
NODE_6112_length_1028_cov_4.727664	416	488	2	40	72	0.5555556
NODE_6112_length_1028_cov_4.727664	461	541	1	24	80	0.3000000
NODE_6112_length_1028_cov_4.727664	461	541	2	56	80	0.7000000
NODE_6125_length_1027_cov_51.341595	399	479	0	80	80	1.0000000
NODE_6125_length_1027_cov_51.341595	452	532	0	80	80	1.0000000
NODE_6125_length_1027_cov_51.341595	528	608	0	48	80	0.6000000
NODE_6125_length_1027_cov_51.341595	528	608	8	32	80	0.4000000
NODE_6125_length_1027_cov_51.341595	581	661	0	16	80	0.2000000
NODE_6125_length_1027_cov_51.341595	581	661	8	64	80	0.8000000
NODE_6126_length_1027_cov_45.613147	347	427	0	52	80	0.6500000
NODE_6126_length_1027_cov_45.613147	347	427	4	28	80	0.3500000
NODE_6126_length_1027_cov_45.613147	400	480	4	80	80	1.0000000
NODE_6126_length_1027_cov_45.613147	476	556	0	30	80	0.3750000
NODE_6126_length_1027_cov_45.613147	476	556	2	38	80	0.4750000
NODE_6126_length_1027_cov_45.613147	476	556	4	12	80	0.1500000
NODE_6126_length_1027_cov_45.613147	529	609	2	29	80	0.3625000
NODE_6126_length_1027_cov_45.613147	529	609	4	1	80	0.0125000
NODE_6126_length_1027_cov_45.613147	529	609	6	12	80	0.1500000
NODE_6126_length_1027_cov_45.613147	529	609	8	38	80	0.4750000
NODE_6127_length_1027_cov_35.435345	431	511	2	35	80	0.4375000
NODE_6127_length_1027_cov_35.435345	431	511	4	45	80	0.5625000
NODE_6127_length_1027_cov_35.435345	484	564	2	2	80	0.0250000
NODE_6127_length_1027_cov_35.435345	484	564	4	78	80	0.9750000
NODE_6135_length_1026_cov_39.737864	374	454	1	17	80	0.2125000
NODE_6135_length_1026_cov_39.737864	374	454	2	20	80	0.2500000
NODE_6135_length_1026_cov_39.737864	374	454	4	43	80	0.5375000
NODE_6135_length_1026_cov_39.737864	427	509	0	5	82	0.0609756
NODE_6135_length_1026_cov_39.737864	427	509	1	67	82	0.8170732
NODE_6135_length_1026_cov_39.737864	427	509	2	10	82	0.1219512
NODE_6135_length_1026_cov_39.737864	505	585	0	19	80	0.2375000
NODE_6135_length_1026_cov_39.737864	505	585	2	27	80	0.3375000
NODE_6135_length_1026_cov_39.737864	505	585	4	34	80	0.4250000
NODE_6135_length_1026_cov_39.737864	558	638	2	11	80	0.1375000
NODE_6135_length_1026_cov_39.737864	558	638	4	69	80	0.8625000
NODE_6136_length_1026_cov_26.400216	423	503	0	16	80	0.2000000
NODE_6136_length_1026_cov_26.400216	423	503	2	64	80	0.8000000
NODE_6136_length_1026_cov_26.400216	476	556	0	69	80	0.8625000
NODE_6136_length_1026_cov_26.400216	476	556	2	11	80	0.1375000
NODE_6137_length_1026_cov_25.325782	477	557	0	78	80	0.9750000
NODE_6137_length_1026_cov_25.325782	477	557	4	2	80	0.0250000
NODE_6137_length_1026_cov_25.325782	530	610	0	25	80	0.3125000
NODE_6137_length_1026_cov_25.325782	530	610	4	55	80	0.6875000
NODE_6137_length_1026_cov_25.325782	606	686	0	15	80	0.1875000
NODE_6137_length_1026_cov_25.325782	606	686	3	1	80	0.0125000
NODE_6137_length_1026_cov_25.325782	606	686	4	64	80	0.8000000
NODE_6137_length_1026_cov_25.325782	659	739	0	68	80	0.8500000
NODE_6137_length_1026_cov_25.325782	659	739	3	1	80	0.0125000
NODE_6137_length_1026_cov_25.325782	659	739	4	11	80	0.1375000
NODE_6138_length_1026_cov_22.218986	408	488	2	29	80	0.3625000
NODE_6138_length_1026_cov_22.218986	408	488	4	51	80	0.6375000
NODE_6138_length_1026_cov_22.218986	461	541	2	66	80	0.8250000
NODE_6138_length_1026_cov_22.218986	461	541	4	14	80	0.1750000
NODE_6138_length_1026_cov_22.218986	537	617	0	36	80	0.4500000
NODE_6138_length_1026_cov_22.218986	537	617	1	1	80	0.0125000
NODE_6138_length_1026_cov_22.218986	537	617	2	43	80	0.5375000
NODE_6138_length_1026_cov_22.218986	590	670	0	80	80	1.0000000
NODE_6139_length_1026_cov_15.640777	450	530	0	11	80	0.1375000
NODE_6139_length_1026_cov_15.640777	450	530	2	21	80	0.2625000
NODE_6139_length_1026_cov_15.640777	450	530	4	48	80	0.6000000
NODE_6139_length_1026_cov_15.640777	503	583	0	7	80	0.0875000
NODE_6139_length_1026_cov_15.640777	503	583	2	1	80	0.0125000
NODE_6139_length_1026_cov_15.640777	503	583	4	72	80	0.9000000
NODE_6140_length_1026_cov_12.062567	165	245	0	4	80	0.0500000
NODE_6140_length_1026_cov_12.062567	165	245	2	76	80	0.9500000
NODE_6140_length_1026_cov_12.062567	218	298	2	62	80	0.7750000
NODE_6140_length_1026_cov_12.062567	218	298	4	18	80	0.2250000
NODE_6142_length_1026_cov_5.002157	335	415	0	80	80	1.0000000
NODE_6142_length_1026_cov_5.002157	388	468	0	80	80	1.0000000
NODE_6155_length_1025_cov_52.053996	366	446	1	40	80	0.5000000
NODE_6155_length_1025_cov_52.053996	366	446	2	40	80	0.5000000
NODE_6155_length_1025_cov_52.053996	419	499	0	10	80	0.1250000
NODE_6155_length_1025_cov_52.053996	419	499	1	70	80	0.8750000
NODE_6155_length_1025_cov_52.053996	495	575	0	56	80	0.7000000
NODE_6155_length_1025_cov_52.053996	495	575	6	24	80	0.3000000
NODE_6155_length_1025_cov_52.053996	548	628	0	3	80	0.0375000
NODE_6155_length_1025_cov_52.053996	548	628	6	77	80	0.9625000
NODE_6156_length_1025_cov_35.980562	318	375	6	57	57	1.0000000
NODE_6156_length_1025_cov_35.980562	348	428	2	6	80	0.0750000
NODE_6156_length_1025_cov_35.980562	348	428	6	63	80	0.7875000
NODE_6156_length_1025_cov_35.980562	348	428	8	11	80	0.1375000
NODE_6156_length_1025_cov_35.980562	425	482	0	2	57	0.0350877
NODE_6156_length_1025_cov_35.980562	425	482	2	55	57	0.9649123
NODE_6156_length_1025_cov_35.980562	455	521	0	41	66	0.6212121
NODE_6156_length_1025_cov_35.980562	455	521	2	25	66	0.3787879
NODE_6157_length_1025_cov_26.954644	607	687	2	39	80	0.4875000
NODE_6157_length_1025_cov_26.954644	607	687	6	41	80	0.5125000
NODE_6157_length_1025_cov_26.954644	660	740	4	35	80	0.4375000
NODE_6157_length_1025_cov_26.954644	660	740	6	45	80	0.5625000
NODE_6158_length_1025_cov_20.576674	428	508	0	80	80	1.0000000
NODE_6158_length_1025_cov_20.576674	481	561	0	80	80	1.0000000
NODE_6159_length_1025_cov_15.525918	415	495	0	2	80	0.0250000
NODE_6159_length_1025_cov_15.525918	415	495	2	15	80	0.1875000
NODE_6159_length_1025_cov_15.525918	415	495	4	47	80	0.5875000
NODE_6159_length_1025_cov_15.525918	415	495	6	16	80	0.2000000
NODE_6159_length_1025_cov_15.525918	468	548	0	55	80	0.6875000
NODE_6159_length_1025_cov_15.525918	468	548	2	15	80	0.1875000
NODE_6159_length_1025_cov_15.525918	468	548	4	10	80	0.1250000
NODE_6160_length_1025_cov_7.044276	240	320	0	80	80	1.0000000
NODE_6161_length_1025_cov_6.688985	334	414	0	80	80	1.0000000
NODE_6161_length_1025_cov_6.688985	387	467	0	50	80	0.6250000
NODE_6161_length_1025_cov_6.688985	387	467	1	23	80	0.2875000
NODE_6161_length_1025_cov_6.688985	387	467	2	7	80	0.0875000
NODE_6170_length_1024_cov_28.681081	264	344	8	25	80	0.3125000
NODE_6170_length_1024_cov_28.681081	264	344	10	24	80	0.3000000
NODE_6170_length_1024_cov_28.681081	264	344	16	31	80	0.3875000
NODE_6170_length_1024_cov_28.681081	317	397	8	32	80	0.4000000
NODE_6170_length_1024_cov_28.681081	317	397	10	21	80	0.2625000
NODE_6170_length_1024_cov_28.681081	317	397	16	27	80	0.3375000
NODE_6170_length_1024_cov_28.681081	393	477	6	5	84	0.0595238
NODE_6170_length_1024_cov_28.681081	393	477	10	9	84	0.1071429
NODE_6170_length_1024_cov_28.681081	393	477	12	9	84	0.1071429
NODE_6170_length_1024_cov_28.681081	393	477	13	1	84	0.0119048
NODE_6170_length_1024_cov_28.681081	393	477	14	29	84	0.3452381
NODE_6170_length_1024_cov_28.681081	393	477	16	9	84	0.1071429
NODE_6170_length_1024_cov_28.681081	393	477	18	22	84	0.2619048
NODE_6171_length_1024_cov_17.922162	324	404	0	80	80	1.0000000
NODE_6171_length_1024_cov_17.922162	377	457	0	80	80	1.0000000
NODE_6173_length_1024_cov_12.018378	368	448	0	30	80	0.3750000
NODE_6173_length_1024_cov_12.018378	368	448	2	1	80	0.0125000
NODE_6173_length_1024_cov_12.018378	368	448	3	49	80	0.6125000
NODE_6173_length_1024_cov_12.018378	421	501	3	46	80	0.5750000
NODE_6173_length_1024_cov_12.018378	421	501	6	25	80	0.3125000
NODE_6173_length_1024_cov_12.018378	421	501	8	9	80	0.1125000
NODE_6174_length_1024_cov_8.800000	517	597	0	80	80	1.0000000
NODE_6174_length_1024_cov_8.800000	570	650	0	80	80	1.0000000
NODE_6175_length_1024_cov_6.207568	318	398	0	10	80	0.1250000
NODE_6175_length_1024_cov_6.207568	318	398	4	12	80	0.1500000
NODE_6175_length_1024_cov_6.207568	318	398	5	58	80	0.7250000
NODE_6175_length_1024_cov_6.207568	371	451	0	29	80	0.3625000
NODE_6175_length_1024_cov_6.207568	371	451	4	9	80	0.1125000
NODE_6175_length_1024_cov_6.207568	371	451	5	42	80	0.5250000
NODE_6178_length_1024_cov_2.468108	274	324	0	50	50	1.0000000
NODE_6178_length_1024_cov_2.468108	274	322	0	48	48	1.0000000
NODE_6178_length_1024_cov_2.468108	274	324	0	50	50	1.0000000
NODE_6178_length_1024_cov_2.468108	274	323	0	49	49	1.0000000
NODE_6178_length_1024_cov_2.468108	274	322	0	48	48	1.0000000
NODE_6185_length_1023_cov_100.366883	441	521	0	80	80	1.0000000
NODE_6185_length_1023_cov_100.366883	494	574	0	80	80	1.0000000
NODE_6186_length_1023_cov_64.271645	349	429	0	36	80	0.4500000
NODE_6186_length_1023_cov_64.271645	349	429	1	1	80	0.0125000
NODE_6186_length_1023_cov_64.271645	349	429	2	43	80	0.5375000
NODE_6186_length_1023_cov_64.271645	402	482	0	8	80	0.1000000
NODE_6186_length_1023_cov_64.271645	402	482	2	72	80	0.9000000
NODE_6186_length_1023_cov_64.271645	478	558	0	33	80	0.4125000
NODE_6186_length_1023_cov_64.271645	478	558	6	22	80	0.2750000
NODE_6186_length_1023_cov_64.271645	478	558	21	7	80	0.0875000
NODE_6186_length_1023_cov_64.271645	478	558	22	18	80	0.2250000
NODE_6186_length_1023_cov_64.271645	531	611	6	2	80	0.0250000
NODE_6186_length_1023_cov_64.271645	531	611	16	4	80	0.0500000
NODE_6186_length_1023_cov_64.271645	531	611	18	18	80	0.2250000
NODE_6186_length_1023_cov_64.271645	531	611	20	1	80	0.0125000
NODE_6186_length_1023_cov_64.271645	531	611	21	37	80	0.4625000
NODE_6186_length_1023_cov_64.271645	531	611	22	18	80	0.2250000
NODE_6187_length_1023_cov_32.695887	318	398	0	80	80	1.0000000
NODE_6187_length_1023_cov_32.695887	371	451	0	80	80	1.0000000
NODE_6187_length_1023_cov_32.695887	447	527	0	80	80	1.0000000
NODE_6187_length_1023_cov_32.695887	500	580	0	80	80	1.0000000
NODE_6188_length_1023_cov_16.244589	601	681	0	17	80	0.2125000
NODE_6188_length_1023_cov_16.244589	601	681	2	63	80	0.7875000
NODE_6188_length_1023_cov_16.244589	654	734	0	70	80	0.8750000
NODE_6188_length_1023_cov_16.244589	654	734	2	10	80	0.1250000
NODE_6189_length_1023_cov_15.876623	371	451	0	7	80	0.0875000
NODE_6189_length_1023_cov_15.876623	371	451	2	73	80	0.9125000
NODE_6189_length_1023_cov_15.876623	424	504	0	60	80	0.7500000
NODE_6189_length_1023_cov_15.876623	424	504	2	20	80	0.2500000
NODE_6189_length_1023_cov_15.876623	500	580	0	80	80	1.0000000
NODE_6189_length_1023_cov_15.876623	553	633	0	80	80	1.0000000
NODE_6190_length_1023_cov_14.678571	555	635	2	36	80	0.4500000
NODE_6190_length_1023_cov_14.678571	555	635	3	1	80	0.0125000
NODE_6190_length_1023_cov_14.678571	555	635	4	43	80	0.5375000
NODE_6190_length_1023_cov_14.678571	608	688	2	80	80	1.0000000
NODE_6191_length_1023_cov_14.443723	406	486	2	15	80	0.1875000
NODE_6191_length_1023_cov_14.443723	406	486	8	65	80	0.8125000
NODE_6191_length_1023_cov_14.443723	459	539	0	8	80	0.1000000
NODE_6191_length_1023_cov_14.443723	459	539	6	45	80	0.5625000
NODE_6191_length_1023_cov_14.443723	459	539	8	27	80	0.3375000
NODE_6192_length_1023_cov_10.984848	590	670	0	80	80	1.0000000
NODE_6192_length_1023_cov_10.984848	643	723	0	28	80	0.3500000
NODE_6192_length_1023_cov_10.984848	643	723	1	52	80	0.6500000
NODE_6202_length_1022_cov_42.952329	555	636	0	81	81	1.0000000
NODE_6202_length_1022_cov_42.952329	609	689	0	80	80	1.0000000
NODE_6202_length_1022_cov_42.952329	685	765	0	31	80	0.3875000
NODE_6202_length_1022_cov_42.952329	685	765	4	49	80	0.6125000
NODE_6202_length_1022_cov_42.952329	738	818	4	80	80	1.0000000
NODE_6203_length_1022_cov_29.949079	510	590	0	80	80	1.0000000
NODE_6203_length_1022_cov_29.949079	563	643	0	80	80	1.0000000
NODE_6204_length_1022_cov_7.672806	461	541	0	80	80	1.0000000
NODE_6204_length_1022_cov_7.672806	514	594	0	80	80	1.0000000
NODE_6213_length_1021_cov_47.379610	341	421	4	1	80	0.0125000
NODE_6213_length_1021_cov_47.379610	341	421	10	29	80	0.3625000
NODE_6213_length_1021_cov_47.379610	341	421	12	11	80	0.1375000
NODE_6213_length_1021_cov_47.379610	341	421	13	1	80	0.0125000
NODE_6213_length_1021_cov_47.379610	341	421	14	38	80	0.4750000
NODE_6213_length_1021_cov_47.379610	394	474	0	18	80	0.2250000
NODE_6213_length_1021_cov_47.379610	394	474	10	62	80	0.7750000
NODE_6213_length_1021_cov_47.379610	470	550	0	6	80	0.0750000
NODE_6213_length_1021_cov_47.379610	470	550	2	37	80	0.4625000
NODE_6213_length_1021_cov_47.379610	470	550	4	37	80	0.4625000
NODE_6213_length_1021_cov_47.379610	523	603	0	15	80	0.1875000
NODE_6213_length_1021_cov_47.379610	523	603	2	16	80	0.2000000
NODE_6213_length_1021_cov_47.379610	523	603	4	49	80	0.6125000
NODE_6214_length_1021_cov_33.255965	588	668	0	80	80	1.0000000
NODE_6214_length_1021_cov_33.255965	641	721	0	80	80	1.0000000
NODE_6227_length_1020_cov_24.565689	485	565	0	80	80	1.0000000
NODE_6227_length_1020_cov_24.565689	538	618	0	80	80	1.0000000
NODE_6228_length_1020_cov_20.825190	395	475	0	80	80	1.0000000
NODE_6228_length_1020_cov_20.825190	448	528	0	80	80	1.0000000
NODE_6229_length_1020_cov_20.305103	285	365	2	80	80	1.0000000
NODE_6229_length_1020_cov_20.305103	338	418	0	27	80	0.3375000
NODE_6229_length_1020_cov_20.305103	338	418	2	53	80	0.6625000
NODE_6229_length_1020_cov_20.305103	414	494	0	80	80	1.0000000
NODE_6229_length_1020_cov_20.305103	467	548	0	81	81	1.0000000
NODE_6230_length_1020_cov_17.919653	408	488	0	26	80	0.3250000
NODE_6230_length_1020_cov_17.919653	408	488	4	33	80	0.4125000
NODE_6230_length_1020_cov_17.919653	408	488	6	21	80	0.2625000
NODE_6230_length_1020_cov_17.919653	461	541	2	21	80	0.2625000
NODE_6230_length_1020_cov_17.919653	461	541	4	6	80	0.0750000
NODE_6230_length_1020_cov_17.919653	461	541	6	53	80	0.6625000
NODE_6231_length_1020_cov_13.972856	436	516	0	80	80	1.0000000
NODE_6231_length_1020_cov_13.972856	489	569	0	80	80	1.0000000
NODE_6232_length_1020_cov_10.472313	407	487	0	39	80	0.4875000
NODE_6232_length_1020_cov_10.472313	407	487	2	41	80	0.5125000
NODE_6232_length_1020_cov_10.472313	460	540	2	43	80	0.5375000
NODE_6232_length_1020_cov_10.472313	460	540	4	37	80	0.4625000
NODE_6235_length_1020_cov_3.707926	821	901	0	80	80	1.0000000
NODE_6235_length_1020_cov_3.707926	874	954	0	80	80	1.0000000
NODE_6238_length_1020_cov_2.648208	0	70	0	70	70	1.0000000
NODE_6238_length_1020_cov_2.648208	43	88	0	44	45	0.9777778
NODE_6238_length_1020_cov_2.648208	43	88	4	1	45	0.0222222
NODE_6248_length_1019_cov_30.164130	476	556	0	80	80	1.0000000
NODE_6248_length_1019_cov_30.164130	529	609	0	35	80	0.4375000
NODE_6248_length_1019_cov_30.164130	529	609	2	45	80	0.5625000
NODE_6248_length_1019_cov_30.164130	605	685	2	23	80	0.2875000
NODE_6248_length_1019_cov_30.164130	605	685	4	8	80	0.1000000
NODE_6248_length_1019_cov_30.164130	605	685	6	49	80	0.6125000
NODE_6248_length_1019_cov_30.164130	658	738	4	61	80	0.7625000
NODE_6248_length_1019_cov_30.164130	658	738	6	19	80	0.2375000
NODE_6249_length_1019_cov_22.845652	343	423	2	7	80	0.0875000
NODE_6249_length_1019_cov_22.845652	343	423	4	73	80	0.9125000
NODE_6249_length_1019_cov_22.845652	396	476	0	35	80	0.4375000
NODE_6249_length_1019_cov_22.845652	396	476	2	25	80	0.3125000
NODE_6249_length_1019_cov_22.845652	396	476	4	20	80	0.2500000
NODE_6249_length_1019_cov_22.845652	472	552	0	80	80	1.0000000
NODE_6249_length_1019_cov_22.845652	525	605	0	80	80	1.0000000
NODE_6250_length_1019_cov_8.098913	523	601	0	16	78	0.2051282
NODE_6250_length_1019_cov_8.098913	523	601	4	27	78	0.3461539
NODE_6250_length_1019_cov_8.098913	523	601	6	15	78	0.1923077
NODE_6250_length_1019_cov_8.098913	523	601	8	20	78	0.2564103
NODE_6250_length_1019_cov_8.098913	574	654	6	18	80	0.2250000
NODE_6250_length_1019_cov_8.098913	574	654	8	62	80	0.7750000
NODE_6251_length_1019_cov_7.896739	423	503	0	80	80	1.0000000
NODE_6251_length_1019_cov_7.896739	476	556	0	80	80	1.0000000
NODE_6252_length_1019_cov_4.597826	625	696	4	5	71	0.0704225
NODE_6252_length_1019_cov_4.597826	625	696	5	15	71	0.2112676
NODE_6252_length_1019_cov_4.597826	625	696	6	5	71	0.0704225
NODE_6252_length_1019_cov_4.597826	625	696	7	7	71	0.0985916
NODE_6252_length_1019_cov_4.597826	625	696	10	3	71	0.0422535
NODE_6252_length_1019_cov_4.597826	625	696	12	36	71	0.5070422
NODE_6263_length_1019_cov_1.139130	89	165	10	3	76	0.0394737
NODE_6263_length_1019_cov_1.139130	89	165	12	12	76	0.1578947
NODE_6263_length_1019_cov_1.139130	89	165	14	3	76	0.0394737
NODE_6263_length_1019_cov_1.139130	89	165	16	7	76	0.0921053
NODE_6263_length_1019_cov_1.139130	89	165	17	3	76	0.0394737
NODE_6263_length_1019_cov_1.139130	89	165	18	10	76	0.1315790
NODE_6263_length_1019_cov_1.139130	89	165	19	7	76	0.0921053
NODE_6263_length_1019_cov_1.139130	89	165	20	31	76	0.4078947
NODE_6265_length_1018_cov_33.494015	212	292	0	9	80	0.1125000
NODE_6265_length_1018_cov_33.494015	212	292	2	9	80	0.1125000
NODE_6265_length_1018_cov_33.494015	212	292	6	38	80	0.4750000
NODE_6265_length_1018_cov_33.494015	212	292	7	2	80	0.0250000
NODE_6265_length_1018_cov_33.494015	212	292	8	22	80	0.2750000
NODE_6265_length_1018_cov_33.494015	265	345	0	62	80	0.7750000
NODE_6265_length_1018_cov_33.494015	265	345	2	9	80	0.1125000
NODE_6265_length_1018_cov_33.494015	265	345	7	2	80	0.0250000
NODE_6265_length_1018_cov_33.494015	265	345	8	7	80	0.0875000
NODE_6266_length_1018_cov_22.776931	372	452	2	63	80	0.7875000
NODE_6266_length_1018_cov_22.776931	372	452	4	17	80	0.2125000
NODE_6266_length_1018_cov_22.776931	425	505	0	6	80	0.0750000
NODE_6266_length_1018_cov_22.776931	425	505	2	53	80	0.6625000
NODE_6266_length_1018_cov_22.776931	425	505	4	21	80	0.2625000
NODE_6268_length_1018_cov_8.486398	404	484	0	80	80	1.0000000
NODE_6268_length_1018_cov_8.486398	457	537	0	80	80	1.0000000
NODE_6270_length_1018_cov_7.737758	357	437	0	80	80	1.0000000
NODE_6270_length_1018_cov_7.737758	410	490	0	80	80	1.0000000
NODE_6286_length_1017_cov_207.523965	0	41	129	1	41	0.0243902
NODE_6286_length_1017_cov_207.523965	0	41	135	1	41	0.0243902
NODE_6286_length_1017_cov_207.523965	0	41	138	1	41	0.0243902
NODE_6286_length_1017_cov_207.523965	0	41	142	1	41	0.0243902
NODE_6286_length_1017_cov_207.523965	0	41	150	1	41	0.0243902
NODE_6286_length_1017_cov_207.523965	0	41	154	1	41	0.0243902
NODE_6286_length_1017_cov_207.523965	0	41	157	1	41	0.0243902
NODE_6286_length_1017_cov_207.523965	0	41	159	1	41	0.0243902
NODE_6286_length_1017_cov_207.523965	0	41	165	1	41	0.0243902
NODE_6286_length_1017_cov_207.523965	0	41	180	2	41	0.0487805
NODE_6286_length_1017_cov_207.523965	0	41	182	1	41	0.0243902
NODE_6286_length_1017_cov_207.523965	0	41	185	1	41	0.0243902
NODE_6286_length_1017_cov_207.523965	0	41	198	1	41	0.0243902
NODE_6286_length_1017_cov_207.523965	0	41	202	1	41	0.0243902
NODE_6286_length_1017_cov_207.523965	0	41	209	1	41	0.0243902
NODE_6286_length_1017_cov_207.523965	0	41	215	2	41	0.0487805
NODE_6286_length_1017_cov_207.523965	0	41	224	2	41	0.0487805
NODE_6286_length_1017_cov_207.523965	0	41	246	1	41	0.0243902
NODE_6286_length_1017_cov_207.523965	0	41	250	1	41	0.0243902
NODE_6286_length_1017_cov_207.523965	0	41	255	4	41	0.0975610
NODE_6286_length_1017_cov_207.523965	0	41	258	2	41	0.0487805
NODE_6286_length_1017_cov_207.523965	0	41	262	2	41	0.0487805
NODE_6286_length_1017_cov_207.523965	0	41	271	5	41	0.1219512
NODE_6286_length_1017_cov_207.523965	0	41	272	1	41	0.0243902
NODE_6286_length_1017_cov_207.523965	0	41	279	2	41	0.0487805
NODE_6286_length_1017_cov_207.523965	0	41	282	1	41	0.0243902
NODE_6286_length_1017_cov_207.523965	0	41	284	2	41	0.0487805
NODE_6286_length_1017_cov_207.523965	14	94	202	1	80	0.0125000
NODE_6286_length_1017_cov_207.523965	14	94	209	1	80	0.0125000
NODE_6286_length_1017_cov_207.523965	14	94	215	2	80	0.0250000
NODE_6286_length_1017_cov_207.523965	14	94	224	2	80	0.0250000
NODE_6286_length_1017_cov_207.523965	14	94	246	1	80	0.0125000
NODE_6286_length_1017_cov_207.523965	14	94	250	1	80	0.0125000
NODE_6286_length_1017_cov_207.523965	14	94	255	4	80	0.0500000
NODE_6286_length_1017_cov_207.523965	14	94	258	2	80	0.0250000
NODE_6286_length_1017_cov_207.523965	14	94	262	2	80	0.0250000
NODE_6286_length_1017_cov_207.523965	14	94	271	5	80	0.0625000
NODE_6286_length_1017_cov_207.523965	14	94	272	1	80	0.0125000
NODE_6286_length_1017_cov_207.523965	14	94	279	2	80	0.0250000
NODE_6286_length_1017_cov_207.523965	14	94	282	1	80	0.0125000
NODE_6286_length_1017_cov_207.523965	14	94	284	2	80	0.0250000
NODE_6286_length_1017_cov_207.523965	14	94	292	1	80	0.0125000
NODE_6286_length_1017_cov_207.523965	14	94	294	1	80	0.0125000
NODE_6286_length_1017_cov_207.523965	14	94	300	1	80	0.0125000
NODE_6286_length_1017_cov_207.523965	14	94	310	1	80	0.0125000
NODE_6286_length_1017_cov_207.523965	14	94	316	1	80	0.0125000
NODE_6286_length_1017_cov_207.523965	14	94	318	1	80	0.0125000
NODE_6286_length_1017_cov_207.523965	14	94	320	1	80	0.0125000
NODE_6286_length_1017_cov_207.523965	14	94	322	1	80	0.0125000
NODE_6286_length_1017_cov_207.523965	14	94	327	1	80	0.0125000
NODE_6286_length_1017_cov_207.523965	14	94	332	1	80	0.0125000
NODE_6286_length_1017_cov_207.523965	14	94	342	3	80	0.0375000
NODE_6286_length_1017_cov_207.523965	14	94	346	1	80	0.0125000
NODE_6286_length_1017_cov_207.523965	14	94	348	1	80	0.0125000
NODE_6286_length_1017_cov_207.523965	14	94	354	2	80	0.0250000
NODE_6286_length_1017_cov_207.523965	14	94	356	2	80	0.0250000
NODE_6286_length_1017_cov_207.523965	14	94	360	2	80	0.0250000
NODE_6286_length_1017_cov_207.523965	14	94	368	1	80	0.0125000
NODE_6286_length_1017_cov_207.523965	14	94	370	1	80	0.0125000
NODE_6286_length_1017_cov_207.523965	14	94	372	2	80	0.0250000
NODE_6286_length_1017_cov_207.523965	14	94	373	1	80	0.0125000
NODE_6286_length_1017_cov_207.523965	14	94	375	2	80	0.0250000
NODE_6286_length_1017_cov_207.523965	14	94	376	2	80	0.0250000
NODE_6286_length_1017_cov_207.523965	14	94	378	2	80	0.0250000
NODE_6286_length_1017_cov_207.523965	14	94	379	1	80	0.0125000
NODE_6286_length_1017_cov_207.523965	14	94	380	6	80	0.0750000
NODE_6286_length_1017_cov_207.523965	14	94	381	4	80	0.0500000
NODE_6286_length_1017_cov_207.523965	14	94	385	4	80	0.0500000
NODE_6286_length_1017_cov_207.523965	14	94	391	1	80	0.0125000
NODE_6286_length_1017_cov_207.523965	14	94	395	3	80	0.0375000
NODE_6286_length_1017_cov_207.523965	14	94	398	2	80	0.0250000
NODE_6287_length_1017_cov_18.824619	490	570	0	80	80	1.0000000
NODE_6287_length_1017_cov_18.824619	543	623	0	41	80	0.5125000
NODE_6287_length_1017_cov_18.824619	543	623	2	39	80	0.4875000
NODE_6288_length_1017_cov_14.794118	428	508	0	77	80	0.9625000
NODE_6288_length_1017_cov_14.794118	428	508	2	3	80	0.0375000
NODE_6288_length_1017_cov_14.794118	481	561	0	24	80	0.3000000
NODE_6288_length_1017_cov_14.794118	481	561	2	56	80	0.7000000
NODE_6288_length_1017_cov_14.794118	557	637	0	56	80	0.7000000
NODE_6288_length_1017_cov_14.794118	557	637	2	24	80	0.3000000
NODE_6288_length_1017_cov_14.794118	610	690	0	80	80	1.0000000
NODE_6297_length_1016_cov_22.267176	577	657	0	80	80	1.0000000
NODE_6297_length_1016_cov_22.267176	630	710	0	80	80	1.0000000
NODE_6298_length_1016_cov_21.134133	625	705	4	11	80	0.1375000
NODE_6298_length_1016_cov_21.134133	625	705	6	52	80	0.6500000
NODE_6298_length_1016_cov_21.134133	625	705	8	5	80	0.0625000
NODE_6298_length_1016_cov_21.134133	625	705	9	2	80	0.0250000
NODE_6298_length_1016_cov_21.134133	625	705	10	10	80	0.1250000
NODE_6298_length_1016_cov_21.134133	678	758	0	19	80	0.2375000
NODE_6298_length_1016_cov_21.134133	678	758	2	18	80	0.2250000
NODE_6298_length_1016_cov_21.134133	678	758	4	4	80	0.0500000
NODE_6298_length_1016_cov_21.134133	678	758	6	39	80	0.4875000
NODE_6299_length_1016_cov_20.392585	504	584	0	78	80	0.9750000
NODE_6299_length_1016_cov_20.392585	504	584	2	2	80	0.0250000
NODE_6299_length_1016_cov_20.392585	557	637	0	25	80	0.3125000
NODE_6299_length_1016_cov_20.392585	557	637	2	55	80	0.6875000
NODE_6299_length_1016_cov_20.392585	633	713	0	27	80	0.3375000
NODE_6299_length_1016_cov_20.392585	633	713	2	53	80	0.6625000
NODE_6299_length_1016_cov_20.392585	686	766	0	22	80	0.2750000
NODE_6299_length_1016_cov_20.392585	686	766	2	58	80	0.7250000
NODE_6300_length_1016_cov_16.917121	524	604	0	80	80	1.0000000
NODE_6300_length_1016_cov_16.917121	577	657	0	30	80	0.3750000
NODE_6300_length_1016_cov_16.917121	577	657	1	10	80	0.1250000
NODE_6300_length_1016_cov_16.917121	577	657	2	40	80	0.5000000
NODE_6301_length_1016_cov_8.243184	438	518	2	80	80	1.0000000
NODE_6301_length_1016_cov_8.243184	491	571	0	53	80	0.6625000
NODE_6301_length_1016_cov_8.243184	491	571	2	27	80	0.3375000
NODE_6301_length_1016_cov_8.243184	567	647	0	80	80	1.0000000
NODE_6301_length_1016_cov_8.243184	620	700	0	80	80	1.0000000
NODE_6302_length_1016_cov_8.141767	166	256	0	9	90	0.1000000
NODE_6302_length_1016_cov_8.141767	166	256	2	4	90	0.0444444
NODE_6302_length_1016_cov_8.141767	166	256	4	3	90	0.0333333
NODE_6302_length_1016_cov_8.141767	166	256	6	7	90	0.0777778
NODE_6302_length_1016_cov_8.141767	166	256	8	21	90	0.2333333
NODE_6302_length_1016_cov_8.141767	166	256	10	5	90	0.0555556
NODE_6302_length_1016_cov_8.141767	166	256	12	21	90	0.2333333
NODE_6302_length_1016_cov_8.141767	166	256	14	2	90	0.0222222
NODE_6302_length_1016_cov_8.141767	166	256	16	4	90	0.0444444
NODE_6302_length_1016_cov_8.141767	166	256	18	12	90	0.1333333
NODE_6302_length_1016_cov_8.141767	166	256	20	2	90	0.0222222
NODE_6303_length_1016_cov_7.466739	576	656	0	80	80	1.0000000
NODE_6303_length_1016_cov_7.466739	629	709	0	80	80	1.0000000
NODE_6318_length_1015_cov_24.680131	459	539	0	80	80	1.0000000
NODE_6318_length_1015_cov_24.680131	512	592	0	80	80	1.0000000
NODE_6318_length_1015_cov_24.680131	588	668	0	80	80	1.0000000
NODE_6318_length_1015_cov_24.680131	641	721	0	80	80	1.0000000
NODE_6319_length_1015_cov_23.198690	407	487	0	73	80	0.9125000
NODE_6319_length_1015_cov_23.198690	407	487	1	7	80	0.0875000
NODE_6319_length_1015_cov_23.198690	460	540	0	80	80	1.0000000
NODE_6319_length_1015_cov_23.198690	536	616	0	80	80	1.0000000
NODE_6319_length_1015_cov_23.198690	589	669	0	80	80	1.0000000
NODE_6320_length_1015_cov_22.544760	490	570	5	37	80	0.4625000
NODE_6320_length_1015_cov_22.544760	490	570	7	22	80	0.2750000
NODE_6320_length_1015_cov_22.544760	490	570	9	21	80	0.2625000
NODE_6320_length_1015_cov_22.544760	543	623	0	39	80	0.4875000
NODE_6320_length_1015_cov_22.544760	543	623	4	1	80	0.0125000
NODE_6320_length_1015_cov_22.544760	543	623	5	40	80	0.5000000
NODE_6321_length_1015_cov_17.994541	510	590	0	51	80	0.6375000
NODE_6321_length_1015_cov_17.994541	510	590	4	29	80	0.3625000
NODE_6321_length_1015_cov_17.994541	563	643	0	11	80	0.1375000
NODE_6321_length_1015_cov_17.994541	563	643	4	69	80	0.8625000
NODE_6322_length_1015_cov_16.594978	437	517	0	16	80	0.2000000
NODE_6322_length_1015_cov_16.594978	437	517	2	64	80	0.8000000
NODE_6322_length_1015_cov_16.594978	490	570	0	28	80	0.3500000
NODE_6322_length_1015_cov_16.594978	490	570	2	52	80	0.6500000
NODE_6323_length_1015_cov_14.000000	505	585	0	18	80	0.2250000
NODE_6323_length_1015_cov_14.000000	505	585	2	62	80	0.7750000
NODE_6323_length_1015_cov_14.000000	558	638	0	71	80	0.8875000
NODE_6323_length_1015_cov_14.000000	558	638	2	9	80	0.1125000
NODE_6324_length_1015_cov_9.978166	345	425	0	80	80	1.0000000
NODE_6324_length_1015_cov_9.978166	398	478	0	80	80	1.0000000
NODE_6325_length_1015_cov_6.844978	393	473	2	13	80	0.1625000
NODE_6325_length_1015_cov_6.844978	393	473	6	15	80	0.1875000
NODE_6325_length_1015_cov_6.844978	393	473	14	26	80	0.3250000
NODE_6325_length_1015_cov_6.844978	393	473	16	26	80	0.3250000
NODE_6325_length_1015_cov_6.844978	446	526	9	2	80	0.0250000
NODE_6325_length_1015_cov_6.844978	446	526	10	36	80	0.4500000
NODE_6325_length_1015_cov_6.844978	446	526	12	2	80	0.0250000
NODE_6325_length_1015_cov_6.844978	446	526	14	37	80	0.4625000
NODE_6325_length_1015_cov_6.844978	446	526	16	3	80	0.0375000
NODE_6337_length_1014_cov_95.709290	259	335	0	76	76	1.0000000
NODE_6337_length_1014_cov_95.709290	310	390	0	80	80	1.0000000
NODE_6337_length_1014_cov_95.709290	386	466	0	18	80	0.2250000
NODE_6337_length_1014_cov_95.709290	386	466	5	39	80	0.4875000
NODE_6337_length_1014_cov_95.709290	386	466	6	23	80	0.2875000
NODE_6337_length_1014_cov_95.709290	439	519	0	48	80	0.6000000
NODE_6337_length_1014_cov_95.709290	439	519	5	22	80	0.2750000
NODE_6337_length_1014_cov_95.709290	439	519	6	10	80	0.1250000
NODE_6338_length_1014_cov_67.918033	182	262	2	22	80	0.2750000
NODE_6338_length_1014_cov_67.918033	182	262	4	58	80	0.7250000
NODE_6338_length_1014_cov_67.918033	235	315	0	22	80	0.2750000
NODE_6338_length_1014_cov_67.918033	235	315	2	19	80	0.2375000
NODE_6338_length_1014_cov_67.918033	235	315	4	39	80	0.4875000
NODE_6338_length_1014_cov_67.918033	311	391	0	80	80	1.0000000
NODE_6338_length_1014_cov_67.918033	364	444	0	40	80	0.5000000
NODE_6338_length_1014_cov_67.918033	364	444	4	40	80	0.5000000
NODE_6339_length_1014_cov_44.802186	418	498	4	80	80	1.0000000
NODE_6339_length_1014_cov_44.802186	471	551	4	27	80	0.3375000
NODE_6339_length_1014_cov_44.802186	471	551	6	52	80	0.6500000
NODE_6339_length_1014_cov_44.802186	471	551	10	1	80	0.0125000
NODE_6340_length_1014_cov_36.349727	369	449	0	13	80	0.1625000
NODE_6340_length_1014_cov_36.349727	369	449	4	67	80	0.8375000
NODE_6340_length_1014_cov_36.349727	422	502	0	2	80	0.0250000
NODE_6340_length_1014_cov_36.349727	422	502	4	78	80	0.9750000
NODE_6340_length_1014_cov_36.349727	498	578	0	78	80	0.9750000
NODE_6340_length_1014_cov_36.349727	498	578	4	2	80	0.0250000
NODE_6340_length_1014_cov_36.349727	551	631	0	80	80	1.0000000
NODE_6341_length_1014_cov_35.547541	363	441	0	78	78	1.0000000
NODE_6341_length_1014_cov_35.547541	416	494	0	78	78	1.0000000
NODE_6342_length_1014_cov_32.266667	428	508	0	80	80	1.0000000
NODE_6342_length_1014_cov_32.266667	481	561	0	80	80	1.0000000
NODE_6343_length_1014_cov_28.493989	480	560	0	80	80	1.0000000
NODE_6343_length_1014_cov_28.493989	533	613	0	80	80	1.0000000
NODE_6343_length_1014_cov_28.493989	609	689	0	80	80	1.0000000
NODE_6343_length_1014_cov_28.493989	662	742	0	80	80	1.0000000
NODE_6344_length_1014_cov_25.171585	500	580	16	6	80	0.0750000
NODE_6344_length_1014_cov_25.171585	500	580	17	7	80	0.0875000
NODE_6344_length_1014_cov_25.171585	500	580	19	3	80	0.0375000
NODE_6344_length_1014_cov_25.171585	500	580	24	6	80	0.0750000
NODE_6344_length_1014_cov_25.171585	500	580	26	13	80	0.1625000
NODE_6344_length_1014_cov_25.171585	500	580	27	45	80	0.5625000
NODE_6344_length_1014_cov_25.171585	553	633	0	2	80	0.0250000
NODE_6344_length_1014_cov_25.171585	553	633	5	9	80	0.1125000
NODE_6344_length_1014_cov_25.171585	553	633	8	40	80	0.5000000
NODE_6344_length_1014_cov_25.171585	553	633	15	1	80	0.0125000
NODE_6344_length_1014_cov_25.171585	553	633	16	7	80	0.0875000
NODE_6344_length_1014_cov_25.171585	553	633	17	7	80	0.0875000
NODE_6344_length_1014_cov_25.171585	553	633	19	3	80	0.0375000
NODE_6344_length_1014_cov_25.171585	553	633	24	6	80	0.0750000
NODE_6344_length_1014_cov_25.171585	553	633	26	5	80	0.0625000
NODE_6345_length_1014_cov_22.437158	534	614	0	80	80	1.0000000
NODE_6345_length_1014_cov_22.437158	587	667	0	80	80	1.0000000
NODE_6346_length_1014_cov_19.238251	379	459	0	80	80	1.0000000
NODE_6346_length_1014_cov_19.238251	432	512	0	80	80	1.0000000
NODE_6346_length_1014_cov_19.238251	508	585	0	77	77	1.0000000
NODE_6346_length_1014_cov_19.238251	558	638	0	65	80	0.8125000
NODE_6346_length_1014_cov_19.238251	558	638	2	15	80	0.1875000
NODE_6347_length_1014_cov_15.926776	594	674	0	80	80	1.0000000
NODE_6347_length_1014_cov_15.926776	647	727	0	80	80	1.0000000
NODE_6348_length_1014_cov_8.691803	285	365	0	24	80	0.3000000
NODE_6348_length_1014_cov_8.691803	285	365	2	6	80	0.0750000
NODE_6348_length_1014_cov_8.691803	285	365	6	9	80	0.1125000
NODE_6348_length_1014_cov_8.691803	285	365	10	2	80	0.0250000
NODE_6348_length_1014_cov_8.691803	285	365	12	28	80	0.3500000
NODE_6348_length_1014_cov_8.691803	285	365	14	11	80	0.1375000
NODE_6348_length_1014_cov_8.691803	338	418	6	18	80	0.2250000
NODE_6348_length_1014_cov_8.691803	338	418	10	24	80	0.3000000
NODE_6348_length_1014_cov_8.691803	338	418	12	18	80	0.2250000
NODE_6348_length_1014_cov_8.691803	338	418	14	20	80	0.2500000
NODE_6349_length_1014_cov_7.959563	531	611	4	80	80	1.0000000
NODE_6349_length_1014_cov_7.959563	584	664	0	49	80	0.6125000
NODE_6349_length_1014_cov_7.959563	584	664	4	31	80	0.3875000
NODE_6351_length_1014_cov_7.608743	298	378	4	80	80	1.0000000
NODE_6351_length_1014_cov_7.608743	351	431	0	53	80	0.6625000
NODE_6351_length_1014_cov_7.608743	351	431	4	27	80	0.3375000
NODE_6352_length_1014_cov_6.209836	321	401	0	13	80	0.1625000
NODE_6352_length_1014_cov_6.209836	321	401	2	67	80	0.8375000
NODE_6352_length_1014_cov_6.209836	374	454	0	32	80	0.4000000
NODE_6352_length_1014_cov_6.209836	374	454	2	48	80	0.6000000
NODE_6364_length_1013_cov_32.695842	423	503	0	49	80	0.6125000
NODE_6364_length_1013_cov_32.695842	423	503	2	31	80	0.3875000
NODE_6364_length_1013_cov_32.695842	476	556	2	80	80	1.0000000
NODE_6364_length_1013_cov_32.695842	552	632	0	70	80	0.8750000
NODE_6364_length_1013_cov_32.695842	552	632	2	10	80	0.1250000
NODE_6364_length_1013_cov_32.695842	605	685	0	80	80	1.0000000
NODE_6365_length_1013_cov_21.935449	424	503	0	79	79	1.0000000
NODE_6365_length_1013_cov_21.935449	476	556	0	80	80	1.0000000
NODE_6366_length_1013_cov_17.532823	440	520	0	80	80	1.0000000
NODE_6366_length_1013_cov_17.532823	493	573	0	80	80	1.0000000
NODE_6367_length_1013_cov_14.555799	478	558	0	34	80	0.4250000
NODE_6367_length_1013_cov_14.555799	478	558	2	46	80	0.5750000
NODE_6367_length_1013_cov_14.555799	531	611	2	68	80	0.8500000
NODE_6367_length_1013_cov_14.555799	531	611	4	12	80	0.1500000
NODE_6368_length_1013_cov_13.142232	476	556	4	30	80	0.3750000
NODE_6368_length_1013_cov_13.142232	476	556	7	1	80	0.0125000
NODE_6368_length_1013_cov_13.142232	476	556	8	49	80	0.6125000
NODE_6368_length_1013_cov_13.142232	529	609	0	25	80	0.3125000
NODE_6368_length_1013_cov_13.142232	529	609	4	39	80	0.4875000
NODE_6368_length_1013_cov_13.142232	529	609	7	1	80	0.0125000
NODE_6368_length_1013_cov_13.142232	529	609	8	15	80	0.1875000
NODE_6369_length_1013_cov_7.756018	538	618	2	80	80	1.0000000
NODE_6369_length_1013_cov_7.756018	591	671	0	31	80	0.3875000
NODE_6369_length_1013_cov_7.756018	591	671	2	49	80	0.6125000
NODE_6371_length_1013_cov_4.368709	550	630	0	3	80	0.0375000
NODE_6371_length_1013_cov_4.368709	550	630	4	77	80	0.9625000
NODE_6371_length_1013_cov_4.368709	603	683	0	13	80	0.1625000
NODE_6371_length_1013_cov_4.368709	603	683	4	67	80	0.8375000
NODE_6380_length_1012_cov_91.547645	378	458	0	80	80	1.0000000
NODE_6380_length_1012_cov_91.547645	431	511	0	80	80	1.0000000
NODE_6380_length_1012_cov_91.547645	507	587	0	80	80	1.0000000
NODE_6380_length_1012_cov_91.547645	560	640	0	80	80	1.0000000
NODE_6381_length_1012_cov_64.409639	345	425	0	80	80	1.0000000
NODE_6381_length_1012_cov_64.409639	398	478	0	80	80	1.0000000
NODE_6382_length_1012_cov_63.035049	438	518	0	80	80	1.0000000
NODE_6382_length_1012_cov_63.035049	491	571	0	33	80	0.4125000
NODE_6382_length_1012_cov_63.035049	491	571	4	47	80	0.5875000
NODE_6383_length_1012_cov_53.686747	276	356	0	80	80	1.0000000
NODE_6383_length_1012_cov_53.686747	329	409	0	80	80	1.0000000
NODE_6383_length_1012_cov_53.686747	405	485	0	4	80	0.0500000
NODE_6383_length_1012_cov_53.686747	405	485	2	61	80	0.7625000
NODE_6383_length_1012_cov_53.686747	405	485	6	15	80	0.1875000
NODE_6383_length_1012_cov_53.686747	458	538	2	12	80	0.1500000
NODE_6383_length_1012_cov_53.686747	458	538	4	11	80	0.1375000
NODE_6383_length_1012_cov_53.686747	458	538	6	57	80	0.7125000
NODE_6384_length_1012_cov_35.861993	453	533	0	80	80	1.0000000
NODE_6384_length_1012_cov_35.861993	506	581	0	75	75	1.0000000
NODE_6385_length_1012_cov_16.125958	510	590	0	21	80	0.2625000
NODE_6385_length_1012_cov_16.125958	510	590	2	59	80	0.7375000
NODE_6385_length_1012_cov_16.125958	563	643	0	11	80	0.1375000
NODE_6385_length_1012_cov_16.125958	563	643	2	69	80	0.8625000
NODE_6386_length_1012_cov_15.395400	501	581	0	17	80	0.2125000
NODE_6386_length_1012_cov_15.395400	501	581	4	63	80	0.7875000
NODE_6386_length_1012_cov_15.395400	554	634	0	11	80	0.1375000
NODE_6386_length_1012_cov_15.395400	554	634	4	69	80	0.8625000
NODE_6388_length_1012_cov_6.409639	528	608	0	5	80	0.0625000
NODE_6388_length_1012_cov_6.409639	528	608	2	75	80	0.9375000
NODE_6388_length_1012_cov_6.409639	581	661	0	4	80	0.0500000
NODE_6388_length_1012_cov_6.409639	581	661	2	76	80	0.9500000
NODE_6398_length_1011_cov_53.032895	515	595	0	80	80	1.0000000
NODE_6398_length_1011_cov_53.032895	568	648	0	80	80	1.0000000
NODE_6399_length_1011_cov_25.838816	366	446	1	52	80	0.6500000
NODE_6399_length_1011_cov_25.838816	366	446	5	15	80	0.1875000
NODE_6399_length_1011_cov_25.838816	366	446	6	13	80	0.1625000
NODE_6399_length_1011_cov_25.838816	419	499	5	14	80	0.1750000
NODE_6399_length_1011_cov_25.838816	419	499	6	22	80	0.2750000
NODE_6399_length_1011_cov_25.838816	419	499	7	41	80	0.5125000
NODE_6399_length_1011_cov_25.838816	419	499	8	3	80	0.0375000
NODE_6400_length_1011_cov_22.734649	426	506	0	80	80	1.0000000
NODE_6400_length_1011_cov_22.734649	479	559	0	80	80	1.0000000
NODE_6400_length_1011_cov_22.734649	555	636	0	35	81	0.4320988
NODE_6400_length_1011_cov_22.734649	555	636	2	46	81	0.5679013
NODE_6400_length_1011_cov_22.734649	609	689	0	21	80	0.2625000
NODE_6400_length_1011_cov_22.734649	609	689	2	59	80	0.7375000
NODE_6401_length_1011_cov_18.127193	389	469	0	80	80	1.0000000
NODE_6401_length_1011_cov_18.127193	442	520	0	78	78	1.0000000
NODE_6401_length_1011_cov_18.127193	516	596	0	6	80	0.0750000
NODE_6401_length_1011_cov_18.127193	516	596	2	13	80	0.1625000
NODE_6401_length_1011_cov_18.127193	516	596	6	32	80	0.4000000
NODE_6401_length_1011_cov_18.127193	516	596	8	29	80	0.3625000
NODE_6401_length_1011_cov_18.127193	569	649	2	25	80	0.3125000
NODE_6401_length_1011_cov_18.127193	569	649	6	15	80	0.1875000
NODE_6401_length_1011_cov_18.127193	569	649	8	40	80	0.5000000
NODE_6402_length_1011_cov_12.709430	309	389	0	78	80	0.9750000
NODE_6402_length_1011_cov_12.709430	309	389	2	2	80	0.0250000
NODE_6402_length_1011_cov_12.709430	362	442	0	25	80	0.3125000
NODE_6402_length_1011_cov_12.709430	362	442	2	55	80	0.6875000
NODE_6403_length_1011_cov_8.731360	441	521	0	80	80	1.0000000
NODE_6403_length_1011_cov_8.731360	494	574	0	80	80	1.0000000
NODE_6405_length_1011_cov_7.212719	219	299	0	14	80	0.1750000
NODE_6405_length_1011_cov_7.212719	219	299	2	66	80	0.8250000
NODE_6408_length_1011_cov_3.569079	173	253	0	15	80	0.1875000
NODE_6408_length_1011_cov_3.569079	173	253	4	65	80	0.8125000
NODE_6408_length_1011_cov_3.569079	226	306	4	80	80	1.0000000
NODE_6409_length_1011_cov_1.703947	779	851	5	1	72	0.0138889
NODE_6409_length_1011_cov_1.703947	779	851	7	1	72	0.0138889
NODE_6409_length_1011_cov_1.703947	779	851	8	3	72	0.0416667
NODE_6409_length_1011_cov_1.703947	779	851	11	5	72	0.0694444
NODE_6409_length_1011_cov_1.703947	779	851	13	5	72	0.0694444
NODE_6409_length_1011_cov_1.703947	779	851	17	3	72	0.0416667
NODE_6409_length_1011_cov_1.703947	779	851	18	1	72	0.0138889
NODE_6409_length_1011_cov_1.703947	779	851	22	2	72	0.0277778
NODE_6409_length_1011_cov_1.703947	779	851	24	1	72	0.0138889
NODE_6409_length_1011_cov_1.703947	779	851	30	1	72	0.0138889
NODE_6409_length_1011_cov_1.703947	779	851	32	11	72	0.1527778
NODE_6409_length_1011_cov_1.703947	779	851	34	5	72	0.0694444
NODE_6409_length_1011_cov_1.703947	779	851	38	1	72	0.0138889
NODE_6409_length_1011_cov_1.703947	779	851	42	4	72	0.0555556
NODE_6409_length_1011_cov_1.703947	779	851	44	7	72	0.0972222
NODE_6409_length_1011_cov_1.703947	779	851	48	10	72	0.1388889
NODE_6409_length_1011_cov_1.703947	779	851	52	8	72	0.1111111
NODE_6409_length_1011_cov_1.703947	779	851	54	1	72	0.0138889
NODE_6409_length_1011_cov_1.703947	779	851	56	2	72	0.0277778
NODE_6416_length_1010_cov_51.841932	335	415	0	2	80	0.0250000
NODE_6416_length_1010_cov_51.841932	335	415	6	24	80	0.3000000
NODE_6416_length_1010_cov_51.841932	335	415	10	54	80	0.6750000
NODE_6416_length_1010_cov_51.841932	388	468	0	55	80	0.6875000
NODE_6416_length_1010_cov_51.841932	388	468	6	24	80	0.3000000
NODE_6416_length_1010_cov_51.841932	388	468	10	1	80	0.0125000
NODE_6417_length_1010_cov_35.860593	576	656	0	80	80	1.0000000
NODE_6417_length_1010_cov_35.860593	629	709	0	80	80	1.0000000
NODE_6418_length_1010_cov_30.043908	509	589	0	12	80	0.1500000
NODE_6418_length_1010_cov_30.043908	509	589	2	21	80	0.2625000
NODE_6418_length_1010_cov_30.043908	509	589	6	47	80	0.5875000
NODE_6418_length_1010_cov_30.043908	562	642	0	2	80	0.0250000
NODE_6418_length_1010_cov_30.043908	562	642	4	32	80	0.4000000
NODE_6418_length_1010_cov_30.043908	562	642	6	46	80	0.5750000
NODE_6418_length_1010_cov_30.043908	638	718	0	37	80	0.4625000
NODE_6418_length_1010_cov_30.043908	638	718	2	41	80	0.5125000
NODE_6418_length_1010_cov_30.043908	638	718	4	2	80	0.0250000
NODE_6418_length_1010_cov_30.043908	691	771	0	15	80	0.1875000
NODE_6418_length_1010_cov_30.043908	691	771	2	65	80	0.8125000
NODE_6420_length_1010_cov_15.156970	364	444	2	64	80	0.8000000
NODE_6420_length_1010_cov_15.156970	364	444	4	16	80	0.2000000
NODE_6420_length_1010_cov_15.156970	417	497	0	3	80	0.0375000
NODE_6420_length_1010_cov_15.156970	417	497	2	64	80	0.8000000
NODE_6420_length_1010_cov_15.156970	417	497	4	13	80	0.1625000
NODE_6421_length_1010_cov_13.546652	385	465	0	80	80	1.0000000
NODE_6421_length_1010_cov_13.546652	438	518	0	80	80	1.0000000
NODE_6422_length_1010_cov_13.317234	480	560	0	48	80	0.6000000
NODE_6422_length_1010_cov_13.317234	480	560	2	32	80	0.4000000
NODE_6422_length_1010_cov_13.317234	533	613	2	71	80	0.8875000
NODE_6422_length_1010_cov_13.317234	533	613	3	9	80	0.1125000
NODE_6423_length_1010_cov_12.900110	427	507	0	14	80	0.1750000
NODE_6423_length_1010_cov_12.900110	427	507	2	28	80	0.3500000
NODE_6423_length_1010_cov_12.900110	427	507	4	38	80	0.4750000
NODE_6423_length_1010_cov_12.900110	480	560	0	67	80	0.8375000
NODE_6423_length_1010_cov_12.900110	480	560	2	13	80	0.1625000
NODE_6424_length_1010_cov_11.423710	631	711	0	28	80	0.3500000
NODE_6424_length_1010_cov_11.423710	631	711	4	52	80	0.6500000
NODE_6424_length_1010_cov_11.423710	684	764	0	80	80	1.0000000
NODE_6425_length_1010_cov_11.256861	492	572	0	80	80	1.0000000
NODE_6425_length_1010_cov_11.256861	545	625	0	80	80	1.0000000
NODE_6426_length_1010_cov_11.000000	455	535	0	80	80	1.0000000
NODE_6426_length_1010_cov_11.000000	508	588	0	80	80	1.0000000
NODE_6428_length_1010_cov_4.990121	476	556	0	80	80	1.0000000
NODE_6428_length_1010_cov_4.990121	529	609	0	45	80	0.5625000
NODE_6428_length_1010_cov_4.990121	529	609	2	35	80	0.4375000
NODE_6430_length_1010_cov_4.892426	476	556	0	26	80	0.3250000
NODE_6430_length_1010_cov_4.892426	476	556	2	54	80	0.6750000
NODE_6430_length_1010_cov_4.892426	529	609	0	26	80	0.3250000
NODE_6430_length_1010_cov_4.892426	529	609	2	16	80	0.2000000
NODE_6430_length_1010_cov_4.892426	529	609	4	38	80	0.4750000
NODE_6431_length_1010_cov_3.624588	157	196	0	39	39	1.0000000
NODE_6435_length_1010_cov_1.440176	1	58	0	57	57	1.0000000
NODE_6436_length_1009_cov_44.626374	288	362	0	74	74	1.0000000
NODE_6436_length_1009_cov_44.626374	335	415	0	80	80	1.0000000
NODE_6436_length_1009_cov_44.626374	411	491	0	80	80	1.0000000
NODE_6436_length_1009_cov_44.626374	464	544	0	80	80	1.0000000
NODE_6437_length_1009_cov_31.828571	412	492	0	10	80	0.1250000
NODE_6437_length_1009_cov_31.828571	412	492	2	70	80	0.8750000
NODE_6437_length_1009_cov_31.828571	465	545	0	3	80	0.0375000
NODE_6437_length_1009_cov_31.828571	465	545	2	77	80	0.9625000
NODE_6438_length_1009_cov_28.539560	571	651	4	80	80	1.0000000
NODE_6438_length_1009_cov_28.539560	624	704	0	45	80	0.5625000
NODE_6438_length_1009_cov_28.539560	624	704	4	35	80	0.4375000
NODE_6439_length_1009_cov_20.281319	577	657	0	21	80	0.2625000
NODE_6439_length_1009_cov_20.281319	577	657	3	1	80	0.0125000
NODE_6439_length_1009_cov_20.281319	577	657	4	58	80	0.7250000
NODE_6439_length_1009_cov_20.281319	630	710	0	7	80	0.0875000
NODE_6439_length_1009_cov_20.281319	630	710	3	1	80	0.0125000
NODE_6439_length_1009_cov_20.281319	630	710	4	72	80	0.9000000
NODE_6440_length_1009_cov_18.649451	430	510	0	47	80	0.5875000
NODE_6440_length_1009_cov_18.649451	430	510	2	20	80	0.2500000
NODE_6440_length_1009_cov_18.649451	430	510	4	13	80	0.1625000
NODE_6440_length_1009_cov_18.649451	483	563	2	14	80	0.1750000
NODE_6440_length_1009_cov_18.649451	483	563	4	66	80	0.8250000
NODE_6442_length_1009_cov_3.767033	647	727	0	80	80	1.0000000
NODE_6442_length_1009_cov_3.767033	700	780	0	80	80	1.0000000
NODE_6443_length_1009_cov_2.903297	36	63	0	27	27	1.0000000
NODE_6451_length_1008_cov_44.825083	399	479	0	80	80	1.0000000
NODE_6451_length_1008_cov_44.825083	452	532	0	80	80	1.0000000
NODE_6452_length_1008_cov_41.030803	280	360	0	80	80	1.0000000
NODE_6452_length_1008_cov_41.030803	333	413	0	54	80	0.6750000
NODE_6452_length_1008_cov_41.030803	333	413	4	26	80	0.3250000
NODE_6452_length_1008_cov_41.030803	409	489	4	80	80	1.0000000
NODE_6452_length_1008_cov_41.030803	462	542	0	43	80	0.5375000
NODE_6452_length_1008_cov_41.030803	462	542	4	37	80	0.4625000
NODE_6453_length_1008_cov_39.377338	311	391	0	80	80	1.0000000
NODE_6453_length_1008_cov_39.377338	364	444	0	80	80	1.0000000
NODE_6453_length_1008_cov_39.377338	440	520	0	80	80	1.0000000
NODE_6453_length_1008_cov_39.377338	493	573	0	80	80	1.0000000
NODE_6454_length_1008_cov_27.836084	405	485	0	16	80	0.2000000
NODE_6454_length_1008_cov_27.836084	405	485	2	64	80	0.8000000
NODE_6454_length_1008_cov_27.836084	458	538	0	69	80	0.8625000
NODE_6454_length_1008_cov_27.836084	458	538	2	11	80	0.1375000
NODE_6454_length_1008_cov_27.836084	534	614	0	80	80	1.0000000
NODE_6454_length_1008_cov_27.836084	587	667	0	80	80	1.0000000
NODE_6455_length_1008_cov_24.741474	485	565	0	80	80	1.0000000
NODE_6455_length_1008_cov_24.741474	538	618	0	80	80	1.0000000
NODE_6456_length_1008_cov_20.278328	401	481	2	19	80	0.2375000
NODE_6456_length_1008_cov_20.278328	401	481	4	21	80	0.2625000
NODE_6456_length_1008_cov_20.278328	401	481	6	26	80	0.3250000
NODE_6456_length_1008_cov_20.278328	401	481	8	14	80	0.1750000
NODE_6456_length_1008_cov_20.278328	454	534	6	44	80	0.5500000
NODE_6456_length_1008_cov_20.278328	454	534	8	36	80	0.4500000
NODE_6457_length_1008_cov_6.071507	460	540	0	80	80	1.0000000
NODE_6457_length_1008_cov_6.071507	513	593	0	80	80	1.0000000
NODE_6466_length_1008_cov_1.798680	0	64	0	64	64	1.0000000
NODE_6466_length_1008_cov_1.798680	37	104	0	61	67	0.9104478
NODE_6466_length_1008_cov_1.798680	37	104	2	6	67	0.0895522
NODE_6473_length_1007_cov_27.011013	294	371	0	8	77	0.1038961
NODE_6473_length_1007_cov_27.011013	294	371	4	5	77	0.0649351
NODE_6473_length_1007_cov_27.011013	294	371	6	27	77	0.3506494
NODE_6473_length_1007_cov_27.011013	294	371	12	1	77	0.0129870
NODE_6473_length_1007_cov_27.011013	294	371	13	1	77	0.0129870
NODE_6473_length_1007_cov_27.011013	294	371	14	35	77	0.4545455
NODE_6473_length_1007_cov_27.011013	347	424	2	22	77	0.2857143
NODE_6473_length_1007_cov_27.011013	347	424	8	4	77	0.0519481
NODE_6473_length_1007_cov_27.011013	347	424	14	51	77	0.6623377
NODE_6474_length_1007_cov_24.668502	369	449	0	2	80	0.0250000
NODE_6474_length_1007_cov_24.668502	369	449	10	78	80	0.9750000
NODE_6474_length_1007_cov_24.668502	422	502	0	7	80	0.0875000
NODE_6474_length_1007_cov_24.668502	422	502	10	73	80	0.9125000
NODE_6474_length_1007_cov_24.668502	498	578	0	80	80	1.0000000
NODE_6474_length_1007_cov_24.668502	551	631	0	80	80	1.0000000
NODE_6475_length_1007_cov_21.729075	454	534	0	38	80	0.4750000
NODE_6475_length_1007_cov_21.729075	454	534	2	42	80	0.5250000
NODE_6475_length_1007_cov_21.729075	507	587	0	19	80	0.2375000
NODE_6475_length_1007_cov_21.729075	507	587	2	61	80	0.7625000
NODE_6475_length_1007_cov_21.729075	583	663	0	9	80	0.1125000
NODE_6475_length_1007_cov_21.729075	583	663	2	11	80	0.1375000
NODE_6475_length_1007_cov_21.729075	583	663	4	20	80	0.2500000
NODE_6475_length_1007_cov_21.729075	583	663	6	40	80	0.5000000
NODE_6475_length_1007_cov_21.729075	636	716	2	64	80	0.8000000
NODE_6475_length_1007_cov_21.729075	636	716	6	16	80	0.2000000
NODE_6476_length_1007_cov_14.515419	400	480	0	12	80	0.1500000
NODE_6476_length_1007_cov_14.515419	400	480	4	68	80	0.8500000
NODE_6476_length_1007_cov_14.515419	453	533	0	14	80	0.1750000
NODE_6476_length_1007_cov_14.515419	453	533	4	66	80	0.8250000
NODE_6477_length_1007_cov_13.685022	376	456	0	54	80	0.6750000
NODE_6477_length_1007_cov_13.685022	376	456	2	26	80	0.3250000
NODE_6477_length_1007_cov_13.685022	429	509	0	1	80	0.0125000
NODE_6477_length_1007_cov_13.685022	429	509	2	79	80	0.9875000
NODE_6478_length_1007_cov_9.189427	438	518	0	17	80	0.2125000
NODE_6478_length_1007_cov_9.189427	438	518	2	33	80	0.4125000
NODE_6478_length_1007_cov_9.189427	438	518	6	30	80	0.3750000
NODE_6478_length_1007_cov_9.189427	491	571	4	17	80	0.2125000
NODE_6478_length_1007_cov_9.189427	491	571	6	63	80	0.7875000
NODE_6491_length_1006_cov_59.773980	379	459	4	80	80	1.0000000
NODE_6491_length_1006_cov_59.773980	432	512	0	18	80	0.2250000
NODE_6491_length_1006_cov_59.773980	432	512	3	18	80	0.2250000
NODE_6491_length_1006_cov_59.773980	432	512	4	44	80	0.5500000
NODE_6491_length_1006_cov_59.773980	508	588	0	15	80	0.1875000
NODE_6491_length_1006_cov_59.773980	508	588	4	65	80	0.8125000
NODE_6491_length_1006_cov_59.773980	561	641	0	15	80	0.1875000
NODE_6491_length_1006_cov_59.773980	561	641	4	65	80	0.8125000
NODE_6492_length_1006_cov_34.762955	482	562	0	80	80	1.0000000
NODE_6492_length_1006_cov_34.762955	535	615	0	80	80	1.0000000
NODE_6493_length_1006_cov_21.776185	516	596	0	80	80	1.0000000
NODE_6493_length_1006_cov_21.776185	569	649	0	80	80	1.0000000
NODE_6494_length_1006_cov_19.690187	371	451	2	80	80	1.0000000
NODE_6494_length_1006_cov_19.690187	424	504	0	47	80	0.5875000
NODE_6494_length_1006_cov_19.690187	424	504	2	33	80	0.4125000
NODE_6495_length_1006_cov_19.299890	495	575	4	80	80	1.0000000
NODE_6495_length_1006_cov_19.299890	548	628	0	40	80	0.5000000
NODE_6495_length_1006_cov_19.299890	548	628	4	40	80	0.5000000
NODE_6496_length_1006_cov_13.187431	245	325	0	40	80	0.5000000
NODE_6496_length_1006_cov_13.187431	245	325	2	1	80	0.0125000
NODE_6496_length_1006_cov_13.187431	245	325	4	39	80	0.4875000
NODE_6496_length_1006_cov_13.187431	298	378	2	10	80	0.1250000
NODE_6496_length_1006_cov_13.187431	298	378	4	70	80	0.8750000
NODE_6497_length_1006_cov_12.862183	383	463	0	80	80	1.0000000
NODE_6497_length_1006_cov_12.862183	436	516	0	80	80	1.0000000
NODE_6498_length_1006_cov_10.986770	762	842	0	35	80	0.4375000
NODE_6498_length_1006_cov_10.986770	762	842	4	45	80	0.5625000
NODE_6498_length_1006_cov_10.986770	815	895	0	80	80	1.0000000
NODE_6499_length_1006_cov_8.633958	314	394	0	36	80	0.4500000
NODE_6499_length_1006_cov_8.633958	314	394	1	9	80	0.1125000
NODE_6499_length_1006_cov_8.633958	314	394	2	35	80	0.4375000
NODE_6499_length_1006_cov_8.633958	367	447	0	17	80	0.2125000
NODE_6499_length_1006_cov_8.633958	367	447	2	63	80	0.7875000
NODE_6515_length_1005_cov_80.271523	509	589	20	8	80	0.1000000
NODE_6515_length_1005_cov_80.271523	509	589	22	8	80	0.1000000
NODE_6515_length_1005_cov_80.271523	509	589	24	8	80	0.1000000
NODE_6515_length_1005_cov_80.271523	509	589	26	27	80	0.3375000
NODE_6515_length_1005_cov_80.271523	509	589	28	29	80	0.3625000
NODE_6515_length_1005_cov_80.271523	562	642	1	1	80	0.0125000
NODE_6515_length_1005_cov_80.271523	562	642	2	4	80	0.0500000
NODE_6515_length_1005_cov_80.271523	562	642	3	20	80	0.2500000
NODE_6515_length_1005_cov_80.271523	562	642	5	13	80	0.1625000
NODE_6515_length_1005_cov_80.271523	562	642	7	1	80	0.0125000
NODE_6515_length_1005_cov_80.271523	562	642	9	2	80	0.0250000
NODE_6515_length_1005_cov_80.271523	562	642	28	39	80	0.4875000
NODE_6516_length_1005_cov_45.008830	357	437	0	80	80	1.0000000
NODE_6516_length_1005_cov_45.008830	410	490	0	33	80	0.4125000
NODE_6516_length_1005_cov_45.008830	410	490	2	47	80	0.5875000
NODE_6517_length_1005_cov_36.636865	567	647	0	6	80	0.0750000
NODE_6517_length_1005_cov_36.636865	567	647	8	18	80	0.2250000
NODE_6517_length_1005_cov_36.636865	567	647	11	4	80	0.0500000
NODE_6517_length_1005_cov_36.636865	567	647	13	1	80	0.0125000
NODE_6517_length_1005_cov_36.636865	567	647	14	7	80	0.0875000
NODE_6517_length_1005_cov_36.636865	567	647	17	12	80	0.1500000
NODE_6517_length_1005_cov_36.636865	567	647	18	32	80	0.4000000
NODE_6517_length_1005_cov_36.636865	620	700	6	16	80	0.2000000
NODE_6517_length_1005_cov_36.636865	620	700	10	17	80	0.2125000
NODE_6517_length_1005_cov_36.636865	620	700	17	32	80	0.4000000
NODE_6517_length_1005_cov_36.636865	620	700	18	15	80	0.1875000
NODE_6518_length_1005_cov_21.222958	389	409	0	20	20	1.0000000
NODE_6518_length_1005_cov_21.222958	451	519	0	68	68	1.0000000
NODE_6518_length_1005_cov_21.222958	515	595	0	80	80	1.0000000
NODE_6518_length_1005_cov_21.222958	568	648	0	80	80	1.0000000
NODE_6520_length_1005_cov_14.278146	480	560	0	55	80	0.6875000
NODE_6520_length_1005_cov_14.278146	480	560	2	25	80	0.3125000
NODE_6520_length_1005_cov_14.278146	533	613	0	28	80	0.3500000
NODE_6520_length_1005_cov_14.278146	533	613	2	52	80	0.6500000
NODE_6521_length_1005_cov_13.215232	511	591	0	80	80	1.0000000
NODE_6521_length_1005_cov_13.215232	564	644	0	34	80	0.4250000
NODE_6521_length_1005_cov_13.215232	564	644	2	46	80	0.5750000
NODE_6523_length_1005_cov_5.579470	534	614	0	80	80	1.0000000
NODE_6523_length_1005_cov_5.579470	587	667	0	80	80	1.0000000
NODE_6536_length_1004_cov_45.470718	343	423	0	80	80	1.0000000
NODE_6536_length_1004_cov_45.470718	396	476	0	80	80	1.0000000
NODE_6536_length_1004_cov_45.470718	472	552	0	80	80	1.0000000
NODE_6536_length_1004_cov_45.470718	525	605	0	80	80	1.0000000
NODE_6537_length_1004_cov_34.565746	419	499	10	54	80	0.6750000
NODE_6537_length_1004_cov_34.565746	419	499	13	25	80	0.3125000
NODE_6537_length_1004_cov_34.565746	419	499	15	1	80	0.0125000
NODE_6537_length_1004_cov_34.565746	472	552	6	31	80	0.3875000
NODE_6537_length_1004_cov_34.565746	472	552	10	1	80	0.0125000
NODE_6537_length_1004_cov_34.565746	472	552	13	25	80	0.3125000
NODE_6537_length_1004_cov_34.565746	472	552	15	1	80	0.0125000
NODE_6537_length_1004_cov_34.565746	472	552	16	22	80	0.2750000
NODE_6538_length_1004_cov_28.710497	385	465	0	6	80	0.0750000
NODE_6538_length_1004_cov_28.710497	385	465	4	55	80	0.6875000
NODE_6538_length_1004_cov_28.710497	385	465	6	19	80	0.2375000
NODE_6538_length_1004_cov_28.710497	438	518	0	59	80	0.7375000
NODE_6538_length_1004_cov_28.710497	438	518	4	21	80	0.2625000
NODE_6538_length_1004_cov_28.710497	514	594	0	80	80	1.0000000
NODE_6538_length_1004_cov_28.710497	567	647	0	80	80	1.0000000
NODE_6539_length_1004_cov_12.745856	432	512	0	80	80	1.0000000
NODE_6539_length_1004_cov_12.745856	485	565	0	80	80	1.0000000
NODE_6550_length_1003_cov_47.014381	383	463	0	49	80	0.6125000
NODE_6550_length_1003_cov_47.014381	383	463	2	31	80	0.3875000
NODE_6550_length_1003_cov_47.014381	436	516	0	80	80	1.0000000
NODE_6550_length_1003_cov_47.014381	512	592	0	80	80	1.0000000
NODE_6550_length_1003_cov_47.014381	565	645	0	80	80	1.0000000
NODE_6551_length_1003_cov_35.329646	372	452	0	1	80	0.0125000
NODE_6551_length_1003_cov_35.329646	372	452	2	23	80	0.2875000
NODE_6551_length_1003_cov_35.329646	372	452	4	10	80	0.1250000
NODE_6551_length_1003_cov_35.329646	372	452	6	23	80	0.2875000
NODE_6551_length_1003_cov_35.329646	372	452	8	23	80	0.2875000
NODE_6551_length_1003_cov_35.329646	425	505	0	11	80	0.1375000
NODE_6551_length_1003_cov_35.329646	425	505	2	16	80	0.2000000
NODE_6551_length_1003_cov_35.329646	425	505	4	26	80	0.3250000
NODE_6551_length_1003_cov_35.329646	425	505	6	7	80	0.0875000
NODE_6551_length_1003_cov_35.329646	425	505	8	20	80	0.2500000
NODE_6552_length_1003_cov_32.721239	357	437	0	80	80	1.0000000
NODE_6552_length_1003_cov_32.721239	410	490	0	80	80	1.0000000
NODE_6553_length_1003_cov_23.758850	467	547	0	59	80	0.7375000
NODE_6553_length_1003_cov_23.758850	467	547	2	13	80	0.1625000
NODE_6553_length_1003_cov_23.758850	467	547	4	8	80	0.1000000
NODE_6553_length_1003_cov_23.758850	520	600	0	6	80	0.0750000
NODE_6553_length_1003_cov_23.758850	520	600	2	13	80	0.1625000
NODE_6553_length_1003_cov_23.758850	520	600	4	61	80	0.7625000
NODE_6554_length_1003_cov_19.939159	240	320	0	80	80	1.0000000
NODE_6554_length_1003_cov_19.939159	293	373	0	80	80	1.0000000
NODE_6555_length_1003_cov_16.618363	524	604	0	80	80	1.0000000
NODE_6555_length_1003_cov_16.618363	577	657	0	80	80	1.0000000
NODE_6555_length_1003_cov_16.618363	653	733	0	53	80	0.6625000
NODE_6555_length_1003_cov_16.618363	653	733	2	27	80	0.3375000
NODE_6555_length_1003_cov_16.618363	706	786	2	80	80	1.0000000
NODE_6556_length_1003_cov_13.863938	537	617	0	80	80	1.0000000
NODE_6556_length_1003_cov_13.863938	590	670	0	80	80	1.0000000
NODE_6557_length_1003_cov_12.363938	529	609	0	25	80	0.3125000
NODE_6557_length_1003_cov_12.363938	529	609	2	55	80	0.6875000
NODE_6557_length_1003_cov_12.363938	582	662	0	32	80	0.4000000
NODE_6557_length_1003_cov_12.363938	582	662	2	48	80	0.6000000
NODE_6567_length_1002_cov_65.513843	387	467	0	80	80	1.0000000
NODE_6567_length_1002_cov_65.513843	440	520	0	80	80	1.0000000
NODE_6567_length_1002_cov_65.513843	516	596	0	80	80	1.0000000
NODE_6567_length_1002_cov_65.513843	569	649	0	80	80	1.0000000
NODE_6568_length_1002_cov_41.995570	408	488	1	13	80	0.1625000
NODE_6568_length_1002_cov_41.995570	408	488	3	11	80	0.1375000
NODE_6568_length_1002_cov_41.995570	408	488	4	28	80	0.3500000
NODE_6568_length_1002_cov_41.995570	408	488	5	28	80	0.3500000
NODE_6568_length_1002_cov_41.995570	461	541	1	66	80	0.8250000
NODE_6568_length_1002_cov_41.995570	461	541	3	4	80	0.0500000
NODE_6568_length_1002_cov_41.995570	461	541	4	10	80	0.1250000
NODE_6569_length_1002_cov_19.966777	401	481	2	80	80	1.0000000
NODE_6569_length_1002_cov_19.966777	454	534	0	52	80	0.6500000
NODE_6569_length_1002_cov_19.966777	454	534	2	28	80	0.3500000
NODE_6570_length_1002_cov_19.539313	334	414	0	80	80	1.0000000
NODE_6570_length_1002_cov_19.539313	335	414	0	79	79	1.0000000
NODE_6570_length_1002_cov_19.539313	387	467	0	80	80	1.0000000
NODE_6570_length_1002_cov_19.539313	387	467	0	80	80	1.0000000
NODE_6570_length_1002_cov_19.539313	396	467	0	71	71	1.0000000
NODE_6570_length_1002_cov_19.539313	463	543	0	17	80	0.2125000
NODE_6570_length_1002_cov_19.539313	463	543	4	38	80	0.4750000
NODE_6570_length_1002_cov_19.539313	463	543	7	25	80	0.3125000
NODE_6570_length_1002_cov_19.539313	516	596	4	2	80	0.0250000
NODE_6570_length_1002_cov_19.539313	516	596	7	59	80	0.7375000
NODE_6570_length_1002_cov_19.539313	516	596	8	19	80	0.2375000
NODE_6571_length_1002_cov_17.780731	631	711	0	18	80	0.2250000
NODE_6571_length_1002_cov_17.780731	631	711	2	62	80	0.7750000
NODE_6571_length_1002_cov_17.780731	684	764	0	71	80	0.8875000
NODE_6571_length_1002_cov_17.780731	684	764	2	9	80	0.1125000
NODE_6572_length_1002_cov_17.590255	0	58	0	58	58	1.0000000
NODE_6572_length_1002_cov_17.590255	31	77	0	46	46	1.0000000
NODE_6573_length_1002_cov_17.105205	522	602	0	80	80	1.0000000
NODE_6573_length_1002_cov_17.105205	575	655	0	80	80	1.0000000
NODE_6574_length_1002_cov_11.954596	480	560	0	53	80	0.6625000
NODE_6574_length_1002_cov_11.954596	480	560	1	27	80	0.3375000
NODE_6574_length_1002_cov_11.954596	533	613	1	38	80	0.4750000
NODE_6574_length_1002_cov_11.954596	533	613	3	25	80	0.3125000
NODE_6574_length_1002_cov_11.954596	533	613	4	17	80	0.2125000
NODE_6575_length_1002_cov_11.823920	471	551	0	78	80	0.9750000
NODE_6575_length_1002_cov_11.823920	471	551	2	2	80	0.0250000
NODE_6575_length_1002_cov_11.823920	524	614	0	90	90	1.0000000
NODE_6577_length_1002_cov_6.596899	422	502	0	14	80	0.1750000
NODE_6577_length_1002_cov_6.596899	422	502	4	66	80	0.8250000
NODE_6577_length_1002_cov_6.596899	475	555	0	33	80	0.4125000
NODE_6577_length_1002_cov_6.596899	475	555	4	47	80	0.5875000
NODE_6588_length_1002_cov_2.102990	29	110	12	1	81	0.0123457
NODE_6588_length_1002_cov_2.102990	29	110	14	20	81	0.2469136
NODE_6588_length_1002_cov_2.102990	29	110	16	12	81	0.1481481
NODE_6588_length_1002_cov_2.102990	29	110	18	5	81	0.0617284
NODE_6588_length_1002_cov_2.102990	29	110	20	11	81	0.1358025
NODE_6588_length_1002_cov_2.102990	29	110	22	32	81	0.3950617
NODE_6596_length_1001_cov_41.914634	549	629	0	80	80	1.0000000
NODE_6596_length_1001_cov_41.914634	602	682	0	80	80	1.0000000
NODE_6597_length_1001_cov_30.378049	306	386	0	61	80	0.7625000
NODE_6597_length_1001_cov_30.378049	306	386	2	11	80	0.1375000
NODE_6597_length_1001_cov_30.378049	306	386	4	8	80	0.1000000
NODE_6597_length_1001_cov_30.378049	359	439	0	8	80	0.1000000
NODE_6597_length_1001_cov_30.378049	359	439	2	11	80	0.1375000
NODE_6597_length_1001_cov_30.378049	359	439	4	61	80	0.7625000
NODE_6597_length_1001_cov_30.378049	369	439	2	9	70	0.1285714
NODE_6597_length_1001_cov_30.378049	369	439	4	61	70	0.8714285
NODE_6597_length_1001_cov_30.378049	435	515	4	7	80	0.0875000
NODE_6597_length_1001_cov_30.378049	435	515	7	15	80	0.1875000
NODE_6597_length_1001_cov_30.378049	435	515	8	9	80	0.1125000
NODE_6597_length_1001_cov_30.378049	435	515	9	18	80	0.2250000
NODE_6597_length_1001_cov_30.378049	435	515	11	20	80	0.2500000
NODE_6597_length_1001_cov_30.378049	435	515	12	11	80	0.1375000
NODE_6597_length_1001_cov_30.378049	488	568	4	26	80	0.3250000
NODE_6597_length_1001_cov_30.378049	488	568	8	3	80	0.0375000
NODE_6597_length_1001_cov_30.378049	488	568	9	15	80	0.1875000
NODE_6597_length_1001_cov_30.378049	488	568	11	25	80	0.3125000
NODE_6597_length_1001_cov_30.378049	488	568	12	11	80	0.1375000
NODE_6598_length_1001_cov_22.517738	536	616	0	36	80	0.4500000
NODE_6598_length_1001_cov_22.517738	536	616	2	44	80	0.5500000
NODE_6598_length_1001_cov_22.517738	589	670	0	73	81	0.9012346
NODE_6598_length_1001_cov_22.517738	589	670	2	8	81	0.0987654
NODE_6599_length_1001_cov_17.996674	414	456	0	42	42	1.0000000
NODE_6599_length_1001_cov_17.996674	429	509	0	80	80	1.0000000
NODE_6599_length_1001_cov_17.996674	505	585	0	80	80	1.0000000
NODE_6599_length_1001_cov_17.996674	558	638	0	44	80	0.5500000
NODE_6599_length_1001_cov_17.996674	558	638	2	36	80	0.4500000
NODE_6600_length_1001_cov_16.798226	422	502	0	80	80	1.0000000
NODE_6600_length_1001_cov_16.798226	475	555	0	80	80	1.0000000
NODE_6600_length_1001_cov_16.798226	551	631	0	80	80	1.0000000
NODE_6600_length_1001_cov_16.798226	604	684	0	80	80	1.0000000
NODE_6601_length_1001_cov_12.778271	348	428	0	80	80	1.0000000
NODE_6601_length_1001_cov_12.778271	401	481	0	80	80	1.0000000
NODE_6602_length_1001_cov_12.305987	255	335	0	9	80	0.1125000
NODE_6602_length_1001_cov_12.305987	255	335	2	71	80	0.8875000
NODE_6602_length_1001_cov_12.305987	308	388	0	56	80	0.7000000
NODE_6602_length_1001_cov_12.305987	308	388	2	24	80	0.3000000
NODE_6603_length_1001_cov_11.955654	485	569	0	84	84	1.0000000
NODE_6603_length_1001_cov_11.955654	542	622	0	80	80	1.0000000
NODE_6604_length_1001_cov_10.156319	587	667	0	80	80	1.0000000
NODE_6604_length_1001_cov_10.156319	640	720	0	80	80	1.0000000
NODE_6605_length_1001_cov_9.754989	377	457	0	24	80	0.3000000
NODE_6605_length_1001_cov_9.754989	377	457	2	2	80	0.0250000
NODE_6605_length_1001_cov_9.754989	377	457	4	54	80	0.6750000
NODE_6605_length_1001_cov_9.754989	430	510	0	77	80	0.9625000
NODE_6605_length_1001_cov_9.754989	430	510	2	2	80	0.0250000
NODE_6605_length_1001_cov_9.754989	430	510	4	1	80	0.0125000
NODE_6607_length_1001_cov_4.616408	408	488	0	80	80	1.0000000
NODE_6607_length_1001_cov_4.616408	461	541	0	80	80	1.0000000
NODE_6616_length_1000_cov_55.578246	393	473	0	22	80	0.2750000
NODE_6616_length_1000_cov_55.578246	393	473	2	52	80	0.6500000
NODE_6616_length_1000_cov_55.578246	393	473	4	6	80	0.0750000
NODE_6616_length_1000_cov_55.578246	446	526	2	69	80	0.8625000
NODE_6616_length_1000_cov_55.578246	446	526	4	11	80	0.1375000
NODE_6616_length_1000_cov_55.578246	522	598	2	6	76	0.0789474
NODE_6616_length_1000_cov_55.578246	522	598	6	22	76	0.2894737
NODE_6616_length_1000_cov_55.578246	522	598	8	1	76	0.0131579
NODE_6616_length_1000_cov_55.578246	522	598	9	7	76	0.0921053
NODE_6616_length_1000_cov_55.578246	522	598	13	22	76	0.2894737
NODE_6616_length_1000_cov_55.578246	522	598	15	15	76	0.1973684
NODE_6616_length_1000_cov_55.578246	522	598	17	3	76	0.0394737
NODE_6616_length_1000_cov_55.578246	575	649	4	4	74	0.0540541
NODE_6616_length_1000_cov_55.578246	575	649	13	20	74	0.2702703
NODE_6616_length_1000_cov_55.578246	575	649	14	33	74	0.4459459
NODE_6616_length_1000_cov_55.578246	575	649	17	9	74	0.1216216
NODE_6616_length_1000_cov_55.578246	575	649	18	8	74	0.1081081
NODE_6617_length_1000_cov_51.534961	432	512	0	65	80	0.8125000
NODE_6617_length_1000_cov_51.534961	432	512	2	15	80	0.1875000
NODE_6617_length_1000_cov_51.534961	485	565	0	12	80	0.1500000
NODE_6617_length_1000_cov_51.534961	485	565	2	45	80	0.5625000
NODE_6617_length_1000_cov_51.534961	485	565	6	23	80	0.2875000
NODE_6617_length_1000_cov_51.534961	561	641	0	6	80	0.0750000
NODE_6617_length_1000_cov_51.534961	561	641	4	43	80	0.5375000
NODE_6617_length_1000_cov_51.534961	561	641	6	31	80	0.3875000
NODE_6617_length_1000_cov_51.534961	614	694	0	59	80	0.7375000
NODE_6617_length_1000_cov_51.534961	614	694	4	21	80	0.2625000
NODE_6618_length_1000_cov_39.011099	186	266	0	80	80	1.0000000
NODE_6618_length_1000_cov_39.011099	239	319	0	80	80	1.0000000
NODE_6619_length_1000_cov_19.897891	451	531	0	47	80	0.5875000
NODE_6619_length_1000_cov_19.897891	451	531	1	4	80	0.0500000
NODE_6619_length_1000_cov_19.897891	451	531	2	29	80	0.3625000
NODE_6619_length_1000_cov_19.897891	504	584	2	80	80	1.0000000
NODE_6619_length_1000_cov_19.897891	580	660	2	30	80	0.3750000
NODE_6619_length_1000_cov_19.897891	580	660	4	8	80	0.1000000
NODE_6619_length_1000_cov_19.897891	580	660	5	4	80	0.0500000
NODE_6619_length_1000_cov_19.897891	580	660	6	38	80	0.4750000
NODE_6619_length_1000_cov_19.897891	633	713	4	14	80	0.1750000
NODE_6619_length_1000_cov_19.897891	633	713	5	4	80	0.0500000
NODE_6619_length_1000_cov_19.897891	633	713	6	62	80	0.7750000
NODE_6620_length_1000_cov_13.349612	324	404	0	12	80	0.1500000
NODE_6620_length_1000_cov_13.349612	324	404	4	46	80	0.5750000
NODE_6620_length_1000_cov_13.349612	324	404	6	13	80	0.1625000
NODE_6620_length_1000_cov_13.349612	324	404	8	9	80	0.1125000
NODE_6620_length_1000_cov_13.349612	377	457	0	5	80	0.0625000
NODE_6620_length_1000_cov_13.349612	377	457	6	13	80	0.1625000
NODE_6620_length_1000_cov_13.349612	377	457	8	62	80	0.7750000
NODE_6621_length_1000_cov_11.463929	382	462	0	70	80	0.8750000
NODE_6621_length_1000_cov_11.463929	382	462	2	1	80	0.0125000
NODE_6621_length_1000_cov_11.463929	382	462	4	9	80	0.1125000
NODE_6621_length_1000_cov_11.463929	435	515	0	17	80	0.2125000
NODE_6621_length_1000_cov_11.463929	435	515	2	1	80	0.0125000
NODE_6621_length_1000_cov_11.463929	435	515	4	40	80	0.5000000
NODE_6621_length_1000_cov_11.463929	435	515	5	22	80	0.2750000
NODE_6622_length_1000_cov_9.675916	625	705	0	80	80	1.0000000
NODE_6622_length_1000_cov_9.675916	678	758	0	80	80	1.0000000
NODE_6623_length_1000_cov_7.051054	358	438	0	34	80	0.4250000
NODE_6623_length_1000_cov_7.051054	358	438	2	46	80	0.5750000
NODE_6623_length_1000_cov_7.051054	411	491	0	51	80	0.6375000
NODE_6623_length_1000_cov_7.051054	411	491	2	29	80	0.3625000
NODE_6626_length_1000_cov_3.652608	203	265	0	62	62	1.0000000
NODE_6639_length_999_cov_47.442222	604	684	0	80	80	1.0000000
NODE_6639_length_999_cov_47.442222	657	723	0	66	66	1.0000000
NODE_6640_length_999_cov_33.055556	458	540	0	34	82	0.4146341
NODE_6640_length_999_cov_33.055556	458	540	2	7	82	0.0853659
NODE_6640_length_999_cov_33.055556	458	540	4	41	82	0.5000000
NODE_6640_length_999_cov_33.055556	513	593	0	11	80	0.1375000
NODE_6640_length_999_cov_33.055556	513	593	2	12	80	0.1500000
NODE_6640_length_999_cov_33.055556	513	593	4	57	80	0.7125000
NODE_6641_length_999_cov_22.755556	493	573	0	45	80	0.5625000
NODE_6641_length_999_cov_22.755556	493	573	1	1	80	0.0125000
NODE_6641_length_999_cov_22.755556	493	573	2	2	80	0.0250000
NODE_6641_length_999_cov_22.755556	493	573	4	3	80	0.0375000
NODE_6641_length_999_cov_22.755556	493	573	6	29	80	0.3625000
NODE_6641_length_999_cov_22.755556	546	626	4	3	80	0.0375000
NODE_6641_length_999_cov_22.755556	546	626	6	77	80	0.9625000
NODE_6642_length_999_cov_21.842222	359	439	0	80	80	1.0000000
NODE_6642_length_999_cov_21.842222	412	492	0	42	80	0.5250000
NODE_6642_length_999_cov_21.842222	412	492	4	38	80	0.4750000
NODE_6643_length_999_cov_20.006667	361	441	0	63	80	0.7875000
NODE_6643_length_999_cov_20.006667	361	441	2	17	80	0.2125000
NODE_6643_length_999_cov_20.006667	414	494	0	10	80	0.1250000
NODE_6643_length_999_cov_20.006667	414	494	2	18	80	0.2250000
NODE_6643_length_999_cov_20.006667	414	494	4	43	80	0.5375000
NODE_6643_length_999_cov_20.006667	414	494	6	9	80	0.1125000
NODE_6643_length_999_cov_20.006667	490	570	2	55	80	0.6875000
NODE_6643_length_999_cov_20.006667	490	570	4	20	80	0.2500000
NODE_6643_length_999_cov_20.006667	490	570	6	5	80	0.0625000
NODE_6643_length_999_cov_20.006667	543	623	0	40	80	0.5000000
NODE_6643_length_999_cov_20.006667	543	623	2	40	80	0.5000000
NODE_6645_length_999_cov_16.794444	438	518	0	80	80	1.0000000
NODE_6645_length_999_cov_16.794444	491	571	0	56	80	0.7000000
NODE_6645_length_999_cov_16.794444	491	571	2	24	80	0.3000000
NODE_6646_length_999_cov_15.146667	464	544	2	69	80	0.8625000
NODE_6646_length_999_cov_15.146667	464	544	3	11	80	0.1375000
NODE_6646_length_999_cov_15.146667	517	597	2	51	80	0.6375000
NODE_6646_length_999_cov_15.146667	517	597	3	16	80	0.2000000
NODE_6646_length_999_cov_15.146667	517	597	4	13	80	0.1625000
NODE_6648_length_999_cov_8.771111	361	441	0	80	80	1.0000000
NODE_6648_length_999_cov_8.771111	414	492	0	78	78	1.0000000
NODE_6649_length_999_cov_5.171111	417	497	0	42	80	0.5250000
NODE_6649_length_999_cov_5.171111	417	497	2	35	80	0.4375000
NODE_6649_length_999_cov_5.171111	417	497	4	3	80	0.0375000
NODE_6649_length_999_cov_5.171111	470	550	2	24	80	0.3000000
NODE_6649_length_999_cov_5.171111	470	550	4	56	80	0.7000000
NODE_6650_length_999_cov_2.854444	35	101	27	62	66	0.9393939
NODE_6650_length_999_cov_2.854444	35	101	33	4	66	0.0606061
NODE_6657_length_998_cov_30.697442	404	484	2	80	80	1.0000000
NODE_6657_length_998_cov_30.697442	457	537	0	52	80	0.6500000
NODE_6657_length_998_cov_30.697442	457	537	2	28	80	0.3500000
NODE_6657_length_998_cov_30.697442	533	613	0	80	80	1.0000000
NODE_6657_length_998_cov_30.697442	586	666	0	80	80	1.0000000
NODE_6658_length_998_cov_23.703003	235	315	0	80	80	1.0000000
NODE_6658_length_998_cov_23.703003	288	368	0	80	80	1.0000000
NODE_6659_length_998_cov_22.692992	531	611	0	80	80	1.0000000
NODE_6659_length_998_cov_22.692992	584	664	0	80	80	1.0000000
NODE_6660_length_998_cov_11.152392	514	594	0	80	80	1.0000000
NODE_6660_length_998_cov_11.152392	567	640	0	65	73	0.8904110
NODE_6660_length_998_cov_11.152392	567	640	2	8	73	0.1095890
NODE_6660_length_998_cov_11.152392	636	716	0	2	80	0.0250000
NODE_6660_length_998_cov_11.152392	636	716	2	78	80	0.9750000
NODE_6660_length_998_cov_11.152392	689	769	0	55	80	0.6875000
NODE_6660_length_998_cov_11.152392	689	769	2	25	80	0.3125000
NODE_6661_length_998_cov_10.061179	422	502	0	16	80	0.2000000
NODE_6661_length_998_cov_10.061179	422	502	2	29	80	0.3625000
NODE_6661_length_998_cov_10.061179	422	502	4	27	80	0.3375000
NODE_6661_length_998_cov_10.061179	422	502	8	8	80	0.1000000
NODE_6661_length_998_cov_10.061179	475	555	4	29	80	0.3625000
NODE_6661_length_998_cov_10.061179	475	555	6	13	80	0.1625000
NODE_6661_length_998_cov_10.061179	475	555	8	38	80	0.4750000
NODE_6662_length_998_cov_7.126808	353	430	0	64	77	0.8311688
NODE_6662_length_998_cov_7.126808	353	430	2	13	77	0.1688312
NODE_6662_length_998_cov_7.126808	403	483	0	14	80	0.1750000
NODE_6662_length_998_cov_7.126808	403	483	2	66	80	0.8250000
NODE_6669_length_997_cov_48.518931	445	525	0	5	80	0.0625000
NODE_6669_length_997_cov_48.518931	445	525	2	75	80	0.9375000
NODE_6669_length_997_cov_48.518931	498	578	0	53	80	0.6625000
NODE_6669_length_997_cov_48.518931	498	578	2	27	80	0.3375000
NODE_6670_length_997_cov_36.721604	400	480	0	80	80	1.0000000
NODE_6670_length_997_cov_36.721604	453	533	0	80	80	1.0000000
NODE_6671_length_997_cov_22.646993	328	408	0	80	80	1.0000000
NODE_6671_length_997_cov_22.646993	381	461	0	62	80	0.7750000
NODE_6671_length_997_cov_22.646993	381	461	2	18	80	0.2250000
NODE_6672_length_997_cov_19.709354	420	500	0	78	80	0.9750000
NODE_6672_length_997_cov_19.709354	420	500	2	2	80	0.0250000
NODE_6672_length_997_cov_19.709354	473	553	0	80	80	1.0000000
NODE_6672_length_997_cov_19.709354	549	629	0	80	80	1.0000000
NODE_6672_length_997_cov_19.709354	602	682	0	80	80	1.0000000
NODE_6673_length_997_cov_17.947661	465	545	0	80	80	1.0000000
NODE_6673_length_997_cov_17.947661	518	598	0	80	80	1.0000000
NODE_6673_length_997_cov_17.947661	594	674	0	80	80	1.0000000
NODE_6673_length_997_cov_17.947661	647	727	0	80	80	1.0000000
NODE_6674_length_997_cov_14.718263	388	468	0	80	80	1.0000000
NODE_6674_length_997_cov_14.718263	441	521	0	80	80	1.0000000
NODE_6675_length_997_cov_7.114699	307	387	0	24	80	0.3000000
NODE_6675_length_997_cov_7.114699	307	387	6	56	80	0.7000000
NODE_6675_length_997_cov_7.114699	360	440	0	22	80	0.2750000
NODE_6675_length_997_cov_7.114699	360	440	6	58	80	0.7250000
NODE_6694_length_996_cov_59.568562	387	467	0	80	80	1.0000000
NODE_6694_length_996_cov_59.568562	440	520	0	80	80	1.0000000
NODE_6695_length_996_cov_32.462653	503	583	2	28	80	0.3500000
NODE_6695_length_996_cov_32.462653	503	583	4	7	80	0.0875000
NODE_6695_length_996_cov_32.462653	503	583	6	45	80	0.5625000
NODE_6695_length_996_cov_32.462653	556	636	0	15	80	0.1875000
NODE_6695_length_996_cov_32.462653	556	636	2	17	80	0.2125000
NODE_6695_length_996_cov_32.462653	556	636	4	15	80	0.1875000
NODE_6695_length_996_cov_32.462653	556	636	6	33	80	0.4125000
NODE_6696_length_996_cov_23.312152	571	651	0	6	80	0.0750000
NODE_6696_length_996_cov_23.312152	571	651	6	74	80	0.9250000
NODE_6696_length_996_cov_23.312152	624	704	0	9	80	0.1125000
NODE_6696_length_996_cov_23.312152	624	704	6	71	80	0.8875000
NODE_6697_length_996_cov_20.979933	533	613	0	36	80	0.4500000
NODE_6697_length_996_cov_20.979933	533	613	2	44	80	0.5500000
NODE_6697_length_996_cov_20.979933	586	666	0	18	80	0.2250000
NODE_6697_length_996_cov_20.979933	586	666	2	62	80	0.7750000
NODE_6698_length_996_cov_17.865106	535	615	0	80	80	1.0000000
NODE_6698_length_996_cov_17.865106	588	668	0	80	80	1.0000000
NODE_6699_length_996_cov_10.297659	499	579	0	37	80	0.4625000
NODE_6699_length_996_cov_10.297659	499	579	2	43	80	0.5375000
NODE_6699_length_996_cov_10.297659	552	630	2	78	78	1.0000000
NODE_6702_length_996_cov_3.205128	499	555	0	56	56	1.0000000
NODE_6707_length_995_cov_26.131696	543	623	0	50	80	0.6250000
NODE_6707_length_995_cov_26.131696	543	623	2	30	80	0.3750000
NODE_6707_length_995_cov_26.131696	596	676	0	80	80	1.0000000
NODE_6708_length_995_cov_20.262277	457	537	0	80	80	1.0000000
NODE_6708_length_995_cov_20.262277	510	590	0	80	80	1.0000000
NODE_6709_length_995_cov_19.382812	457	537	0	80	80	1.0000000
NODE_6709_length_995_cov_19.382812	510	590	0	80	80	1.0000000
NODE_6710_length_995_cov_19.034598	453	533	0	80	80	1.0000000
NODE_6710_length_995_cov_19.034598	506	586	0	80	80	1.0000000
NODE_6711_length_995_cov_9.734375	222	323	0	101	101	1.0000000
NODE_6711_length_995_cov_9.734375	296	376	0	80	80	1.0000000
NODE_6723_length_994_cov_74.678212	362	442	0	63	80	0.7875000
NODE_6723_length_994_cov_74.678212	362	442	8	17	80	0.2125000
NODE_6723_length_994_cov_74.678212	415	495	0	10	80	0.1250000
NODE_6723_length_994_cov_74.678212	415	495	8	70	80	0.8750000
NODE_6723_length_994_cov_74.678212	491	571	0	7	80	0.0875000
NODE_6723_length_994_cov_74.678212	491	571	4	11	80	0.1375000
NODE_6723_length_994_cov_74.678212	491	571	6	10	80	0.1250000
NODE_6723_length_994_cov_74.678212	491	571	8	52	80	0.6500000
NODE_6723_length_994_cov_74.678212	544	624	0	7	80	0.0875000
NODE_6723_length_994_cov_74.678212	544	624	4	64	80	0.8000000
NODE_6723_length_994_cov_74.678212	544	624	6	9	80	0.1125000
NODE_6724_length_994_cov_26.045810	442	522	0	52	80	0.6500000
NODE_6724_length_994_cov_26.045810	442	522	2	28	80	0.3500000
NODE_6724_length_994_cov_26.045810	495	575	2	80	80	1.0000000
NODE_6725_length_994_cov_25.240223	504	584	0	56	80	0.7000000
NODE_6725_length_994_cov_25.240223	504	584	2	1	80	0.0125000
NODE_6725_length_994_cov_25.240223	504	584	4	23	80	0.2875000
NODE_6725_length_994_cov_25.240223	557	637	0	80	80	1.0000000
NODE_6726_length_994_cov_24.615642	422	502	0	80	80	1.0000000
NODE_6726_length_994_cov_24.615642	475	555	0	35	80	0.4375000
NODE_6726_length_994_cov_24.615642	475	555	2	45	80	0.5625000
NODE_6726_length_994_cov_24.615642	551	631	0	57	80	0.7125000
NODE_6726_length_994_cov_24.615642	551	631	2	23	80	0.2875000
NODE_6726_length_994_cov_24.615642	604	684	0	65	80	0.8125000
NODE_6726_length_994_cov_24.615642	604	684	2	15	80	0.1875000
NODE_6727_length_994_cov_22.593296	323	403	0	80	80	1.0000000
NODE_6727_length_994_cov_22.593296	376	456	0	80	80	1.0000000
NODE_6727_length_994_cov_22.593296	452	532	0	80	80	1.0000000
NODE_6727_length_994_cov_22.593296	505	585	0	80	80	1.0000000
NODE_6728_length_994_cov_6.985475	0	58	0	58	58	1.0000000
NODE_6728_length_994_cov_6.985475	15	95	0	80	80	1.0000000
NODE_6728_length_994_cov_6.985475	68	148	0	80	80	1.0000000
NODE_6740_length_993_cov_56.321029	266	346	0	80	80	1.0000000
NODE_6740_length_993_cov_56.321029	319	399	0	80	80	1.0000000
NODE_6740_length_993_cov_56.321029	400	470	0	70	70	1.0000000
NODE_6740_length_993_cov_56.321029	443	523	0	80	80	1.0000000
NODE_6741_length_993_cov_44.695749	385	465	4	45	80	0.5625000
NODE_6741_length_993_cov_44.695749	385	465	6	35	80	0.4375000
NODE_6741_length_993_cov_44.695749	438	518	0	29	80	0.3625000
NODE_6741_length_993_cov_44.695749	438	518	2	14	80	0.1750000
NODE_6741_length_993_cov_44.695749	438	518	4	29	80	0.3625000
NODE_6741_length_993_cov_44.695749	438	518	6	8	80	0.1000000
NODE_6742_length_993_cov_40.574944	417	497	0	47	80	0.5875000
NODE_6742_length_993_cov_40.574944	417	497	2	33	80	0.4125000
NODE_6742_length_993_cov_40.574944	470	550	2	80	80	1.0000000
NODE_6742_length_993_cov_40.574944	546	628	0	75	82	0.9146342
NODE_6742_length_993_cov_40.574944	546	628	2	7	82	0.0853659
NODE_6742_length_993_cov_40.574944	601	681	0	27	80	0.3375000
NODE_6742_length_993_cov_40.574944	601	681	2	53	80	0.6625000
NODE_6743_length_993_cov_39.817673	3	83	0	9	80	0.1125000
NODE_6743_length_993_cov_39.817673	3	83	6	71	80	0.8875000
NODE_6744_length_993_cov_30.128635	477	557	0	80	80	1.0000000
NODE_6744_length_993_cov_30.128635	530	610	0	80	80	1.0000000
NODE_6745_length_993_cov_17.435123	573	653	0	48	80	0.6000000
NODE_6745_length_993_cov_17.435123	573	653	2	32	80	0.4000000
NODE_6745_length_993_cov_17.435123	626	706	0	7	80	0.0875000
NODE_6745_length_993_cov_17.435123	626	706	2	73	80	0.9125000
NODE_6746_length_993_cov_13.074944	483	563	0	7	80	0.0875000
NODE_6746_length_993_cov_13.074944	483	563	4	1	80	0.0125000
NODE_6746_length_993_cov_13.074944	483	563	5	8	80	0.1000000
NODE_6746_length_993_cov_13.074944	483	563	6	64	80	0.8000000
NODE_6746_length_993_cov_13.074944	536	616	0	25	80	0.3125000
NODE_6746_length_993_cov_13.074944	536	616	6	55	80	0.6875000
NODE_6747_length_993_cov_10.190157	500	580	0	80	80	1.0000000
NODE_6747_length_993_cov_10.190157	553	633	0	80	80	1.0000000
NODE_6756_length_993_cov_0.909396	16	73	0	57	57	1.0000000
NODE_6757_length_992_cov_36.119821	354	434	0	80	80	1.0000000
NODE_6757_length_992_cov_36.119821	407	487	0	80	80	1.0000000
NODE_6757_length_992_cov_36.119821	483	563	0	80	80	1.0000000
NODE_6757_length_992_cov_36.119821	536	616	0	80	80	1.0000000
NODE_6758_length_992_cov_34.802912	443	523	0	80	80	1.0000000
NODE_6758_length_992_cov_34.802912	496	576	0	80	80	1.0000000
NODE_6759_length_992_cov_33.047032	381	461	22	40	80	0.5000000
NODE_6759_length_992_cov_33.047032	381	461	25	36	80	0.4500000
NODE_6759_length_992_cov_33.047032	381	461	27	4	80	0.0500000
NODE_6759_length_992_cov_33.047032	434	514	4	4	80	0.0500000
NODE_6759_length_992_cov_33.047032	434	514	8	11	80	0.1375000
NODE_6759_length_992_cov_33.047032	434	514	25	23	80	0.2875000
NODE_6759_length_992_cov_33.047032	434	514	27	7	80	0.0875000
NODE_6759_length_992_cov_33.047032	434	514	28	1	80	0.0125000
NODE_6759_length_992_cov_33.047032	434	514	29	7	80	0.0875000
NODE_6759_length_992_cov_33.047032	434	514	30	27	80	0.3375000
NODE_6759_length_992_cov_33.047032	510	590	0	19	80	0.2375000
NODE_6759_length_992_cov_33.047032	510	590	3	1	80	0.0125000
NODE_6759_length_992_cov_33.047032	510	590	4	60	80	0.7500000
NODE_6759_length_992_cov_33.047032	563	643	0	72	80	0.9000000
NODE_6759_length_992_cov_33.047032	563	643	3	1	80	0.0125000
NODE_6759_length_992_cov_33.047032	563	643	4	7	80	0.0875000
NODE_6760_length_992_cov_23.543113	435	515	8	59	80	0.7375000
NODE_6760_length_992_cov_23.543113	435	515	10	21	80	0.2625000
NODE_6760_length_992_cov_23.543113	488	568	0	6	80	0.0750000
NODE_6760_length_992_cov_23.543113	488	568	8	53	80	0.6625000
NODE_6760_length_992_cov_23.543113	488	568	10	21	80	0.2625000
NODE_6761_length_992_cov_22.608063	440	520	0	80	80	1.0000000
NODE_6761_length_992_cov_22.608063	493	573	0	80	80	1.0000000
NODE_6762_length_992_cov_21.427772	216	296	0	64	80	0.8000000
NODE_6762_length_992_cov_21.427772	216	296	4	10	80	0.1250000
NODE_6762_length_992_cov_21.427772	216	296	6	6	80	0.0750000
NODE_6762_length_992_cov_21.427772	269	349	0	11	80	0.1375000
NODE_6762_length_992_cov_21.427772	269	349	2	3	80	0.0375000
NODE_6762_length_992_cov_21.427772	269	349	4	10	80	0.1250000
NODE_6762_length_992_cov_21.427772	269	349	6	56	80	0.7000000
NODE_6763_length_992_cov_20.010078	312	392	0	32	80	0.4000000
NODE_6763_length_992_cov_20.010078	312	392	2	48	80	0.6000000
NODE_6763_length_992_cov_20.010078	365	445	0	80	80	1.0000000
NODE_6764_length_992_cov_16.524076	465	545	0	80	80	1.0000000
NODE_6764_length_992_cov_16.524076	518	598	0	80	80	1.0000000
NODE_6765_length_992_cov_16.266517	396	476	0	66	80	0.8250000
NODE_6765_length_992_cov_16.266517	396	476	2	14	80	0.1750000
NODE_6765_length_992_cov_16.266517	449	529	0	13	80	0.1625000
NODE_6765_length_992_cov_16.266517	449	529	2	67	80	0.8375000
NODE_6766_length_992_cov_16.146697	272	352	0	80	80	1.0000000
NODE_6766_length_992_cov_16.146697	325	405	0	80	80	1.0000000
NODE_6767_length_992_cov_15.212766	354	434	0	80	80	1.0000000
NODE_6767_length_992_cov_15.212766	407	487	0	80	80	1.0000000
NODE_6767_length_992_cov_15.212766	483	563	0	80	80	1.0000000
NODE_6767_length_992_cov_15.212766	536	616	0	80	80	1.0000000
NODE_6781_length_991_cov_48.582960	451	531	0	80	80	1.0000000
NODE_6781_length_991_cov_48.582960	504	584	0	69	80	0.8625000
NODE_6781_length_991_cov_48.582960	504	584	6	11	80	0.1375000
NODE_6782_length_991_cov_25.891256	340	420	0	80	80	1.0000000
NODE_6782_length_991_cov_25.891256	393	473	0	80	80	1.0000000
NODE_6782_length_991_cov_25.891256	469	549	0	80	80	1.0000000
NODE_6782_length_991_cov_25.891256	522	602	0	80	80	1.0000000
NODE_6783_length_991_cov_25.392377	377	457	0	66	80	0.8250000
NODE_6783_length_991_cov_25.392377	377	457	4	14	80	0.1750000
NODE_6783_length_991_cov_25.392377	430	510	0	80	80	1.0000000
NODE_6783_length_991_cov_25.392377	506	586	0	42	80	0.5250000
NODE_6783_length_991_cov_25.392377	506	586	2	7	80	0.0875000
NODE_6783_length_991_cov_25.392377	506	586	5	31	80	0.3875000
NODE_6783_length_991_cov_25.392377	559	639	5	41	80	0.5125000
NODE_6783_length_991_cov_25.392377	559	639	6	26	80	0.3250000
NODE_6783_length_991_cov_25.392377	559	639	7	13	80	0.1625000
NODE_6784_length_991_cov_22.210762	421	501	0	45	80	0.5625000
NODE_6784_length_991_cov_22.210762	421	501	4	35	80	0.4375000
NODE_6784_length_991_cov_22.210762	474	554	4	80	80	1.0000000
NODE_6785_length_991_cov_18.008969	366	446	0	80	80	1.0000000
NODE_6785_length_991_cov_18.008969	419	499	0	80	80	1.0000000
NODE_6785_length_991_cov_18.008969	495	575	0	80	80	1.0000000
NODE_6785_length_991_cov_18.008969	548	629	0	81	81	1.0000000
NODE_6786_length_991_cov_14.727578	426	506	0	80	80	1.0000000
NODE_6786_length_991_cov_14.727578	479	559	0	80	80	1.0000000
NODE_6787_length_991_cov_13.081839	240	320	0	5	80	0.0625000
NODE_6787_length_991_cov_13.081839	240	320	1	35	80	0.4375000
NODE_6787_length_991_cov_13.081839	240	320	2	40	80	0.5000000
NODE_6787_length_991_cov_13.081839	293	373	2	80	80	1.0000000
NODE_6788_length_991_cov_12.693946	425	505	0	44	80	0.5500000
NODE_6788_length_991_cov_12.693946	425	505	6	36	80	0.4500000
NODE_6788_length_991_cov_12.693946	478	558	6	80	80	1.0000000
NODE_6789_length_991_cov_9.647982	436	516	0	80	80	1.0000000
NODE_6789_length_991_cov_9.647982	489	569	0	80	80	1.0000000
NODE_6790_length_991_cov_5.176009	538	618	0	80	80	1.0000000
NODE_6790_length_991_cov_5.176009	591	671	0	80	80	1.0000000
NODE_6801_length_990_cov_39.386083	402	482	0	26	80	0.3250000
NODE_6801_length_990_cov_39.386083	402	482	3	54	80	0.6750000
NODE_6801_length_990_cov_39.386083	455	535	0	17	80	0.2125000
NODE_6801_length_990_cov_39.386083	455	535	3	63	80	0.7875000
NODE_6802_length_990_cov_35.993266	321	401	0	66	80	0.8250000
NODE_6802_length_990_cov_35.993266	321	401	2	14	80	0.1750000
NODE_6802_length_990_cov_35.993266	374	454	0	13	80	0.1625000
NODE_6802_length_990_cov_35.993266	374	454	2	18	80	0.2250000
NODE_6802_length_990_cov_35.993266	374	454	4	49	80	0.6125000
NODE_6802_length_990_cov_35.993266	450	530	0	30	80	0.3750000
NODE_6802_length_990_cov_35.993266	450	530	2	5	80	0.0625000
NODE_6802_length_990_cov_35.993266	450	530	4	45	80	0.5625000
NODE_6802_length_990_cov_35.993266	503	583	0	6	80	0.0750000
NODE_6802_length_990_cov_35.993266	503	583	4	40	80	0.5000000
NODE_6802_length_990_cov_35.993266	503	583	6	34	80	0.4250000
NODE_6803_length_990_cov_24.445567	588	668	4	23	80	0.2875000
NODE_6803_length_990_cov_24.445567	588	668	6	3	80	0.0375000
NODE_6803_length_990_cov_24.445567	588	668	9	23	80	0.2875000
NODE_6803_length_990_cov_24.445567	588	668	10	31	80	0.3875000
NODE_6803_length_990_cov_24.445567	641	721	0	36	80	0.4500000
NODE_6803_length_990_cov_24.445567	641	721	3	1	80	0.0125000
NODE_6803_length_990_cov_24.445567	641	721	4	7	80	0.0875000
NODE_6803_length_990_cov_24.445567	641	721	6	9	80	0.1125000
NODE_6803_length_990_cov_24.445567	641	721	10	27	80	0.3375000
NODE_6805_length_990_cov_22.378227	430	510	0	80	80	1.0000000
NODE_6805_length_990_cov_22.378227	483	563	0	80	80	1.0000000
NODE_6806_length_990_cov_20.150393	408	488	0	27	80	0.3375000
NODE_6806_length_990_cov_20.150393	408	488	2	53	80	0.6625000
NODE_6806_length_990_cov_20.150393	461	541	0	80	80	1.0000000
NODE_6807_length_990_cov_18.154882	434	514	0	80	80	1.0000000
NODE_6807_length_990_cov_18.154882	487	567	0	80	80	1.0000000
NODE_6808_length_990_cov_17.250281	329	409	0	80	80	1.0000000
NODE_6808_length_990_cov_17.250281	382	462	0	80	80	1.0000000
NODE_6808_length_990_cov_17.250281	458	538	0	32	80	0.4000000
NODE_6808_length_990_cov_17.250281	458	538	4	48	80	0.6000000
NODE_6808_length_990_cov_17.250281	511	591	4	80	80	1.0000000
NODE_6809_length_990_cov_14.977553	448	528	0	80	80	1.0000000
NODE_6809_length_990_cov_14.977553	501	581	0	47	80	0.5875000
NODE_6809_length_990_cov_14.977553	501	581	2	33	80	0.4125000
NODE_6810_length_990_cov_13.846240	482	562	6	22	80	0.2750000
NODE_6810_length_990_cov_13.846240	482	562	10	58	80	0.7250000
NODE_6810_length_990_cov_13.846240	535	615	0	45	80	0.5625000
NODE_6810_length_990_cov_13.846240	535	615	6	30	80	0.3750000
NODE_6810_length_990_cov_13.846240	535	615	10	5	80	0.0625000
NODE_6821_length_990_cov_0.978676	79	151	2	6	72	0.0833333
NODE_6821_length_990_cov_0.978676	79	151	6	11	72	0.1527778
NODE_6821_length_990_cov_0.978676	79	151	8	55	72	0.7638889
NODE_6821_length_990_cov_0.978676	82	152	2	7	70	0.1000000
NODE_6821_length_990_cov_0.978676	82	152	6	11	70	0.1571429
NODE_6821_length_990_cov_0.978676	82	152	8	52	70	0.7428572
NODE_6823_length_989_cov_45.902247	47	127	2	1	80	0.0125000
NODE_6823_length_989_cov_45.902247	47	127	10	2	80	0.0250000
NODE_6823_length_989_cov_45.902247	47	127	20	2	80	0.0250000
NODE_6823_length_989_cov_45.902247	47	127	24	3	80	0.0375000
NODE_6823_length_989_cov_45.902247	47	127	26	4	80	0.0500000
NODE_6823_length_989_cov_45.902247	47	127	28	2	80	0.0250000
NODE_6823_length_989_cov_45.902247	47	127	32	9	80	0.1125000
NODE_6823_length_989_cov_45.902247	47	127	38	57	80	0.7125000
NODE_6823_length_989_cov_45.902247	330	410	0	80	80	1.0000000
NODE_6823_length_989_cov_45.902247	383	463	0	80	80	1.0000000
NODE_6824_length_989_cov_35.430337	412	492	2	6	80	0.0750000
NODE_6824_length_989_cov_35.430337	412	492	4	4	80	0.0500000
NODE_6824_length_989_cov_35.430337	412	492	8	43	80	0.5375000
NODE_6824_length_989_cov_35.430337	412	492	10	11	80	0.1375000
NODE_6824_length_989_cov_35.430337	412	492	12	16	80	0.2000000
NODE_6824_length_989_cov_35.430337	465	545	4	36	80	0.4500000
NODE_6824_length_989_cov_35.430337	465	545	8	18	80	0.2250000
NODE_6824_length_989_cov_35.430337	465	545	10	10	80	0.1250000
NODE_6824_length_989_cov_35.430337	465	545	12	16	80	0.2000000
NODE_6825_length_989_cov_30.124719	477	557	0	80	80	1.0000000
NODE_6825_length_989_cov_30.124719	530	610	0	80	80	1.0000000
NODE_6826_length_989_cov_29.347191	447	527	2	39	80	0.4875000
NODE_6826_length_989_cov_29.347191	447	527	4	41	80	0.5125000
NODE_6826_length_989_cov_29.347191	500	580	0	52	80	0.6500000
NODE_6826_length_989_cov_29.347191	500	580	2	28	80	0.3500000
NODE_6826_length_989_cov_29.347191	576	656	0	15	80	0.1875000
NODE_6826_length_989_cov_29.347191	576	656	4	22	80	0.2750000
NODE_6826_length_989_cov_29.347191	576	656	6	43	80	0.5375000
NODE_6826_length_989_cov_29.347191	629	709	0	35	80	0.4375000
NODE_6826_length_989_cov_29.347191	629	709	6	45	80	0.5625000
NODE_6827_length_989_cov_27.886517	245	325	0	75	80	0.9375000
NODE_6827_length_989_cov_27.886517	245	325	4	5	80	0.0625000
NODE_6827_length_989_cov_27.886517	298	378	0	80	80	1.0000000
NODE_6827_length_989_cov_27.886517	374	454	0	55	80	0.6875000
NODE_6827_length_989_cov_27.886517	374	454	4	2	80	0.0250000
NODE_6827_length_989_cov_27.886517	374	454	8	23	80	0.2875000
NODE_6827_length_989_cov_27.886517	427	507	0	2	80	0.0250000
NODE_6827_length_989_cov_27.886517	427	507	4	2	80	0.0250000
NODE_6827_length_989_cov_27.886517	427	507	8	76	80	0.9500000
NODE_6828_length_989_cov_27.515730	393	473	6	11	80	0.1375000
NODE_6828_length_989_cov_27.515730	393	473	10	69	80	0.8625000
NODE_6828_length_989_cov_27.515730	446	526	0	7	80	0.0875000
NODE_6828_length_989_cov_27.515730	446	526	3	18	80	0.2250000
NODE_6828_length_989_cov_27.515730	446	526	7	2	80	0.0250000
NODE_6828_length_989_cov_27.515730	446	526	9	2	80	0.0250000
NODE_6828_length_989_cov_27.515730	446	526	10	51	80	0.6375000
NODE_6828_length_989_cov_27.515730	522	602	0	13	80	0.1625000
NODE_6828_length_989_cov_27.515730	522	602	8	67	80	0.8375000
NODE_6828_length_989_cov_27.515730	575	655	0	17	80	0.2125000
NODE_6828_length_989_cov_27.515730	575	655	8	63	80	0.7875000
NODE_6829_length_989_cov_23.844944	312	392	0	18	80	0.2250000
NODE_6829_length_989_cov_23.844944	312	392	2	62	80	0.7750000
NODE_6829_length_989_cov_23.844944	365	445	2	65	80	0.8125000
NODE_6829_length_989_cov_23.844944	365	445	4	10	80	0.1250000
NODE_6829_length_989_cov_23.844944	365	445	6	5	80	0.0625000
NODE_6830_length_989_cov_23.131461	475	555	0	80	80	1.0000000
NODE_6830_length_989_cov_23.131461	528	608	0	80	80	1.0000000
NODE_6831_length_989_cov_20.189888	500	580	2	26	80	0.3250000
NODE_6831_length_989_cov_20.189888	500	580	4	54	80	0.6750000
NODE_6831_length_989_cov_20.189888	553	633	0	16	80	0.2000000
NODE_6831_length_989_cov_20.189888	553	633	2	42	80	0.5250000
NODE_6831_length_989_cov_20.189888	553	633	4	22	80	0.2750000
NODE_6832_length_989_cov_18.429213	190	270	0	73	80	0.9125000
NODE_6832_length_989_cov_18.429213	190	270	2	7	80	0.0875000
NODE_6832_length_989_cov_18.429213	258	323	0	18	65	0.2769231
NODE_6832_length_989_cov_18.429213	258	323	2	31	65	0.4769231
NODE_6832_length_989_cov_18.429213	258	323	4	9	65	0.1384615
NODE_6832_length_989_cov_18.429213	258	323	6	2	65	0.0307692
NODE_6832_length_989_cov_18.429213	258	323	10	5	65	0.0769231
NODE_6832_length_989_cov_18.429213	319	399	10	5	80	0.0625000
NODE_6832_length_989_cov_18.429213	319	399	12	7	80	0.0875000
NODE_6832_length_989_cov_18.429213	319	399	14	2	80	0.0250000
NODE_6832_length_989_cov_18.429213	319	399	16	17	80	0.2125000
NODE_6832_length_989_cov_18.429213	319	399	18	6	80	0.0750000
NODE_6832_length_989_cov_18.429213	319	399	21	12	80	0.1500000
NODE_6832_length_989_cov_18.429213	319	399	23	6	80	0.0750000
NODE_6832_length_989_cov_18.429213	319	399	26	2	80	0.0250000
NODE_6832_length_989_cov_18.429213	319	399	28	2	80	0.0250000
NODE_6832_length_989_cov_18.429213	319	399	30	6	80	0.0750000
NODE_6832_length_989_cov_18.429213	319	399	32	15	80	0.1875000
NODE_6832_length_989_cov_18.429213	372	412	23	2	40	0.0500000
NODE_6832_length_989_cov_18.429213	372	412	26	7	40	0.1750000
NODE_6832_length_989_cov_18.429213	372	412	28	6	40	0.1500000
NODE_6832_length_989_cov_18.429213	372	412	30	10	40	0.2500000
NODE_6832_length_989_cov_18.429213	372	412	32	15	40	0.3750000
NODE_6833_length_989_cov_10.307865	433	513	0	61	80	0.7625000
NODE_6833_length_989_cov_10.307865	433	513	4	19	80	0.2375000
NODE_6833_length_989_cov_10.307865	486	570	0	8	84	0.0952381
NODE_6833_length_989_cov_10.307865	486	570	4	76	84	0.9047619
NODE_6833_length_989_cov_10.307865	566	642	0	28	76	0.3684210
NODE_6833_length_989_cov_10.307865	566	642	1	16	76	0.2105263
NODE_6833_length_989_cov_10.307865	566	642	3	19	76	0.2500000
NODE_6833_length_989_cov_10.307865	566	642	4	4	76	0.0526316
NODE_6833_length_989_cov_10.307865	566	642	5	9	76	0.1184211
NODE_6833_length_989_cov_10.307865	615	695	3	18	80	0.2250000
NODE_6833_length_989_cov_10.307865	615	695	5	9	80	0.1125000
NODE_6833_length_989_cov_10.307865	615	695	6	15	80	0.1875000
NODE_6833_length_989_cov_10.307865	615	695	8	38	80	0.4750000
NODE_6834_length_989_cov_8.941573	528	608	0	80	80	1.0000000
NODE_6834_length_989_cov_8.941573	581	661	0	80	80	1.0000000
NODE_6835_length_989_cov_5.132584	459	524	0	65	65	1.0000000
NODE_6838_length_989_cov_2.540449	703	783	0	80	80	1.0000000
NODE_6845_length_988_cov_52.168729	361	441	0	80	80	1.0000000
NODE_6845_length_988_cov_52.168729	414	494	0	80	80	1.0000000
NODE_6845_length_988_cov_52.168729	490	570	0	20	80	0.2500000
NODE_6845_length_988_cov_52.168729	490	570	2	49	80	0.6125000
NODE_6845_length_988_cov_52.168729	490	570	3	11	80	0.1375000
NODE_6845_length_988_cov_52.168729	543	623	1	26	80	0.3250000
NODE_6845_length_988_cov_52.168729	543	623	2	16	80	0.2000000
NODE_6845_length_988_cov_52.168729	543	623	3	38	80	0.4750000
NODE_6846_length_988_cov_36.733408	390	470	0	72	80	0.9000000
NODE_6846_length_988_cov_36.733408	390	470	1	8	80	0.1000000
NODE_6846_length_988_cov_36.733408	443	523	0	80	80	1.0000000
NODE_6847_length_988_cov_36.221597	478	558	0	80	80	1.0000000
NODE_6847_length_988_cov_36.221597	531	611	0	80	80	1.0000000
NODE_6848_length_988_cov_25.895388	389	469	0	34	80	0.4250000
NODE_6848_length_988_cov_25.895388	389	469	8	20	80	0.2500000
NODE_6848_length_988_cov_25.895388	389	469	9	26	80	0.3250000
NODE_6848_length_988_cov_25.895388	442	522	1	12	80	0.1500000
NODE_6848_length_988_cov_25.895388	442	522	8	1	80	0.0125000
NODE_6848_length_988_cov_25.895388	442	522	9	67	80	0.8375000
NODE_6848_length_988_cov_25.895388	518	598	1	49	80	0.6125000
NODE_6848_length_988_cov_25.895388	518	598	2	31	80	0.3875000
NODE_6848_length_988_cov_25.895388	571	651	1	58	80	0.7250000
NODE_6848_length_988_cov_25.895388	571	651	2	22	80	0.2750000
NODE_6849_length_988_cov_20.250844	423	503	4	3	80	0.0375000
NODE_6849_length_988_cov_20.250844	423	503	8	77	80	0.9625000
NODE_6849_length_988_cov_20.250844	476	556	4	40	80	0.5000000
NODE_6849_length_988_cov_20.250844	476	556	8	40	80	0.5000000
NODE_6850_length_988_cov_15.812148	474	554	13	58	80	0.7250000
NODE_6850_length_988_cov_15.812148	474	554	14	22	80	0.2750000
NODE_6850_length_988_cov_15.812148	527	607	0	14	80	0.1750000
NODE_6850_length_988_cov_15.812148	527	607	7	33	80	0.4125000
NODE_6850_length_988_cov_15.812148	527	607	13	5	80	0.0625000
NODE_6850_length_988_cov_15.812148	527	607	14	28	80	0.3500000
NODE_6851_length_988_cov_15.082115	435	517	0	82	82	1.0000000
NODE_6851_length_988_cov_15.082115	490	570	0	80	80	1.0000000
NODE_6852_length_988_cov_14.697413	467	547	0	80	80	1.0000000
NODE_6852_length_988_cov_14.697413	520	600	0	80	80	1.0000000
NODE_6853_length_988_cov_7.730034	562	642	0	80	80	1.0000000
NODE_6853_length_988_cov_7.730034	615	695	0	80	80	1.0000000
NODE_6862_length_987_cov_42.784910	383	476	0	21	93	0.2258064
NODE_6862_length_987_cov_42.784910	383	476	2	72	93	0.7741935
NODE_6862_length_987_cov_42.784910	449	529	0	10	80	0.1250000
NODE_6862_length_987_cov_42.784910	449	529	2	70	80	0.8750000
NODE_6863_length_987_cov_39.716216	290	370	0	80	80	1.0000000
NODE_6863_length_987_cov_39.716216	343	423	0	80	80	1.0000000
NODE_6863_length_987_cov_39.716216	419	499	0	80	80	1.0000000
NODE_6863_length_987_cov_39.716216	472	552	0	33	80	0.4125000
NODE_6863_length_987_cov_39.716216	472	552	2	47	80	0.5875000
NODE_6864_length_987_cov_28.171171	406	486	0	80	80	1.0000000
NODE_6864_length_987_cov_28.171171	459	539	0	80	80	1.0000000
NODE_6864_length_987_cov_28.171171	535	615	0	71	80	0.8875000
NODE_6864_length_987_cov_28.171171	535	615	2	9	80	0.1125000
NODE_6864_length_987_cov_28.171171	588	668	0	18	80	0.2250000
NODE_6864_length_987_cov_28.171171	588	668	2	62	80	0.7750000
NODE_6865_length_987_cov_23.627252	331	411	0	80	80	1.0000000
NODE_6865_length_987_cov_23.627252	384	464	0	80	80	1.0000000
NODE_6866_length_987_cov_18.797297	437	517	0	18	80	0.2250000
NODE_6866_length_987_cov_18.797297	437	517	2	62	80	0.7750000
NODE_6866_length_987_cov_18.797297	490	570	0	71	80	0.8875000
NODE_6866_length_987_cov_18.797297	490	570	2	9	80	0.1125000
NODE_6867_length_987_cov_15.628378	369	449	0	55	80	0.6875000
NODE_6867_length_987_cov_15.628378	369	449	2	25	80	0.3125000
NODE_6867_length_987_cov_15.628378	422	502	0	2	80	0.0250000
NODE_6867_length_987_cov_15.628378	422	502	2	78	80	0.9750000
NODE_6868_length_987_cov_15.439189	438	518	0	80	80	1.0000000
NODE_6868_length_987_cov_15.439189	491	571	0	80	80	1.0000000
NODE_6869_length_987_cov_14.343468	506	586	0	45	80	0.5625000
NODE_6869_length_987_cov_14.343468	506	586	4	22	80	0.2750000
NODE_6869_length_987_cov_14.343468	506	586	5	13	80	0.1625000
NODE_6869_length_987_cov_14.343468	559	639	0	39	80	0.4875000
NODE_6869_length_987_cov_14.343468	559	639	2	41	80	0.5125000
NODE_6870_length_987_cov_13.515766	475	555	2	57	80	0.7125000
NODE_6870_length_987_cov_13.515766	475	555	3	1	80	0.0125000
NODE_6870_length_987_cov_13.515766	475	555	4	22	80	0.2750000
NODE_6870_length_987_cov_13.515766	528	608	2	46	80	0.5750000
NODE_6870_length_987_cov_13.515766	528	608	3	1	80	0.0125000
NODE_6870_length_987_cov_13.515766	528	608	4	33	80	0.4125000
NODE_6871_length_987_cov_9.521396	408	482	0	74	74	1.0000000
NODE_6871_length_987_cov_9.521396	455	535	0	80	80	1.0000000
NODE_6872_length_987_cov_9.054054	440	520	0	6	80	0.0750000
NODE_6872_length_987_cov_9.054054	440	520	4	74	80	0.9250000
NODE_6872_length_987_cov_9.054054	493	573	0	31	80	0.3875000
NODE_6872_length_987_cov_9.054054	493	573	2	24	80	0.3000000
NODE_6872_length_987_cov_9.054054	493	573	4	25	80	0.3125000
NODE_6875_length_987_cov_5.378378	509	589	0	80	80	1.0000000
NODE_6875_length_987_cov_5.378378	562	642	0	80	80	1.0000000
NODE_6889_length_986_cov_36.937993	327	407	0	45	80	0.5625000
NODE_6889_length_986_cov_36.937993	327	407	4	27	80	0.3375000
NODE_6889_length_986_cov_36.937993	327	407	6	8	80	0.1000000
NODE_6889_length_986_cov_36.937993	380	460	2	2	80	0.0250000
NODE_6889_length_986_cov_36.937993	380	460	4	19	80	0.2375000
NODE_6889_length_986_cov_36.937993	380	460	6	59	80	0.7375000
NODE_6889_length_986_cov_36.937993	456	536	0	57	80	0.7125000
NODE_6889_length_986_cov_36.937993	456	536	2	21	80	0.2625000
NODE_6889_length_986_cov_36.937993	456	536	6	2	80	0.0250000
NODE_6889_length_986_cov_36.937993	509	589	0	80	80	1.0000000
NODE_6890_length_986_cov_35.130778	325	405	0	2	80	0.0250000
NODE_6890_length_986_cov_35.130778	325	405	2	6	80	0.0750000
NODE_6890_length_986_cov_35.130778	325	405	4	72	80	0.9000000
NODE_6890_length_986_cov_35.130778	378	458	0	24	80	0.3000000
NODE_6890_length_986_cov_35.130778	378	458	2	9	80	0.1125000
NODE_6890_length_986_cov_35.130778	378	458	4	47	80	0.5875000
NODE_6890_length_986_cov_35.130778	454	534	0	80	80	1.0000000
NODE_6890_length_986_cov_35.130778	507	587	0	80	80	1.0000000
NODE_6891_length_986_cov_24.037204	602	682	0	80	80	1.0000000
NODE_6891_length_986_cov_24.037204	655	735	0	46	80	0.5750000
NODE_6891_length_986_cov_24.037204	655	735	4	16	80	0.2000000
NODE_6891_length_986_cov_24.037204	655	735	20	1	80	0.0125000
NODE_6891_length_986_cov_24.037204	655	735	22	17	80	0.2125000
NODE_6891_length_986_cov_24.037204	731	811	20	22	80	0.2750000
NODE_6891_length_986_cov_24.037204	731	811	22	58	80	0.7250000
NODE_6891_length_986_cov_24.037204	784	864	2	22	80	0.2750000
NODE_6891_length_986_cov_24.037204	784	864	4	1	80	0.0125000
NODE_6891_length_986_cov_24.037204	784	864	16	16	80	0.2000000
NODE_6891_length_986_cov_24.037204	784	864	17	6	80	0.0750000
NODE_6891_length_986_cov_24.037204	784	864	20	30	80	0.3750000
NODE_6891_length_986_cov_24.037204	784	864	22	5	80	0.0625000
NODE_6892_length_986_cov_20.591883	395	475	2	32	80	0.4000000
NODE_6892_length_986_cov_20.591883	395	475	4	16	80	0.2000000
NODE_6892_length_986_cov_20.591883	395	475	6	32	80	0.4000000
NODE_6892_length_986_cov_20.591883	448	528	0	5	80	0.0625000
NODE_6892_length_986_cov_20.591883	448	528	2	6	80	0.0750000
NODE_6892_length_986_cov_20.591883	448	528	4	56	80	0.7000000
NODE_6892_length_986_cov_20.591883	448	528	6	13	80	0.1625000
NODE_6893_length_986_cov_16.815107	389	469	0	80	80	1.0000000
NODE_6893_length_986_cov_16.815107	442	522	0	80	80	1.0000000
NODE_6894_length_986_cov_11.021421	474	554	0	80	80	1.0000000
NODE_6894_length_986_cov_11.021421	527	607	0	68	80	0.8500000
NODE_6894_length_986_cov_11.021421	527	607	2	12	80	0.1500000
NODE_6905_length_985_cov_41.707675	443	523	0	80	80	1.0000000
NODE_6905_length_985_cov_41.707675	496	576	0	80	80	1.0000000
NODE_6911_length_984_cov_64.531073	412	481	4	69	69	1.0000000
NODE_6911_length_984_cov_64.531073	454	534	0	43	80	0.5375000
NODE_6911_length_984_cov_64.531073	454	534	4	37	80	0.4625000
NODE_6911_length_984_cov_64.531073	475	555	0	64	80	0.8000000
NODE_6911_length_984_cov_64.531073	475	555	4	16	80	0.2000000
NODE_6911_length_984_cov_64.531073	528	608	0	80	80	1.0000000
NODE_6911_length_984_cov_64.531073	549	629	0	80	80	1.0000000
NODE_6912_length_984_cov_28.832768	430	510	0	4	80	0.0500000
NODE_6912_length_984_cov_28.832768	430	510	8	76	80	0.9500000
NODE_6912_length_984_cov_28.832768	483	563	8	80	80	1.0000000
NODE_6913_length_984_cov_27.247458	203	283	0	44	80	0.5500000
NODE_6913_length_984_cov_27.247458	203	283	2	36	80	0.4500000
NODE_6913_length_984_cov_27.247458	256	336	0	35	80	0.4375000
NODE_6913_length_984_cov_27.247458	256	336	1	8	80	0.1000000
NODE_6913_length_984_cov_27.247458	256	336	3	6	80	0.0750000
NODE_6913_length_984_cov_27.247458	256	336	4	31	80	0.3875000
NODE_6913_length_984_cov_27.247458	332	412	2	31	80	0.3875000
NODE_6913_length_984_cov_27.247458	332	412	4	49	80	0.6125000
NODE_6913_length_984_cov_27.247458	385	465	0	10	80	0.1250000
NODE_6913_length_984_cov_27.247458	385	465	1	14	80	0.1750000
NODE_6913_length_984_cov_27.247458	385	465	2	56	80	0.7000000
NODE_6914_length_984_cov_25.944633	483	563	0	10	80	0.1250000
NODE_6914_length_984_cov_25.944633	483	563	3	18	80	0.2250000
NODE_6914_length_984_cov_25.944633	483	563	4	52	80	0.6500000
NODE_6914_length_984_cov_25.944633	536	616	0	63	80	0.7875000
NODE_6914_length_984_cov_25.944633	536	616	4	17	80	0.2125000
NODE_6915_length_984_cov_16.611299	351	431	2	44	80	0.5500000
NODE_6915_length_984_cov_16.611299	351	431	4	36	80	0.4500000
NODE_6915_length_984_cov_16.611299	404	484	0	40	80	0.5000000
NODE_6915_length_984_cov_16.611299	404	484	2	39	80	0.4875000
NODE_6915_length_984_cov_16.611299	404	484	4	1	80	0.0125000
NODE_6917_length_984_cov_6.414689	415	495	2	76	80	0.9500000
NODE_6917_length_984_cov_6.414689	415	495	4	4	80	0.0500000
NODE_6917_length_984_cov_6.414689	468	548	2	76	80	0.9500000
NODE_6917_length_984_cov_6.414689	468	548	4	4	80	0.0500000
NODE_6918_length_984_cov_4.720904	494	574	0	80	80	1.0000000
NODE_6918_length_984_cov_4.720904	547	627	0	80	80	1.0000000
NODE_6927_length_984_cov_1.333333	922	971	0	6	49	0.1224490
NODE_6927_length_984_cov_1.333333	922	971	2	1	49	0.0204082
NODE_6927_length_984_cov_1.333333	922	971	4	19	49	0.3877551
NODE_6927_length_984_cov_1.333333	922	971	6	23	49	0.4693878
NODE_6931_length_983_cov_34.566742	466	546	0	80	80	1.0000000
NODE_6931_length_983_cov_34.566742	519	599	0	80	80	1.0000000
NODE_6932_length_983_cov_26.011312	449	529	0	1	80	0.0125000
NODE_6932_length_983_cov_26.011312	449	529	1	29	80	0.3625000
NODE_6932_length_983_cov_26.011312	449	529	2	50	80	0.6250000
NODE_6932_length_983_cov_26.011312	502	582	2	80	80	1.0000000
NODE_6932_length_983_cov_26.011312	578	658	0	39	80	0.4875000
NODE_6932_length_983_cov_26.011312	578	658	1	19	80	0.2375000
NODE_6932_length_983_cov_26.011312	578	658	2	22	80	0.2750000
NODE_6932_length_983_cov_26.011312	631	711	0	80	80	1.0000000
NODE_6933_length_983_cov_24.694570	539	619	8	80	80	1.0000000
NODE_6933_length_983_cov_24.694570	592	672	0	30	80	0.3750000
NODE_6933_length_983_cov_24.694570	592	672	6	6	80	0.0750000
NODE_6933_length_983_cov_24.694570	592	672	7	8	80	0.1000000
NODE_6933_length_983_cov_24.694570	592	672	8	36	80	0.4500000
NODE_6934_length_983_cov_22.214932	395	475	0	35	80	0.4375000
NODE_6934_length_983_cov_22.214932	395	475	2	45	80	0.5625000
NODE_6934_length_983_cov_22.214932	448	528	0	80	80	1.0000000
NODE_6935_length_983_cov_19.132353	377	457	0	29	80	0.3625000
NODE_6935_length_983_cov_19.132353	377	457	2	31	80	0.3875000
NODE_6935_length_983_cov_19.132353	377	457	4	20	80	0.2500000
NODE_6935_length_983_cov_19.132353	430	510	0	80	80	1.0000000
NODE_6936_length_983_cov_16.875566	419	499	0	45	80	0.5625000
NODE_6936_length_983_cov_16.875566	419	499	1	21	80	0.2625000
NODE_6936_length_983_cov_16.875566	419	499	2	14	80	0.1750000
NODE_6936_length_983_cov_16.875566	472	552	0	80	80	1.0000000
NODE_6936_length_983_cov_16.875566	548	628	0	80	80	1.0000000
NODE_6936_length_983_cov_16.875566	601	681	0	80	80	1.0000000
NODE_6937_length_983_cov_7.240950	487	567	0	80	80	1.0000000
NODE_6937_length_983_cov_7.240950	540	620	0	80	80	1.0000000
NODE_6949_length_982_cov_30.750849	357	437	2	9	80	0.1125000
NODE_6949_length_982_cov_30.750849	357	437	6	27	80	0.3375000
NODE_6949_length_982_cov_30.750849	357	437	7	1	80	0.0125000
NODE_6949_length_982_cov_30.750849	357	437	8	43	80	0.5375000
NODE_6949_length_982_cov_30.750849	410	490	0	29	80	0.3625000
NODE_6949_length_982_cov_30.750849	410	490	6	51	80	0.6375000
NODE_6950_length_982_cov_29.901472	516	596	0	9	80	0.1125000
NODE_6950_length_982_cov_29.901472	516	596	1	28	80	0.3500000
NODE_6950_length_982_cov_29.901472	516	596	2	43	80	0.5375000
NODE_6950_length_982_cov_29.901472	569	649	0	17	80	0.2125000
NODE_6950_length_982_cov_29.901472	569	649	2	63	80	0.7875000
NODE_6951_length_982_cov_18.251416	356	436	0	80	80	1.0000000
NODE_6951_length_982_cov_18.251416	409	489	0	67	80	0.8375000
NODE_6951_length_982_cov_18.251416	409	489	2	11	80	0.1375000
NODE_6951_length_982_cov_18.251416	409	489	4	2	80	0.0250000
NODE_6951_length_982_cov_18.251416	485	565	2	19	80	0.2375000
NODE_6951_length_982_cov_18.251416	485	565	4	61	80	0.7625000
NODE_6951_length_982_cov_18.251416	538	618	0	42	80	0.5250000
NODE_6951_length_982_cov_18.251416	538	618	2	28	80	0.3500000
NODE_6951_length_982_cov_18.251416	538	618	4	10	80	0.1250000
NODE_6952_length_982_cov_13.840317	608	688	0	80	80	1.0000000
NODE_6952_length_982_cov_13.840317	661	741	0	80	80	1.0000000
NODE_6953_length_982_cov_13.227633	317	397	2	19	80	0.2375000
NODE_6953_length_982_cov_13.227633	317	397	4	5	80	0.0625000
NODE_6953_length_982_cov_13.227633	317	397	6	45	80	0.5625000
NODE_6953_length_982_cov_13.227633	317	397	8	11	80	0.1375000
NODE_6953_length_982_cov_13.227633	370	450	2	14	80	0.1750000
NODE_6953_length_982_cov_13.227633	370	450	4	15	80	0.1875000
NODE_6953_length_982_cov_13.227633	370	450	6	31	80	0.3875000
NODE_6953_length_982_cov_13.227633	370	450	8	20	80	0.2500000
NODE_6954_length_982_cov_10.918460	209	289	0	48	80	0.6000000
NODE_6954_length_982_cov_10.918460	209	289	4	32	80	0.4000000
NODE_6954_length_982_cov_10.918460	262	342	4	80	80	1.0000000
NODE_6956_length_982_cov_7.210646	216	296	0	45	80	0.5625000
NODE_6956_length_982_cov_7.210646	216	296	6	35	80	0.4375000
NODE_6956_length_982_cov_7.210646	269	349	6	80	80	1.0000000
NODE_6973_length_981_cov_55.260771	410	490	0	48	80	0.6000000
NODE_6973_length_981_cov_55.260771	410	490	2	32	80	0.4000000
NODE_6973_length_981_cov_55.260771	463	543	0	65	80	0.8125000
NODE_6973_length_981_cov_55.260771	463	543	9	1	80	0.0125000
NODE_6973_length_981_cov_55.260771	463	543	10	14	80	0.1750000
NODE_6973_length_981_cov_55.260771	539	619	10	80	80	1.0000000
NODE_6973_length_981_cov_55.260771	592	672	0	27	80	0.3375000
NODE_6973_length_981_cov_55.260771	592	672	10	53	80	0.6625000
NODE_6974_length_981_cov_33.287982	362	441	0	50	79	0.6329114
NODE_6974_length_981_cov_33.287982	362	441	2	29	79	0.3670886
NODE_6974_length_981_cov_33.287982	414	495	2	81	81	1.0000000
NODE_6974_length_981_cov_33.287982	491	571	0	27	80	0.3375000
NODE_6974_length_981_cov_33.287982	491	571	2	53	80	0.6625000
NODE_6974_length_981_cov_33.287982	544	624	0	80	80	1.0000000
NODE_6975_length_981_cov_33.121315	269	349	0	80	80	1.0000000
NODE_6975_length_981_cov_33.121315	322	402	0	80	80	1.0000000
NODE_6975_length_981_cov_33.121315	398	478	0	80	80	1.0000000
NODE_6975_length_981_cov_33.121315	451	531	0	80	80	1.0000000
NODE_6976_length_981_cov_26.732426	397	477	0	54	80	0.6750000
NODE_6976_length_981_cov_26.732426	397	477	2	26	80	0.3250000
NODE_6976_length_981_cov_26.732426	450	530	0	1	80	0.0125000
NODE_6976_length_981_cov_26.732426	450	530	2	79	80	0.9875000
NODE_6977_length_981_cov_24.304989	390	470	0	36	80	0.4500000
NODE_6977_length_981_cov_24.304989	390	470	7	1	80	0.0125000
NODE_6977_length_981_cov_24.304989	390	470	8	29	80	0.3625000
NODE_6977_length_981_cov_24.304989	390	470	15	14	80	0.1750000
NODE_6977_length_981_cov_24.304989	443	523	8	13	80	0.1625000
NODE_6977_length_981_cov_24.304989	443	523	15	43	80	0.5375000
NODE_6977_length_981_cov_24.304989	443	523	16	24	80	0.3000000
NODE_6978_length_981_cov_10.485261	363	443	0	80	80	1.0000000
NODE_6978_length_981_cov_10.485261	416	496	0	80	80	1.0000000
NODE_6980_length_981_cov_5.328798	821	885	2	11	64	0.1718750
NODE_6980_length_981_cov_5.328798	821	885	4	53	64	0.8281250
NODE_6980_length_981_cov_5.328798	847	884	2	11	37	0.2972973
NODE_6980_length_981_cov_5.328798	847	884	4	26	37	0.7027027
NODE_6998_length_980_cov_40.710556	329	409	0	80	80	1.0000000
NODE_6998_length_980_cov_40.710556	382	462	0	80	80	1.0000000
NODE_6998_length_980_cov_40.710556	458	538	0	80	80	1.0000000
NODE_6998_length_980_cov_40.710556	511	591	0	80	80	1.0000000
NODE_6999_length_980_cov_37.634506	666	746	0	80	80	1.0000000
NODE_6999_length_980_cov_37.634506	719	799	0	80	80	1.0000000
NODE_7000_length_980_cov_36.261067	331	411	2	80	80	1.0000000
NODE_7000_length_980_cov_36.261067	384	453	0	29	69	0.4202898
NODE_7000_length_980_cov_36.261067	384	453	2	40	69	0.5797101
NODE_7000_length_980_cov_36.261067	465	545	0	7	80	0.0875000
NODE_7000_length_980_cov_36.261067	465	545	2	73	80	0.9125000
NODE_7000_length_980_cov_36.261067	518	598	0	9	80	0.1125000
NODE_7000_length_980_cov_36.261067	518	598	2	71	80	0.8875000
NODE_7001_length_980_cov_28.514188	430	510	0	80	80	1.0000000
NODE_7001_length_980_cov_28.514188	483	563	0	80	80	1.0000000
NODE_7002_length_980_cov_25.205448	497	577	0	80	80	1.0000000
NODE_7002_length_980_cov_25.205448	550	630	0	80	80	1.0000000
NODE_7003_length_980_cov_24.321226	417	497	0	54	80	0.6750000
NODE_7003_length_980_cov_24.321226	417	497	2	26	80	0.3250000
NODE_7003_length_980_cov_24.321226	470	550	0	7	80	0.0875000
NODE_7003_length_980_cov_24.321226	470	550	2	73	80	0.9125000
NODE_7004_length_980_cov_20.460840	388	468	0	80	80	1.0000000
NODE_7004_length_980_cov_20.460840	441	521	0	80	80	1.0000000
NODE_7005_length_980_cov_19.969353	486	566	0	80	80	1.0000000
NODE_7005_length_980_cov_19.969353	539	619	0	80	80	1.0000000
NODE_7006_length_980_cov_13.736663	350	430	0	51	80	0.6375000
NODE_7006_length_980_cov_13.736663	350	430	2	20	80	0.2500000
NODE_7006_length_980_cov_13.736663	350	430	4	9	80	0.1125000
NODE_7006_length_980_cov_13.736663	403	483	2	18	80	0.2250000
NODE_7006_length_980_cov_13.736663	403	483	4	62	80	0.7750000
NODE_7006_length_980_cov_13.736663	479	559	0	58	80	0.7250000
NODE_7006_length_980_cov_13.736663	479	559	2	6	80	0.0750000
NODE_7006_length_980_cov_13.736663	479	559	4	16	80	0.2000000
NODE_7006_length_980_cov_13.736663	532	612	0	80	80	1.0000000
NODE_7008_length_980_cov_10.842225	517	597	0	7	80	0.0875000
NODE_7008_length_980_cov_10.842225	517	597	4	14	80	0.1750000
NODE_7008_length_980_cov_10.842225	517	597	6	45	80	0.5625000
NODE_7008_length_980_cov_10.842225	517	597	8	14	80	0.1750000
NODE_7008_length_980_cov_10.842225	570	650	2	20	80	0.2500000
NODE_7008_length_980_cov_10.842225	570	650	6	41	80	0.5125000
NODE_7008_length_980_cov_10.842225	570	650	8	19	80	0.2375000
NODE_7009_length_980_cov_10.087401	341	424	0	83	83	1.0000000
NODE_7009_length_980_cov_10.087401	397	477	0	80	80	1.0000000
NODE_7010_length_980_cov_9.643587	267	347	0	51	80	0.6375000
NODE_7010_length_980_cov_9.643587	267	347	2	29	80	0.3625000
NODE_7010_length_980_cov_9.643587	320	400	2	80	80	1.0000000
NODE_7010_length_980_cov_9.643587	396	476	0	57	80	0.7125000
NODE_7010_length_980_cov_9.643587	396	476	2	23	80	0.2875000
NODE_7010_length_980_cov_9.643587	449	529	0	59	80	0.7375000
NODE_7010_length_980_cov_9.643587	449	529	2	21	80	0.2625000
NODE_7026_length_979_cov_22.576136	442	522	0	12	80	0.1500000
NODE_7026_length_979_cov_22.576136	442	522	10	68	80	0.8500000
NODE_7026_length_979_cov_22.576136	495	575	2	2	80	0.0250000
NODE_7026_length_979_cov_22.576136	495	575	10	46	80	0.5750000
NODE_7026_length_979_cov_22.576136	495	575	12	32	80	0.4000000
NODE_7027_length_979_cov_19.739773	445	524	0	79	79	1.0000000
NODE_7027_length_979_cov_19.739773	497	577	0	80	80	1.0000000
NODE_7028_length_979_cov_19.480682	436	516	0	70	80	0.8750000
NODE_7028_length_979_cov_19.480682	436	516	2	2	80	0.0250000
NODE_7028_length_979_cov_19.480682	436	516	6	8	80	0.1000000
NODE_7028_length_979_cov_19.480682	489	569	0	17	80	0.2125000
NODE_7028_length_979_cov_19.480682	489	569	2	2	80	0.0250000
NODE_7028_length_979_cov_19.480682	489	569	4	2	80	0.0250000
NODE_7028_length_979_cov_19.480682	489	569	6	59	80	0.7375000
NODE_7028_length_979_cov_19.480682	565	645	4	30	80	0.3750000
NODE_7028_length_979_cov_19.480682	565	645	6	2	80	0.0250000
NODE_7028_length_979_cov_19.480682	565	645	8	4	80	0.0500000
NODE_7028_length_979_cov_19.480682	565	645	12	6	80	0.0750000
NODE_7028_length_979_cov_19.480682	565	645	17	38	80	0.4750000
NODE_7028_length_979_cov_19.480682	618	698	17	70	80	0.8750000
NODE_7028_length_979_cov_19.480682	618	698	18	10	80	0.1250000
NODE_7029_length_979_cov_18.901136	470	550	0	80	80	1.0000000
NODE_7029_length_979_cov_18.901136	523	603	0	80	80	1.0000000
NODE_7031_length_979_cov_3.519318	101	168	10	2	67	0.0298507
NODE_7031_length_979_cov_3.519318	101	168	12	1	67	0.0149254
NODE_7031_length_979_cov_3.519318	101	168	14	19	67	0.2835821
NODE_7031_length_979_cov_3.519318	101	168	15	18	67	0.2686567
NODE_7031_length_979_cov_3.519318	101	168	16	2	67	0.0298507
NODE_7031_length_979_cov_3.519318	101	168	18	25	67	0.3731343
NODE_7040_length_978_cov_23.195677	424	504	0	3	80	0.0375000
NODE_7040_length_978_cov_23.195677	424	504	2	2	80	0.0250000
NODE_7040_length_978_cov_23.195677	424	504	4	3	80	0.0375000
NODE_7040_length_978_cov_23.195677	424	504	6	3	80	0.0375000
NODE_7040_length_978_cov_23.195677	424	504	8	69	80	0.8625000
NODE_7040_length_978_cov_23.195677	477	557	0	56	80	0.7000000
NODE_7040_length_978_cov_23.195677	477	557	2	2	80	0.0250000
NODE_7040_length_978_cov_23.195677	477	557	4	3	80	0.0375000
NODE_7040_length_978_cov_23.195677	477	557	6	3	80	0.0375000
NODE_7040_length_978_cov_23.195677	477	557	8	16	80	0.2000000
NODE_7041_length_978_cov_18.866894	440	520	2	43	80	0.5375000
NODE_7041_length_978_cov_18.866894	440	520	6	37	80	0.4625000
NODE_7041_length_978_cov_18.866894	493	573	4	18	80	0.2250000
NODE_7041_length_978_cov_18.866894	493	573	6	62	80	0.7750000
NODE_7042_length_978_cov_15.614334	341	421	0	80	80	1.0000000
NODE_7042_length_978_cov_15.614334	394	474	0	69	80	0.8625000
NODE_7042_length_978_cov_15.614334	394	474	2	11	80	0.1375000
NODE_7042_length_978_cov_15.614334	470	550	2	80	80	1.0000000
NODE_7042_length_978_cov_15.614334	523	603	2	80	80	1.0000000
NODE_7043_length_978_cov_15.253697	327	407	0	80	80	1.0000000
NODE_7043_length_978_cov_15.253697	380	460	0	38	80	0.4750000
NODE_7043_length_978_cov_15.253697	380	460	6	17	80	0.2125000
NODE_7043_length_978_cov_15.253697	380	460	8	25	80	0.3125000
NODE_7043_length_978_cov_15.253697	456	536	0	7	80	0.0875000
NODE_7043_length_978_cov_15.253697	456	536	2	6	80	0.0750000
NODE_7043_length_978_cov_15.253697	456	536	8	67	80	0.8375000
NODE_7043_length_978_cov_15.253697	509	589	0	60	80	0.7500000
NODE_7043_length_978_cov_15.253697	509	589	2	6	80	0.0750000
NODE_7043_length_978_cov_15.253697	509	589	8	14	80	0.1750000
NODE_7044_length_978_cov_14.730375	407	487	0	30	80	0.3750000
NODE_7044_length_978_cov_14.730375	407	487	2	50	80	0.6250000
NODE_7044_length_978_cov_14.730375	460	540	0	80	80	1.0000000
NODE_7045_length_978_cov_7.257110	571	651	0	80	80	1.0000000
NODE_7045_length_978_cov_7.257110	624	704	0	80	80	1.0000000
NODE_7062_length_977_cov_47.484055	427	507	4	26	80	0.3250000
NODE_7062_length_977_cov_47.484055	427	507	11	1	80	0.0125000
NODE_7062_length_977_cov_47.484055	427	507	12	53	80	0.6625000
NODE_7062_length_977_cov_47.484055	480	560	1	2	80	0.0250000
NODE_7062_length_977_cov_47.484055	480	560	2	16	80	0.2000000
NODE_7062_length_977_cov_47.484055	480	560	4	61	80	0.7625000
NODE_7062_length_977_cov_47.484055	480	560	11	1	80	0.0125000
NODE_7063_length_977_cov_47.116173	428	508	2	50	80	0.6250000
NODE_7063_length_977_cov_47.116173	428	508	8	2	80	0.0250000
NODE_7063_length_977_cov_47.116173	428	508	9	1	80	0.0125000
NODE_7063_length_977_cov_47.116173	428	508	10	27	80	0.3375000
NODE_7063_length_977_cov_47.116173	481	561	7	4	80	0.0500000
NODE_7063_length_977_cov_47.116173	481	561	8	51	80	0.6375000
NODE_7063_length_977_cov_47.116173	481	561	10	25	80	0.3125000
NODE_7063_length_977_cov_47.116173	557	637	0	62	80	0.7750000
NODE_7063_length_977_cov_47.116173	557	637	6	1	80	0.0125000
NODE_7063_length_977_cov_47.116173	557	637	7	17	80	0.2125000
NODE_7063_length_977_cov_47.116173	610	690	0	80	80	1.0000000
NODE_7064_length_977_cov_32.542141	486	566	0	80	80	1.0000000
NODE_7064_length_977_cov_32.542141	539	619	0	80	80	1.0000000
NODE_7065_length_977_cov_30.676538	361	441	0	80	80	1.0000000
NODE_7065_length_977_cov_30.676538	414	494	0	80	80	1.0000000
NODE_7066_length_977_cov_28.348519	455	535	0	9	80	0.1125000
NODE_7066_length_977_cov_28.348519	455	535	2	71	80	0.8875000
NODE_7066_length_977_cov_28.348519	508	588	0	62	80	0.7750000
NODE_7066_length_977_cov_28.348519	508	588	2	18	80	0.2250000
NODE_7067_length_977_cov_26.571754	343	423	0	15	80	0.1875000
NODE_7067_length_977_cov_26.571754	343	423	2	5	80	0.0625000
NODE_7067_length_977_cov_26.571754	343	423	6	60	80	0.7500000
NODE_7067_length_977_cov_26.571754	396	476	0	68	80	0.8500000
NODE_7067_length_977_cov_26.571754	396	476	2	5	80	0.0625000
NODE_7067_length_977_cov_26.571754	396	476	6	7	80	0.0875000
NODE_7067_length_977_cov_26.571754	472	552	0	80	80	1.0000000
NODE_7067_length_977_cov_26.571754	525	600	0	75	75	1.0000000
NODE_7068_length_977_cov_24.898633	470	550	2	31	80	0.3875000
NODE_7068_length_977_cov_24.898633	470	550	6	49	80	0.6125000
NODE_7068_length_977_cov_24.898633	523	603	4	32	80	0.4000000
NODE_7068_length_977_cov_24.898633	523	603	6	48	80	0.6000000
NODE_7069_length_977_cov_22.986333	313	393	0	53	80	0.6625000
NODE_7069_length_977_cov_22.986333	313	393	6	27	80	0.3375000
NODE_7069_length_977_cov_22.986333	366	446	0	24	80	0.3000000
NODE_7069_length_977_cov_22.986333	366	446	4	7	80	0.0875000
NODE_7069_length_977_cov_22.986333	366	446	6	49	80	0.6125000
NODE_7069_length_977_cov_22.986333	442	522	0	41	80	0.5125000
NODE_7069_length_977_cov_22.986333	442	522	2	39	80	0.4875000
NODE_7069_length_977_cov_22.986333	495	575	2	80	80	1.0000000
NODE_7070_length_977_cov_10.753986	290	370	0	80	80	1.0000000
NODE_7070_length_977_cov_10.753986	343	423	0	80	80	1.0000000
NODE_7071_length_977_cov_9.924829	401	456	0	9	55	0.1636364
NODE_7071_length_977_cov_9.924829	401	456	4	10	55	0.1818182
NODE_7071_length_977_cov_9.924829	401	456	6	3	55	0.0545455
NODE_7071_length_977_cov_9.924829	401	456	8	33	55	0.6000000
NODE_7073_length_977_cov_6.391800	483	563	0	80	80	1.0000000
NODE_7073_length_977_cov_6.391800	536	616	0	80	80	1.0000000
NODE_7075_length_977_cov_2.907745	191	241	4	42	50	0.8400000
NODE_7075_length_977_cov_2.907745	191	241	6	8	50	0.1600000
NODE_7085_length_976_cov_38.192702	326	406	0	80	80	1.0000000
NODE_7085_length_976_cov_38.192702	379	459	0	80	80	1.0000000
NODE_7085_length_976_cov_38.192702	455	535	0	80	80	1.0000000
NODE_7085_length_976_cov_38.192702	455	536	0	81	81	1.0000000
NODE_7085_length_976_cov_38.192702	455	519	0	64	64	1.0000000
NODE_7085_length_976_cov_38.192702	508	588	0	80	80	1.0000000
NODE_7086_length_976_cov_26.275941	499	579	1	51	80	0.6375000
NODE_7086_length_976_cov_26.275941	499	579	2	29	80	0.3625000
NODE_7086_length_976_cov_26.275941	552	632	0	20	80	0.2500000
NODE_7086_length_976_cov_26.275941	552	632	1	60	80	0.7500000
NODE_7087_length_976_cov_25.559863	376	456	0	77	80	0.9625000
NODE_7087_length_976_cov_25.559863	376	456	4	3	80	0.0375000
NODE_7087_length_976_cov_25.559863	429	509	0	24	80	0.3000000
NODE_7087_length_976_cov_25.559863	429	509	4	56	80	0.7000000
NODE_7088_length_976_cov_17.961231	572	652	0	80	80	1.0000000
NODE_7088_length_976_cov_17.961231	625	705	0	80	80	1.0000000
NODE_7089_length_976_cov_5.567845	789	851	2	4	62	0.0645161
NODE_7089_length_976_cov_5.567845	789	851	4	58	62	0.9354839
NODE_7089_length_976_cov_5.567845	842	904	0	34	62	0.5483871
NODE_7089_length_976_cov_5.567845	842	904	2	20	62	0.3225806
NODE_7089_length_976_cov_5.567845	842	904	4	8	62	0.1290323
NODE_7101_length_975_cov_192.211187	722	802	12	6	80	0.0750000
NODE_7101_length_975_cov_192.211187	722	802	14	8	80	0.1000000
NODE_7101_length_975_cov_192.211187	722	802	15	1	80	0.0125000
NODE_7101_length_975_cov_192.211187	722	802	16	10	80	0.1250000
NODE_7101_length_975_cov_192.211187	722	802	17	19	80	0.2375000
NODE_7101_length_975_cov_192.211187	722	802	18	2	80	0.0250000
NODE_7101_length_975_cov_192.211187	722	802	19	12	80	0.1500000
NODE_7101_length_975_cov_192.211187	722	802	20	1	80	0.0125000
NODE_7101_length_975_cov_192.211187	722	802	21	21	80	0.2625000
NODE_7102_length_975_cov_41.446347	414	494	0	30	80	0.3750000
NODE_7102_length_975_cov_41.446347	414	494	2	4	80	0.0500000
NODE_7102_length_975_cov_41.446347	414	494	4	27	80	0.3375000
NODE_7102_length_975_cov_41.446347	414	494	6	19	80	0.2375000
NODE_7102_length_975_cov_41.446347	467	547	2	18	80	0.2250000
NODE_7102_length_975_cov_41.446347	467	547	4	32	80	0.4000000
NODE_7102_length_975_cov_41.446347	467	547	6	30	80	0.3750000
NODE_7103_length_975_cov_37.618721	375	455	0	20	80	0.2500000
NODE_7103_length_975_cov_37.618721	375	455	2	60	80	0.7500000
NODE_7103_length_975_cov_37.618721	428	508	0	59	80	0.7375000
NODE_7103_length_975_cov_37.618721	428	508	2	21	80	0.2625000
NODE_7104_length_975_cov_34.265982	424	504	0	24	80	0.3000000
NODE_7104_length_975_cov_34.265982	424	504	2	56	80	0.7000000
NODE_7104_length_975_cov_34.265982	477	557	2	80	80	1.0000000
NODE_7105_length_975_cov_31.888128	461	541	0	45	80	0.5625000
NODE_7105_length_975_cov_31.888128	461	541	2	35	80	0.4375000
NODE_7105_length_975_cov_31.888128	514	594	0	33	80	0.4125000
NODE_7105_length_975_cov_31.888128	514	594	1	1	80	0.0125000
NODE_7105_length_975_cov_31.888128	514	594	2	46	80	0.5750000
NODE_7106_length_975_cov_22.093607	392	472	0	5	80	0.0625000
NODE_7106_length_975_cov_22.093607	392	472	2	75	80	0.9375000
NODE_7106_length_975_cov_22.093607	445	525	0	46	80	0.5750000
NODE_7106_length_975_cov_22.093607	445	525	2	34	80	0.4250000
NODE_7107_length_975_cov_15.091324	403	483	0	80	80	1.0000000
NODE_7107_length_975_cov_15.091324	456	536	0	80	80	1.0000000
NODE_7108_length_975_cov_15.046804	63	143	0	80	80	1.0000000
NODE_7108_length_975_cov_15.046804	116	196	0	30	80	0.3750000
NODE_7108_length_975_cov_15.046804	116	196	2	50	80	0.6250000
NODE_7109_length_975_cov_12.043379	535	615	0	21	80	0.2625000
NODE_7109_length_975_cov_12.043379	535	615	1	1	80	0.0125000
NODE_7109_length_975_cov_12.043379	535	615	2	58	80	0.7250000
NODE_7109_length_975_cov_12.043379	588	668	0	61	80	0.7625000
NODE_7109_length_975_cov_12.043379	588	668	2	19	80	0.2375000
NODE_7110_length_975_cov_11.772831	276	354	0	78	78	1.0000000
NODE_7110_length_975_cov_11.772831	327	407	0	42	80	0.5250000
NODE_7110_length_975_cov_11.772831	327	407	2	38	80	0.4750000
NODE_7111_length_975_cov_10.599315	405	485	0	80	80	1.0000000
NODE_7111_length_975_cov_10.599315	458	538	0	80	80	1.0000000
NODE_7112_length_975_cov_8.089041	430	510	0	54	80	0.6750000
NODE_7112_length_975_cov_8.089041	430	510	2	26	80	0.3250000
NODE_7112_length_975_cov_8.089041	483	563	0	1	80	0.0125000
NODE_7112_length_975_cov_8.089041	483	563	2	79	80	0.9875000
NODE_7114_length_975_cov_3.728311	254	334	0	62	80	0.7750000
NODE_7114_length_975_cov_3.728311	254	334	2	18	80	0.2250000
NODE_7114_length_975_cov_3.728311	307	387	0	80	80	1.0000000
NODE_7125_length_974_cov_293.334857	564	642	132	2	78	0.0256410
NODE_7125_length_974_cov_293.334857	564	642	133	5	78	0.0641026
NODE_7125_length_974_cov_293.334857	564	642	135	2	78	0.0256410
NODE_7125_length_974_cov_293.334857	564	642	136	3	78	0.0384615
NODE_7125_length_974_cov_293.334857	564	642	137	1	78	0.0128205
NODE_7125_length_974_cov_293.334857	564	642	139	3	78	0.0384615
NODE_7125_length_974_cov_293.334857	564	642	144	1	78	0.0128205
NODE_7125_length_974_cov_293.334857	564	642	145	1	78	0.0128205
NODE_7125_length_974_cov_293.334857	564	642	146	1	78	0.0128205
NODE_7125_length_974_cov_293.334857	564	642	147	2	78	0.0256410
NODE_7125_length_974_cov_293.334857	564	642	148	3	78	0.0384615
NODE_7125_length_974_cov_293.334857	564	642	149	1	78	0.0128205
NODE_7125_length_974_cov_293.334857	564	642	150	1	78	0.0128205
NODE_7125_length_974_cov_293.334857	564	642	151	1	78	0.0128205
NODE_7125_length_974_cov_293.334857	564	642	153	2	78	0.0256410
NODE_7125_length_974_cov_293.334857	564	642	154	2	78	0.0256410
NODE_7125_length_974_cov_293.334857	564	642	155	3	78	0.0384615
NODE_7125_length_974_cov_293.334857	564	642	156	1	78	0.0128205
NODE_7125_length_974_cov_293.334857	564	642	157	10	78	0.1282051
NODE_7125_length_974_cov_293.334857	564	642	158	1	78	0.0128205
NODE_7125_length_974_cov_293.334857	564	642	159	2	78	0.0256410
NODE_7125_length_974_cov_293.334857	564	642	160	4	78	0.0512821
NODE_7125_length_974_cov_293.334857	564	642	161	1	78	0.0128205
NODE_7125_length_974_cov_293.334857	564	642	162	2	78	0.0256410
NODE_7125_length_974_cov_293.334857	564	642	163	1	78	0.0128205
NODE_7125_length_974_cov_293.334857	564	642	164	1	78	0.0128205
NODE_7125_length_974_cov_293.334857	564	642	165	2	78	0.0256410
NODE_7125_length_974_cov_293.334857	564	642	168	1	78	0.0128205
NODE_7125_length_974_cov_293.334857	564	642	177	1	78	0.0128205
NODE_7125_length_974_cov_293.334857	564	642	186	1	78	0.0128205
NODE_7125_length_974_cov_293.334857	564	642	189	1	78	0.0128205
NODE_7125_length_974_cov_293.334857	564	642	198	1	78	0.0128205
NODE_7125_length_974_cov_293.334857	564	642	204	1	78	0.0128205
NODE_7125_length_974_cov_293.334857	564	642	214	1	78	0.0128205
NODE_7125_length_974_cov_293.334857	564	642	217	1	78	0.0128205
NODE_7125_length_974_cov_293.334857	564	642	219	1	78	0.0128205
NODE_7125_length_974_cov_293.334857	564	642	221	1	78	0.0128205
NODE_7125_length_974_cov_293.334857	564	642	228	1	78	0.0128205
NODE_7125_length_974_cov_293.334857	564	642	231	1	78	0.0128205
NODE_7125_length_974_cov_293.334857	564	642	250	1	78	0.0128205
NODE_7125_length_974_cov_293.334857	564	642	253	1	78	0.0128205
NODE_7125_length_974_cov_293.334857	564	642	263	1	78	0.0128205
NODE_7125_length_974_cov_293.334857	564	642	265	1	78	0.0128205
NODE_7125_length_974_cov_293.334857	564	642	266	1	78	0.0128205
NODE_7125_length_974_cov_293.334857	564	642	270	1	78	0.0128205
NODE_7125_length_974_cov_293.334857	564	642	271	1	78	0.0128205
NODE_7125_length_974_cov_293.334857	564	642	132	2	78	0.0256410
NODE_7125_length_974_cov_293.334857	564	642	133	5	78	0.0641026
NODE_7125_length_974_cov_293.334857	564	642	135	2	78	0.0256410
NODE_7125_length_974_cov_293.334857	564	642	136	3	78	0.0384615
NODE_7125_length_974_cov_293.334857	564	642	137	1	78	0.0128205
NODE_7125_length_974_cov_293.334857	564	642	139	3	78	0.0384615
NODE_7125_length_974_cov_293.334857	564	642	144	1	78	0.0128205
NODE_7125_length_974_cov_293.334857	564	642	145	1	78	0.0128205
NODE_7125_length_974_cov_293.334857	564	642	146	1	78	0.0128205
NODE_7125_length_974_cov_293.334857	564	642	147	2	78	0.0256410
NODE_7125_length_974_cov_293.334857	564	642	148	3	78	0.0384615
NODE_7125_length_974_cov_293.334857	564	642	149	1	78	0.0128205
NODE_7125_length_974_cov_293.334857	564	642	150	1	78	0.0128205
NODE_7125_length_974_cov_293.334857	564	642	151	1	78	0.0128205
NODE_7125_length_974_cov_293.334857	564	642	153	2	78	0.0256410
NODE_7125_length_974_cov_293.334857	564	642	154	2	78	0.0256410
NODE_7125_length_974_cov_293.334857	564	642	155	3	78	0.0384615
NODE_7125_length_974_cov_293.334857	564	642	156	1	78	0.0128205
NODE_7125_length_974_cov_293.334857	564	642	157	10	78	0.1282051
NODE_7125_length_974_cov_293.334857	564	642	158	1	78	0.0128205
NODE_7125_length_974_cov_293.334857	564	642	159	2	78	0.0256410
NODE_7125_length_974_cov_293.334857	564	642	160	4	78	0.0512821
NODE_7125_length_974_cov_293.334857	564	642	161	1	78	0.0128205
NODE_7125_length_974_cov_293.334857	564	642	162	2	78	0.0256410
NODE_7125_length_974_cov_293.334857	564	642	163	1	78	0.0128205
NODE_7125_length_974_cov_293.334857	564	642	164	1	78	0.0128205
NODE_7125_length_974_cov_293.334857	564	642	165	2	78	0.0256410
NODE_7125_length_974_cov_293.334857	564	642	168	1	78	0.0128205
NODE_7125_length_974_cov_293.334857	564	642	177	1	78	0.0128205
NODE_7125_length_974_cov_293.334857	564	642	186	1	78	0.0128205
NODE_7125_length_974_cov_293.334857	564	642	189	1	78	0.0128205
NODE_7125_length_974_cov_293.334857	564	642	198	1	78	0.0128205
NODE_7125_length_974_cov_293.334857	564	642	204	1	78	0.0128205
NODE_7125_length_974_cov_293.334857	564	642	214	1	78	0.0128205
NODE_7125_length_974_cov_293.334857	564	642	217	1	78	0.0128205
NODE_7125_length_974_cov_293.334857	564	642	219	1	78	0.0128205
NODE_7125_length_974_cov_293.334857	564	642	221	1	78	0.0128205
NODE_7125_length_974_cov_293.334857	564	642	228	1	78	0.0128205
NODE_7125_length_974_cov_293.334857	564	642	231	1	78	0.0128205
NODE_7125_length_974_cov_293.334857	564	642	250	1	78	0.0128205
NODE_7125_length_974_cov_293.334857	564	642	253	1	78	0.0128205
NODE_7125_length_974_cov_293.334857	564	642	263	1	78	0.0128205
NODE_7125_length_974_cov_293.334857	564	642	265	1	78	0.0128205
NODE_7125_length_974_cov_293.334857	564	642	266	1	78	0.0128205
NODE_7125_length_974_cov_293.334857	564	642	270	1	78	0.0128205
NODE_7125_length_974_cov_293.334857	564	642	271	1	78	0.0128205
NODE_7125_length_974_cov_293.334857	564	633	132	2	69	0.0289855
NODE_7125_length_974_cov_293.334857	564	633	133	5	69	0.0724638
NODE_7125_length_974_cov_293.334857	564	633	135	2	69	0.0289855
NODE_7125_length_974_cov_293.334857	564	633	136	3	69	0.0434783
NODE_7125_length_974_cov_293.334857	564	633	137	1	69	0.0144928
NODE_7125_length_974_cov_293.334857	564	633	139	3	69	0.0434783
NODE_7125_length_974_cov_293.334857	564	633	144	1	69	0.0144928
NODE_7125_length_974_cov_293.334857	564	633	145	1	69	0.0144928
NODE_7125_length_974_cov_293.334857	564	633	146	1	69	0.0144928
NODE_7125_length_974_cov_293.334857	564	633	147	2	69	0.0289855
NODE_7125_length_974_cov_293.334857	564	633	148	3	69	0.0434783
NODE_7125_length_974_cov_293.334857	564	633	149	1	69	0.0144928
NODE_7125_length_974_cov_293.334857	564	633	150	1	69	0.0144928
NODE_7125_length_974_cov_293.334857	564	633	153	2	69	0.0289855
NODE_7125_length_974_cov_293.334857	564	633	154	2	69	0.0289855
NODE_7125_length_974_cov_293.334857	564	633	155	2	69	0.0289855
NODE_7125_length_974_cov_293.334857	564	633	157	7	69	0.1014493
NODE_7125_length_974_cov_293.334857	564	633	159	1	69	0.0144928
NODE_7125_length_974_cov_293.334857	564	633	160	4	69	0.0579710
NODE_7125_length_974_cov_293.334857	564	633	162	2	69	0.0289855
NODE_7125_length_974_cov_293.334857	564	633	163	1	69	0.0144928
NODE_7125_length_974_cov_293.334857	564	633	164	1	69	0.0144928
NODE_7125_length_974_cov_293.334857	564	633	165	2	69	0.0289855
NODE_7125_length_974_cov_293.334857	564	633	168	1	69	0.0144928
NODE_7125_length_974_cov_293.334857	564	633	177	1	69	0.0144928
NODE_7125_length_974_cov_293.334857	564	633	186	1	69	0.0144928
NODE_7125_length_974_cov_293.334857	564	633	189	1	69	0.0144928
NODE_7125_length_974_cov_293.334857	564	633	198	1	69	0.0144928
NODE_7125_length_974_cov_293.334857	564	633	204	1	69	0.0144928
NODE_7125_length_974_cov_293.334857	564	633	214	1	69	0.0144928
NODE_7125_length_974_cov_293.334857	564	633	217	1	69	0.0144928
NODE_7125_length_974_cov_293.334857	564	633	219	1	69	0.0144928
NODE_7125_length_974_cov_293.334857	564	633	221	1	69	0.0144928
NODE_7125_length_974_cov_293.334857	564	633	228	1	69	0.0144928
NODE_7125_length_974_cov_293.334857	564	633	231	1	69	0.0144928
NODE_7125_length_974_cov_293.334857	564	633	250	1	69	0.0144928
NODE_7125_length_974_cov_293.334857	564	633	253	1	69	0.0144928
NODE_7125_length_974_cov_293.334857	564	633	263	1	69	0.0144928
NODE_7125_length_974_cov_293.334857	564	633	265	1	69	0.0144928
NODE_7125_length_974_cov_293.334857	564	633	266	1	69	0.0144928
NODE_7125_length_974_cov_293.334857	564	633	270	1	69	0.0144928
NODE_7125_length_974_cov_293.334857	564	633	271	1	69	0.0144928
NODE_7126_length_974_cov_49.884571	459	539	0	2	80	0.0250000
NODE_7126_length_974_cov_49.884571	459	539	2	13	80	0.1625000
NODE_7126_length_974_cov_49.884571	459	539	4	45	80	0.5625000
NODE_7126_length_974_cov_49.884571	459	539	6	20	80	0.2500000
NODE_7126_length_974_cov_49.884571	512	592	0	55	80	0.6875000
NODE_7126_length_974_cov_49.884571	512	592	2	13	80	0.1625000
NODE_7126_length_974_cov_49.884571	512	592	4	12	80	0.1500000
NODE_7127_length_974_cov_38.384000	430	508	2	36	78	0.4615385
NODE_7127_length_974_cov_38.384000	430	508	3	42	78	0.5384616
NODE_7127_length_974_cov_38.384000	483	561	1	10	78	0.1282051
NODE_7127_length_974_cov_38.384000	483	561	2	21	78	0.2692308
NODE_7127_length_974_cov_38.384000	483	561	3	47	78	0.6025641
NODE_7128_length_974_cov_26.008000	391	471	0	80	80	1.0000000
NODE_7128_length_974_cov_26.008000	444	524	0	69	80	0.8625000
NODE_7128_length_974_cov_26.008000	444	524	2	11	80	0.1375000
NODE_7128_length_974_cov_26.008000	520	600	2	9	80	0.1125000
NODE_7128_length_974_cov_26.008000	520	600	6	16	80	0.2000000
NODE_7128_length_974_cov_26.008000	520	600	7	1	80	0.0125000
NODE_7128_length_974_cov_26.008000	520	600	8	54	80	0.6750000
NODE_7128_length_974_cov_26.008000	573	653	2	23	80	0.2875000
NODE_7128_length_974_cov_26.008000	573	653	6	18	80	0.2250000
NODE_7128_length_974_cov_26.008000	573	653	8	39	80	0.4875000
NODE_7129_length_974_cov_21.160000	460	540	0	20	80	0.2500000
NODE_7129_length_974_cov_21.160000	460	540	4	60	80	0.7500000
NODE_7129_length_974_cov_21.160000	513	593	4	80	80	1.0000000
NODE_7131_length_974_cov_11.384000	290	370	0	19	80	0.2375000
NODE_7131_length_974_cov_11.384000	290	370	2	61	80	0.7625000
NODE_7131_length_974_cov_11.384000	343	423	0	45	80	0.5625000
NODE_7131_length_974_cov_11.384000	343	423	2	35	80	0.4375000
NODE_7132_length_974_cov_11.216000	543	623	0	4	80	0.0500000
NODE_7132_length_974_cov_11.216000	543	623	2	76	80	0.9500000
NODE_7132_length_974_cov_11.216000	596	668	0	49	72	0.6805556
NODE_7132_length_974_cov_11.216000	596	668	2	23	72	0.3194444
NODE_7133_length_974_cov_9.601143	436	516	0	80	80	1.0000000
NODE_7133_length_974_cov_9.601143	489	569	0	80	80	1.0000000
NODE_7134_length_974_cov_7.436571	382	462	0	80	80	1.0000000
NODE_7134_length_974_cov_7.436571	436	515	0	79	79	1.0000000
NODE_7147_length_973_cov_46.012586	349	429	0	34	80	0.4250000
NODE_7147_length_973_cov_46.012586	349	429	2	2	80	0.0250000
NODE_7147_length_973_cov_46.012586	349	429	9	44	80	0.5500000
NODE_7147_length_973_cov_46.012586	402	482	9	39	80	0.4875000
NODE_7147_length_973_cov_46.012586	402	482	12	41	80	0.5125000
NODE_7147_length_973_cov_46.012586	478	558	6	20	80	0.2500000
NODE_7147_length_973_cov_46.012586	478	558	10	26	80	0.3250000
NODE_7147_length_973_cov_46.012586	478	558	12	28	80	0.3500000
NODE_7147_length_973_cov_46.012586	478	558	16	6	80	0.0750000
NODE_7147_length_973_cov_46.012586	531	611	6	9	80	0.1125000
NODE_7147_length_973_cov_46.012586	531	611	10	71	80	0.8875000
NODE_7148_length_973_cov_40.305492	364	444	2	62	80	0.7750000
NODE_7148_length_973_cov_40.305492	364	444	4	18	80	0.2250000
NODE_7148_length_973_cov_40.305492	417	497	2	80	80	1.0000000
NODE_7149_length_973_cov_24.105263	460	540	1	80	80	1.0000000
NODE_7149_length_973_cov_24.105263	513	593	0	18	80	0.2250000
NODE_7149_length_973_cov_24.105263	513	593	1	62	80	0.7750000
NODE_7150_length_973_cov_22.106407	342	422	0	12	80	0.1500000
NODE_7150_length_973_cov_22.106407	342	422	2	68	80	0.8500000
NODE_7150_length_973_cov_22.106407	395	475	0	65	80	0.8125000
NODE_7150_length_973_cov_22.106407	395	475	2	15	80	0.1875000
NODE_7150_length_973_cov_22.106407	471	550	0	79	79	1.0000000
NODE_7150_length_973_cov_22.106407	526	604	0	78	78	1.0000000
NODE_7151_length_973_cov_10.994279	430	510	0	80	80	1.0000000
NODE_7151_length_973_cov_10.994279	483	563	0	80	80	1.0000000
NODE_7151_length_973_cov_10.994279	559	635	0	76	76	1.0000000
NODE_7151_length_973_cov_10.994279	608	688	0	80	80	1.0000000
NODE_7153_length_973_cov_2.973684	734	814	0	71	80	0.8875000
NODE_7153_length_973_cov_2.973684	734	814	2	9	80	0.1125000
NODE_7153_length_973_cov_2.973684	820	890	2	10	70	0.1428571
NODE_7153_length_973_cov_2.973684	820	890	4	12	70	0.1714286
NODE_7153_length_973_cov_2.973684	820	890	10	48	70	0.6857143
NODE_7153_length_973_cov_2.973684	863	944	0	12	81	0.1481481
NODE_7153_length_973_cov_2.973684	863	944	2	13	81	0.1604938
NODE_7153_length_973_cov_2.973684	863	944	8	19	81	0.2345679
NODE_7153_length_973_cov_2.973684	863	944	10	37	81	0.4567901
NODE_7166_length_972_cov_32.547537	299	379	13	17	80	0.2125000
NODE_7166_length_972_cov_32.547537	299	379	14	17	80	0.2125000
NODE_7166_length_972_cov_32.547537	299	379	16	46	80	0.5750000
NODE_7166_length_972_cov_32.547537	352	432	0	10	80	0.1250000
NODE_7166_length_972_cov_32.547537	352	432	12	1	80	0.0125000
NODE_7166_length_972_cov_32.547537	352	432	13	59	80	0.7375000
NODE_7166_length_972_cov_32.547537	352	432	14	10	80	0.1250000
NODE_7166_length_972_cov_32.547537	428	508	0	64	80	0.8000000
NODE_7166_length_972_cov_32.547537	428	508	4	16	80	0.2000000
NODE_7166_length_972_cov_32.547537	481	561	0	11	80	0.1375000
NODE_7166_length_972_cov_32.547537	481	561	4	69	80	0.8625000
NODE_7167_length_972_cov_31.010309	474	554	8	52	80	0.6500000
NODE_7167_length_972_cov_31.010309	474	554	10	28	80	0.3500000
NODE_7167_length_972_cov_31.010309	527	607	2	25	80	0.3125000
NODE_7167_length_972_cov_31.010309	527	607	10	55	80	0.6875000
NODE_7168_length_972_cov_29.810997	481	561	0	80	80	1.0000000
NODE_7168_length_972_cov_29.810997	534	614	0	80	80	1.0000000
NODE_7169_length_972_cov_23.438717	442	522	0	4	80	0.0500000
NODE_7169_length_972_cov_23.438717	442	522	11	1	80	0.0125000
NODE_7169_length_972_cov_23.438717	442	522	12	75	80	0.9375000
NODE_7169_length_972_cov_23.438717	495	575	12	57	80	0.7125000
NODE_7169_length_972_cov_23.438717	495	575	14	4	80	0.0500000
NODE_7169_length_972_cov_23.438717	495	575	16	19	80	0.2375000
NODE_7170_length_972_cov_18.886598	453	533	0	14	80	0.1750000
NODE_7170_length_972_cov_18.886598	453	533	6	66	80	0.8250000
NODE_7170_length_972_cov_18.886598	506	585	0	24	79	0.3037975
NODE_7170_length_972_cov_18.886598	506	585	6	55	79	0.6962025
NODE_7171_length_972_cov_15.100802	329	409	0	50	80	0.6250000
NODE_7171_length_972_cov_15.100802	329	409	3	1	80	0.0125000
NODE_7171_length_972_cov_15.100802	329	409	4	29	80	0.3625000
NODE_7171_length_972_cov_15.100802	382	462	3	4	80	0.0500000
NODE_7171_length_972_cov_15.100802	382	462	4	76	80	0.9500000
NODE_7172_length_972_cov_12.674685	444	524	0	61	80	0.7625000
NODE_7172_length_972_cov_12.674685	444	524	2	19	80	0.2375000
NODE_7172_length_972_cov_12.674685	497	577	0	80	80	1.0000000
NODE_7173_length_972_cov_11.235968	504	584	0	80	80	1.0000000
NODE_7173_length_972_cov_11.235968	557	637	0	80	80	1.0000000
NODE_7174_length_972_cov_10.983963	402	482	2	80	80	1.0000000
NODE_7174_length_972_cov_10.983963	455	535	0	30	80	0.3750000
NODE_7174_length_972_cov_10.983963	455	535	1	2	80	0.0250000
NODE_7174_length_972_cov_10.983963	455	535	2	48	80	0.6000000
NODE_7175_length_972_cov_8.887743	302	382	0	75	80	0.9375000
NODE_7175_length_972_cov_8.887743	302	382	2	5	80	0.0625000
NODE_7175_length_972_cov_8.887743	355	430	0	22	75	0.2933333
NODE_7175_length_972_cov_8.887743	355	430	2	53	75	0.7066666
NODE_7176_length_972_cov_8.265750	488	568	0	80	80	1.0000000
NODE_7176_length_972_cov_8.265750	541	621	0	80	80	1.0000000
NODE_7182_length_972_cov_2.714777	165	241	6	17	76	0.2236842
NODE_7182_length_972_cov_2.714777	165	241	8	59	76	0.7763158
NODE_7195_length_971_cov_52.575688	398	478	0	80	80	1.0000000
NODE_7195_length_971_cov_52.575688	451	531	0	80	80	1.0000000
NODE_7195_length_971_cov_52.575688	527	607	0	80	80	1.0000000
NODE_7195_length_971_cov_52.575688	580	660	0	80	80	1.0000000
NODE_7196_length_971_cov_44.464450	280	360	0	80	80	1.0000000
NODE_7196_length_971_cov_44.464450	333	413	0	80	80	1.0000000
NODE_7196_length_971_cov_44.464450	409	489	0	80	80	1.0000000
NODE_7196_length_971_cov_44.464450	462	542	0	80	80	1.0000000
NODE_7197_length_971_cov_32.721330	509	589	0	80	80	1.0000000
NODE_7197_length_971_cov_32.721330	562	642	0	80	80	1.0000000
NODE_7198_length_971_cov_30.264908	474	554	0	80	80	1.0000000
NODE_7198_length_971_cov_30.264908	527	607	0	80	80	1.0000000
NODE_7199_length_971_cov_26.631881	434	514	0	80	80	1.0000000
NODE_7199_length_971_cov_26.631881	487	567	0	80	80	1.0000000
NODE_7200_length_971_cov_25.635321	404	484	0	80	80	1.0000000
NODE_7200_length_971_cov_25.635321	457	537	0	80	80	1.0000000
NODE_7201_length_971_cov_23.334862	363	443	0	80	80	1.0000000
NODE_7201_length_971_cov_23.334862	416	497	0	81	81	1.0000000
NODE_7202_length_971_cov_18.254587	468	548	0	8	80	0.1000000
NODE_7202_length_971_cov_18.254587	468	548	6	72	80	0.9000000
NODE_7202_length_971_cov_18.254587	521	601	0	37	80	0.4625000
NODE_7202_length_971_cov_18.254587	521	601	5	16	80	0.2000000
NODE_7202_length_971_cov_18.254587	521	601	6	27	80	0.3375000
NODE_7203_length_971_cov_18.229358	392	472	0	80	80	1.0000000
NODE_7203_length_971_cov_18.229358	445	525	0	80	80	1.0000000
NODE_7204_length_971_cov_16.591743	481	561	0	80	80	1.0000000
NODE_7204_length_971_cov_16.591743	534	614	0	80	80	1.0000000
NODE_7205_length_971_cov_15.563073	463	543	0	21	80	0.2625000
NODE_7205_length_971_cov_15.563073	463	543	2	59	80	0.7375000
NODE_7205_length_971_cov_15.563073	516	596	0	38	80	0.4750000
NODE_7205_length_971_cov_15.563073	516	596	2	42	80	0.5250000
NODE_7206_length_971_cov_12.141055	415	495	0	80	80	1.0000000
NODE_7206_length_971_cov_12.141055	468	548	0	80	80	1.0000000
NODE_7222_length_970_cov_34.928817	438	518	0	80	80	1.0000000
NODE_7222_length_970_cov_34.928817	491	571	0	80	80	1.0000000
NODE_7223_length_970_cov_34.445465	540	620	4	80	80	1.0000000
NODE_7223_length_970_cov_34.445465	593	673	0	51	80	0.6375000
NODE_7223_length_970_cov_34.445465	593	673	4	29	80	0.3625000
NODE_7224_length_970_cov_34.257176	352	432	0	39	80	0.4875000
NODE_7224_length_970_cov_34.257176	352	432	4	41	80	0.5125000
NODE_7224_length_970_cov_34.257176	405	485	4	80	80	1.0000000
NODE_7225_length_970_cov_26.904707	297	372	29	1	75	0.0133333
NODE_7225_length_970_cov_26.904707	297	372	31	4	75	0.0533333
NODE_7225_length_970_cov_26.904707	297	372	32	18	75	0.2400000
NODE_7225_length_970_cov_26.904707	297	372	34	5	75	0.0666667
NODE_7225_length_970_cov_26.904707	297	372	35	11	75	0.1466667
NODE_7225_length_970_cov_26.904707	297	372	36	1	75	0.0133333
NODE_7225_length_970_cov_26.904707	297	372	37	13	75	0.1733333
NODE_7225_length_970_cov_26.904707	297	372	40	22	75	0.2933333
NODE_7225_length_970_cov_26.904707	303	376	29	5	73	0.0684932
NODE_7225_length_970_cov_26.904707	303	376	31	4	73	0.0547945
NODE_7225_length_970_cov_26.904707	303	376	32	18	73	0.2465753
NODE_7225_length_970_cov_26.904707	303	376	34	5	73	0.0684932
NODE_7225_length_970_cov_26.904707	303	376	35	11	73	0.1506849
NODE_7225_length_970_cov_26.904707	303	376	36	1	73	0.0136986
NODE_7225_length_970_cov_26.904707	303	376	37	13	73	0.1780822
NODE_7225_length_970_cov_26.904707	303	376	40	16	73	0.2191781
NODE_7225_length_970_cov_26.904707	311	377	29	6	66	0.0909091
NODE_7225_length_970_cov_26.904707	311	377	31	4	66	0.0606061
NODE_7225_length_970_cov_26.904707	311	377	32	18	66	0.2727273
NODE_7225_length_970_cov_26.904707	311	377	34	5	66	0.0757576
NODE_7225_length_970_cov_26.904707	311	377	35	11	66	0.1666667
NODE_7225_length_970_cov_26.904707	311	377	36	1	66	0.0151515
NODE_7225_length_970_cov_26.904707	311	377	37	13	66	0.1969697
NODE_7225_length_970_cov_26.904707	311	377	40	8	66	0.1212121
NODE_7225_length_970_cov_26.904707	350	429	0	20	79	0.2531646
NODE_7225_length_970_cov_26.904707	350	429	14	19	79	0.2405063
NODE_7225_length_970_cov_26.904707	350	429	21	1	79	0.0126582
NODE_7225_length_970_cov_26.904707	350	429	22	3	79	0.0379747
NODE_7225_length_970_cov_26.904707	350	429	24	1	79	0.0126582
NODE_7225_length_970_cov_26.904707	350	429	25	1	79	0.0126582
NODE_7225_length_970_cov_26.904707	350	429	27	4	79	0.0506329
NODE_7225_length_970_cov_26.904707	350	429	29	9	79	0.1139240
NODE_7225_length_970_cov_26.904707	350	429	31	4	79	0.0506329
NODE_7225_length_970_cov_26.904707	350	429	32	17	79	0.2151899
NODE_7225_length_970_cov_26.904707	350	429	0	20	79	0.2531646
NODE_7225_length_970_cov_26.904707	350	429	14	19	79	0.2405063
NODE_7225_length_970_cov_26.904707	350	429	21	1	79	0.0126582
NODE_7225_length_970_cov_26.904707	350	429	22	3	79	0.0379747
NODE_7225_length_970_cov_26.904707	350	429	24	1	79	0.0126582
NODE_7225_length_970_cov_26.904707	350	429	25	1	79	0.0126582
NODE_7225_length_970_cov_26.904707	350	429	27	4	79	0.0506329
NODE_7225_length_970_cov_26.904707	350	429	29	9	79	0.1139240
NODE_7225_length_970_cov_26.904707	350	429	31	4	79	0.0506329
NODE_7225_length_970_cov_26.904707	350	429	32	17	79	0.2151899
NODE_7225_length_970_cov_26.904707	350	429	0	20	79	0.2531646
NODE_7225_length_970_cov_26.904707	350	429	14	19	79	0.2405063
NODE_7225_length_970_cov_26.904707	350	429	21	1	79	0.0126582
NODE_7225_length_970_cov_26.904707	350	429	22	3	79	0.0379747
NODE_7225_length_970_cov_26.904707	350	429	24	1	79	0.0126582
NODE_7225_length_970_cov_26.904707	350	429	25	1	79	0.0126582
NODE_7225_length_970_cov_26.904707	350	429	27	4	79	0.0506329
NODE_7225_length_970_cov_26.904707	350	429	29	9	79	0.1139240
NODE_7225_length_970_cov_26.904707	350	429	31	4	79	0.0506329
NODE_7225_length_970_cov_26.904707	350	429	32	17	79	0.2151899
NODE_7226_length_970_cov_26.040184	266	346	0	80	80	1.0000000
NODE_7226_length_970_cov_26.040184	319	399	0	80	80	1.0000000
NODE_7226_length_970_cov_26.040184	395	475	0	80	80	1.0000000
NODE_7226_length_970_cov_26.040184	448	528	0	80	80	1.0000000
NODE_7227_length_970_cov_19.291619	415	495	4	7	80	0.0875000
NODE_7227_length_970_cov_19.291619	415	495	6	24	80	0.3000000
NODE_7227_length_970_cov_19.291619	415	495	8	17	80	0.2125000
NODE_7227_length_970_cov_19.291619	415	495	10	32	80	0.4000000
NODE_7227_length_970_cov_19.291619	468	548	0	17	80	0.2125000
NODE_7227_length_970_cov_19.291619	468	548	2	27	80	0.3375000
NODE_7227_length_970_cov_19.291619	468	548	4	16	80	0.2000000
NODE_7227_length_970_cov_19.291619	468	548	10	20	80	0.2500000
NODE_7228_length_970_cov_17.731343	557	637	6	33	80	0.4125000
NODE_7228_length_970_cov_17.731343	557	637	8	4	80	0.0500000
NODE_7228_length_970_cov_17.731343	557	637	10	14	80	0.1750000
NODE_7228_length_970_cov_17.731343	557	637	14	29	80	0.3625000
NODE_7228_length_970_cov_17.731343	610	690	0	6	80	0.0750000
NODE_7228_length_970_cov_17.731343	610	690	6	21	80	0.2625000
NODE_7228_length_970_cov_17.731343	610	690	8	29	80	0.3625000
NODE_7228_length_970_cov_17.731343	610	690	10	14	80	0.1750000
NODE_7228_length_970_cov_17.731343	610	690	14	10	80	0.1250000
NODE_7229_length_970_cov_15.135476	407	487	0	80	80	1.0000000
NODE_7229_length_970_cov_15.135476	460	540	0	80	80	1.0000000
NODE_7230_length_970_cov_12.675086	534	614	0	80	80	1.0000000
NODE_7230_length_970_cov_12.675086	587	667	0	80	80	1.0000000
NODE_7231_length_970_cov_8.095293	487	567	0	14	80	0.1750000
NODE_7231_length_970_cov_8.095293	487	567	2	62	80	0.7750000
NODE_7231_length_970_cov_8.095293	487	567	4	4	80	0.0500000
NODE_7231_length_970_cov_8.095293	540	620	0	67	80	0.8375000
NODE_7231_length_970_cov_8.095293	540	620	2	13	80	0.1625000
NODE_7233_length_970_cov_7.127440	336	416	0	80	80	1.0000000
NODE_7233_length_970_cov_7.127440	389	469	0	80	80	1.0000000
NODE_7234_length_970_cov_5.824340	0	56	0	56	56	1.0000000
NODE_7246_length_969_cov_47.172414	419	499	4	27	80	0.3375000
NODE_7246_length_969_cov_47.172414	419	499	6	16	80	0.2000000
NODE_7246_length_969_cov_47.172414	419	499	8	37	80	0.4625000
NODE_7246_length_969_cov_47.172414	472	552	2	28	80	0.3500000
NODE_7246_length_969_cov_47.172414	472	552	4	14	80	0.1750000
NODE_7246_length_969_cov_47.172414	472	552	5	12	80	0.1500000
NODE_7246_length_969_cov_47.172414	472	552	6	23	80	0.2875000
NODE_7246_length_969_cov_47.172414	472	552	8	3	80	0.0375000
NODE_7247_length_969_cov_28.234483	327	407	0	43	80	0.5375000
NODE_7247_length_969_cov_28.234483	327	407	2	37	80	0.4625000
NODE_7247_length_969_cov_28.234483	380	460	0	15	80	0.1875000
NODE_7247_length_969_cov_28.234483	380	460	2	65	80	0.8125000
NODE_7248_length_969_cov_27.131034	392	472	0	6	80	0.0750000
NODE_7248_length_969_cov_27.131034	392	472	2	74	80	0.9250000
NODE_7248_length_969_cov_27.131034	445	525	0	59	80	0.7375000
NODE_7248_length_969_cov_27.131034	445	525	2	21	80	0.2625000
NODE_7249_length_969_cov_26.345977	466	542	0	76	76	1.0000000
NODE_7249_length_969_cov_26.345977	515	595	0	80	80	1.0000000
NODE_7250_length_969_cov_18.954023	274	354	0	4	80	0.0500000
NODE_7250_length_969_cov_18.954023	274	354	2	58	80	0.7250000
NODE_7250_length_969_cov_18.954023	274	354	4	18	80	0.2250000
NODE_7250_length_969_cov_18.954023	327	407	2	37	80	0.4625000
NODE_7250_length_969_cov_18.954023	327	407	4	43	80	0.5375000
NODE_7251_length_969_cov_17.952874	410	490	9	13	80	0.1625000
NODE_7251_length_969_cov_17.952874	410	490	10	10	80	0.1250000
NODE_7251_length_969_cov_17.952874	410	490	12	57	80	0.7125000
NODE_7251_length_969_cov_17.952874	463	543	2	6	80	0.0750000
NODE_7251_length_969_cov_17.952874	463	543	7	14	80	0.1750000
NODE_7251_length_969_cov_17.952874	463	543	12	60	80	0.7500000
NODE_7251_length_969_cov_17.952874	693	773	2	5	80	0.0625000
NODE_7251_length_969_cov_17.952874	693	773	4	23	80	0.2875000
NODE_7251_length_969_cov_17.952874	693	773	12	52	80	0.6500000
NODE_7251_length_969_cov_17.952874	746	826	8	4	80	0.0500000
NODE_7251_length_969_cov_17.952874	746	826	10	31	80	0.3875000
NODE_7251_length_969_cov_17.952874	746	826	12	36	80	0.4500000
NODE_7251_length_969_cov_17.952874	746	826	14	9	80	0.1125000
NODE_7252_length_969_cov_15.942529	446	526	0	2	80	0.0250000
NODE_7252_length_969_cov_15.942529	446	526	4	78	80	0.9750000
NODE_7252_length_969_cov_15.942529	499	579	0	55	80	0.6875000
NODE_7252_length_969_cov_15.942529	499	579	4	25	80	0.3125000
NODE_7253_length_969_cov_9.926437	573	653	0	80	80	1.0000000
NODE_7253_length_969_cov_9.926437	626	706	0	80	80	1.0000000
NODE_7265_length_968_cov_59.162255	376	456	0	80	80	1.0000000
NODE_7265_length_968_cov_59.162255	429	509	0	80	80	1.0000000
NODE_7265_length_968_cov_59.162255	505	585	0	80	80	1.0000000
NODE_7265_length_968_cov_59.162255	558	638	0	80	80	1.0000000
NODE_7266_length_968_cov_40.005754	514	594	0	80	80	1.0000000
NODE_7266_length_968_cov_40.005754	567	647	0	80	80	1.0000000
NODE_7267_length_968_cov_36.521289	450	530	0	80	80	1.0000000
NODE_7267_length_968_cov_36.521289	503	583	0	80	80	1.0000000
NODE_7268_length_968_cov_34.799770	474	554	0	4	80	0.0500000
NODE_7268_length_968_cov_34.799770	474	554	2	7	80	0.0875000
NODE_7268_length_968_cov_34.799770	474	554	6	59	80	0.7375000
NODE_7268_length_968_cov_34.799770	474	554	8	10	80	0.1250000
NODE_7268_length_968_cov_34.799770	527	607	2	21	80	0.2625000
NODE_7268_length_968_cov_34.799770	527	607	4	5	80	0.0625000
NODE_7268_length_968_cov_34.799770	527	607	6	17	80	0.2125000
NODE_7268_length_968_cov_34.799770	527	607	8	37	80	0.4625000
NODE_7269_length_968_cov_26.929804	293	372	0	69	79	0.8734177
NODE_7269_length_968_cov_26.929804	293	372	2	10	79	0.1265823
NODE_7269_length_968_cov_26.929804	345	425	0	80	80	1.0000000
NODE_7269_length_968_cov_26.929804	421	501	0	28	80	0.3500000
NODE_7269_length_968_cov_26.929804	421	501	4	31	80	0.3875000
NODE_7269_length_968_cov_26.929804	421	501	6	19	80	0.2375000
NODE_7269_length_968_cov_26.929804	421	501	7	1	80	0.0125000
NODE_7269_length_968_cov_26.929804	421	501	8	1	80	0.0125000
NODE_7269_length_968_cov_26.929804	474	554	4	22	80	0.2750000
NODE_7269_length_968_cov_26.929804	474	554	6	19	80	0.2375000
NODE_7269_length_968_cov_26.929804	474	554	7	1	80	0.0125000
NODE_7269_length_968_cov_26.929804	474	554	8	38	80	0.4750000
NODE_7270_length_968_cov_24.468354	434	514	0	80	80	1.0000000
NODE_7270_length_968_cov_24.468354	487	567	0	80	80	1.0000000
NODE_7271_length_968_cov_23.204833	344	424	0	80	80	1.0000000
NODE_7271_length_968_cov_23.204833	397	477	0	80	80	1.0000000
NODE_7271_length_968_cov_23.204833	473	553	0	80	80	1.0000000
NODE_7271_length_968_cov_23.204833	526	606	0	45	80	0.5625000
NODE_7271_length_968_cov_23.204833	526	606	2	35	80	0.4375000
NODE_7272_length_968_cov_22.321059	417	497	0	80	80	1.0000000
NODE_7272_length_968_cov_22.321059	470	550	0	80	80	1.0000000
NODE_7273_length_968_cov_20.897583	313	393	4	23	80	0.2875000
NODE_7273_length_968_cov_20.897583	313	393	6	57	80	0.7125000
NODE_7273_length_968_cov_20.897583	366	446	0	14	80	0.1750000
NODE_7273_length_968_cov_20.897583	366	446	2	23	80	0.2875000
NODE_7273_length_968_cov_20.897583	366	446	4	39	80	0.4875000
NODE_7273_length_968_cov_20.897583	366	446	6	4	80	0.0500000
NODE_7274_length_968_cov_19.296893	401	481	5	23	80	0.2875000
NODE_7274_length_968_cov_19.296893	401	481	10	1	80	0.0125000
NODE_7274_length_968_cov_19.296893	401	481	12	30	80	0.3750000
NODE_7274_length_968_cov_19.296893	401	481	14	1	80	0.0125000
NODE_7274_length_968_cov_19.296893	401	481	15	25	80	0.3125000
NODE_7274_length_968_cov_19.296893	454	534	12	80	80	1.0000000
NODE_7275_length_968_cov_18.100115	573	653	0	80	80	1.0000000
NODE_7275_length_968_cov_18.100115	626	706	0	58	80	0.7250000
NODE_7275_length_968_cov_18.100115	626	706	2	22	80	0.2750000
NODE_7276_length_968_cov_15.576525	472	552	0	35	80	0.4375000
NODE_7276_length_968_cov_15.576525	472	552	2	45	80	0.5625000
NODE_7276_length_968_cov_15.576525	525	605	2	80	80	1.0000000
NODE_7277_length_968_cov_15.024166	329	409	0	80	80	1.0000000
NODE_7277_length_968_cov_15.024166	382	462	0	80	80	1.0000000
NODE_7277_length_968_cov_15.024166	458	538	0	74	80	0.9250000
NODE_7277_length_968_cov_15.024166	458	538	2	6	80	0.0750000
NODE_7277_length_968_cov_15.024166	511	591	0	21	80	0.2625000
NODE_7277_length_968_cov_15.024166	511	591	2	59	80	0.7375000
NODE_7278_length_968_cov_13.911392	674	754	8	41	80	0.5125000
NODE_7278_length_968_cov_13.911392	674	754	10	39	80	0.4875000
NODE_7278_length_968_cov_13.911392	727	807	0	15	80	0.1875000
NODE_7278_length_968_cov_13.911392	727	807	2	25	80	0.3125000
NODE_7278_length_968_cov_13.911392	727	807	10	40	80	0.5000000
NODE_7279_length_968_cov_11.698504	598	678	0	61	80	0.7625000
NODE_7279_length_968_cov_11.698504	598	678	2	19	80	0.2375000
NODE_7279_length_968_cov_11.698504	651	731	0	80	80	1.0000000
NODE_7280_length_968_cov_6.490219	538	618	0	45	80	0.5625000
NODE_7280_length_968_cov_6.490219	538	618	2	35	80	0.4375000
NODE_7280_length_968_cov_6.490219	591	671	0	80	80	1.0000000
NODE_7294_length_967_cov_25.572581	332	412	0	6	80	0.0750000
NODE_7294_length_967_cov_25.572581	332	412	6	74	80	0.9250000
NODE_7294_length_967_cov_25.572581	385	465	0	22	80	0.2750000
NODE_7294_length_967_cov_25.572581	385	465	6	58	80	0.7250000
NODE_7295_length_967_cov_24.919355	396	476	0	41	80	0.5125000
NODE_7295_length_967_cov_24.919355	396	476	4	39	80	0.4875000
NODE_7295_length_967_cov_24.919355	449	529	4	80	80	1.0000000
NODE_7296_length_967_cov_19.137097	374	454	0	3	80	0.0375000
NODE_7296_length_967_cov_19.137097	374	454	2	77	80	0.9625000
NODE_7296_length_967_cov_19.137097	427	507	0	56	80	0.7000000
NODE_7296_length_967_cov_19.137097	427	507	2	24	80	0.3000000
NODE_7296_length_967_cov_19.137097	503	583	0	80	80	1.0000000
NODE_7296_length_967_cov_19.137097	556	636	0	80	80	1.0000000
NODE_7297_length_967_cov_14.654378	453	533	0	14	80	0.1750000
NODE_7297_length_967_cov_14.654378	453	533	2	64	80	0.8000000
NODE_7297_length_967_cov_14.654378	453	533	4	2	80	0.0250000
NODE_7297_length_967_cov_14.654378	506	586	2	54	80	0.6750000
NODE_7297_length_967_cov_14.654378	506	586	4	26	80	0.3250000
NODE_7298_length_967_cov_8.027650	280	360	0	80	80	1.0000000
NODE_7298_length_967_cov_8.027650	333	413	0	80	80	1.0000000
NODE_7310_length_966_cov_43.154556	401	474	0	22	73	0.3013699
NODE_7310_length_966_cov_43.154556	401	474	1	20	73	0.2739726
NODE_7310_length_966_cov_43.154556	401	474	2	31	73	0.4246575
NODE_7310_length_966_cov_43.154556	447	527	0	75	80	0.9375000
NODE_7310_length_966_cov_43.154556	447	527	1	5	80	0.0625000
NODE_7311_length_966_cov_42.877739	477	557	0	34	80	0.4250000
NODE_7311_length_966_cov_42.877739	477	557	2	46	80	0.5750000
NODE_7311_length_966_cov_42.877739	530	610	0	20	80	0.2500000
NODE_7311_length_966_cov_42.877739	530	610	2	60	80	0.7500000
NODE_7312_length_966_cov_39.956171	283	363	0	16	80	0.2000000
NODE_7312_length_966_cov_39.956171	283	363	10	64	80	0.8000000
NODE_7312_length_966_cov_39.956171	336	416	10	80	80	1.0000000
NODE_7312_length_966_cov_39.956171	412	494	0	74	82	0.9024390
NODE_7312_length_966_cov_39.956171	412	494	9	1	82	0.0121951
NODE_7312_length_966_cov_39.956171	412	494	10	7	82	0.0853659
NODE_7312_length_966_cov_39.956171	467	547	0	80	80	1.0000000
NODE_7313_length_966_cov_36.160323	461	541	0	72	80	0.9000000
NODE_7313_length_966_cov_36.160323	461	541	2	1	80	0.0125000
NODE_7313_length_966_cov_36.160323	461	541	4	7	80	0.0875000
NODE_7313_length_966_cov_36.160323	461	541	0	72	80	0.9000000
NODE_7313_length_966_cov_36.160323	461	541	2	1	80	0.0125000
NODE_7313_length_966_cov_36.160323	461	541	4	7	80	0.0875000
NODE_7313_length_966_cov_36.160323	514	594	0	19	80	0.2375000
NODE_7313_length_966_cov_36.160323	514	594	2	1	80	0.0125000
NODE_7313_length_966_cov_36.160323	514	594	4	60	80	0.7500000
NODE_7314_length_966_cov_18.658593	408	488	0	44	80	0.5500000
NODE_7314_length_966_cov_18.658593	408	488	2	31	80	0.3875000
NODE_7314_length_966_cov_18.658593	408	488	3	2	80	0.0250000
NODE_7314_length_966_cov_18.658593	408	488	7	3	80	0.0375000
NODE_7314_length_966_cov_18.658593	461	541	2	22	80	0.2750000
NODE_7314_length_966_cov_18.658593	461	541	3	2	80	0.0250000
NODE_7314_length_966_cov_18.658593	461	541	5	2	80	0.0250000
NODE_7314_length_966_cov_18.658593	461	541	6	11	80	0.1375000
NODE_7314_length_966_cov_18.658593	461	541	7	43	80	0.5375000
NODE_7315_length_966_cov_17.606690	341	421	0	80	80	1.0000000
NODE_7315_length_966_cov_17.606690	394	474	0	80	80	1.0000000
NODE_7316_length_966_cov_16.064591	296	376	0	80	80	1.0000000
NODE_7316_length_966_cov_16.064591	349	429	0	80	80	1.0000000
NODE_7317_length_966_cov_15.155709	562	642	0	80	80	1.0000000
NODE_7317_length_966_cov_15.155709	615	695	0	80	80	1.0000000
NODE_7318_length_966_cov_7.726644	280	360	0	80	80	1.0000000
NODE_7318_length_966_cov_7.726644	334	414	0	80	80	1.0000000
NODE_7335_length_965_cov_51.524249	197	277	0	10	80	0.1250000
NODE_7335_length_965_cov_51.524249	197	277	2	70	80	0.8750000
NODE_7335_length_965_cov_51.524249	250	327	0	60	77	0.7792208
NODE_7335_length_965_cov_51.524249	250	327	2	17	77	0.2207792
NODE_7335_length_965_cov_51.524249	329	406	0	6	77	0.0779221
NODE_7335_length_965_cov_51.524249	329	406	2	46	77	0.5974026
NODE_7335_length_965_cov_51.524249	329	406	6	15	77	0.1948052
NODE_7335_length_965_cov_51.524249	329	406	8	10	77	0.1298701
NODE_7335_length_965_cov_51.524249	379	459	2	2	80	0.0250000
NODE_7335_length_965_cov_51.524249	379	459	6	50	80	0.6250000
NODE_7335_length_965_cov_51.524249	379	459	8	28	80	0.3500000
NODE_7336_length_965_cov_18.072748	515	595	2	80	80	1.0000000
NODE_7336_length_965_cov_18.072748	568	648	0	41	80	0.5125000
NODE_7336_length_965_cov_18.072748	568	648	2	39	80	0.4875000
NODE_7337_length_965_cov_14.277136	342	422	0	35	80	0.4375000
NODE_7337_length_965_cov_14.277136	342	422	2	45	80	0.5625000
NODE_7337_length_965_cov_14.277136	395	470	0	75	75	1.0000000
NODE_7338_length_965_cov_7.808314	567	647	0	35	80	0.4375000
NODE_7338_length_965_cov_7.808314	567	647	2	45	80	0.5625000
NODE_7338_length_965_cov_7.808314	620	700	2	80	80	1.0000000
NODE_7344_length_964_cov_60.153757	197	277	17	7	80	0.0875000
NODE_7344_length_964_cov_60.153757	197	277	18	4	80	0.0500000
NODE_7344_length_964_cov_60.153757	197	277	20	8	80	0.1000000
NODE_7344_length_964_cov_60.153757	197	277	25	1	80	0.0125000
NODE_7344_length_964_cov_60.153757	197	277	27	9	80	0.1125000
NODE_7344_length_964_cov_60.153757	197	277	28	1	80	0.0125000
NODE_7344_length_964_cov_60.153757	197	277	29	1	80	0.0125000
NODE_7344_length_964_cov_60.153757	197	277	30	6	80	0.0750000
NODE_7344_length_964_cov_60.153757	197	277	33	1	80	0.0125000
NODE_7344_length_964_cov_60.153757	197	277	35	4	80	0.0500000
NODE_7344_length_964_cov_60.153757	197	277	37	1	80	0.0125000
NODE_7344_length_964_cov_60.153757	197	277	41	5	80	0.0625000
NODE_7344_length_964_cov_60.153757	197	277	53	3	80	0.0375000
NODE_7344_length_964_cov_60.153757	197	277	54	2	80	0.0250000
NODE_7344_length_964_cov_60.153757	197	277	55	2	80	0.0250000
NODE_7344_length_964_cov_60.153757	197	277	59	1	80	0.0125000
NODE_7344_length_964_cov_60.153757	197	277	61	1	80	0.0125000
NODE_7344_length_964_cov_60.153757	197	277	64	1	80	0.0125000
NODE_7344_length_964_cov_60.153757	197	277	66	1	80	0.0125000
NODE_7344_length_964_cov_60.153757	197	277	67	3	80	0.0375000
NODE_7344_length_964_cov_60.153757	197	277	68	2	80	0.0250000
NODE_7344_length_964_cov_60.153757	197	277	69	4	80	0.0500000
NODE_7344_length_964_cov_60.153757	197	277	70	2	80	0.0250000
NODE_7344_length_964_cov_60.153757	197	277	72	3	80	0.0375000
NODE_7344_length_964_cov_60.153757	197	277	78	2	80	0.0250000
NODE_7344_length_964_cov_60.153757	197	277	80	2	80	0.0250000
NODE_7344_length_964_cov_60.153757	197	277	82	1	80	0.0125000
NODE_7344_length_964_cov_60.153757	197	277	84	2	80	0.0250000
NODE_7344_length_964_cov_60.153757	250	314	2	5	64	0.0781250
NODE_7344_length_964_cov_60.153757	250	314	3	1	64	0.0156250
NODE_7344_length_964_cov_60.153757	250	314	5	10	64	0.1562500
NODE_7344_length_964_cov_60.153757	250	314	7	6	64	0.0937500
NODE_7344_length_964_cov_60.153757	250	314	9	2	64	0.0312500
NODE_7344_length_964_cov_60.153757	250	314	11	8	64	0.1250000
NODE_7344_length_964_cov_60.153757	250	314	14	3	64	0.0468750
NODE_7344_length_964_cov_60.153757	250	314	16	2	64	0.0312500
NODE_7344_length_964_cov_60.153757	250	314	17	7	64	0.1093750
NODE_7344_length_964_cov_60.153757	250	314	18	4	64	0.0625000
NODE_7344_length_964_cov_60.153757	250	314	20	8	64	0.1250000
NODE_7344_length_964_cov_60.153757	250	314	25	1	64	0.0156250
NODE_7344_length_964_cov_60.153757	250	314	27	7	64	0.1093750
NODE_7344_length_964_cov_60.153757	672	752	0	72	80	0.9000000
NODE_7344_length_964_cov_60.153757	672	752	2	8	80	0.1000000
NODE_7344_length_964_cov_60.153757	725	805	0	80	80	1.0000000
NODE_7345_length_964_cov_45.564162	314	394	0	44	80	0.5500000
NODE_7345_length_964_cov_45.564162	314	394	4	36	80	0.4500000
NODE_7345_length_964_cov_45.564162	367	447	0	16	80	0.2000000
NODE_7345_length_964_cov_45.564162	367	447	4	64	80	0.8000000
NODE_7345_length_964_cov_45.564162	443	523	0	45	80	0.5625000
NODE_7345_length_964_cov_45.564162	443	523	2	2	80	0.0250000
NODE_7345_length_964_cov_45.564162	443	523	4	33	80	0.4125000
NODE_7345_length_964_cov_45.564162	496	566	2	38	70	0.5428572
NODE_7345_length_964_cov_45.564162	496	566	4	32	70	0.4571429
NODE_7346_length_964_cov_33.487861	363	443	0	80	80	1.0000000
NODE_7346_length_964_cov_33.487861	416	496	0	80	80	1.0000000
NODE_7347_length_964_cov_33.077457	408	488	0	80	80	1.0000000
NODE_7347_length_964_cov_33.077457	461	541	0	80	80	1.0000000
NODE_7347_length_964_cov_33.077457	537	617	0	80	80	1.0000000
NODE_7347_length_964_cov_33.077457	590	670	0	80	80	1.0000000
NODE_7348_length_964_cov_29.250867	419	499	16	32	80	0.4000000
NODE_7348_length_964_cov_29.250867	419	499	17	25	80	0.3125000
NODE_7348_length_964_cov_29.250867	419	499	22	23	80	0.2875000
NODE_7348_length_964_cov_29.250867	472	552	0	4	80	0.0500000
NODE_7348_length_964_cov_29.250867	472	552	1	2	80	0.0250000
NODE_7348_length_964_cov_29.250867	472	552	7	8	80	0.1000000
NODE_7348_length_964_cov_29.250867	472	552	16	4	80	0.0500000
NODE_7348_length_964_cov_29.250867	472	552	22	62	80	0.7750000
NODE_7349_length_964_cov_20.191908	228	301	2	1	73	0.0136986
NODE_7349_length_964_cov_20.191908	228	301	6	72	73	0.9863014
NODE_7349_length_964_cov_20.191908	349	429	2	9	80	0.1125000
NODE_7349_length_964_cov_20.191908	349	429	4	48	80	0.6000000
NODE_7349_length_964_cov_20.191908	349	429	6	23	80	0.2875000
NODE_7349_length_964_cov_20.191908	402	482	2	55	80	0.6875000
NODE_7349_length_964_cov_20.191908	402	482	4	25	80	0.3125000
NODE_7350_length_964_cov_18.510983	486	566	0	24	80	0.3000000
NODE_7350_length_964_cov_18.510983	486	566	2	56	80	0.7000000
NODE_7350_length_964_cov_18.510983	539	619	0	77	80	0.9625000
NODE_7350_length_964_cov_18.510983	539	619	2	3	80	0.0375000
NODE_7351_length_964_cov_16.613873	464	544	0	70	80	0.8750000
NODE_7351_length_964_cov_16.613873	464	544	2	10	80	0.1250000
NODE_7351_length_964_cov_16.613873	517	597	0	78	80	0.9750000
NODE_7351_length_964_cov_16.613873	517	597	2	2	80	0.0250000
NODE_7352_length_964_cov_15.717919	411	491	0	80	80	1.0000000
NODE_7352_length_964_cov_15.717919	464	544	0	80	80	1.0000000
NODE_7352_length_964_cov_15.717919	540	620	0	80	80	1.0000000
NODE_7352_length_964_cov_15.717919	593	668	0	75	75	1.0000000
NODE_7353_length_964_cov_14.591908	521	601	0	80	80	1.0000000
NODE_7353_length_964_cov_14.591908	574	654	0	80	80	1.0000000
NODE_7354_length_964_cov_11.589595	475	555	0	80	80	1.0000000
NODE_7354_length_964_cov_11.589595	528	608	0	80	80	1.0000000
NODE_7355_length_964_cov_7.639306	420	500	0	80	80	1.0000000
NODE_7355_length_964_cov_7.639306	473	553	0	80	80	1.0000000
NODE_7356_length_964_cov_7.596532	534	614	0	80	80	1.0000000
NODE_7356_length_964_cov_7.596532	587	667	0	80	80	1.0000000
NODE_7357_length_964_cov_6.568786	368	448	0	80	80	1.0000000
NODE_7357_length_964_cov_6.568786	421	501	0	80	80	1.0000000
NODE_7359_length_964_cov_6.027746	890	940	12	10	50	0.2000000
NODE_7359_length_964_cov_6.027746	890	940	14	2	50	0.0400000
NODE_7359_length_964_cov_6.027746	890	940	16	3	50	0.0600000
NODE_7359_length_964_cov_6.027746	890	940	18	5	50	0.1000000
NODE_7359_length_964_cov_6.027746	890	940	20	13	50	0.2600000
NODE_7359_length_964_cov_6.027746	890	940	22	3	50	0.0600000
NODE_7359_length_964_cov_6.027746	890	940	24	14	50	0.2800000
NODE_7361_length_964_cov_4.665896	706	772	0	66	66	1.0000000
NODE_7376_length_963_cov_66.251157	456	536	4	7	80	0.0875000
NODE_7376_length_963_cov_66.251157	456	536	14	8	80	0.1000000
NODE_7376_length_963_cov_66.251157	456	536	16	29	80	0.3625000
NODE_7376_length_963_cov_66.251157	456	536	18	36	80	0.4500000
NODE_7376_length_963_cov_66.251157	509	589	0	16	80	0.2000000
NODE_7376_length_963_cov_66.251157	509	589	12	24	80	0.3000000
NODE_7376_length_963_cov_66.251157	509	589	14	21	80	0.2625000
NODE_7376_length_963_cov_66.251157	509	589	16	14	80	0.1750000
NODE_7376_length_963_cov_66.251157	509	589	18	5	80	0.0625000
NODE_7376_length_963_cov_66.251157	585	665	0	24	80	0.3000000
NODE_7376_length_963_cov_66.251157	585	665	2	56	80	0.7000000
NODE_7376_length_963_cov_66.251157	638	718	0	36	80	0.4500000
NODE_7376_length_963_cov_66.251157	638	718	2	44	80	0.5500000
NODE_7377_length_963_cov_35.638889	381	461	0	43	80	0.5375000
NODE_7377_length_963_cov_35.638889	381	461	2	37	80	0.4625000
NODE_7377_length_963_cov_35.638889	434	514	2	80	80	1.0000000
NODE_7377_length_963_cov_35.638889	510	590	0	61	80	0.7625000
NODE_7377_length_963_cov_35.638889	510	590	2	19	80	0.2375000
NODE_7377_length_963_cov_35.638889	563	643	0	80	80	1.0000000
NODE_7378_length_963_cov_33.642361	347	427	0	80	80	1.0000000
NODE_7378_length_963_cov_33.642361	400	480	0	80	80	1.0000000
NODE_7379_length_963_cov_18.626157	392	472	10	11	80	0.1375000
NODE_7379_length_963_cov_18.626157	392	472	12	58	80	0.7250000
NODE_7379_length_963_cov_18.626157	392	472	14	11	80	0.1375000
NODE_7379_length_963_cov_18.626157	445	525	4	6	80	0.0750000
NODE_7379_length_963_cov_18.626157	445	525	8	17	80	0.2125000
NODE_7379_length_963_cov_18.626157	445	525	12	16	80	0.2000000
NODE_7379_length_963_cov_18.626157	445	525	14	31	80	0.3875000
NODE_7379_length_963_cov_18.626157	445	525	16	10	80	0.1250000
NODE_7380_length_963_cov_17.750000	402	482	0	67	80	0.8375000
NODE_7380_length_963_cov_17.750000	402	482	2	13	80	0.1625000
NODE_7380_length_963_cov_17.750000	455	535	0	14	80	0.1750000
NODE_7380_length_963_cov_17.750000	455	535	2	66	80	0.8250000
NODE_7381_length_963_cov_17.023148	542	622	0	80	80	1.0000000
NODE_7381_length_963_cov_17.023148	595	675	0	80	80	1.0000000
NODE_7382_length_963_cov_16.642361	481	561	7	80	80	1.0000000
NODE_7382_length_963_cov_16.642361	534	614	0	14	80	0.1750000
NODE_7382_length_963_cov_16.642361	534	614	7	66	80	0.8250000
NODE_7382_length_963_cov_16.642361	572	629	0	29	57	0.5087720
NODE_7382_length_963_cov_16.642361	572	629	7	28	57	0.4912281
NODE_7383_length_963_cov_14.961806	283	363	0	45	80	0.5625000
NODE_7383_length_963_cov_14.961806	283	363	3	35	80	0.4375000
NODE_7383_length_963_cov_14.961806	336	416	3	36	80	0.4500000
NODE_7383_length_963_cov_14.961806	336	416	4	44	80	0.5500000
NODE_7384_length_963_cov_13.341435	558	638	0	20	80	0.2500000
NODE_7384_length_963_cov_13.341435	558	638	4	60	80	0.7500000
NODE_7384_length_963_cov_13.341435	611	691	0	30	80	0.3750000
NODE_7384_length_963_cov_13.341435	611	691	4	50	80	0.6250000
NODE_7386_length_963_cov_9.520833	459	539	0	80	80	1.0000000
NODE_7386_length_963_cov_9.520833	512	592	0	80	80	1.0000000
NODE_7386_length_963_cov_9.520833	588	662	0	74	74	1.0000000
NODE_7386_length_963_cov_9.520833	641	724	0	83	83	1.0000000
NODE_7388_length_963_cov_7.510417	781	842	12	20	61	0.3278688
NODE_7388_length_963_cov_7.510417	781	842	17	1	61	0.0163934
NODE_7388_length_963_cov_7.510417	781	842	18	5	61	0.0819672
NODE_7388_length_963_cov_7.510417	781	842	20	12	61	0.1967213
NODE_7388_length_963_cov_7.510417	781	842	23	1	61	0.0163934
NODE_7388_length_963_cov_7.510417	781	842	24	7	61	0.1147541
NODE_7388_length_963_cov_7.510417	781	842	30	5	61	0.0819672
NODE_7388_length_963_cov_7.510417	781	842	32	6	61	0.0983607
NODE_7388_length_963_cov_7.510417	781	842	34	1	61	0.0163934
NODE_7388_length_963_cov_7.510417	781	842	36	3	61	0.0491803
NODE_7388_length_963_cov_7.510417	815	894	20	4	79	0.0506329
NODE_7388_length_963_cov_7.510417	815	894	23	1	79	0.0126582
NODE_7388_length_963_cov_7.510417	815	894	24	7	79	0.0886076
NODE_7388_length_963_cov_7.510417	815	894	26	7	79	0.0886076
NODE_7388_length_963_cov_7.510417	815	894	30	5	79	0.0632911
NODE_7388_length_963_cov_7.510417	815	894	32	8	79	0.1012658
NODE_7388_length_963_cov_7.510417	815	894	33	6	79	0.0759494
NODE_7388_length_963_cov_7.510417	815	894	34	1	79	0.0126582
NODE_7388_length_963_cov_7.510417	815	894	36	40	79	0.5063291
NODE_7392_length_963_cov_3.755787	378	458	0	80	80	1.0000000
NODE_7392_length_963_cov_3.755787	431	511	0	36	80	0.4500000
NODE_7392_length_963_cov_3.755787	431	511	2	4	80	0.0500000
NODE_7392_length_963_cov_3.755787	431	511	4	40	80	0.5000000
NODE_7397_length_963_cov_1.931713	426	485	0	32	59	0.5423729
NODE_7397_length_963_cov_1.931713	426	485	4	27	59	0.4576271
NODE_7404_length_962_cov_37.169177	356	436	0	59	80	0.7375000
NODE_7404_length_962_cov_37.169177	356	436	2	21	80	0.2625000
NODE_7404_length_962_cov_37.169177	409	489	0	12	80	0.1500000
NODE_7404_length_962_cov_37.169177	409	489	2	68	80	0.8500000
NODE_7405_length_962_cov_28.852839	474	554	0	80	80	1.0000000
NODE_7405_length_962_cov_28.852839	527	607	0	80	80	1.0000000
NODE_7405_length_962_cov_28.852839	603	683	0	66	80	0.8250000
NODE_7405_length_962_cov_28.852839	603	683	1	9	80	0.1125000
NODE_7405_length_962_cov_28.852839	603	683	3	5	80	0.0625000
NODE_7405_length_962_cov_28.852839	656	736	0	13	80	0.1625000
NODE_7405_length_962_cov_28.852839	656	736	1	9	80	0.1125000
NODE_7405_length_962_cov_28.852839	656	736	3	8	80	0.1000000
NODE_7405_length_962_cov_28.852839	656	736	4	50	80	0.6250000
NODE_7406_length_962_cov_27.859791	441	521	0	8	80	0.1000000
NODE_7406_length_962_cov_27.859791	441	521	1	9	80	0.1125000
NODE_7406_length_962_cov_27.859791	441	521	2	63	80	0.7875000
NODE_7406_length_962_cov_27.859791	494	574	2	80	80	1.0000000
NODE_7407_length_962_cov_21.019699	318	398	0	80	80	1.0000000
NODE_7407_length_962_cov_21.019699	371	451	0	80	80	1.0000000
NODE_7408_length_962_cov_16.792584	350	430	0	29	80	0.3625000
NODE_7408_length_962_cov_16.792584	350	430	4	51	80	0.6375000
NODE_7408_length_962_cov_16.792584	403	483	0	80	80	1.0000000
NODE_7409_length_962_cov_14.650058	477	557	2	80	80	1.0000000
NODE_7409_length_962_cov_14.650058	530	610	2	80	80	1.0000000
NODE_7410_length_962_cov_7.993048	308	345	0	37	37	1.0000000
NODE_7411_length_962_cov_7.835458	447	527	0	43	80	0.5375000
NODE_7411_length_962_cov_7.835458	447	527	2	37	80	0.4625000
NODE_7411_length_962_cov_7.835458	500	580	0	8	80	0.1000000
NODE_7411_length_962_cov_7.835458	500	580	2	72	80	0.9000000
NODE_7412_length_962_cov_6.855156	490	570	0	62	80	0.7750000
NODE_7412_length_962_cov_6.855156	490	570	2	18	80	0.2250000
NODE_7412_length_962_cov_6.855156	543	623	0	9	80	0.1125000
NODE_7412_length_962_cov_6.855156	543	623	2	71	80	0.8875000
NODE_7417_length_962_cov_1.840093	88	151	0	1	63	0.0158730
NODE_7417_length_962_cov_1.840093	88	151	2	1	63	0.0158730
NODE_7417_length_962_cov_1.840093	88	151	6	1	63	0.0158730
NODE_7417_length_962_cov_1.840093	88	151	14	1	63	0.0158730
NODE_7417_length_962_cov_1.840093	88	151	16	3	63	0.0476190
NODE_7417_length_962_cov_1.840093	88	151	20	1	63	0.0158730
NODE_7417_length_962_cov_1.840093	88	151	22	1	63	0.0158730
NODE_7417_length_962_cov_1.840093	88	151	26	1	63	0.0158730
NODE_7417_length_962_cov_1.840093	88	151	28	1	63	0.0158730
NODE_7417_length_962_cov_1.840093	88	151	30	1	63	0.0158730
NODE_7417_length_962_cov_1.840093	88	151	36	2	63	0.0317460
NODE_7417_length_962_cov_1.840093	88	151	40	2	63	0.0317460
NODE_7417_length_962_cov_1.840093	88	151	44	1	63	0.0158730
NODE_7417_length_962_cov_1.840093	88	151	46	1	63	0.0158730
NODE_7417_length_962_cov_1.840093	88	151	50	2	63	0.0317460
NODE_7417_length_962_cov_1.840093	88	151	56	1	63	0.0158730
NODE_7417_length_962_cov_1.840093	88	151	60	1	63	0.0158730
NODE_7417_length_962_cov_1.840093	88	151	62	2	63	0.0317460
NODE_7417_length_962_cov_1.840093	88	151	66	3	63	0.0476190
NODE_7417_length_962_cov_1.840093	88	151	68	4	63	0.0634921
NODE_7417_length_962_cov_1.840093	88	151	82	2	63	0.0317460
NODE_7417_length_962_cov_1.840093	88	151	84	1	63	0.0158730
NODE_7417_length_962_cov_1.840093	88	151	87	1	63	0.0158730
NODE_7417_length_962_cov_1.840093	88	151	90	3	63	0.0476190
NODE_7417_length_962_cov_1.840093	88	151	92	2	63	0.0317460
NODE_7417_length_962_cov_1.840093	88	151	96	2	63	0.0317460
NODE_7417_length_962_cov_1.840093	88	151	98	5	63	0.0793651
NODE_7417_length_962_cov_1.840093	88	151	102	1	63	0.0158730
NODE_7417_length_962_cov_1.840093	88	151	106	1	63	0.0158730
NODE_7417_length_962_cov_1.840093	88	151	108	1	63	0.0158730
NODE_7417_length_962_cov_1.840093	88	151	110	8	63	0.1269841
NODE_7417_length_962_cov_1.840093	88	151	112	1	63	0.0158730
NODE_7417_length_962_cov_1.840093	88	151	114	1	63	0.0158730
NODE_7417_length_962_cov_1.840093	88	151	116	3	63	0.0476190
NODE_7422_length_961_cov_61.019722	453	533	0	80	80	1.0000000
NODE_7422_length_961_cov_61.019722	506	586	0	80	80	1.0000000
NODE_7422_length_961_cov_61.019722	614	672	0	58	58	1.0000000
NODE_7423_length_961_cov_51.005800	334	414	18	47	80	0.5875000
NODE_7423_length_961_cov_51.005800	334	414	22	33	80	0.4125000
NODE_7423_length_961_cov_51.005800	387	467	4	51	80	0.6375000
NODE_7423_length_961_cov_51.005800	387	467	18	5	80	0.0625000
NODE_7423_length_961_cov_51.005800	387	467	22	24	80	0.3000000
NODE_7424_length_961_cov_45.923434	391	471	0	41	80	0.5125000
NODE_7424_length_961_cov_45.923434	391	471	4	39	80	0.4875000
NODE_7424_length_961_cov_45.923434	444	524	0	6	80	0.0750000
NODE_7424_length_961_cov_45.923434	444	524	4	74	80	0.9250000
NODE_7426_length_961_cov_21.410673	313	393	4	2	80	0.0250000
NODE_7426_length_961_cov_21.410673	313	393	12	16	80	0.2000000
NODE_7426_length_961_cov_21.410673	313	393	14	9	80	0.1125000
NODE_7426_length_961_cov_21.410673	313	393	16	1	80	0.0125000
NODE_7426_length_961_cov_21.410673	313	393	17	10	80	0.1250000
NODE_7426_length_961_cov_21.410673	313	393	18	17	80	0.2125000
NODE_7426_length_961_cov_21.410673	313	393	22	25	80	0.3125000
NODE_7426_length_961_cov_21.410673	366	446	16	42	80	0.5250000
NODE_7426_length_961_cov_21.410673	366	446	18	2	80	0.0250000
NODE_7426_length_961_cov_21.410673	366	446	19	1	80	0.0125000
NODE_7426_length_961_cov_21.410673	366	446	20	8	80	0.1000000
NODE_7426_length_961_cov_21.410673	366	446	22	27	80	0.3375000
NODE_7427_length_961_cov_18.592807	403	483	0	70	80	0.8750000
NODE_7427_length_961_cov_18.592807	403	483	2	10	80	0.1250000
NODE_7427_length_961_cov_18.592807	456	536	0	80	80	1.0000000
NODE_7428_length_961_cov_17.701856	433	513	0	80	80	1.0000000
NODE_7428_length_961_cov_17.701856	486	566	0	80	80	1.0000000
NODE_7429_length_961_cov_17.020882	505	585	0	9	80	0.1125000
NODE_7429_length_961_cov_17.020882	505	585	2	15	80	0.1875000
NODE_7429_length_961_cov_17.020882	505	585	4	56	80	0.7000000
NODE_7429_length_961_cov_17.020882	558	638	0	53	80	0.6625000
NODE_7429_length_961_cov_17.020882	558	638	2	13	80	0.1625000
NODE_7429_length_961_cov_17.020882	558	638	4	14	80	0.1750000
NODE_7430_length_961_cov_16.235499	328	408	0	80	80	1.0000000
NODE_7430_length_961_cov_16.235499	381	461	0	80	80	1.0000000
NODE_7432_length_961_cov_12.968677	347	427	0	80	80	1.0000000
NODE_7432_length_961_cov_12.968677	400	480	0	80	80	1.0000000
NODE_7433_length_961_cov_9.875870	439	519	0	80	80	1.0000000
NODE_7433_length_961_cov_9.875870	492	572	0	80	80	1.0000000
NODE_7434_length_961_cov_6.172854	624	704	0	11	80	0.1375000
NODE_7434_length_961_cov_6.172854	624	704	2	69	80	0.8625000
NODE_7434_length_961_cov_6.172854	677	757	0	37	80	0.4625000
NODE_7434_length_961_cov_6.172854	677	757	2	43	80	0.5375000
NODE_7435_length_961_cov_4.553364	451	531	0	80	80	1.0000000
NODE_7435_length_961_cov_4.553364	504	584	0	44	80	0.5500000
NODE_7435_length_961_cov_4.553364	504	584	2	36	80	0.4500000
NODE_7440_length_960_cov_35.649245	65	145	0	80	80	1.0000000
NODE_7440_length_960_cov_35.649245	118	198	0	80	80	1.0000000
NODE_7440_length_960_cov_35.649245	446	526	0	80	80	1.0000000
NODE_7440_length_960_cov_35.649245	499	579	0	80	80	1.0000000
NODE_7441_length_960_cov_34.886179	386	466	0	34	80	0.4250000
NODE_7441_length_960_cov_34.886179	386	466	4	46	80	0.5750000
NODE_7441_length_960_cov_34.886179	439	519	0	80	80	1.0000000
NODE_7443_length_960_cov_25.133566	413	493	1	45	80	0.5625000
NODE_7443_length_960_cov_25.133566	413	493	6	14	80	0.1750000
NODE_7443_length_960_cov_25.133566	413	493	7	21	80	0.2625000
NODE_7443_length_960_cov_25.133566	466	546	0	18	80	0.2250000
NODE_7443_length_960_cov_25.133566	466	546	5	11	80	0.1375000
NODE_7443_length_960_cov_25.133566	466	546	6	38	80	0.4750000
NODE_7443_length_960_cov_25.133566	466	546	7	13	80	0.1625000
NODE_7444_length_960_cov_19.336818	385	465	1	80	80	1.0000000
NODE_7444_length_960_cov_19.336818	438	518	1	67	80	0.8375000
NODE_7444_length_960_cov_19.336818	438	518	2	13	80	0.1625000
NODE_7445_length_960_cov_13.221835	460	539	0	79	79	1.0000000
NODE_7445_length_960_cov_13.221835	512	592	0	80	80	1.0000000
NODE_7446_length_960_cov_12.804878	347	427	0	80	80	1.0000000
NODE_7446_length_960_cov_12.804878	400	480	0	80	80	1.0000000
NODE_7462_length_959_cov_39.394186	326	406	0	22	80	0.2750000
NODE_7462_length_959_cov_39.394186	326	406	2	58	80	0.7250000
NODE_7462_length_959_cov_39.394186	379	459	0	75	80	0.9375000
NODE_7462_length_959_cov_39.394186	379	459	2	5	80	0.0625000
NODE_7463_length_959_cov_28.895349	327	407	4	73	80	0.9125000
NODE_7463_length_959_cov_28.895349	327	407	6	7	80	0.0875000
NODE_7463_length_959_cov_28.895349	380	460	4	20	80	0.2500000
NODE_7463_length_959_cov_28.895349	380	460	6	48	80	0.6000000
NODE_7463_length_959_cov_28.895349	380	460	7	2	80	0.0250000
NODE_7463_length_959_cov_28.895349	380	460	8	10	80	0.1250000
NODE_7464_length_959_cov_26.634884	563	643	0	80	80	1.0000000
NODE_7464_length_959_cov_26.634884	616	696	0	44	80	0.5500000
NODE_7464_length_959_cov_26.634884	616	696	2	36	80	0.4500000
NODE_7464_length_959_cov_26.634884	692	772	2	18	80	0.2250000
NODE_7464_length_959_cov_26.634884	692	772	4	35	80	0.4375000
NODE_7464_length_959_cov_26.634884	692	772	6	27	80	0.3375000
NODE_7464_length_959_cov_26.634884	745	825	0	4	80	0.0500000
NODE_7464_length_959_cov_26.634884	745	825	2	23	80	0.2875000
NODE_7464_length_959_cov_26.634884	745	825	4	27	80	0.3375000
NODE_7464_length_959_cov_26.634884	745	825	6	26	80	0.3250000
NODE_7465_length_959_cov_18.862791	320	400	8	32	80	0.4000000
NODE_7465_length_959_cov_18.862791	320	400	10	48	80	0.6000000
NODE_7465_length_959_cov_18.862791	373	453	6	36	80	0.4500000
NODE_7465_length_959_cov_18.862791	373	453	8	18	80	0.2250000
NODE_7465_length_959_cov_18.862791	373	453	10	26	80	0.3250000
NODE_7466_length_959_cov_17.910465	358	438	0	24	80	0.3000000
NODE_7466_length_959_cov_17.910465	358	438	2	56	80	0.7000000
NODE_7466_length_959_cov_17.910465	411	491	0	77	80	0.9625000
NODE_7466_length_959_cov_17.910465	411	491	2	3	80	0.0375000
NODE_7467_length_959_cov_15.337209	267	347	0	32	80	0.4000000
NODE_7467_length_959_cov_15.337209	267	347	4	22	80	0.2750000
NODE_7467_length_959_cov_15.337209	267	347	7	26	80	0.3250000
NODE_7467_length_959_cov_15.337209	320	400	4	1	80	0.0125000
NODE_7467_length_959_cov_15.337209	320	400	7	35	80	0.4375000
NODE_7467_length_959_cov_15.337209	320	400	10	44	80	0.5500000
NODE_7468_length_959_cov_9.005814	529	609	2	80	80	1.0000000
NODE_7468_length_959_cov_9.005814	582	662	1	5	80	0.0625000
NODE_7468_length_959_cov_9.005814	582	662	2	75	80	0.9375000
NODE_7469_length_959_cov_8.163953	392	472	0	12	80	0.1500000
NODE_7469_length_959_cov_8.163953	392	472	4	45	80	0.5625000
NODE_7469_length_959_cov_8.163953	392	472	6	23	80	0.2875000
NODE_7469_length_959_cov_8.163953	445	525	4	4	80	0.0500000
NODE_7469_length_959_cov_8.163953	445	525	6	76	80	0.9500000
NODE_7470_length_959_cov_7.097674	401	481	0	80	80	1.0000000
NODE_7470_length_959_cov_7.097674	454	534	0	80	80	1.0000000
NODE_7472_length_959_cov_4.603488	596	676	0	18	80	0.2250000
NODE_7472_length_959_cov_4.603488	596	676	2	33	80	0.4125000
NODE_7472_length_959_cov_4.603488	596	676	4	8	80	0.1000000
NODE_7472_length_959_cov_4.603488	596	676	6	21	80	0.2625000
NODE_7472_length_959_cov_4.603488	649	729	2	9	80	0.1125000
NODE_7472_length_959_cov_4.603488	649	729	4	23	80	0.2875000
NODE_7472_length_959_cov_4.603488	649	729	6	48	80	0.6000000
NODE_7486_length_958_cov_57.015134	328	408	8	28	80	0.3500000
NODE_7486_length_958_cov_57.015134	328	408	10	52	80	0.6500000
NODE_7486_length_958_cov_57.015134	381	461	0	32	80	0.4000000
NODE_7486_length_958_cov_57.015134	381	461	8	48	80	0.6000000
NODE_7486_length_958_cov_57.015134	457	537	0	80	80	1.0000000
NODE_7486_length_958_cov_57.015134	510	590	0	80	80	1.0000000
NODE_7487_length_958_cov_42.265425	418	498	0	17	80	0.2125000
NODE_7487_length_958_cov_42.265425	418	498	4	63	80	0.7875000
NODE_7487_length_958_cov_42.265425	471	551	0	63	80	0.7875000
NODE_7487_length_958_cov_42.265425	471	551	4	17	80	0.2125000
NODE_7488_length_958_cov_28.618161	336	416	6	28	80	0.3500000
NODE_7488_length_958_cov_28.618161	336	416	8	50	80	0.6250000
NODE_7488_length_958_cov_28.618161	336	416	10	2	80	0.0250000
NODE_7488_length_958_cov_28.618161	389	469	2	16	80	0.2000000
NODE_7488_length_958_cov_28.618161	389	469	4	1	80	0.0125000
NODE_7488_length_958_cov_28.618161	389	469	6	63	80	0.7875000
NODE_7488_length_958_cov_28.618161	465	545	0	18	80	0.2250000
NODE_7488_length_958_cov_28.618161	465	545	2	4	80	0.0500000
NODE_7488_length_958_cov_28.618161	465	545	8	30	80	0.3750000
NODE_7488_length_958_cov_28.618161	465	545	14	5	80	0.0625000
NODE_7488_length_958_cov_28.618161	465	545	16	23	80	0.2875000
NODE_7488_length_958_cov_28.618161	518	598	14	4	80	0.0500000
NODE_7488_length_958_cov_28.618161	518	598	16	76	80	0.9500000
NODE_7489_length_958_cov_16.452852	446	526	4	3	80	0.0375000
NODE_7489_length_958_cov_16.452852	446	526	11	6	80	0.0750000
NODE_7489_length_958_cov_16.452852	446	526	15	26	80	0.3250000
NODE_7489_length_958_cov_16.452852	446	526	16	45	80	0.5625000
NODE_7489_length_958_cov_16.452852	499	579	0	30	80	0.3750000
NODE_7489_length_958_cov_16.452852	499	579	4	26	80	0.3250000
NODE_7489_length_958_cov_16.452852	499	579	16	24	80	0.3000000
NODE_7490_length_958_cov_16.008149	446	526	0	80	80	1.0000000
NODE_7490_length_958_cov_16.008149	499	579	0	29	80	0.3625000
NODE_7490_length_958_cov_16.008149	499	579	2	51	80	0.6375000
NODE_7491_length_958_cov_14.154831	516	596	0	43	80	0.5375000
NODE_7491_length_958_cov_14.154831	516	596	2	37	80	0.4625000
NODE_7491_length_958_cov_14.154831	569	649	0	80	80	1.0000000
NODE_7492_length_958_cov_12.381839	454	534	0	80	80	1.0000000
NODE_7492_length_958_cov_12.381839	507	587	0	80	80	1.0000000
NODE_7493_length_958_cov_11.782305	479	559	0	66	80	0.8250000
NODE_7493_length_958_cov_11.782305	479	559	2	14	80	0.1750000
NODE_7493_length_958_cov_11.782305	532	612	0	13	80	0.1625000
NODE_7493_length_958_cov_11.782305	532	612	2	21	80	0.2625000
NODE_7493_length_958_cov_11.782305	532	612	4	46	80	0.5750000
NODE_7501_length_957_cov_40.837995	746	826	0	80	80	1.0000000
NODE_7501_length_957_cov_40.837995	799	879	0	80	80	1.0000000
NODE_7502_length_957_cov_25.976690	631	711	2	2	80	0.0250000
NODE_7502_length_957_cov_25.976690	631	711	4	16	80	0.2000000
NODE_7502_length_957_cov_25.976690	631	711	6	22	80	0.2750000
NODE_7502_length_957_cov_25.976690	631	711	8	40	80	0.5000000
NODE_7502_length_957_cov_25.976690	684	764	0	19	80	0.2375000
NODE_7502_length_957_cov_25.976690	684	764	2	15	80	0.1875000
NODE_7502_length_957_cov_25.976690	684	764	4	28	80	0.3500000
NODE_7502_length_957_cov_25.976690	684	764	6	11	80	0.1375000
NODE_7502_length_957_cov_25.976690	684	764	8	7	80	0.0875000
NODE_7503_length_957_cov_25.855478	57	131	2	16	74	0.2162162
NODE_7503_length_957_cov_25.855478	57	131	4	3	74	0.0405405
NODE_7503_length_957_cov_25.855478	57	131	5	1	74	0.0135135
NODE_7503_length_957_cov_25.855478	57	131	6	2	74	0.0270270
NODE_7503_length_957_cov_25.855478	57	131	8	3	74	0.0405405
NODE_7503_length_957_cov_25.855478	57	131	10	49	74	0.6621622
NODE_7503_length_957_cov_25.855478	414	494	1	19	80	0.2375000
NODE_7503_length_957_cov_25.855478	414	494	2	61	80	0.7625000
NODE_7503_length_957_cov_25.855478	467	547	0	28	80	0.3500000
NODE_7503_length_957_cov_25.855478	467	547	1	44	80	0.5500000
NODE_7503_length_957_cov_25.855478	467	547	2	8	80	0.1000000
NODE_7504_length_957_cov_24.625874	445	525	0	80	80	1.0000000
NODE_7504_length_957_cov_24.625874	498	578	0	80	80	1.0000000
NODE_7505_length_957_cov_19.955711	286	366	0	29	80	0.3625000
NODE_7505_length_957_cov_19.955711	286	366	4	51	80	0.6375000
NODE_7505_length_957_cov_19.955711	339	419	0	80	80	1.0000000
NODE_7506_length_957_cov_18.861305	414	494	6	80	80	1.0000000
NODE_7506_length_957_cov_18.861305	467	547	0	8	80	0.1000000
NODE_7506_length_957_cov_18.861305	467	547	2	27	80	0.3375000
NODE_7506_length_957_cov_18.861305	467	547	5	3	80	0.0375000
NODE_7506_length_957_cov_18.861305	467	547	6	42	80	0.5250000
NODE_7507_length_957_cov_17.356643	361	441	0	80	80	1.0000000
NODE_7507_length_957_cov_17.356643	414	494	0	80	80	1.0000000
NODE_7508_length_957_cov_13.569930	162	242	0	56	80	0.7000000
NODE_7508_length_957_cov_13.569930	162	242	4	24	80	0.3000000
NODE_7508_length_957_cov_13.569930	215	299	0	3	84	0.0357143
NODE_7508_length_957_cov_13.569930	215	299	4	81	84	0.9642857
NODE_7509_length_957_cov_12.334499	314	394	8	80	80	1.0000000
NODE_7509_length_957_cov_12.334499	367	447	0	23	80	0.2875000
NODE_7509_length_957_cov_12.334499	367	447	2	25	80	0.3125000
NODE_7509_length_957_cov_12.334499	367	447	8	32	80	0.4000000
NODE_7510_length_957_cov_12.017483	173	253	0	80	80	1.0000000
NODE_7510_length_957_cov_12.017483	226	306	0	80	80	1.0000000
NODE_7511_length_957_cov_10.026807	446	526	0	80	80	1.0000000
NODE_7511_length_957_cov_10.026807	499	579	0	80	80	1.0000000
NODE_7529_length_956_cov_48.047841	479	559	0	35	80	0.4375000
NODE_7529_length_956_cov_48.047841	479	559	2	45	80	0.5625000
NODE_7529_length_956_cov_48.047841	532	612	0	65	80	0.8125000
NODE_7529_length_956_cov_48.047841	532	612	6	4	80	0.0500000
NODE_7529_length_956_cov_48.047841	532	612	8	11	80	0.1375000
NODE_7529_length_956_cov_48.047841	608	688	8	7	80	0.0875000
NODE_7529_length_956_cov_48.047841	608	688	10	7	80	0.0875000
NODE_7529_length_956_cov_48.047841	608	688	12	2	80	0.0250000
NODE_7529_length_956_cov_48.047841	608	688	14	14	80	0.1750000
NODE_7529_length_956_cov_48.047841	608	688	16	50	80	0.6250000
NODE_7529_length_956_cov_48.047841	661	741	0	7	80	0.0875000
NODE_7529_length_956_cov_48.047841	661	741	2	15	80	0.1875000
NODE_7529_length_956_cov_48.047841	661	741	4	5	80	0.0625000
NODE_7529_length_956_cov_48.047841	661	741	10	5	80	0.0625000
NODE_7529_length_956_cov_48.047841	661	741	12	5	80	0.0625000
NODE_7529_length_956_cov_48.047841	661	741	13	1	80	0.0125000
NODE_7529_length_956_cov_48.047841	661	741	14	10	80	0.1250000
NODE_7529_length_956_cov_48.047841	661	741	16	32	80	0.4000000
NODE_7530_length_956_cov_34.539090	298	378	0	80	80	1.0000000
NODE_7530_length_956_cov_34.539090	351	431	0	80	80	1.0000000
NODE_7530_length_956_cov_34.539090	427	507	0	80	80	1.0000000
NODE_7530_length_956_cov_34.539090	480	560	0	80	80	1.0000000
NODE_7531_length_956_cov_24.355893	398	478	0	80	80	1.0000000
NODE_7531_length_956_cov_24.355893	451	531	0	74	80	0.9250000
NODE_7531_length_956_cov_24.355893	451	531	2	6	80	0.0750000
NODE_7532_length_956_cov_21.940490	373	453	0	80	80	1.0000000
NODE_7532_length_956_cov_21.940490	426	506	0	80	80	1.0000000
NODE_7532_length_956_cov_21.940490	502	582	0	80	80	1.0000000
NODE_7532_length_956_cov_21.940490	555	635	0	80	80	1.0000000
NODE_7533_length_956_cov_19.435239	274	354	0	9	80	0.1125000
NODE_7533_length_956_cov_19.435239	274	354	2	71	80	0.8875000
NODE_7533_length_956_cov_19.435239	274	301	2	27	27	1.0000000
NODE_7534_length_956_cov_17.819137	378	458	4	66	80	0.8250000
NODE_7534_length_956_cov_17.819137	378	458	6	14	80	0.1750000
NODE_7534_length_956_cov_17.819137	431	511	2	18	80	0.2250000
NODE_7534_length_956_cov_17.819137	431	511	4	13	80	0.1625000
NODE_7534_length_956_cov_17.819137	431	511	6	49	80	0.6125000
NODE_7535_length_956_cov_16.098016	551	631	0	23	80	0.2875000
NODE_7535_length_956_cov_16.098016	551	631	2	57	80	0.7125000
NODE_7535_length_956_cov_16.098016	604	684	0	26	80	0.3250000
NODE_7535_length_956_cov_16.098016	604	684	2	54	80	0.6750000
NODE_7536_length_956_cov_15.229872	490	570	0	80	80	1.0000000
NODE_7536_length_956_cov_15.229872	543	623	0	80	80	1.0000000
NODE_7537_length_956_cov_7.533256	439	519	0	80	80	1.0000000
NODE_7537_length_956_cov_7.533256	497	572	0	75	75	1.0000000
NODE_7545_length_955_cov_30.821262	438	518	0	5	80	0.0625000
NODE_7545_length_955_cov_30.821262	438	518	14	75	80	0.9375000
NODE_7545_length_955_cov_30.821262	491	571	14	80	80	1.0000000
NODE_7546_length_955_cov_30.574766	380	460	0	80	80	1.0000000
NODE_7546_length_955_cov_30.574766	433	513	0	27	80	0.3375000
NODE_7546_length_955_cov_30.574766	433	513	1	8	80	0.1000000
NODE_7546_length_955_cov_30.574766	433	513	5	45	80	0.5625000
NODE_7546_length_955_cov_30.574766	509	589	1	10	80	0.1250000
NODE_7546_length_955_cov_30.574766	509	589	5	70	80	0.8750000
NODE_7546_length_955_cov_30.574766	562	642	4	32	80	0.4000000
NODE_7546_length_955_cov_30.574766	562	642	5	48	80	0.6000000
NODE_7547_length_955_cov_27.734813	373	453	0	80	80	1.0000000
NODE_7547_length_955_cov_27.734813	426	506	0	80	80	1.0000000
NODE_7548_length_955_cov_24.475467	439	519	0	80	80	1.0000000
NODE_7548_length_955_cov_24.475467	492	572	0	80	80	1.0000000
NODE_7549_length_955_cov_22.146028	351	431	0	80	80	1.0000000
NODE_7549_length_955_cov_22.146028	404	484	0	80	80	1.0000000
NODE_7550_length_955_cov_16.212617	441	521	0	53	80	0.6625000
NODE_7550_length_955_cov_16.212617	441	521	2	27	80	0.3375000
NODE_7550_length_955_cov_16.212617	494	574	2	80	80	1.0000000
NODE_7551_length_955_cov_13.334112	269	349	0	18	80	0.2250000
NODE_7551_length_955_cov_13.334112	269	349	2	62	80	0.7750000
NODE_7551_length_955_cov_13.334112	322	402	0	20	80	0.2500000
NODE_7551_length_955_cov_13.334112	322	402	2	60	80	0.7500000
NODE_7552_length_955_cov_12.544393	363	443	0	80	80	1.0000000
NODE_7552_length_955_cov_12.544393	416	496	0	80	80	1.0000000
NODE_7553_length_955_cov_8.204439	358	438	0	12	80	0.1500000
NODE_7553_length_955_cov_8.204439	358	438	2	3	80	0.0375000
NODE_7553_length_955_cov_8.204439	358	438	4	65	80	0.8125000
NODE_7553_length_955_cov_8.204439	411	491	0	64	80	0.8000000
NODE_7553_length_955_cov_8.204439	411	491	4	16	80	0.2000000
NODE_7563_length_954_cov_35.691228	381	461	8	10	80	0.1250000
NODE_7563_length_954_cov_35.691228	381	461	16	70	80	0.8750000
NODE_7563_length_954_cov_35.691228	434	514	16	80	80	1.0000000
NODE_7564_length_954_cov_30.769591	408	488	0	80	80	1.0000000
NODE_7564_length_954_cov_30.769591	461	541	0	80	80	1.0000000
NODE_7565_length_954_cov_27.247953	418	498	0	28	80	0.3500000
NODE_7565_length_954_cov_27.247953	418	498	2	52	80	0.6500000
NODE_7565_length_954_cov_27.247953	471	551	0	72	80	0.9000000
NODE_7565_length_954_cov_27.247953	471	551	2	8	80	0.1000000
NODE_7566_length_954_cov_22.796491	270	350	0	10	80	0.1250000
NODE_7566_length_954_cov_22.796491	270	350	4	70	80	0.8750000
NODE_7566_length_954_cov_22.796491	323	403	0	63	80	0.7875000
NODE_7566_length_954_cov_22.796491	323	403	4	17	80	0.2125000
NODE_7567_length_954_cov_15.645614	337	417	2	70	80	0.8750000
NODE_7567_length_954_cov_15.645614	337	417	4	10	80	0.1250000
NODE_7567_length_954_cov_15.645614	390	470	0	10	80	0.1250000
NODE_7567_length_954_cov_15.645614	390	470	2	60	80	0.7500000
NODE_7567_length_954_cov_15.645614	390	470	4	10	80	0.1250000
NODE_7568_length_954_cov_13.538012	346	426	2	76	80	0.9500000
NODE_7568_length_954_cov_13.538012	346	426	4	4	80	0.0500000
NODE_7568_length_954_cov_13.538012	399	479	2	76	80	0.9500000
NODE_7568_length_954_cov_13.538012	399	479	4	4	80	0.0500000
NODE_7569_length_954_cov_12.162573	155	217	0	40	62	0.6451613
NODE_7569_length_954_cov_12.162573	155	217	4	22	62	0.3548387
NODE_7570_length_954_cov_10.714620	239	319	0	12	80	0.1500000
NODE_7570_length_954_cov_10.714620	239	319	2	68	80	0.8500000
NODE_7570_length_954_cov_10.714620	292	372	0	7	80	0.0875000
NODE_7570_length_954_cov_10.714620	292	372	2	73	80	0.9125000
NODE_7571_length_954_cov_5.670175	431	511	0	80	80	1.0000000
NODE_7571_length_954_cov_5.670175	484	564	0	80	80	1.0000000
NODE_7582_length_953_cov_35.789227	425	505	4	10	80	0.1250000
NODE_7582_length_953_cov_35.789227	425	505	6	8	80	0.1000000
NODE_7582_length_953_cov_35.789227	425	505	8	62	80	0.7750000
NODE_7582_length_953_cov_35.789227	478	558	0	5	80	0.0625000
NODE_7582_length_953_cov_35.789227	478	558	2	13	80	0.1625000
NODE_7582_length_953_cov_35.789227	478	558	4	3	80	0.0375000
NODE_7582_length_953_cov_35.789227	478	558	8	59	80	0.7375000
NODE_7583_length_953_cov_33.940281	430	510	0	57	80	0.7125000
NODE_7583_length_953_cov_33.940281	430	510	2	10	80	0.1250000
NODE_7583_length_953_cov_33.940281	430	510	6	13	80	0.1625000
NODE_7583_length_953_cov_33.940281	483	563	0	4	80	0.0500000
NODE_7583_length_953_cov_33.940281	483	563	2	10	80	0.1250000
NODE_7583_length_953_cov_33.940281	483	563	6	66	80	0.8250000
NODE_7584_length_953_cov_26.844262	333	413	4	65	80	0.8125000
NODE_7584_length_953_cov_26.844262	333	413	6	15	80	0.1875000
NODE_7584_length_953_cov_26.844262	386	466	1	22	80	0.2750000
NODE_7584_length_953_cov_26.844262	386	466	2	9	80	0.1125000
NODE_7584_length_953_cov_26.844262	386	466	4	49	80	0.6125000
NODE_7584_length_953_cov_26.844262	462	542	0	6	80	0.0750000
NODE_7584_length_953_cov_26.844262	462	542	1	10	80	0.1250000
NODE_7584_length_953_cov_26.844262	462	542	2	1	80	0.0125000
NODE_7584_length_953_cov_26.844262	462	542	3	12	80	0.1500000
NODE_7584_length_953_cov_26.844262	462	542	5	1	80	0.0125000
NODE_7584_length_953_cov_26.844262	462	542	6	50	80	0.6250000
NODE_7584_length_953_cov_26.844262	515	595	6	80	80	1.0000000
NODE_7585_length_953_cov_20.770492	301	381	0	80	80	1.0000000
NODE_7585_length_953_cov_20.770492	354	434	0	80	80	1.0000000
NODE_7586_length_953_cov_17.514052	421	501	0	32	80	0.4000000
NODE_7586_length_953_cov_17.514052	421	501	2	48	80	0.6000000
NODE_7586_length_953_cov_17.514052	474	554	0	16	80	0.2000000
NODE_7586_length_953_cov_17.514052	474	554	2	64	80	0.8000000
NODE_7586_length_953_cov_17.514052	550	630	0	5	80	0.0625000
NODE_7586_length_953_cov_17.514052	550	630	2	75	80	0.9375000
NODE_7586_length_953_cov_17.514052	603	683	0	18	80	0.2250000
NODE_7586_length_953_cov_17.514052	603	683	2	62	80	0.7750000
NODE_7587_length_953_cov_11.579625	332	412	0	79	80	0.9875000
NODE_7587_length_953_cov_11.579625	332	412	1	1	80	0.0125000
NODE_7587_length_953_cov_11.579625	385	465	0	80	80	1.0000000
NODE_7588_length_953_cov_7.281030	276	356	0	80	80	1.0000000
NODE_7588_length_953_cov_7.281030	329	409	0	52	80	0.6500000
NODE_7588_length_953_cov_7.281030	329	409	2	28	80	0.3500000
NODE_7599_length_952_cov_44.880422	447	527	0	80	80	1.0000000
NODE_7599_length_952_cov_44.880422	500	580	0	28	80	0.3500000
NODE_7599_length_952_cov_44.880422	500	580	2	52	80	0.6500000
NODE_7599_length_952_cov_44.880422	871	951	0	80	80	1.0000000
NODE_7600_length_952_cov_42.485346	402	482	0	80	80	1.0000000
NODE_7600_length_952_cov_42.485346	455	535	0	80	80	1.0000000
NODE_7601_length_952_cov_40.065651	422	502	0	80	80	1.0000000
NODE_7601_length_952_cov_40.065651	475	555	0	80	80	1.0000000
NODE_7602_length_952_cov_34.813599	308	388	0	80	80	1.0000000
NODE_7602_length_952_cov_34.813599	361	441	0	80	80	1.0000000
NODE_7603_length_952_cov_28.055100	661	741	0	19	80	0.2375000
NODE_7603_length_952_cov_28.055100	661	741	2	61	80	0.7625000
NODE_7603_length_952_cov_28.055100	714	794	0	72	80	0.9000000
NODE_7603_length_952_cov_28.055100	714	794	2	8	80	0.1000000
NODE_7604_length_952_cov_23.739742	435	515	4	80	80	1.0000000
NODE_7604_length_952_cov_23.739742	488	568	0	46	80	0.5750000
NODE_7604_length_952_cov_23.739742	488	568	2	4	80	0.0500000
NODE_7604_length_952_cov_23.739742	488	568	4	30	80	0.3750000
NODE_7606_length_952_cov_11.478312	245	324	0	59	79	0.7468355
NODE_7606_length_952_cov_11.478312	245	324	2	20	79	0.2531646
NODE_7606_length_952_cov_11.478312	297	377	0	7	80	0.0875000
NODE_7606_length_952_cov_11.478312	297	377	2	73	80	0.9125000
NODE_7607_length_952_cov_11.284877	272	352	0	80	80	1.0000000
NODE_7607_length_952_cov_11.284877	325	405	0	80	80	1.0000000
NODE_7608_length_952_cov_10.807737	458	538	0	80	80	1.0000000
NODE_7608_length_952_cov_10.807737	511	591	0	80	80	1.0000000
NODE_7609_length_952_cov_8.770223	375	455	0	80	80	1.0000000
NODE_7609_length_952_cov_8.770223	428	508	0	80	80	1.0000000
NODE_7623_length_951_cov_54.397887	354	434	0	18	80	0.2250000
NODE_7623_length_951_cov_54.397887	354	434	4	62	80	0.7750000
NODE_7623_length_951_cov_54.397887	407	487	0	27	80	0.3375000
NODE_7623_length_951_cov_54.397887	407	487	4	53	80	0.6625000
NODE_7623_length_951_cov_54.397887	483	563	4	30	80	0.3750000
NODE_7623_length_951_cov_54.397887	483	563	5	22	80	0.2750000
NODE_7623_length_951_cov_54.397887	483	563	6	1	80	0.0125000
NODE_7623_length_951_cov_54.397887	483	563	7	27	80	0.3375000
NODE_7623_length_951_cov_54.397887	544	616	1	13	72	0.1805556
NODE_7623_length_951_cov_54.397887	544	616	3	40	72	0.5555556
NODE_7623_length_951_cov_54.397887	544	616	6	1	72	0.0138889
NODE_7623_length_951_cov_54.397887	544	616	7	18	72	0.2500000
NODE_7624_length_951_cov_47.881455	355	435	0	80	80	1.0000000
NODE_7624_length_951_cov_47.881455	408	488	0	80	80	1.0000000
NODE_7624_length_951_cov_47.881455	484	564	0	43	80	0.5375000
NODE_7624_length_951_cov_47.881455	484	564	8	37	80	0.4625000
NODE_7624_length_951_cov_47.881455	537	617	8	80	80	1.0000000
NODE_7625_length_951_cov_24.322770	479	559	0	16	80	0.2000000
NODE_7625_length_951_cov_24.322770	479	559	2	20	80	0.2500000
NODE_7625_length_951_cov_24.322770	479	559	6	44	80	0.5500000
NODE_7625_length_951_cov_24.322770	532	612	0	18	80	0.2250000
NODE_7625_length_951_cov_24.322770	532	612	4	15	80	0.1875000
NODE_7625_length_951_cov_24.322770	532	612	6	47	80	0.5875000
NODE_7626_length_951_cov_23.001174	470	550	0	80	80	1.0000000
NODE_7626_length_951_cov_23.001174	523	603	0	80	80	1.0000000
NODE_7627_length_951_cov_22.059859	562	642	0	80	80	1.0000000
NODE_7627_length_951_cov_22.059859	615	695	0	80	80	1.0000000
NODE_7628_length_951_cov_19.413146	456	536	0	74	80	0.9250000
NODE_7628_length_951_cov_19.413146	456	536	6	6	80	0.0750000
NODE_7628_length_951_cov_19.413146	509	589	0	21	80	0.2625000
NODE_7628_length_951_cov_19.413146	509	589	6	42	80	0.5250000
NODE_7628_length_951_cov_19.413146	509	589	8	17	80	0.2125000
NODE_7628_length_951_cov_19.413146	830	877	0	47	47	1.0000000
NODE_7629_length_951_cov_18.970657	384	464	0	80	80	1.0000000
NODE_7629_length_951_cov_18.970657	437	517	0	80	80	1.0000000
NODE_7629_length_951_cov_18.970657	513	593	0	80	80	1.0000000
NODE_7629_length_951_cov_18.970657	566	646	0	80	80	1.0000000
NODE_7630_length_951_cov_17.164319	409	490	0	81	81	1.0000000
NODE_7630_length_951_cov_17.164319	463	543	0	80	80	1.0000000
NODE_7631_length_951_cov_17.009390	393	473	0	80	80	1.0000000
NODE_7631_length_951_cov_17.009390	446	526	0	80	80	1.0000000
NODE_7632_length_951_cov_15.551643	520	600	8	46	80	0.5750000
NODE_7632_length_951_cov_15.551643	520	600	12	34	80	0.4250000
NODE_7632_length_951_cov_15.551643	573	653	4	48	80	0.6000000
NODE_7632_length_951_cov_15.551643	573	653	12	32	80	0.4000000
NODE_7633_length_951_cov_13.562207	364	444	0	80	80	1.0000000
NODE_7633_length_951_cov_13.562207	417	497	0	80	80	1.0000000
NODE_7634_length_951_cov_13.086854	450	530	0	80	80	1.0000000
NODE_7634_length_951_cov_13.086854	503	583	0	80	80	1.0000000
NODE_7635_length_951_cov_6.812207	350	430	0	80	80	1.0000000
NODE_7635_length_951_cov_6.812207	403	483	0	80	80	1.0000000
NODE_7636_length_951_cov_5.076291	80	160	1	79	80	0.9875000
NODE_7636_length_951_cov_5.076291	80	160	2	1	80	0.0125000
NODE_7636_length_951_cov_5.076291	133	213	1	29	80	0.3625000
NODE_7636_length_951_cov_5.076291	133	213	2	51	80	0.6375000
NODE_7649_length_950_cov_62.151586	731	794	6	13	63	0.2063492
NODE_7649_length_950_cov_62.151586	731	794	8	27	63	0.4285714
NODE_7649_length_950_cov_62.151586	731	794	10	23	63	0.3650794
NODE_7650_length_950_cov_56.088132	354	434	0	71	80	0.8875000
NODE_7650_length_950_cov_56.088132	354	434	4	9	80	0.1125000
NODE_7650_length_950_cov_56.088132	407	487	0	18	80	0.2250000
NODE_7650_length_950_cov_56.088132	407	487	4	25	80	0.3125000
NODE_7650_length_950_cov_56.088132	407	487	6	37	80	0.4625000
NODE_7650_length_950_cov_56.088132	483	563	0	24	80	0.3000000
NODE_7650_length_950_cov_56.088132	483	563	4	8	80	0.1000000
NODE_7650_length_950_cov_56.088132	483	563	6	48	80	0.6000000
NODE_7650_length_950_cov_56.088132	536	616	0	77	80	0.9625000
NODE_7650_length_950_cov_56.088132	536	616	4	3	80	0.0375000
NODE_7651_length_950_cov_29.780259	501	581	0	14	80	0.1750000
NODE_7651_length_950_cov_29.780259	501	581	4	66	80	0.8250000
NODE_7651_length_950_cov_29.780259	554	634	0	67	80	0.8375000
NODE_7651_length_950_cov_29.780259	554	634	4	13	80	0.1625000
NODE_7652_length_950_cov_27.278496	388	468	0	10	80	0.1250000
NODE_7652_length_950_cov_27.278496	388	468	2	70	80	0.8750000
NODE_7652_length_950_cov_27.278496	441	519	0	61	78	0.7820513
NODE_7652_length_950_cov_27.278496	441	519	2	17	78	0.2179487
NODE_7653_length_950_cov_26.766157	322	402	0	80	80	1.0000000
NODE_7653_length_950_cov_26.766157	375	455	0	80	80	1.0000000
NODE_7653_length_950_cov_26.766157	451	531	0	80	80	1.0000000
NODE_7653_length_950_cov_26.766157	504	584	0	80	80	1.0000000
NODE_7654_length_950_cov_19.638073	421	501	0	16	80	0.2000000
NODE_7654_length_950_cov_19.638073	421	501	6	16	80	0.2000000
NODE_7654_length_950_cov_19.638073	421	501	8	48	80	0.6000000
NODE_7654_length_950_cov_19.638073	474	554	6	25	80	0.3125000
NODE_7654_length_950_cov_19.638073	474	554	8	55	80	0.6875000
NODE_7654_length_950_cov_19.638073	550	630	0	51	80	0.6375000
NODE_7654_length_950_cov_19.638073	550	630	2	24	80	0.3000000
NODE_7654_length_950_cov_19.638073	550	630	6	5	80	0.0625000
NODE_7654_length_950_cov_19.638073	603	683	0	12	80	0.1500000
NODE_7654_length_950_cov_19.638073	603	683	2	68	80	0.8500000
NODE_7655_length_950_cov_14.686251	376	456	0	43	80	0.5375000
NODE_7655_length_950_cov_14.686251	376	456	4	37	80	0.4625000
NODE_7655_length_950_cov_14.686251	429	509	0	80	80	1.0000000
NODE_7656_length_950_cov_14.215041	339	419	0	80	80	1.0000000
NODE_7656_length_950_cov_14.215041	392	472	0	80	80	1.0000000
NODE_7657_length_950_cov_6.397180	370	450	0	80	80	1.0000000
NODE_7657_length_950_cov_6.397180	423	504	0	81	81	1.0000000
NODE_7659_length_950_cov_4.430082	594	674	0	80	80	1.0000000
NODE_7659_length_950_cov_4.430082	647	727	0	80	80	1.0000000
NODE_7672_length_949_cov_25.550588	371	451	0	80	80	1.0000000
NODE_7672_length_949_cov_25.550588	500	580	0	80	80	1.0000000
NODE_7672_length_949_cov_25.550588	553	633	0	80	80	1.0000000
NODE_7673_length_949_cov_20.949412	252	332	0	80	80	1.0000000
NODE_7673_length_949_cov_20.949412	305	385	0	80	80	1.0000000
NODE_7674_length_949_cov_20.601176	364	444	0	20	80	0.2500000
NODE_7674_length_949_cov_20.601176	364	444	2	60	80	0.7500000
NODE_7674_length_949_cov_20.601176	417	497	0	2	80	0.0250000
NODE_7674_length_949_cov_20.601176	417	497	2	78	80	0.9750000
NODE_7674_length_949_cov_20.601176	493	573	0	78	80	0.9750000
NODE_7674_length_949_cov_20.601176	493	573	2	2	80	0.0250000
NODE_7674_length_949_cov_20.601176	546	626	0	80	80	1.0000000
NODE_7675_length_949_cov_20.575294	481	561	0	80	80	1.0000000
NODE_7675_length_949_cov_20.575294	534	614	0	46	80	0.5750000
NODE_7675_length_949_cov_20.575294	534	614	1	9	80	0.1125000
NODE_7675_length_949_cov_20.575294	534	614	2	25	80	0.3125000
NODE_7676_length_949_cov_19.483529	340	420	0	80	80	1.0000000
NODE_7676_length_949_cov_19.483529	393	473	0	80	80	1.0000000
NODE_7676_length_949_cov_19.483529	469	549	0	80	80	1.0000000
NODE_7676_length_949_cov_19.483529	522	602	0	65	80	0.8125000
NODE_7676_length_949_cov_19.483529	522	602	2	15	80	0.1875000
NODE_7677_length_949_cov_19.407059	433	513	8	7	80	0.0875000
NODE_7677_length_949_cov_19.407059	433	513	10	73	80	0.9125000
NODE_7677_length_949_cov_19.407059	486	566	0	16	80	0.2000000
NODE_7677_length_949_cov_19.407059	486	566	4	9	80	0.1125000
NODE_7677_length_949_cov_19.407059	486	566	8	35	80	0.4375000
NODE_7677_length_949_cov_19.407059	486	566	10	20	80	0.2500000
NODE_7677_length_949_cov_19.407059	562	642	0	8	80	0.1000000
NODE_7677_length_949_cov_19.407059	562	642	2	72	80	0.9000000
NODE_7677_length_949_cov_19.407059	615	695	0	18	80	0.2250000
NODE_7677_length_949_cov_19.407059	615	695	2	62	80	0.7750000
NODE_7678_length_949_cov_10.903529	561	641	2	45	80	0.5625000
NODE_7678_length_949_cov_10.903529	561	641	4	35	80	0.4375000
NODE_7678_length_949_cov_10.903529	614	694	0	36	80	0.4500000
NODE_7678_length_949_cov_10.903529	614	694	2	33	80	0.4125000
NODE_7678_length_949_cov_10.903529	614	694	4	11	80	0.1375000
NODE_7679_length_949_cov_7.245882	0	71	2	5	71	0.0704225
NODE_7679_length_949_cov_7.245882	0	71	4	2	71	0.0281690
NODE_7679_length_949_cov_7.245882	0	71	6	56	71	0.7887324
NODE_7679_length_949_cov_7.245882	0	71	8	8	71	0.1126761
NODE_7679_length_949_cov_7.245882	0	71	2	5	71	0.0704225
NODE_7679_length_949_cov_7.245882	0	71	4	2	71	0.0281690
NODE_7679_length_949_cov_7.245882	0	71	6	56	71	0.7887324
NODE_7679_length_949_cov_7.245882	0	71	8	8	71	0.1126761
NODE_7679_length_949_cov_7.245882	44	124	6	19	80	0.2375000
NODE_7679_length_949_cov_7.245882	44	124	8	41	80	0.5125000
NODE_7679_length_949_cov_7.245882	44	124	9	13	80	0.1625000
NODE_7679_length_949_cov_7.245882	44	124	11	7	80	0.0875000
NODE_7680_length_949_cov_6.998824	494	574	0	80	80	1.0000000
NODE_7680_length_949_cov_6.998824	547	627	0	80	80	1.0000000
NODE_7702_length_948_cov_37.201413	510	590	0	69	80	0.8625000
NODE_7702_length_948_cov_37.201413	510	590	1	1	80	0.0125000
NODE_7702_length_948_cov_37.201413	510	590	2	10	80	0.1250000
NODE_7702_length_948_cov_37.201413	563	643	0	80	80	1.0000000
NODE_7703_length_948_cov_20.082450	58	99	0	41	41	1.0000000
NODE_7703_length_948_cov_20.082450	113	193	0	53	80	0.6625000
NODE_7703_length_948_cov_20.082450	113	193	2	20	80	0.2500000
NODE_7703_length_948_cov_20.082450	113	193	6	7	80	0.0875000
NODE_7703_length_948_cov_20.082450	166	246	2	20	80	0.2500000
NODE_7703_length_948_cov_20.082450	166	246	6	10	80	0.1250000
NODE_7703_length_948_cov_20.082450	166	246	8	22	80	0.2750000
NODE_7703_length_948_cov_20.082450	166	246	10	28	80	0.3500000
NODE_7704_length_948_cov_16.785630	308	388	0	80	80	1.0000000
NODE_7704_length_948_cov_16.785630	361	441	0	80	80	1.0000000
NODE_7704_length_948_cov_16.785630	437	517	0	80	80	1.0000000
NODE_7704_length_948_cov_16.785630	490	570	0	80	80	1.0000000
NODE_7705_length_948_cov_12.740872	400	480	0	80	80	1.0000000
NODE_7705_length_948_cov_12.740872	453	533	0	80	80	1.0000000
NODE_7706_length_948_cov_10.220259	465	545	0	31	80	0.3875000
NODE_7706_length_948_cov_10.220259	465	545	2	16	80	0.2000000
NODE_7706_length_948_cov_10.220259	465	545	4	33	80	0.4125000
NODE_7706_length_948_cov_10.220259	518	598	2	1	80	0.0125000
NODE_7706_length_948_cov_10.220259	518	598	4	79	80	0.9875000
NODE_7707_length_948_cov_8.504122	456	536	0	1	80	0.0125000
NODE_7707_length_948_cov_8.504122	456	536	2	79	80	0.9875000
NODE_7707_length_948_cov_8.504122	509	589	0	12	80	0.1500000
NODE_7707_length_948_cov_8.504122	509	589	2	68	80	0.8500000
NODE_7709_length_948_cov_5.425206	641	721	0	14	80	0.1750000
NODE_7709_length_948_cov_5.425206	641	721	2	66	80	0.8250000
NODE_7709_length_948_cov_5.425206	694	774	0	67	80	0.8375000
NODE_7709_length_948_cov_5.425206	694	774	2	13	80	0.1625000
NODE_7711_length_948_cov_3.586572	696	776	0	34	80	0.4250000
NODE_7711_length_948_cov_3.586572	696	776	2	17	80	0.2125000
NODE_7711_length_948_cov_3.586572	696	776	4	29	80	0.3625000
NODE_7715_length_948_cov_2.786808	259	324	0	65	65	1.0000000
NODE_7715_length_948_cov_2.786808	297	377	0	80	80	1.0000000
NODE_7721_length_947_cov_91.466981	393	473	0	34	80	0.4250000
NODE_7721_length_947_cov_91.466981	393	473	4	46	80	0.5750000
NODE_7721_length_947_cov_91.466981	446	526	0	15	80	0.1875000
NODE_7721_length_947_cov_91.466981	446	526	2	4	80	0.0500000
NODE_7721_length_947_cov_91.466981	446	526	4	61	80	0.7625000
NODE_7722_length_947_cov_61.139151	402	482	0	80	80	1.0000000
NODE_7722_length_947_cov_61.139151	455	535	0	80	80	1.0000000
NODE_7723_length_947_cov_50.009434	488	568	0	59	80	0.7375000
NODE_7723_length_947_cov_50.009434	488	568	2	21	80	0.2625000
NODE_7723_length_947_cov_50.009434	541	621	0	6	80	0.0750000
NODE_7723_length_947_cov_50.009434	541	621	2	74	80	0.9250000
NODE_7724_length_947_cov_36.271226	511	591	6	80	80	1.0000000
NODE_7724_length_947_cov_36.271226	564	644	0	49	80	0.6125000
NODE_7724_length_947_cov_36.271226	564	644	6	31	80	0.3875000
NODE_7725_length_947_cov_23.384434	425	505	2	15	80	0.1875000
NODE_7725_length_947_cov_23.384434	425	505	6	48	80	0.6000000
NODE_7725_length_947_cov_23.384434	425	505	8	17	80	0.2125000
NODE_7725_length_947_cov_23.384434	478	558	2	68	80	0.8500000
NODE_7725_length_947_cov_23.384434	478	558	6	12	80	0.1500000
NODE_7726_length_947_cov_19.103774	316	396	0	25	80	0.3125000
NODE_7726_length_947_cov_19.103774	316	396	2	55	80	0.6875000
NODE_7726_length_947_cov_19.103774	369	449	0	25	80	0.3125000
NODE_7726_length_947_cov_19.103774	369	449	2	55	80	0.6875000
NODE_7727_length_947_cov_18.853774	516	596	0	49	80	0.6125000
NODE_7727_length_947_cov_18.853774	516	596	2	3	80	0.0375000
NODE_7727_length_947_cov_18.853774	516	596	4	28	80	0.3500000
NODE_7727_length_947_cov_18.853774	569	649	2	30	80	0.3750000
NODE_7727_length_947_cov_18.853774	569	649	4	50	80	0.6250000
NODE_7728_length_947_cov_18.077830	315	395	2	80	80	1.0000000
NODE_7728_length_947_cov_18.077830	368	448	0	36	80	0.4500000
NODE_7728_length_947_cov_18.077830	368	448	2	44	80	0.5500000
NODE_7729_length_947_cov_17.713443	403	483	2	80	80	1.0000000
NODE_7729_length_947_cov_17.713443	456	536	0	34	80	0.4250000
NODE_7729_length_947_cov_17.713443	456	536	2	46	80	0.5750000
NODE_7730_length_947_cov_14.492925	358	438	0	80	80	1.0000000
NODE_7730_length_947_cov_14.492925	411	491	0	80	80	1.0000000
NODE_7730_length_947_cov_14.492925	487	567	0	49	80	0.6125000
NODE_7730_length_947_cov_14.492925	487	567	4	31	80	0.3875000
NODE_7730_length_947_cov_14.492925	540	620	4	60	80	0.7500000
NODE_7730_length_947_cov_14.492925	540	620	7	1	80	0.0125000
NODE_7730_length_947_cov_14.492925	540	620	8	19	80	0.2375000
NODE_7731_length_947_cov_10.573113	550	630	0	80	80	1.0000000
NODE_7731_length_947_cov_10.573113	603	683	0	80	80	1.0000000
NODE_7732_length_947_cov_7.762972	550	630	4	80	80	1.0000000
NODE_7732_length_947_cov_7.762972	607	683	0	48	76	0.6315789
NODE_7732_length_947_cov_7.762972	607	683	3	1	76	0.0131579
NODE_7732_length_947_cov_7.762972	607	683	4	27	76	0.3552631
NODE_7747_length_946_cov_39.726092	378	458	0	80	80	1.0000000
NODE_7747_length_946_cov_39.726092	431	511	0	80	80	1.0000000
NODE_7747_length_946_cov_39.726092	507	587	0	80	80	1.0000000
NODE_7747_length_946_cov_39.726092	560	640	0	80	80	1.0000000
NODE_7748_length_946_cov_32.728453	404	484	0	39	80	0.4875000
NODE_7748_length_946_cov_32.728453	404	484	2	41	80	0.5125000
NODE_7748_length_946_cov_32.728453	457	537	0	27	80	0.3375000
NODE_7748_length_946_cov_32.728453	457	537	2	53	80	0.6625000
NODE_7749_length_946_cov_27.548996	280	360	0	80	80	1.0000000
NODE_7749_length_946_cov_27.548996	333	413	0	80	80	1.0000000
NODE_7750_length_946_cov_24.622196	352	432	0	80	80	1.0000000
NODE_7750_length_946_cov_24.622196	405	486	0	81	81	1.0000000
NODE_7751_length_946_cov_18.082645	492	572	0	80	80	1.0000000
NODE_7751_length_946_cov_18.082645	545	625	0	80	80	1.0000000
NODE_7752_length_946_cov_18.031877	433	513	0	45	80	0.5625000
NODE_7752_length_946_cov_18.031877	433	513	16	35	80	0.4375000
NODE_7752_length_946_cov_18.031877	486	566	16	80	80	1.0000000
NODE_7753_length_946_cov_15.188902	472	552	0	80	80	1.0000000
NODE_7753_length_946_cov_15.188902	525	605	0	80	80	1.0000000
NODE_7754_length_946_cov_11.201889	408	488	0	77	80	0.9625000
NODE_7754_length_946_cov_11.201889	408	488	2	3	80	0.0375000
NODE_7754_length_946_cov_11.201889	461	541	0	80	80	1.0000000
NODE_7768_length_945_cov_42.997636	361	441	0	35	80	0.4375000
NODE_7768_length_945_cov_42.997636	361	441	3	20	80	0.2500000
NODE_7768_length_945_cov_42.997636	361	441	4	25	80	0.3125000
NODE_7768_length_945_cov_42.997636	414	494	3	2	80	0.0250000
NODE_7768_length_945_cov_42.997636	414	494	4	78	80	0.9750000
NODE_7769_length_945_cov_31.223404	357	437	10	11	80	0.1375000
NODE_7769_length_945_cov_31.223404	357	437	12	26	80	0.3250000
NODE_7769_length_945_cov_31.223404	357	437	19	1	80	0.0125000
NODE_7769_length_945_cov_31.223404	357	437	20	42	80	0.5250000
NODE_7769_length_945_cov_31.223404	410	490	0	1	80	0.0125000
NODE_7769_length_945_cov_31.223404	410	490	8	14	80	0.1750000
NODE_7769_length_945_cov_31.223404	410	490	18	1	80	0.0125000
NODE_7769_length_945_cov_31.223404	410	490	20	64	80	0.8000000
NODE_7770_length_945_cov_26.348700	331	411	0	49	80	0.6125000
NODE_7770_length_945_cov_26.348700	331	411	4	4	80	0.0500000
NODE_7770_length_945_cov_26.348700	331	411	8	27	80	0.3375000
NODE_7770_length_945_cov_26.348700	384	464	4	2	80	0.0250000
NODE_7770_length_945_cov_26.348700	384	464	8	78	80	0.9750000
NODE_7771_length_945_cov_20.349882	435	515	0	80	80	1.0000000
NODE_7771_length_945_cov_20.349882	488	568	0	80	80	1.0000000
NODE_7772_length_945_cov_14.771868	386	466	0	80	80	1.0000000
NODE_7772_length_945_cov_14.771868	439	519	0	80	80	1.0000000
NODE_7773_length_945_cov_10.158392	599	679	0	80	80	1.0000000
NODE_7773_length_945_cov_10.158392	652	732	0	80	80	1.0000000
NODE_7775_length_945_cov_5.403073	357	437	0	80	80	1.0000000
NODE_7775_length_945_cov_5.403073	410	490	0	80	80	1.0000000
NODE_7785_length_944_cov_42.401183	358	438	0	15	80	0.1875000
NODE_7785_length_944_cov_42.401183	358	438	4	65	80	0.8125000
NODE_7785_length_944_cov_42.401183	411	498	0	49	87	0.5632184
NODE_7785_length_944_cov_42.401183	411	498	4	38	87	0.4367816
NODE_7786_length_944_cov_32.712426	377	457	0	80	80	1.0000000
NODE_7786_length_944_cov_32.712426	430	510	0	80	80	1.0000000
NODE_7787_length_944_cov_27.839053	417	497	0	29	80	0.3625000
NODE_7787_length_944_cov_27.839053	417	497	4	10	80	0.1250000
NODE_7787_length_944_cov_27.839053	417	497	6	41	80	0.5125000
NODE_7787_length_944_cov_27.839053	470	550	0	8	80	0.1000000
NODE_7787_length_944_cov_27.839053	470	550	2	24	80	0.3000000
NODE_7787_length_944_cov_27.839053	470	550	6	48	80	0.6000000
NODE_7788_length_944_cov_24.702959	413	493	0	80	80	1.0000000
NODE_7788_length_944_cov_24.702959	466	546	0	80	80	1.0000000
NODE_7789_length_944_cov_11.951479	347	427	0	23	80	0.2875000
NODE_7789_length_944_cov_11.951479	347	427	2	23	80	0.2875000
NODE_7789_length_944_cov_11.951479	347	427	4	34	80	0.4250000
NODE_7789_length_944_cov_11.951479	400	480	0	76	80	0.9500000
NODE_7789_length_944_cov_11.951479	400	480	2	4	80	0.0500000
NODE_7789_length_944_cov_11.951479	476	556	0	80	80	1.0000000
NODE_7789_length_944_cov_11.951479	529	609	0	80	80	1.0000000
NODE_7790_length_944_cov_6.745562	366	446	0	80	80	1.0000000
NODE_7790_length_944_cov_6.745562	419	499	0	80	80	1.0000000
NODE_7792_length_944_cov_4.420118	236	316	0	80	80	1.0000000
NODE_7792_length_944_cov_4.420118	289	369	0	80	80	1.0000000
NODE_7800_length_943_cov_40.111374	536	614	0	78	78	1.0000000
NODE_7800_length_943_cov_40.111374	587	667	0	80	80	1.0000000
NODE_7801_length_943_cov_29.446682	338	418	0	79	80	0.9875000
NODE_7801_length_943_cov_29.446682	338	418	2	1	80	0.0125000
NODE_7801_length_943_cov_29.446682	391	471	0	80	80	1.0000000
NODE_7802_length_943_cov_28.289100	393	473	0	16	80	0.2000000
NODE_7802_length_943_cov_28.289100	393	473	6	64	80	0.8000000
NODE_7802_length_943_cov_28.289100	446	526	0	37	80	0.4625000
NODE_7802_length_943_cov_28.289100	446	526	6	43	80	0.5375000
NODE_7803_length_943_cov_27.225118	343	423	0	80	80	1.0000000
NODE_7803_length_943_cov_27.225118	396	476	0	80	80	1.0000000
NODE_7804_length_943_cov_26.536730	275	303	2	28	28	1.0000000
NODE_7804_length_943_cov_26.536730	299	379	0	7	80	0.0875000
NODE_7804_length_943_cov_26.536730	299	379	2	73	80	0.9125000
NODE_7804_length_943_cov_26.536730	352	432	0	60	80	0.7500000
NODE_7804_length_943_cov_26.536730	352	432	2	20	80	0.2500000
NODE_7805_length_943_cov_24.992891	374	454	0	80	80	1.0000000
NODE_7805_length_943_cov_24.992891	427	507	0	80	80	1.0000000
NODE_7805_length_943_cov_24.992891	503	583	0	57	80	0.7125000
NODE_7805_length_943_cov_24.992891	503	583	6	12	80	0.1500000
NODE_7805_length_943_cov_24.992891	503	583	8	6	80	0.0750000
NODE_7805_length_943_cov_24.992891	503	583	10	4	80	0.0500000
NODE_7805_length_943_cov_24.992891	503	583	12	1	80	0.0125000
NODE_7805_length_943_cov_24.992891	556	636	0	4	80	0.0500000
NODE_7805_length_943_cov_24.992891	556	636	6	12	80	0.1500000
NODE_7805_length_943_cov_24.992891	556	636	8	6	80	0.0750000
NODE_7805_length_943_cov_24.992891	556	636	10	4	80	0.0500000
NODE_7805_length_943_cov_24.992891	556	636	12	17	80	0.2125000
NODE_7805_length_943_cov_24.992891	556	636	14	37	80	0.4625000
NODE_7806_length_943_cov_24.758294	403	483	0	1	80	0.0125000
NODE_7806_length_943_cov_24.758294	403	483	2	79	80	0.9875000
NODE_7806_length_943_cov_24.758294	456	536	0	54	80	0.6750000
NODE_7806_length_943_cov_24.758294	456	536	2	26	80	0.3250000
NODE_7807_length_943_cov_22.316351	432	512	2	54	80	0.6750000
NODE_7807_length_943_cov_22.316351	432	512	6	3	80	0.0375000
NODE_7807_length_943_cov_22.316351	432	512	8	23	80	0.2875000
NODE_7807_length_943_cov_22.316351	485	565	2	1	80	0.0125000
NODE_7807_length_943_cov_22.316351	485	565	5	4	80	0.0500000
NODE_7807_length_943_cov_22.316351	485	565	6	14	80	0.1750000
NODE_7807_length_943_cov_22.316351	485	565	7	38	80	0.4750000
NODE_7807_length_943_cov_22.316351	485	565	8	23	80	0.2875000
NODE_7808_length_943_cov_22.149289	393	473	4	76	80	0.9500000
NODE_7808_length_943_cov_22.149289	393	473	6	4	80	0.0500000
NODE_7808_length_943_cov_22.149289	446	526	2	51	80	0.6375000
NODE_7808_length_943_cov_22.149289	446	526	4	25	80	0.3125000
NODE_7808_length_943_cov_22.149289	446	526	6	4	80	0.0500000
NODE_7809_length_943_cov_20.055687	412	492	0	80	80	1.0000000
NODE_7809_length_943_cov_20.055687	465	545	0	80	80	1.0000000
NODE_7810_length_943_cov_16.022512	338	418	0	66	80	0.8250000
NODE_7810_length_943_cov_16.022512	338	418	2	14	80	0.1750000
NODE_7810_length_943_cov_16.022512	391	471	0	80	80	1.0000000
NODE_7811_length_943_cov_10.939573	474	554	0	80	80	1.0000000
NODE_7811_length_943_cov_10.939573	527	607	0	80	80	1.0000000
NODE_7812_length_943_cov_9.483412	422	502	0	7	80	0.0875000
NODE_7812_length_943_cov_9.483412	422	502	2	73	80	0.9125000
NODE_7812_length_943_cov_9.483412	475	555	0	11	80	0.1375000
NODE_7812_length_943_cov_9.483412	475	555	2	69	80	0.8625000
NODE_7830_length_942_cov_58.088968	384	464	0	32	80	0.4000000
NODE_7830_length_942_cov_58.088968	384	464	2	48	80	0.6000000
NODE_7830_length_942_cov_58.088968	437	517	2	80	80	1.0000000
NODE_7832_length_942_cov_27.466192	360	440	0	64	80	0.8000000
NODE_7832_length_942_cov_27.466192	360	440	2	16	80	0.2000000
NODE_7832_length_942_cov_27.466192	413	493	0	11	80	0.1375000
NODE_7832_length_942_cov_27.466192	413	493	2	69	80	0.8625000
NODE_7833_length_942_cov_26.914591	346	426	0	80	80	1.0000000
NODE_7833_length_942_cov_26.914591	399	479	0	80	80	1.0000000
NODE_7834_length_942_cov_17.911032	390	470	0	20	80	0.2500000
NODE_7834_length_942_cov_17.911032	390	470	6	60	80	0.7500000
NODE_7834_length_942_cov_17.911032	443	523	6	80	80	1.0000000
NODE_7835_length_942_cov_14.695136	442	522	4	80	80	1.0000000
NODE_7835_length_942_cov_14.695136	495	575	0	27	80	0.3375000
NODE_7835_length_942_cov_14.695136	495	575	4	53	80	0.6625000
NODE_7836_length_942_cov_14.097272	547	627	2	80	80	1.0000000
NODE_7836_length_942_cov_14.097272	600	680	0	51	80	0.6375000
NODE_7836_length_942_cov_14.097272	600	680	2	29	80	0.3625000
NODE_7837_length_942_cov_13.174377	322	402	0	80	80	1.0000000
NODE_7837_length_942_cov_13.174377	375	455	0	80	80	1.0000000
NODE_7858_length_941_cov_36.592637	259	339	2	7	80	0.0875000
NODE_7858_length_941_cov_36.592637	259	339	4	73	80	0.9125000
NODE_7858_length_941_cov_36.592637	312	392	0	6	80	0.0750000
NODE_7858_length_941_cov_36.592637	312	392	2	54	80	0.6750000
NODE_7858_length_941_cov_36.592637	312	392	4	20	80	0.2500000
NODE_7858_length_941_cov_36.592637	388	468	0	80	80	1.0000000
NODE_7858_length_941_cov_36.592637	441	521	0	80	80	1.0000000
NODE_7859_length_941_cov_35.375297	352	432	0	13	80	0.1625000
NODE_7859_length_941_cov_35.375297	352	432	3	22	80	0.2750000
NODE_7859_length_941_cov_35.375297	352	432	5	11	80	0.1375000
NODE_7859_length_941_cov_35.375297	352	432	6	34	80	0.4250000
NODE_7859_length_941_cov_35.375297	405	485	6	80	80	1.0000000
NODE_7859_length_941_cov_35.375297	481	561	0	24	80	0.3000000
NODE_7859_length_941_cov_35.375297	481	561	2	1	80	0.0125000
NODE_7859_length_941_cov_35.375297	481	561	3	21	80	0.2625000
NODE_7859_length_941_cov_35.375297	481	561	6	34	80	0.4250000
NODE_7859_length_941_cov_35.375297	534	614	0	77	80	0.9625000
NODE_7859_length_941_cov_35.375297	534	614	2	1	80	0.0125000
NODE_7859_length_941_cov_35.375297	534	614	3	2	80	0.0250000
NODE_7860_length_941_cov_32.222090	407	487	0	80	80	1.0000000
NODE_7860_length_941_cov_32.222090	460	540	0	80	80	1.0000000
NODE_7861_length_941_cov_28.442993	391	471	0	5	80	0.0625000
NODE_7861_length_941_cov_28.442993	391	471	4	75	80	0.9375000
NODE_7861_length_941_cov_28.442993	444	524	2	29	80	0.3625000
NODE_7861_length_941_cov_28.442993	444	524	4	32	80	0.4000000
NODE_7861_length_941_cov_28.442993	444	524	6	19	80	0.2375000
NODE_7862_length_941_cov_20.788599	341	421	0	80	80	1.0000000
NODE_7862_length_941_cov_20.788599	394	474	0	80	80	1.0000000
NODE_7863_length_941_cov_18.000000	364	444	0	28	80	0.3500000
NODE_7863_length_941_cov_18.000000	364	444	2	52	80	0.6500000
NODE_7863_length_941_cov_18.000000	417	497	2	80	80	1.0000000
NODE_7864_length_941_cov_11.020190	325	405	8	80	80	1.0000000
NODE_7864_length_941_cov_11.020190	378	458	0	15	80	0.1875000
NODE_7864_length_941_cov_11.020190	378	458	4	5	80	0.0625000
NODE_7864_length_941_cov_11.020190	378	458	5	1	80	0.0125000
NODE_7864_length_941_cov_11.020190	378	458	8	59	80	0.7375000
NODE_7865_length_941_cov_6.020190	260	287	4	27	27	1.0000000
NODE_7865_length_941_cov_6.020190	260	340	2	8	80	0.1000000
NODE_7865_length_941_cov_6.020190	260	340	4	72	80	0.9000000
NODE_7867_length_941_cov_3.745843	867	941	0	20	74	0.2702703
NODE_7867_length_941_cov_3.745843	867	941	4	12	74	0.1621622
NODE_7867_length_941_cov_3.745843	867	941	8	8	74	0.1081081
NODE_7867_length_941_cov_3.745843	867	941	10	6	74	0.0810811
NODE_7867_length_941_cov_3.745843	867	941	12	28	74	0.3783784
NODE_7877_length_940_cov_43.954816	243	323	0	51	80	0.6375000
NODE_7877_length_940_cov_43.954816	243	323	2	29	80	0.3625000
NODE_7877_length_940_cov_43.954816	296	376	2	80	80	1.0000000
NODE_7877_length_940_cov_43.954816	372	452	0	48	80	0.6000000
NODE_7877_length_940_cov_43.954816	372	452	2	32	80	0.4000000
NODE_7877_length_940_cov_43.954816	425	505	0	80	80	1.0000000
NODE_7878_length_940_cov_27.763377	423	503	0	49	80	0.6125000
NODE_7878_length_940_cov_27.763377	423	503	4	31	80	0.3875000
NODE_7878_length_940_cov_27.763377	476	556	4	80	80	1.0000000
NODE_7897_length_939_cov_58.982143	363	443	15	21	80	0.2625000
NODE_7897_length_939_cov_58.982143	363	443	17	36	80	0.4500000
NODE_7897_length_939_cov_58.982143	363	443	19	8	80	0.1000000
NODE_7897_length_939_cov_58.982143	363	443	20	10	80	0.1250000
NODE_7897_length_939_cov_58.982143	363	443	22	5	80	0.0625000
NODE_7897_length_939_cov_58.982143	416	496	9	11	80	0.1375000
NODE_7897_length_939_cov_58.982143	416	496	11	31	80	0.3875000
NODE_7897_length_939_cov_58.982143	416	496	13	5	80	0.0625000
NODE_7897_length_939_cov_58.982143	416	496	15	7	80	0.0875000
NODE_7897_length_939_cov_58.982143	416	496	17	3	80	0.0375000
NODE_7897_length_939_cov_58.982143	416	496	19	8	80	0.1000000
NODE_7897_length_939_cov_58.982143	416	496	20	10	80	0.1250000
NODE_7897_length_939_cov_58.982143	416	496	22	5	80	0.0625000
NODE_7898_length_939_cov_32.469048	327	407	0	56	80	0.7000000
NODE_7898_length_939_cov_32.469048	327	407	2	24	80	0.3000000
NODE_7898_length_939_cov_32.469048	380	460	0	8	80	0.1000000
NODE_7898_length_939_cov_32.469048	380	460	2	72	80	0.9000000
NODE_7899_length_939_cov_31.895238	265	345	4	80	80	1.0000000
NODE_7899_length_939_cov_31.895238	318	398	1	23	80	0.2875000
NODE_7899_length_939_cov_31.895238	318	398	3	10	80	0.1250000
NODE_7899_length_939_cov_31.895238	318	398	4	47	80	0.5875000
NODE_7900_length_939_cov_25.354762	439	519	0	80	80	1.0000000
NODE_7900_length_939_cov_25.354762	492	572	0	80	80	1.0000000
NODE_7901_length_939_cov_24.892857	370	450	0	58	80	0.7250000
NODE_7901_length_939_cov_24.892857	370	450	2	22	80	0.2750000
NODE_7901_length_939_cov_24.892857	423	503	0	5	80	0.0625000
NODE_7901_length_939_cov_24.892857	423	503	2	48	80	0.6000000
NODE_7901_length_939_cov_24.892857	423	503	4	27	80	0.3375000
NODE_7902_length_939_cov_24.246429	422	502	0	80	80	1.0000000
NODE_7902_length_939_cov_24.246429	475	555	0	80	80	1.0000000
NODE_7902_length_939_cov_24.246429	551	631	0	80	80	1.0000000
NODE_7902_length_939_cov_24.246429	604	684	0	80	80	1.0000000
NODE_7903_length_939_cov_21.141667	368	448	0	80	80	1.0000000
NODE_7903_length_939_cov_21.141667	421	501	0	80	80	1.0000000
NODE_7904_length_939_cov_16.425000	327	407	2	80	80	1.0000000
NODE_7904_length_939_cov_16.425000	380	460	0	46	80	0.5750000
NODE_7904_length_939_cov_16.425000	380	460	2	34	80	0.4250000
NODE_7905_length_939_cov_13.828571	469	548	0	77	79	0.9746835
NODE_7905_length_939_cov_13.828571	469	548	2	2	79	0.0253165
NODE_7905_length_939_cov_13.828571	522	603	0	24	81	0.2962963
NODE_7905_length_939_cov_13.828571	522	603	2	57	81	0.7037037
NODE_7906_length_939_cov_13.521429	402	482	0	80	80	1.0000000
NODE_7906_length_939_cov_13.521429	455	535	0	80	80	1.0000000
NODE_7907_length_939_cov_12.955952	398	478	0	79	80	0.9875000
NODE_7907_length_939_cov_12.955952	398	478	2	1	80	0.0125000
NODE_7907_length_939_cov_12.955952	451	531	0	26	80	0.3250000
NODE_7907_length_939_cov_12.955952	451	531	2	54	80	0.6750000
NODE_7908_length_939_cov_6.564286	523	545	0	22	22	1.0000000
NODE_7922_length_938_cov_44.458880	362	442	0	73	80	0.9125000
NODE_7922_length_938_cov_44.458880	362	442	2	7	80	0.0875000
NODE_7922_length_938_cov_44.458880	415	495	0	20	80	0.2500000
NODE_7922_length_938_cov_44.458880	415	495	2	10	80	0.1250000
NODE_7922_length_938_cov_44.458880	415	495	4	9	80	0.1125000
NODE_7922_length_938_cov_44.458880	415	495	6	41	80	0.5125000
NODE_7923_length_938_cov_44.435042	748	815	8	13	67	0.1940299
NODE_7923_length_938_cov_44.435042	748	815	10	35	67	0.5223880
NODE_7923_length_938_cov_44.435042	748	815	12	19	67	0.2835821
NODE_7924_length_938_cov_32.177592	466	546	2	18	80	0.2250000
NODE_7924_length_938_cov_32.177592	466	546	6	1	80	0.0125000
NODE_7924_length_938_cov_32.177592	466	546	8	61	80	0.7625000
NODE_7924_length_938_cov_32.177592	519	599	0	20	80	0.2500000
NODE_7924_length_938_cov_32.177592	519	599	6	34	80	0.4250000
NODE_7924_length_938_cov_32.177592	519	599	8	26	80	0.3250000
NODE_7925_length_938_cov_21.139452	474	554	0	80	80	1.0000000
NODE_7925_length_938_cov_21.139452	527	607	0	80	80	1.0000000
NODE_7927_length_938_cov_8.791418	300	380	2	60	80	0.7500000
NODE_7927_length_938_cov_8.791418	300	380	6	20	80	0.2500000
NODE_7927_length_938_cov_8.791418	353	433	2	7	80	0.0875000
NODE_7927_length_938_cov_8.791418	353	433	6	57	80	0.7125000
NODE_7927_length_938_cov_8.791418	353	433	8	16	80	0.2000000
NODE_7932_length_938_cov_2.693683	59	139	10	1	80	0.0125000
NODE_7932_length_938_cov_2.693683	59	139	12	16	80	0.2000000
NODE_7932_length_938_cov_2.693683	59	139	14	32	80	0.4000000
NODE_7932_length_938_cov_2.693683	59	139	16	31	80	0.3875000
NODE_7932_length_938_cov_2.693683	112	192	0	24	80	0.3000000
NODE_7932_length_938_cov_2.693683	112	192	2	9	80	0.1125000
NODE_7932_length_938_cov_2.693683	112	192	4	11	80	0.1375000
NODE_7932_length_938_cov_2.693683	112	192	6	6	80	0.0750000
NODE_7932_length_938_cov_2.693683	112	192	12	10	80	0.1250000
NODE_7932_length_938_cov_2.693683	112	192	14	11	80	0.1375000
NODE_7932_length_938_cov_2.693683	112	192	16	9	80	0.1125000
NODE_7946_length_937_cov_31.890215	407	487	2	80	80	1.0000000
NODE_7946_length_937_cov_31.890215	460	536	0	41	76	0.5394737
NODE_7946_length_937_cov_31.890215	460	536	2	35	76	0.4605263
NODE_7947_length_937_cov_31.198091	425	505	0	80	80	1.0000000
NODE_7947_length_937_cov_31.198091	478	558	0	80	80	1.0000000
NODE_7948_length_937_cov_29.742243	296	376	0	38	80	0.4750000
NODE_7948_length_937_cov_29.742243	296	376	2	42	80	0.5250000
NODE_7948_length_937_cov_29.742243	349	429	0	65	80	0.8125000
NODE_7948_length_937_cov_29.742243	349	429	9	15	80	0.1875000
NODE_7948_length_937_cov_29.742243	425	505	9	15	80	0.1875000
NODE_7948_length_937_cov_29.742243	425	505	19	52	80	0.6500000
NODE_7948_length_937_cov_29.742243	425	505	20	13	80	0.1625000
NODE_7948_length_937_cov_29.742243	478	558	0	14	80	0.1750000
NODE_7948_length_937_cov_29.742243	478	558	10	19	80	0.2375000
NODE_7948_length_937_cov_29.742243	478	558	19	14	80	0.1750000
NODE_7948_length_937_cov_29.742243	478	558	20	33	80	0.4125000
NODE_7950_length_937_cov_26.153938	487	567	0	80	80	1.0000000
NODE_7950_length_937_cov_26.153938	540	620	0	80	80	1.0000000
NODE_7951_length_937_cov_20.898568	515	595	2	7	80	0.0875000
NODE_7951_length_937_cov_20.898568	515	595	5	8	80	0.1000000
NODE_7951_length_937_cov_20.898568	515	595	7	56	80	0.7000000
NODE_7951_length_937_cov_20.898568	515	595	8	9	80	0.1125000
NODE_7951_length_937_cov_20.898568	568	648	2	45	80	0.5625000
NODE_7951_length_937_cov_20.898568	568	648	3	15	80	0.1875000
NODE_7951_length_937_cov_20.898568	568	648	5	8	80	0.1000000
NODE_7951_length_937_cov_20.898568	568	648	7	12	80	0.1500000
NODE_7952_length_937_cov_20.502387	181	261	0	80	80	1.0000000
NODE_7952_length_937_cov_20.502387	234	314	0	56	80	0.7000000
NODE_7952_length_937_cov_20.502387	234	314	2	24	80	0.3000000
NODE_7952_length_937_cov_20.502387	310	390	2	37	80	0.4625000
NODE_7952_length_937_cov_20.502387	310	390	8	14	80	0.1750000
NODE_7952_length_937_cov_20.502387	310	390	10	29	80	0.3625000
NODE_7952_length_937_cov_20.502387	363	443	8	66	80	0.8250000
NODE_7952_length_937_cov_20.502387	363	443	10	14	80	0.1750000
NODE_7953_length_937_cov_15.219570	526	606	0	4	80	0.0500000
NODE_7953_length_937_cov_15.219570	526	606	2	13	80	0.1625000
NODE_7953_length_937_cov_15.219570	526	606	6	63	80	0.7875000
NODE_7953_length_937_cov_15.219570	579	659	0	34	80	0.4250000
NODE_7953_length_937_cov_15.219570	579	659	4	12	80	0.1500000
NODE_7953_length_937_cov_15.219570	579	659	6	34	80	0.4250000
NODE_7954_length_937_cov_9.633652	521	601	0	19	80	0.2375000
NODE_7954_length_937_cov_9.633652	521	601	2	61	80	0.7625000
NODE_7954_length_937_cov_9.633652	574	654	0	72	80	0.9000000
NODE_7954_length_937_cov_9.633652	574	654	2	8	80	0.1000000
NODE_7956_length_937_cov_6.630072	305	385	0	80	80	1.0000000
NODE_7956_length_937_cov_6.630072	358	438	0	80	80	1.0000000
NODE_7957_length_937_cov_4.649165	470	550	0	65	80	0.8125000
NODE_7957_length_937_cov_4.649165	470	550	2	15	80	0.1875000
NODE_7957_length_937_cov_4.649165	523	603	0	80	80	1.0000000
NODE_7969_length_936_cov_57.105137	267	347	0	15	80	0.1875000
NODE_7969_length_936_cov_57.105137	267	347	2	65	80	0.8125000
NODE_7969_length_936_cov_57.105137	320	400	2	66	80	0.8250000
NODE_7969_length_936_cov_57.105137	320	400	4	14	80	0.1750000
NODE_7969_length_936_cov_57.105137	396	476	0	18	80	0.2250000
NODE_7969_length_936_cov_57.105137	396	476	2	62	80	0.7750000
NODE_7969_length_936_cov_57.105137	449	529	0	71	80	0.8875000
NODE_7969_length_936_cov_57.105137	449	529	2	9	80	0.1125000
NODE_7970_length_936_cov_39.983274	433	513	2	80	80	1.0000000
NODE_7970_length_936_cov_39.983274	486	566	0	39	80	0.4875000
NODE_7970_length_936_cov_39.983274	486	566	2	41	80	0.5125000
NODE_7971_length_936_cov_22.486260	534	614	0	80	80	1.0000000
NODE_7971_length_936_cov_22.486260	587	667	0	80	80	1.0000000
NODE_7972_length_936_cov_19.639188	409	489	0	73	80	0.9125000
NODE_7972_length_936_cov_19.639188	409	489	2	7	80	0.0875000
NODE_7972_length_936_cov_19.639188	462	542	0	20	80	0.2500000
NODE_7972_length_936_cov_19.639188	462	542	2	31	80	0.3875000
NODE_7972_length_936_cov_19.639188	462	542	4	29	80	0.3625000
NODE_7973_length_936_cov_15.083632	322	402	0	58	80	0.7250000
NODE_7973_length_936_cov_15.083632	322	402	6	22	80	0.2750000
NODE_7973_length_936_cov_15.083632	375	455	0	5	80	0.0625000
NODE_7973_length_936_cov_15.083632	375	455	6	75	80	0.9375000
NODE_7974_length_936_cov_13.962963	356	424	2	1	68	0.0147059
NODE_7974_length_936_cov_13.962963	356	424	4	44	68	0.6470588
NODE_7974_length_936_cov_13.962963	356	424	6	23	68	0.3382353
NODE_7975_length_936_cov_12.502987	447	527	0	80	80	1.0000000
NODE_7975_length_936_cov_12.502987	500	580	0	80	80	1.0000000
NODE_7976_length_936_cov_12.279570	340	420	0	80	80	1.0000000
NODE_7976_length_936_cov_12.279570	393	473	0	80	80	1.0000000
NODE_7977_length_936_cov_7.906810	587	667	0	20	80	0.2500000
NODE_7977_length_936_cov_7.906810	587	667	4	4	80	0.0500000
NODE_7977_length_936_cov_7.906810	587	667	6	5	80	0.0625000
NODE_7977_length_936_cov_7.906810	587	667	8	5	80	0.0625000
NODE_7977_length_936_cov_7.906810	587	667	12	46	80	0.5750000
NODE_7977_length_936_cov_7.906810	640	720	2	28	80	0.3500000
NODE_7977_length_936_cov_7.906810	640	720	6	5	80	0.0625000
NODE_7977_length_936_cov_7.906810	640	720	10	3	80	0.0375000
NODE_7977_length_936_cov_7.906810	640	720	12	44	80	0.5500000
NODE_7978_length_936_cov_6.845878	322	402	0	80	80	1.0000000
NODE_7978_length_936_cov_6.845878	375	455	0	80	80	1.0000000
NODE_7979_length_936_cov_6.434886	556	635	0	79	79	1.0000000
NODE_7979_length_936_cov_6.434886	608	688	0	36	80	0.4500000
NODE_7979_length_936_cov_6.434886	608	688	2	44	80	0.5500000
NODE_7993_length_935_cov_38.209330	57	137	86	1	80	0.0125000
NODE_7993_length_935_cov_38.209330	57	137	88	1	80	0.0125000
NODE_7993_length_935_cov_38.209330	57	137	89	2	80	0.0250000
NODE_7993_length_935_cov_38.209330	57	137	92	2	80	0.0250000
NODE_7993_length_935_cov_38.209330	57	137	96	1	80	0.0125000
NODE_7993_length_935_cov_38.209330	57	137	98	3	80	0.0375000
NODE_7993_length_935_cov_38.209330	57	137	100	1	80	0.0125000
NODE_7993_length_935_cov_38.209330	57	137	102	1	80	0.0125000
NODE_7993_length_935_cov_38.209330	57	137	104	1	80	0.0125000
NODE_7993_length_935_cov_38.209330	57	137	106	1	80	0.0125000
NODE_7993_length_935_cov_38.209330	57	137	108	6	80	0.0750000
NODE_7993_length_935_cov_38.209330	57	137	113	1	80	0.0125000
NODE_7993_length_935_cov_38.209330	57	137	116	1	80	0.0125000
NODE_7993_length_935_cov_38.209330	57	137	122	1	80	0.0125000
NODE_7993_length_935_cov_38.209330	57	137	124	2	80	0.0250000
NODE_7993_length_935_cov_38.209330	57	137	126	2	80	0.0250000
NODE_7993_length_935_cov_38.209330	57	137	128	2	80	0.0250000
NODE_7993_length_935_cov_38.209330	57	137	129	1	80	0.0125000
NODE_7993_length_935_cov_38.209330	57	137	130	2	80	0.0250000
NODE_7993_length_935_cov_38.209330	57	137	132	15	80	0.1875000
NODE_7993_length_935_cov_38.209330	57	137	133	33	80	0.4125000
NODE_7994_length_935_cov_27.306220	439	519	0	80	80	1.0000000
NODE_7994_length_935_cov_27.306220	492	572	0	80	80	1.0000000
NODE_7995_length_935_cov_26.562201	321	401	4	43	80	0.5375000
NODE_7995_length_935_cov_26.562201	321	401	8	37	80	0.4625000
NODE_7995_length_935_cov_26.562201	374	454	4	37	80	0.4625000
NODE_7995_length_935_cov_26.562201	374	454	8	43	80	0.5375000
NODE_7995_length_935_cov_26.562201	450	530	0	64	80	0.8000000
NODE_7995_length_935_cov_26.562201	450	530	4	16	80	0.2000000
NODE_7995_length_935_cov_26.562201	503	583	0	80	80	1.0000000
NODE_7996_length_935_cov_25.098086	356	436	0	80	80	1.0000000
NODE_7996_length_935_cov_25.098086	409	489	0	80	80	1.0000000
NODE_7997_length_935_cov_24.316986	467	547	10	14	80	0.1750000
NODE_7997_length_935_cov_24.316986	467	547	12	14	80	0.1750000
NODE_7997_length_935_cov_24.316986	467	547	13	23	80	0.2875000
NODE_7997_length_935_cov_24.316986	467	547	14	9	80	0.1125000
NODE_7997_length_935_cov_24.316986	467	547	16	2	80	0.0250000
NODE_7997_length_935_cov_24.316986	467	547	17	18	80	0.2250000
NODE_7997_length_935_cov_24.316986	520	600	0	21	80	0.2625000
NODE_7997_length_935_cov_24.316986	520	600	2	1	80	0.0125000
NODE_7997_length_935_cov_24.316986	520	600	3	5	80	0.0625000
NODE_7997_length_935_cov_24.316986	520	600	5	10	80	0.1250000
NODE_7997_length_935_cov_24.316986	520	600	12	1	80	0.0125000
NODE_7997_length_935_cov_24.316986	520	600	13	24	80	0.3000000
NODE_7997_length_935_cov_24.316986	520	600	14	18	80	0.2250000
NODE_7998_length_935_cov_19.221292	397	477	2	12	80	0.1500000
NODE_7998_length_935_cov_19.221292	397	477	6	63	80	0.7875000
NODE_7998_length_935_cov_19.221292	397	477	8	5	80	0.0625000
NODE_7998_length_935_cov_19.221292	450	530	0	13	80	0.1625000
NODE_7998_length_935_cov_19.221292	450	530	2	6	80	0.0750000
NODE_7998_length_935_cov_19.221292	450	530	6	61	80	0.7625000
NODE_7999_length_935_cov_15.016746	404	484	2	79	80	0.9875000
NODE_7999_length_935_cov_15.016746	404	484	4	1	80	0.0125000
NODE_7999_length_935_cov_15.016746	457	537	0	49	80	0.6125000
NODE_7999_length_935_cov_15.016746	457	537	2	31	80	0.3875000
NODE_8000_length_935_cov_13.138756	341	421	0	8	80	0.1000000
NODE_8000_length_935_cov_13.138756	341	421	2	72	80	0.9000000
NODE_8000_length_935_cov_13.138756	394	474	0	9	80	0.1125000
NODE_8000_length_935_cov_13.138756	394	474	2	71	80	0.8875000
NODE_8002_length_935_cov_6.485646	512	592	0	27	80	0.3375000
NODE_8002_length_935_cov_6.485646	512	592	4	53	80	0.6625000
NODE_8002_length_935_cov_6.485646	565	645	0	45	80	0.5625000
NODE_8002_length_935_cov_6.485646	565	645	4	35	80	0.4375000
NODE_8003_length_935_cov_6.467703	250	330	2	59	80	0.7375000
NODE_8003_length_935_cov_6.467703	250	330	4	21	80	0.2625000
NODE_8003_length_935_cov_6.467703	303	383	0	41	80	0.5125000
NODE_8003_length_935_cov_6.467703	303	383	2	39	80	0.4875000
NODE_8004_length_935_cov_6.144737	478	558	0	80	80	1.0000000
NODE_8004_length_935_cov_6.144737	531	611	0	80	80	1.0000000
NODE_8005_length_935_cov_3.905502	39	119	6	2	80	0.0250000
NODE_8005_length_935_cov_3.905502	39	119	8	2	80	0.0250000
NODE_8005_length_935_cov_3.905502	39	119	10	5	80	0.0625000
NODE_8005_length_935_cov_3.905502	39	119	12	20	80	0.2500000
NODE_8005_length_935_cov_3.905502	39	119	14	51	80	0.6375000
NODE_8005_length_935_cov_3.905502	92	166	0	7	74	0.0945946
NODE_8005_length_935_cov_3.905502	92	166	2	28	74	0.3783784
NODE_8005_length_935_cov_3.905502	92	166	6	14	74	0.1891892
NODE_8005_length_935_cov_3.905502	92	166	8	2	74	0.0270270
NODE_8005_length_935_cov_3.905502	92	166	10	5	74	0.0675676
NODE_8005_length_935_cov_3.905502	92	166	12	3	74	0.0405405
NODE_8005_length_935_cov_3.905502	92	166	14	15	74	0.2027027
NODE_8028_length_934_cov_22.898204	403	483	0	80	80	1.0000000
NODE_8028_length_934_cov_22.898204	456	536	0	59	80	0.7375000
NODE_8028_length_934_cov_22.898204	456	536	2	21	80	0.2625000
NODE_8029_length_934_cov_17.746108	246	326	0	20	80	0.2500000
NODE_8029_length_934_cov_17.746108	246	326	2	24	80	0.3000000
NODE_8029_length_934_cov_17.746108	246	326	4	36	80	0.4500000
NODE_8029_length_934_cov_17.746108	299	379	0	8	80	0.1000000
NODE_8029_length_934_cov_17.746108	299	379	2	27	80	0.3375000
NODE_8029_length_934_cov_17.746108	299	379	4	45	80	0.5625000
NODE_8030_length_934_cov_16.049102	367	447	0	80	80	1.0000000
NODE_8030_length_934_cov_16.049102	420	500	0	80	80	1.0000000
NODE_8031_length_934_cov_13.738922	379	459	0	80	80	1.0000000
NODE_8031_length_934_cov_13.738922	432	459	0	27	27	1.0000000
NODE_8031_length_934_cov_13.738922	470	512	0	42	42	1.0000000
NODE_8032_length_934_cov_9.091018	407	487	0	80	80	1.0000000
NODE_8032_length_934_cov_9.091018	460	540	0	80	80	1.0000000
NODE_8034_length_934_cov_5.349701	583	663	0	78	80	0.9750000
NODE_8034_length_934_cov_5.349701	583	663	2	2	80	0.0250000
NODE_8050_length_933_cov_36.557554	462	542	0	36	80	0.4500000
NODE_8050_length_933_cov_36.557554	462	542	2	44	80	0.5500000
NODE_8050_length_933_cov_36.557554	515	595	0	80	80	1.0000000
NODE_8051_length_933_cov_27.645084	476	556	0	80	80	1.0000000
NODE_8051_length_933_cov_27.645084	529	609	0	80	80	1.0000000
NODE_8052_length_933_cov_26.749400	611	691	0	55	80	0.6875000
NODE_8052_length_933_cov_26.749400	611	691	8	25	80	0.3125000
NODE_8052_length_933_cov_26.749400	664	744	0	2	80	0.0250000
NODE_8052_length_933_cov_26.749400	664	744	7	19	80	0.2375000
NODE_8052_length_933_cov_26.749400	664	744	8	59	80	0.7375000
NODE_8053_length_933_cov_26.308153	430	510	0	44	80	0.5500000
NODE_8053_length_933_cov_26.308153	430	510	2	36	80	0.4500000
NODE_8053_length_933_cov_26.308153	483	563	0	80	80	1.0000000
NODE_8054_length_933_cov_19.966427	444	530	2	17	86	0.1976744
NODE_8054_length_933_cov_19.966427	444	530	5	69	86	0.8023256
NODE_8054_length_933_cov_19.966427	497	583	0	3	86	0.0348837
NODE_8054_length_933_cov_19.966427	497	583	1	31	86	0.3604651
NODE_8054_length_933_cov_19.966427	497	583	2	36	86	0.4186046
NODE_8054_length_933_cov_19.966427	497	583	5	16	86	0.1860465
NODE_8055_length_933_cov_16.870504	284	364	0	80	80	1.0000000
NODE_8055_length_933_cov_16.870504	337	415	0	78	78	1.0000000
NODE_8056_length_933_cov_16.699041	366	446	2	66	80	0.8250000
NODE_8056_length_933_cov_16.699041	366	446	4	2	80	0.0250000
NODE_8056_length_933_cov_16.699041	366	446	5	1	80	0.0125000
NODE_8056_length_933_cov_16.699041	366	446	6	11	80	0.1375000
NODE_8056_length_933_cov_16.699041	419	499	2	25	80	0.3125000
NODE_8056_length_933_cov_16.699041	419	499	4	49	80	0.6125000
NODE_8056_length_933_cov_16.699041	419	499	6	6	80	0.0750000
NODE_8057_length_933_cov_11.171463	197	277	0	16	80	0.2000000
NODE_8057_length_933_cov_11.171463	197	277	2	21	80	0.2625000
NODE_8057_length_933_cov_11.171463	197	277	12	1	80	0.0125000
NODE_8057_length_933_cov_11.171463	197	277	14	42	80	0.5250000
NODE_8057_length_933_cov_11.171463	250	330	8	23	80	0.2875000
NODE_8057_length_933_cov_11.171463	250	330	14	57	80	0.7125000
NODE_8073_length_932_cov_26.656663	397	477	0	6	80	0.0750000
NODE_8073_length_932_cov_26.656663	397	477	4	74	80	0.9250000
NODE_8073_length_932_cov_26.656663	450	530	0	52	80	0.6500000
NODE_8073_length_932_cov_26.656663	450	530	4	28	80	0.3500000
NODE_8074_length_932_cov_16.581032	407	485	0	78	78	1.0000000
NODE_8074_length_932_cov_16.581032	460	538	0	31	78	0.3974359
NODE_8074_length_932_cov_16.581032	460	538	4	47	78	0.6025641
NODE_8075_length_932_cov_13.462185	413	493	0	21	80	0.2625000
NODE_8075_length_932_cov_13.462185	413	493	1	59	80	0.7375000
NODE_8075_length_932_cov_13.462185	466	546	1	42	80	0.5250000
NODE_8075_length_932_cov_13.462185	466	546	2	38	80	0.4750000
NODE_8076_length_932_cov_13.442977	386	466	0	59	80	0.7375000
NODE_8076_length_932_cov_13.442977	386	466	2	21	80	0.2625000
NODE_8076_length_932_cov_13.442977	439	519	0	80	80	1.0000000
NODE_8077_length_932_cov_11.947179	344	424	1	15	80	0.1875000
NODE_8077_length_932_cov_11.947179	344	424	2	28	80	0.3500000
NODE_8077_length_932_cov_11.947179	344	424	4	1	80	0.0125000
NODE_8077_length_932_cov_11.947179	344	424	6	36	80	0.4500000
NODE_8077_length_932_cov_11.947179	397	477	5	33	80	0.4125000
NODE_8077_length_932_cov_11.947179	397	477	6	47	80	0.5875000
NODE_8079_length_932_cov_10.849940	409	489	0	39	80	0.4875000
NODE_8079_length_932_cov_10.849940	409	489	2	41	80	0.5125000
NODE_8079_length_932_cov_10.849940	462	542	0	30	80	0.3750000
NODE_8079_length_932_cov_10.849940	462	542	2	50	80	0.6250000
NODE_8080_length_932_cov_10.174070	342	422	0	80	80	1.0000000
NODE_8080_length_932_cov_10.174070	395	475	0	80	80	1.0000000
NODE_8082_length_932_cov_9.200480	184	264	0	80	80	1.0000000
NODE_8082_length_932_cov_9.200480	237	317	0	80	80	1.0000000
NODE_8090_length_932_cov_2.689076	598	676	0	78	78	1.0000000
NODE_8090_length_932_cov_2.689076	798	845	0	47	47	1.0000000
NODE_8103_length_931_cov_51.451923	320	400	0	80	80	1.0000000
NODE_8103_length_931_cov_51.451923	373	453	0	40	80	0.5000000
NODE_8103_length_931_cov_51.451923	373	453	2	40	80	0.5000000
NODE_8104_length_931_cov_46.621394	527	607	0	40	80	0.5000000
NODE_8104_length_931_cov_46.621394	527	607	2	35	80	0.4375000
NODE_8104_length_931_cov_46.621394	527	607	6	5	80	0.0625000
NODE_8104_length_931_cov_46.621394	580	660	0	80	80	1.0000000
NODE_8105_length_931_cov_36.334135	347	427	0	80	80	1.0000000
NODE_8105_length_931_cov_36.334135	400	480	0	80	80	1.0000000
NODE_8106_length_931_cov_32.495192	482	562	0	19	80	0.2375000
NODE_8106_length_931_cov_32.495192	482	562	2	61	80	0.7625000
NODE_8106_length_931_cov_32.495192	535	617	0	21	82	0.2560976
NODE_8106_length_931_cov_32.495192	535	617	2	8	82	0.0975610
NODE_8106_length_931_cov_32.495192	535	617	4	21	82	0.2560976
NODE_8106_length_931_cov_32.495192	535	617	6	32	82	0.3902439
NODE_8107_length_931_cov_22.100962	375	455	2	19	80	0.2375000
NODE_8107_length_931_cov_22.100962	375	455	6	61	80	0.7625000
NODE_8107_length_931_cov_22.100962	428	508	0	33	80	0.4125000
NODE_8107_length_931_cov_22.100962	428	508	2	39	80	0.4875000
NODE_8107_length_931_cov_22.100962	428	508	6	8	80	0.1000000
NODE_8108_length_931_cov_21.781250	347	427	0	23	80	0.2875000
NODE_8108_length_931_cov_21.781250	347	427	2	27	80	0.3375000
NODE_8108_length_931_cov_21.781250	347	427	6	30	80	0.3750000
NODE_8108_length_931_cov_21.781250	400	480	0	20	80	0.2500000
NODE_8108_length_931_cov_21.781250	400	480	4	10	80	0.1250000
NODE_8108_length_931_cov_21.781250	400	480	6	50	80	0.6250000
NODE_8109_length_931_cov_19.084135	411	491	2	35	80	0.4375000
NODE_8109_length_931_cov_19.084135	411	491	4	15	80	0.1875000
NODE_8109_length_931_cov_19.084135	411	491	6	30	80	0.3750000
NODE_8109_length_931_cov_19.084135	464	544	0	6	80	0.0750000
NODE_8109_length_931_cov_19.084135	464	544	2	3	80	0.0375000
NODE_8109_length_931_cov_19.084135	464	544	4	26	80	0.3250000
NODE_8109_length_931_cov_19.084135	464	544	6	45	80	0.5625000
NODE_8110_length_931_cov_14.879808	444	524	0	80	80	1.0000000
NODE_8110_length_931_cov_14.879808	497	577	0	80	80	1.0000000
NODE_8111_length_931_cov_13.087740	759	800	2	2	41	0.0487805
NODE_8111_length_931_cov_13.087740	759	800	4	1	41	0.0243902
NODE_8111_length_931_cov_13.087740	759	800	6	4	41	0.0975610
NODE_8111_length_931_cov_13.087740	759	800	8	29	41	0.7073171
NODE_8111_length_931_cov_13.087740	759	800	10	4	41	0.0975610
NODE_8111_length_931_cov_13.087740	759	800	12	1	41	0.0243902
NODE_8112_length_931_cov_10.534856	399	479	0	42	80	0.5250000
NODE_8112_length_931_cov_10.534856	399	479	2	38	80	0.4750000
NODE_8112_length_931_cov_10.534856	452	532	0	36	80	0.4500000
NODE_8112_length_931_cov_10.534856	452	532	2	44	80	0.5500000
NODE_8113_length_931_cov_9.865385	236	316	0	80	80	1.0000000
NODE_8113_length_931_cov_9.865385	289	369	0	80	80	1.0000000
NODE_8115_length_931_cov_6.201923	479	559	2	80	80	1.0000000
NODE_8115_length_931_cov_6.201923	532	612	0	46	80	0.5750000
NODE_8115_length_931_cov_6.201923	532	612	2	34	80	0.4250000
NODE_8124_length_931_cov_1.780048	832	902	0	68	70	0.9714286
NODE_8124_length_931_cov_1.780048	832	902	2	2	70	0.0285714
NODE_8126_length_931_cov_1.433894	220	284	10	7	64	0.1093750
NODE_8126_length_931_cov_1.433894	220	284	12	34	64	0.5312500
NODE_8126_length_931_cov_1.433894	220	284	14	23	64	0.3593750
NODE_8131_length_930_cov_49.052948	252	332	0	26	80	0.3250000
NODE_8131_length_930_cov_49.052948	252	332	2	54	80	0.6750000
NODE_8131_length_930_cov_49.052948	305	385	0	1	80	0.0125000
NODE_8131_length_930_cov_49.052948	305	385	2	79	80	0.9875000
NODE_8131_length_930_cov_49.052948	381	462	2	34	81	0.4197531
NODE_8131_length_930_cov_49.052948	381	462	4	22	81	0.2716049
NODE_8131_length_930_cov_49.052948	381	462	7	1	81	0.0123457
NODE_8131_length_930_cov_49.052948	381	462	8	24	81	0.2962963
NODE_8131_length_930_cov_49.052948	435	515	4	2	80	0.0250000
NODE_8131_length_930_cov_49.052948	435	515	6	15	80	0.1875000
NODE_8131_length_930_cov_49.052948	435	515	7	39	80	0.4875000
NODE_8131_length_930_cov_49.052948	435	515	8	24	80	0.3000000
NODE_8132_length_930_cov_31.510229	400	482	7	17	82	0.2073171
NODE_8132_length_930_cov_31.510229	400	482	12	29	82	0.3536585
NODE_8132_length_930_cov_31.510229	400	482	13	36	82	0.4390244
NODE_8132_length_930_cov_31.510229	453	535	0	44	82	0.5365854
NODE_8132_length_930_cov_31.510229	453	535	6	1	82	0.0121951
NODE_8132_length_930_cov_31.510229	453	535	7	25	82	0.3048781
NODE_8132_length_930_cov_31.510229	453	535	13	12	82	0.1463415
NODE_8133_length_930_cov_29.139591	329	409	2	80	80	1.0000000
NODE_8133_length_930_cov_29.139591	382	462	2	75	80	0.9375000
NODE_8133_length_930_cov_29.139591	382	462	3	5	80	0.0625000
NODE_8134_length_930_cov_24.787004	518	598	0	8	80	0.1000000
NODE_8134_length_930_cov_24.787004	518	598	2	72	80	0.9000000
NODE_8134_length_930_cov_24.787004	571	651	0	34	80	0.4250000
NODE_8134_length_930_cov_24.787004	571	651	2	46	80	0.5750000
NODE_8135_length_930_cov_24.608905	300	380	4	16	80	0.2000000
NODE_8135_length_930_cov_24.608905	300	380	8	64	80	0.8000000
NODE_8135_length_930_cov_24.608905	353	433	8	80	80	1.0000000
NODE_8136_length_930_cov_16.494585	482	562	0	4	80	0.0500000
NODE_8136_length_930_cov_16.494585	482	562	1	4	80	0.0500000
NODE_8136_length_930_cov_16.494585	482	562	2	72	80	0.9000000
NODE_8136_length_930_cov_16.494585	535	615	0	33	80	0.4125000
NODE_8136_length_930_cov_16.494585	535	615	2	47	80	0.5875000
NODE_8137_length_930_cov_13.296029	249	329	0	17	80	0.2125000
NODE_8137_length_930_cov_13.296029	249	329	2	63	80	0.7875000
NODE_8137_length_930_cov_13.296029	302	382	0	52	80	0.6500000
NODE_8137_length_930_cov_13.296029	302	382	2	28	80	0.3500000
NODE_8137_length_930_cov_13.296029	378	458	0	80	80	1.0000000
NODE_8137_length_930_cov_13.296029	431	511	0	80	80	1.0000000
NODE_8138_length_930_cov_11.758123	463	543	0	21	80	0.2625000
NODE_8138_length_930_cov_11.758123	463	543	1	1	80	0.0125000
NODE_8138_length_930_cov_11.758123	463	543	2	3	80	0.0375000
NODE_8138_length_930_cov_11.758123	463	543	3	27	80	0.3375000
NODE_8138_length_930_cov_11.758123	463	543	4	28	80	0.3500000
NODE_8138_length_930_cov_11.758123	516	596	2	56	80	0.7000000
NODE_8138_length_930_cov_11.758123	516	596	4	24	80	0.3000000
NODE_8139_length_930_cov_7.576414	531	611	2	33	80	0.4125000
NODE_8139_length_930_cov_7.576414	531	611	4	47	80	0.5875000
NODE_8139_length_930_cov_7.576414	584	664	0	11	80	0.1375000
NODE_8139_length_930_cov_7.576414	584	664	1	18	80	0.2250000
NODE_8139_length_930_cov_7.576414	584	664	3	1	80	0.0125000
NODE_8139_length_930_cov_7.576414	584	664	4	50	80	0.6250000
NODE_8156_length_930_cov_0.821901	676	736	0	60	60	1.0000000
NODE_8157_length_929_cov_54.485542	313	393	0	80	80	1.0000000
NODE_8157_length_929_cov_54.485542	366	446	0	80	80	1.0000000
NODE_8157_length_929_cov_54.485542	442	522	0	72	80	0.9000000
NODE_8157_length_929_cov_54.485542	442	522	2	1	80	0.0125000
NODE_8157_length_929_cov_54.485542	442	522	3	7	80	0.0875000
NODE_8157_length_929_cov_54.485542	495	575	0	19	80	0.2375000
NODE_8157_length_929_cov_54.485542	495	575	2	1	80	0.0125000
NODE_8157_length_929_cov_54.485542	495	575	3	60	80	0.7500000
NODE_8158_length_929_cov_49.865060	429	509	0	57	80	0.7125000
NODE_8158_length_929_cov_49.865060	429	509	2	8	80	0.1000000
NODE_8158_length_929_cov_49.865060	429	509	6	15	80	0.1875000
NODE_8158_length_929_cov_49.865060	482	562	0	4	80	0.0500000
NODE_8158_length_929_cov_49.865060	482	562	2	8	80	0.1000000
NODE_8158_length_929_cov_49.865060	482	562	6	65	80	0.8125000
NODE_8158_length_929_cov_49.865060	482	562	8	3	80	0.0375000
NODE_8159_length_929_cov_34.634940	358	438	10	80	80	1.0000000
NODE_8159_length_929_cov_34.634940	411	491	0	32	80	0.4000000
NODE_8159_length_929_cov_34.634940	411	491	9	1	80	0.0125000
NODE_8159_length_929_cov_34.634940	411	491	10	47	80	0.5875000
NODE_8161_length_929_cov_20.815663	365	445	0	50	80	0.6250000
NODE_8161_length_929_cov_20.815663	365	445	6	7	80	0.0875000
NODE_8161_length_929_cov_20.815663	365	445	7	9	80	0.1125000
NODE_8161_length_929_cov_20.815663	365	445	8	3	80	0.0375000
NODE_8161_length_929_cov_20.815663	365	445	10	10	80	0.1250000
NODE_8161_length_929_cov_20.815663	365	445	12	1	80	0.0125000
NODE_8161_length_929_cov_20.815663	418	498	0	80	80	1.0000000
NODE_8162_length_929_cov_17.798795	376	456	0	80	80	1.0000000
NODE_8162_length_929_cov_17.798795	429	509	0	80	80	1.0000000
NODE_8163_length_929_cov_16.622892	331	408	0	77	77	1.0000000
NODE_8163_length_929_cov_16.622892	381	461	0	80	80	1.0000000
NODE_8163_length_929_cov_16.622892	457	537	0	80	80	1.0000000
NODE_8163_length_929_cov_16.622892	510	590	0	80	80	1.0000000
NODE_8164_length_929_cov_15.242169	302	382	0	80	80	1.0000000
NODE_8164_length_929_cov_15.242169	355	435	0	80	80	1.0000000
NODE_8164_length_929_cov_15.242169	431	511	0	80	80	1.0000000
NODE_8164_length_929_cov_15.242169	484	564	0	80	80	1.0000000
NODE_8165_length_929_cov_13.197590	259	339	0	33	80	0.4125000
NODE_8165_length_929_cov_13.197590	259	339	3	47	80	0.5875000
NODE_8165_length_929_cov_13.197590	312	392	3	77	80	0.9625000
NODE_8165_length_929_cov_13.197590	312	392	4	3	80	0.0375000
NODE_8167_length_929_cov_7.766265	385	465	0	80	80	1.0000000
NODE_8167_length_929_cov_7.766265	438	518	0	80	80	1.0000000
NODE_8168_length_929_cov_5.750602	382	462	0	80	80	1.0000000
NODE_8168_length_929_cov_5.750602	435	515	0	80	80	1.0000000
NODE_8181_length_928_cov_35.226779	273	353	4	80	80	1.0000000
NODE_8181_length_928_cov_35.226779	326	406	0	48	80	0.6000000
NODE_8181_length_928_cov_35.226779	326	406	4	32	80	0.4000000
NODE_8181_length_928_cov_35.226779	402	482	0	80	80	1.0000000
NODE_8181_length_928_cov_35.226779	455	535	0	80	80	1.0000000
NODE_8182_length_928_cov_25.218335	299	379	0	9	80	0.1125000
NODE_8182_length_928_cov_25.218335	299	379	2	71	80	0.8875000
NODE_8182_length_928_cov_25.218335	352	432	0	58	80	0.7250000
NODE_8182_length_928_cov_25.218335	352	432	2	22	80	0.2750000
NODE_8183_length_928_cov_22.815440	342	422	0	30	80	0.3750000
NODE_8183_length_928_cov_22.815440	342	422	2	50	80	0.6250000
NODE_8183_length_928_cov_22.815440	395	475	0	15	80	0.1875000
NODE_8183_length_928_cov_22.815440	395	475	2	65	80	0.8125000
NODE_8183_length_928_cov_22.815440	471	551	0	9	80	0.1125000
NODE_8183_length_928_cov_22.815440	471	551	4	71	80	0.8875000
NODE_8183_length_928_cov_22.815440	524	604	0	37	80	0.4625000
NODE_8183_length_928_cov_22.815440	524	604	4	43	80	0.5375000
NODE_8184_length_928_cov_20.718938	365	445	2	12	80	0.1500000
NODE_8184_length_928_cov_20.718938	365	445	6	35	80	0.4375000
NODE_8184_length_928_cov_20.718938	365	445	14	7	80	0.0875000
NODE_8184_length_928_cov_20.718938	365	445	16	26	80	0.3250000
NODE_8184_length_928_cov_20.718938	418	498	9	41	80	0.5125000
NODE_8184_length_928_cov_20.718938	418	498	10	12	80	0.1500000
NODE_8184_length_928_cov_20.718938	418	498	14	7	80	0.0875000
NODE_8184_length_928_cov_20.718938	418	498	16	20	80	0.2500000
NODE_8185_length_928_cov_19.418577	420	500	2	50	80	0.6250000
NODE_8185_length_928_cov_19.418577	420	500	4	30	80	0.3750000
NODE_8185_length_928_cov_19.418577	473	553	0	45	80	0.5625000
NODE_8185_length_928_cov_19.418577	473	553	2	35	80	0.4375000
NODE_8185_length_928_cov_19.418577	549	591	2	42	42	1.0000000
NODE_8186_length_928_cov_13.354644	323	403	0	2	80	0.0250000
NODE_8186_length_928_cov_13.354644	323	403	2	24	80	0.3000000
NODE_8186_length_928_cov_13.354644	323	403	4	6	80	0.0750000
NODE_8186_length_928_cov_13.354644	323	403	8	48	80	0.6000000
NODE_8186_length_928_cov_13.354644	376	456	0	2	80	0.0250000
NODE_8186_length_928_cov_13.354644	376	456	3	1	80	0.0125000
NODE_8186_length_928_cov_13.354644	376	456	4	9	80	0.1125000
NODE_8186_length_928_cov_13.354644	376	456	6	28	80	0.3500000
NODE_8186_length_928_cov_13.354644	376	456	8	40	80	0.5000000
NODE_8187_length_928_cov_13.096502	361	441	0	80	80	1.0000000
NODE_8187_length_928_cov_13.096502	414	494	0	80	80	1.0000000
NODE_8189_length_928_cov_10.399276	447	527	0	6	80	0.0750000
NODE_8189_length_928_cov_10.399276	447	527	2	74	80	0.9250000
NODE_8189_length_928_cov_10.399276	500	580	0	55	80	0.6875000
NODE_8189_length_928_cov_10.399276	500	580	2	25	80	0.3125000
NODE_8207_length_927_cov_19.516908	398	478	6	50	80	0.6250000
NODE_8207_length_927_cov_19.516908	398	478	8	28	80	0.3500000
NODE_8207_length_927_cov_19.516908	398	478	10	1	80	0.0125000
NODE_8207_length_927_cov_19.516908	398	478	12	1	80	0.0125000
NODE_8207_length_927_cov_19.516908	451	531	2	14	80	0.1750000
NODE_8207_length_927_cov_19.516908	451	531	6	30	80	0.3750000
NODE_8207_length_927_cov_19.516908	451	531	8	36	80	0.4500000
NODE_8208_length_927_cov_11.190821	358	438	0	36	80	0.4500000
NODE_8208_length_927_cov_11.190821	358	438	2	44	80	0.5500000
NODE_8208_length_927_cov_11.190821	411	491	0	12	80	0.1500000
NODE_8208_length_927_cov_11.190821	411	491	2	68	80	0.8500000
NODE_8209_length_927_cov_8.123188	239	319	0	16	80	0.2000000
NODE_8209_length_927_cov_8.123188	239	319	2	64	80	0.8000000
NODE_8209_length_927_cov_8.123188	292	372	0	40	80	0.5000000
NODE_8209_length_927_cov_8.123188	292	372	2	40	80	0.5000000
NODE_8210_length_927_cov_4.585749	515	595	0	80	80	1.0000000
NODE_8210_length_927_cov_4.585749	568	648	0	80	80	1.0000000
NODE_8222_length_927_cov_1.250000	626	706	0	80	80	1.0000000
NODE_8222_length_927_cov_1.250000	679	759	0	80	80	1.0000000
NODE_8227_length_926_cov_78.382104	433	513	2	19	80	0.2375000
NODE_8227_length_926_cov_78.382104	433	513	6	7	80	0.0875000
NODE_8227_length_926_cov_78.382104	433	513	7	1	80	0.0125000
NODE_8227_length_926_cov_78.382104	433	513	8	53	80	0.6625000
NODE_8227_length_926_cov_78.382104	486	566	0	43	80	0.5375000
NODE_8227_length_926_cov_78.382104	486	566	6	17	80	0.2125000
NODE_8227_length_926_cov_78.382104	486	566	8	20	80	0.2500000
NODE_8228_length_926_cov_44.385732	383	463	1	22	80	0.2750000
NODE_8228_length_926_cov_44.385732	383	463	5	29	80	0.3625000
NODE_8228_length_926_cov_44.385732	383	463	6	3	80	0.0375000
NODE_8228_length_926_cov_44.385732	383	463	8	26	80	0.3250000
NODE_8228_length_926_cov_44.385732	436	516	3	9	80	0.1125000
NODE_8228_length_926_cov_44.385732	436	516	4	16	80	0.2000000
NODE_8228_length_926_cov_44.385732	436	516	6	1	80	0.0125000
NODE_8228_length_926_cov_44.385732	436	516	8	42	80	0.5250000
NODE_8228_length_926_cov_44.385732	436	516	9	12	80	0.1500000
NODE_8229_length_926_cov_43.446191	362	442	0	80	80	1.0000000
NODE_8229_length_926_cov_43.446191	415	495	0	50	80	0.6250000
NODE_8229_length_926_cov_43.446191	415	495	2	4	80	0.0500000
NODE_8229_length_926_cov_43.446191	415	495	4	26	80	0.3250000
NODE_8229_length_926_cov_43.446191	491	571	0	21	80	0.2625000
NODE_8229_length_926_cov_43.446191	491	571	2	5	80	0.0625000
NODE_8229_length_926_cov_43.446191	491	571	4	54	80	0.6750000
NODE_8229_length_926_cov_43.446191	544	624	0	74	80	0.9250000
NODE_8229_length_926_cov_43.446191	544	624	2	5	80	0.0625000
NODE_8229_length_926_cov_43.446191	544	624	4	1	80	0.0125000
NODE_8230_length_926_cov_40.163241	42	61	0	19	19	1.0000000
NODE_8230_length_926_cov_40.163241	279	359	5	2	80	0.0250000
NODE_8230_length_926_cov_40.163241	279	359	13	12	80	0.1500000
NODE_8230_length_926_cov_40.163241	279	359	15	66	80	0.8250000
NODE_8230_length_926_cov_40.163241	332	412	1	8	80	0.1000000
NODE_8230_length_926_cov_40.163241	332	412	9	7	80	0.0875000
NODE_8230_length_926_cov_40.163241	332	412	10	2	80	0.0250000
NODE_8230_length_926_cov_40.163241	332	412	12	4	80	0.0500000
NODE_8230_length_926_cov_40.163241	332	412	13	1	80	0.0125000
NODE_8230_length_926_cov_40.163241	332	412	14	1	80	0.0125000
NODE_8230_length_926_cov_40.163241	332	412	15	29	80	0.3625000
NODE_8230_length_926_cov_40.163241	332	412	16	28	80	0.3500000
NODE_8230_length_926_cov_40.163241	408	488	1	13	80	0.1625000
NODE_8230_length_926_cov_40.163241	408	488	3	19	80	0.2375000
NODE_8230_length_926_cov_40.163241	408	488	4	31	80	0.3875000
NODE_8230_length_926_cov_40.163241	408	488	5	17	80	0.2125000
NODE_8230_length_926_cov_40.163241	461	541	2	5	80	0.0625000
NODE_8230_length_926_cov_40.163241	461	541	4	75	80	0.9375000
NODE_8231_length_926_cov_29.923821	372	452	0	22	80	0.2750000
NODE_8231_length_926_cov_29.923821	372	452	4	58	80	0.7250000
NODE_8231_length_926_cov_29.923821	425	505	0	25	80	0.3125000
NODE_8231_length_926_cov_29.923821	425	505	4	55	80	0.6875000
NODE_8232_length_926_cov_24.657799	350	430	0	46	80	0.5750000
NODE_8232_length_926_cov_24.657799	350	430	2	34	80	0.4250000
NODE_8232_length_926_cov_24.657799	403	483	2	80	80	1.0000000
NODE_8233_length_926_cov_17.438936	360	440	2	80	80	1.0000000
NODE_8233_length_926_cov_17.438936	413	493	0	14	80	0.1750000
NODE_8233_length_926_cov_17.438936	413	493	2	66	80	0.8250000
NODE_8234_length_926_cov_12.413543	418	491	2	73	73	1.0000000
NODE_8234_length_926_cov_12.413543	464	544	0	6	80	0.0750000
NODE_8234_length_926_cov_12.413543	464	544	2	74	80	0.9250000
NODE_8235_length_926_cov_5.771463	453	533	0	80	80	1.0000000
NODE_8235_length_926_cov_5.771463	505	586	0	81	81	1.0000000
NODE_8236_length_926_cov_5.209190	435	515	0	80	80	1.0000000
NODE_8236_length_926_cov_5.209190	488	568	0	80	80	1.0000000
NODE_8247_length_925_cov_40.767554	514	594	0	32	80	0.4000000
NODE_8247_length_925_cov_40.767554	514	594	4	48	80	0.6000000
NODE_8247_length_925_cov_40.767554	567	647	4	80	80	1.0000000
NODE_8248_length_925_cov_30.226392	262	342	0	66	80	0.8250000
NODE_8248_length_925_cov_30.226392	262	342	2	14	80	0.1750000
NODE_8248_length_925_cov_30.226392	315	395	0	61	80	0.7625000
NODE_8248_length_925_cov_30.226392	315	395	2	19	80	0.2375000
NODE_8248_length_925_cov_30.226392	391	471	0	80	80	1.0000000
NODE_8248_length_925_cov_30.226392	444	524	0	80	80	1.0000000
NODE_8249_length_925_cov_22.075061	334	414	0	18	80	0.2250000
NODE_8249_length_925_cov_22.075061	334	414	2	62	80	0.7750000
NODE_8249_length_925_cov_22.075061	387	467	0	18	80	0.2250000
NODE_8249_length_925_cov_22.075061	387	467	2	62	80	0.7750000
NODE_8250_length_925_cov_18.164649	410	490	0	4	80	0.0500000
NODE_8250_length_925_cov_18.164649	410	490	3	1	80	0.0125000
NODE_8250_length_925_cov_18.164649	410	490	5	46	80	0.5750000
NODE_8250_length_925_cov_18.164649	410	490	6	29	80	0.3625000
NODE_8250_length_925_cov_18.164649	464	543	0	57	79	0.7215190
NODE_8250_length_925_cov_18.164649	464	543	3	1	79	0.0126582
NODE_8250_length_925_cov_18.164649	464	543	5	21	79	0.2658228
NODE_8251_length_925_cov_14.067797	472	548	0	58	76	0.7631579
NODE_8251_length_925_cov_14.067797	472	548	2	18	76	0.2368421
NODE_8251_length_925_cov_14.067797	525	601	0	76	76	1.0000000
NODE_8252_length_925_cov_7.098063	418	498	0	80	80	1.0000000
NODE_8252_length_925_cov_7.098063	471	551	0	80	80	1.0000000
NODE_8266_length_924_cov_61.292121	397	477	0	49	80	0.6125000
NODE_8266_length_924_cov_61.292121	397	477	4	31	80	0.3875000
NODE_8266_length_924_cov_61.292121	450	530	0	2	80	0.0250000
NODE_8266_length_924_cov_61.292121	450	530	3	1	80	0.0125000
NODE_8266_length_924_cov_61.292121	450	530	4	77	80	0.9625000
NODE_8267_length_924_cov_31.522424	375	455	2	60	80	0.7500000
NODE_8267_length_924_cov_31.522424	375	455	4	20	80	0.2500000
NODE_8267_length_924_cov_31.522424	428	508	0	14	80	0.1750000
NODE_8267_length_924_cov_31.522424	428	508	2	66	80	0.8250000
NODE_8268_length_924_cov_30.446061	299	379	0	80	80	1.0000000
NODE_8268_length_924_cov_30.446061	352	432	0	80	80	1.0000000
NODE_8268_length_924_cov_30.446061	428	508	0	80	80	1.0000000
NODE_8268_length_924_cov_30.446061	481	561	0	80	80	1.0000000
NODE_8269_length_924_cov_28.877576	542	622	0	80	80	1.0000000
NODE_8269_length_924_cov_28.877576	595	675	0	80	80	1.0000000
NODE_8270_length_924_cov_27.261818	506	586	0	54	80	0.6750000
NODE_8270_length_924_cov_27.261818	506	586	2	26	80	0.3250000
NODE_8270_length_924_cov_27.261818	559	639	0	80	80	1.0000000
NODE_8271_length_924_cov_25.946667	371	451	0	80	80	1.0000000
NODE_8271_length_924_cov_25.946667	424	504	0	72	80	0.9000000
NODE_8271_length_924_cov_25.946667	424	504	5	8	80	0.1000000
NODE_8271_length_924_cov_25.946667	500	580	5	24	80	0.3000000
NODE_8271_length_924_cov_25.946667	500	580	7	49	80	0.6125000
NODE_8271_length_924_cov_25.946667	500	580	8	7	80	0.0875000
NODE_8271_length_924_cov_25.946667	553	633	0	20	80	0.2500000
NODE_8271_length_924_cov_25.946667	553	633	2	5	80	0.0625000
NODE_8271_length_924_cov_25.946667	553	633	6	1	80	0.0125000
NODE_8271_length_924_cov_25.946667	553	633	7	45	80	0.5625000
NODE_8271_length_924_cov_25.946667	553	633	8	9	80	0.1125000
NODE_8272_length_924_cov_25.113939	305	385	0	80	80	1.0000000
NODE_8272_length_924_cov_25.113939	358	438	0	80	80	1.0000000
NODE_8272_length_924_cov_25.113939	434	514	0	80	80	1.0000000
NODE_8272_length_924_cov_25.113939	487	567	0	80	80	1.0000000
NODE_8273_length_924_cov_16.343030	481	561	0	21	80	0.2625000
NODE_8273_length_924_cov_16.343030	481	561	2	22	80	0.2750000
NODE_8273_length_924_cov_16.343030	481	561	4	37	80	0.4625000
NODE_8273_length_924_cov_16.343030	534	614	2	28	80	0.3500000
NODE_8273_length_924_cov_16.343030	534	614	4	52	80	0.6500000
NODE_8274_length_924_cov_14.793939	299	379	0	80	80	1.0000000
NODE_8274_length_924_cov_14.793939	352	432	0	80	80	1.0000000
NODE_8275_length_924_cov_14.209697	485	562	0	77	77	1.0000000
NODE_8275_length_924_cov_14.209697	535	615	0	80	80	1.0000000
NODE_8276_length_924_cov_13.423030	287	367	0	17	80	0.2125000
NODE_8276_length_924_cov_13.423030	287	367	1	63	80	0.7875000
NODE_8276_length_924_cov_13.423030	340	420	0	70	80	0.8750000
NODE_8276_length_924_cov_13.423030	340	420	1	10	80	0.1250000
NODE_8277_length_924_cov_12.008485	237	307	0	70	70	1.0000000
NODE_8279_length_924_cov_8.619394	560	640	0	80	80	1.0000000
NODE_8279_length_924_cov_8.619394	613	693	0	80	80	1.0000000
NODE_8280_length_924_cov_4.640000	426	506	0	80	80	1.0000000
NODE_8280_length_924_cov_4.640000	479	559	0	28	80	0.3500000
NODE_8280_length_924_cov_4.640000	479	559	2	52	80	0.6500000
NODE_8290_length_924_cov_1.467879	352	381	0	29	29	1.0000000
NODE_8296_length_924_cov_0.648485	830	890	0	10	60	0.1666667
NODE_8296_length_924_cov_0.648485	830	890	2	50	60	0.8333333
NODE_8296_length_924_cov_0.648485	863	924	0	8	61	0.1311475
NODE_8296_length_924_cov_0.648485	863	924	2	53	61	0.8688524
NODE_8297_length_923_cov_43.213592	371	451	0	44	80	0.5500000
NODE_8297_length_923_cov_43.213592	371	451	1	29	80	0.3625000
NODE_8297_length_923_cov_43.213592	371	451	5	7	80	0.0875000
NODE_8297_length_923_cov_43.213592	424	504	1	20	80	0.2500000
NODE_8297_length_923_cov_43.213592	424	504	5	60	80	0.7500000
NODE_8297_length_923_cov_43.213592	500	580	0	15	80	0.1875000
NODE_8297_length_923_cov_43.213592	500	580	1	42	80	0.5250000
NODE_8297_length_923_cov_43.213592	500	580	5	23	80	0.2875000
NODE_8297_length_923_cov_43.213592	553	633	0	29	80	0.3625000
NODE_8297_length_923_cov_43.213592	553	633	1	51	80	0.6375000
NODE_8298_length_923_cov_34.108010	370	450	6	3	80	0.0375000
NODE_8298_length_923_cov_34.108010	370	450	10	16	80	0.2000000
NODE_8298_length_923_cov_34.108010	370	450	12	61	80	0.7625000
NODE_8298_length_923_cov_34.108010	423	503	0	38	80	0.4750000
NODE_8298_length_923_cov_34.108010	423	503	6	2	80	0.0250000
NODE_8298_length_923_cov_34.108010	423	503	10	29	80	0.3625000
NODE_8298_length_923_cov_34.108010	423	503	12	11	80	0.1375000
NODE_8299_length_923_cov_29.163835	392	472	0	80	80	1.0000000
NODE_8299_length_923_cov_29.163835	445	525	0	80	80	1.0000000
NODE_8300_length_923_cov_19.139563	375	455	0	80	80	1.0000000
NODE_8300_length_923_cov_19.139563	428	508	0	80	80	1.0000000
NODE_8301_length_923_cov_17.433252	512	592	0	8	80	0.1000000
NODE_8301_length_923_cov_17.433252	512	592	2	72	80	0.9000000
NODE_8301_length_923_cov_17.433252	565	645	0	33	80	0.4125000
NODE_8301_length_923_cov_17.433252	565	645	2	47	80	0.5875000
NODE_8302_length_923_cov_16.597087	279	359	0	37	80	0.4625000
NODE_8302_length_923_cov_16.597087	279	359	1	11	80	0.1375000
NODE_8302_length_923_cov_16.597087	279	359	2	32	80	0.4000000
NODE_8302_length_923_cov_16.597087	332	412	2	80	80	1.0000000
NODE_8303_length_923_cov_15.229369	446	526	0	80	80	1.0000000
NODE_8303_length_923_cov_15.229369	499	579	0	80	80	1.0000000
NODE_8304_length_923_cov_14.007282	304	349	0	45	45	1.0000000
NODE_8304_length_923_cov_14.007282	345	427	0	82	82	1.0000000
NODE_8304_length_923_cov_14.007282	397	480	0	83	83	1.0000000
NODE_8305_length_923_cov_6.500000	308	388	6	6	80	0.0750000
NODE_8305_length_923_cov_6.500000	308	388	12	29	80	0.3625000
NODE_8305_length_923_cov_6.500000	308	388	14	45	80	0.5625000
NODE_8305_length_923_cov_6.500000	361	441	8	11	80	0.1375000
NODE_8305_length_923_cov_6.500000	361	441	14	69	80	0.8625000
NODE_8307_length_923_cov_6.115291	447	527	0	26	80	0.3250000
NODE_8307_length_923_cov_6.115291	447	527	2	54	80	0.6750000
NODE_8307_length_923_cov_6.115291	500	580	0	22	80	0.2750000
NODE_8307_length_923_cov_6.115291	500	580	2	58	80	0.7250000
NODE_8308_length_923_cov_5.351942	363	445	0	29	82	0.3536585
NODE_8308_length_923_cov_5.351942	363	445	2	53	82	0.6463414
NODE_8308_length_923_cov_5.351942	365	445	0	29	80	0.3625000
NODE_8308_length_923_cov_5.351942	365	445	2	51	80	0.6375000
NODE_8317_length_923_cov_1.059466	63	143	2	35	80	0.4375000
NODE_8317_length_923_cov_1.059466	63	143	4	4	80	0.0500000
NODE_8317_length_923_cov_1.059466	63	143	6	41	80	0.5125000
NODE_8320_length_922_cov_40.331713	243	289	72	5	46	0.1086956
NODE_8320_length_922_cov_40.331713	243	289	74	3	46	0.0652174
NODE_8320_length_922_cov_40.331713	243	289	75	1	46	0.0217391
NODE_8320_length_922_cov_40.331713	243	289	76	2	46	0.0434783
NODE_8320_length_922_cov_40.331713	243	289	79	2	46	0.0434783
NODE_8320_length_922_cov_40.331713	243	289	80	2	46	0.0434783
NODE_8320_length_922_cov_40.331713	243	289	81	5	46	0.1086956
NODE_8320_length_922_cov_40.331713	243	289	82	2	46	0.0434783
NODE_8320_length_922_cov_40.331713	243	289	85	1	46	0.0217391
NODE_8320_length_922_cov_40.331713	243	289	86	1	46	0.0217391
NODE_8320_length_922_cov_40.331713	243	289	87	3	46	0.0652174
NODE_8320_length_922_cov_40.331713	243	289	89	3	46	0.0652174
NODE_8320_length_922_cov_40.331713	243	289	91	1	46	0.0217391
NODE_8320_length_922_cov_40.331713	243	289	93	2	46	0.0434783
NODE_8320_length_922_cov_40.331713	243	289	95	1	46	0.0217391
NODE_8320_length_922_cov_40.331713	243	289	97	1	46	0.0217391
NODE_8320_length_922_cov_40.331713	243	289	106	3	46	0.0652174
NODE_8320_length_922_cov_40.331713	243	289	108	1	46	0.0217391
NODE_8320_length_922_cov_40.331713	243	289	110	1	46	0.0217391
NODE_8320_length_922_cov_40.331713	243	289	121	1	46	0.0217391
NODE_8320_length_922_cov_40.331713	243	289	123	3	46	0.0652174
NODE_8320_length_922_cov_40.331713	243	289	125	1	46	0.0217391
NODE_8320_length_922_cov_40.331713	243	289	129	1	46	0.0217391
NODE_8320_length_922_cov_40.331713	262	342	72	5	80	0.0625000
NODE_8320_length_922_cov_40.331713	262	342	74	3	80	0.0375000
NODE_8320_length_922_cov_40.331713	262	342	75	1	80	0.0125000
NODE_8320_length_922_cov_40.331713	262	342	76	2	80	0.0250000
NODE_8320_length_922_cov_40.331713	262	342	79	2	80	0.0250000
NODE_8320_length_922_cov_40.331713	262	342	80	2	80	0.0250000
NODE_8320_length_922_cov_40.331713	262	342	81	5	80	0.0625000
NODE_8320_length_922_cov_40.331713	262	342	82	1	80	0.0125000
NODE_8320_length_922_cov_40.331713	262	342	83	1	80	0.0125000
NODE_8320_length_922_cov_40.331713	262	342	84	1	80	0.0125000
NODE_8320_length_922_cov_40.331713	262	342	86	1	80	0.0125000
NODE_8320_length_922_cov_40.331713	262	342	87	3	80	0.0375000
NODE_8320_length_922_cov_40.331713	262	342	89	2	80	0.0250000
NODE_8320_length_922_cov_40.331713	262	342	93	1	80	0.0125000
NODE_8320_length_922_cov_40.331713	262	342	96	1	80	0.0125000
NODE_8320_length_922_cov_40.331713	262	342	98	2	80	0.0250000
NODE_8320_length_922_cov_40.331713	262	342	102	1	80	0.0125000
NODE_8320_length_922_cov_40.331713	262	342	104	1	80	0.0125000
NODE_8320_length_922_cov_40.331713	262	342	105	2	80	0.0250000
NODE_8320_length_922_cov_40.331713	262	342	107	1	80	0.0125000
NODE_8320_length_922_cov_40.331713	262	342	111	1	80	0.0125000
NODE_8320_length_922_cov_40.331713	262	342	117	4	80	0.0500000
NODE_8320_length_922_cov_40.331713	262	342	119	2	80	0.0250000
NODE_8320_length_922_cov_40.331713	262	342	122	1	80	0.0125000
NODE_8320_length_922_cov_40.331713	262	342	132	1	80	0.0125000
NODE_8320_length_922_cov_40.331713	262	342	134	1	80	0.0125000
NODE_8320_length_922_cov_40.331713	262	342	141	1	80	0.0125000
NODE_8320_length_922_cov_40.331713	262	342	151	1	80	0.0125000
NODE_8320_length_922_cov_40.331713	262	342	153	2	80	0.0250000
NODE_8320_length_922_cov_40.331713	262	342	155	1	80	0.0125000
NODE_8320_length_922_cov_40.331713	262	342	156	1	80	0.0125000
NODE_8320_length_922_cov_40.331713	262	342	160	1	80	0.0125000
NODE_8320_length_922_cov_40.331713	262	342	167	1	80	0.0125000
NODE_8320_length_922_cov_40.331713	262	342	173	1	80	0.0125000
NODE_8320_length_922_cov_40.331713	262	342	188	1	80	0.0125000
NODE_8320_length_922_cov_40.331713	262	342	201	1	80	0.0125000
NODE_8320_length_922_cov_40.331713	262	342	217	1	80	0.0125000
NODE_8320_length_922_cov_40.331713	262	342	224	2	80	0.0250000
NODE_8320_length_922_cov_40.331713	262	342	228	1	80	0.0125000
NODE_8320_length_922_cov_40.331713	262	342	234	1	80	0.0125000
NODE_8320_length_922_cov_40.331713	262	342	240	1	80	0.0125000
NODE_8320_length_922_cov_40.331713	262	342	242	1	80	0.0125000
NODE_8320_length_922_cov_40.331713	262	342	244	2	80	0.0250000
NODE_8320_length_922_cov_40.331713	262	342	248	1	80	0.0125000
NODE_8320_length_922_cov_40.331713	262	342	250	2	80	0.0250000
NODE_8320_length_922_cov_40.331713	262	342	255	1	80	0.0125000
NODE_8320_length_922_cov_40.331713	262	342	256	1	80	0.0125000
NODE_8320_length_922_cov_40.331713	262	342	263	1	80	0.0125000
NODE_8320_length_922_cov_40.331713	262	342	264	1	80	0.0125000
NODE_8320_length_922_cov_40.331713	262	342	276	1	80	0.0125000
NODE_8320_length_922_cov_40.331713	262	342	282	1	80	0.0125000
NODE_8320_length_922_cov_40.331713	262	342	296	1	80	0.0125000
NODE_8320_length_922_cov_40.331713	262	342	304	1	80	0.0125000
NODE_8320_length_922_cov_40.331713	262	342	315	1	80	0.0125000
NODE_8320_length_922_cov_40.331713	780	860	0	20	80	0.2500000
NODE_8320_length_922_cov_40.331713	780	860	4	60	80	0.7500000
NODE_8320_length_922_cov_40.331713	833	913	0	22	80	0.2750000
NODE_8320_length_922_cov_40.331713	833	913	3	17	80	0.2125000
NODE_8320_length_922_cov_40.331713	833	913	4	41	80	0.5125000
NODE_8321_length_922_cov_38.549210	126	177	181	1	51	0.0196078
NODE_8321_length_922_cov_38.549210	126	177	183	1	51	0.0196078
NODE_8321_length_922_cov_38.549210	126	177	202	1	51	0.0196078
NODE_8321_length_922_cov_38.549210	126	177	208	1	51	0.0196078
NODE_8321_length_922_cov_38.549210	126	177	225	1	51	0.0196078
NODE_8321_length_922_cov_38.549210	126	177	231	1	51	0.0196078
NODE_8321_length_922_cov_38.549210	126	177	235	1	51	0.0196078
NODE_8321_length_922_cov_38.549210	126	177	239	1	51	0.0196078
NODE_8321_length_922_cov_38.549210	126	177	255	1	51	0.0196078
NODE_8321_length_922_cov_38.549210	126	177	263	1	51	0.0196078
NODE_8321_length_922_cov_38.549210	126	177	270	1	51	0.0196078
NODE_8321_length_922_cov_38.549210	126	177	272	1	51	0.0196078
NODE_8321_length_922_cov_38.549210	126	177	293	1	51	0.0196078
NODE_8321_length_922_cov_38.549210	126	177	308	1	51	0.0196078
NODE_8321_length_922_cov_38.549210	126	177	323	1	51	0.0196078
NODE_8321_length_922_cov_38.549210	126	177	329	1	51	0.0196078
NODE_8321_length_922_cov_38.549210	126	177	333	1	51	0.0196078
NODE_8321_length_922_cov_38.549210	126	177	339	1	51	0.0196078
NODE_8321_length_922_cov_38.549210	126	177	341	1	51	0.0196078
NODE_8321_length_922_cov_38.549210	126	177	345	1	51	0.0196078
NODE_8321_length_922_cov_38.549210	126	177	349	1	51	0.0196078
NODE_8321_length_922_cov_38.549210	126	177	351	2	51	0.0392157
NODE_8321_length_922_cov_38.549210	126	177	353	1	51	0.0196078
NODE_8321_length_922_cov_38.549210	126	177	363	3	51	0.0588235
NODE_8321_length_922_cov_38.549210	126	177	365	2	51	0.0392157
NODE_8321_length_922_cov_38.549210	126	177	379	1	51	0.0196078
NODE_8321_length_922_cov_38.549210	126	177	388	1	51	0.0196078
NODE_8321_length_922_cov_38.549210	126	177	393	1	51	0.0196078
NODE_8321_length_922_cov_38.549210	126	177	398	1	51	0.0196078
NODE_8321_length_922_cov_38.549210	126	177	402	1	51	0.0196078
NODE_8321_length_922_cov_38.549210	126	177	417	1	51	0.0196078
NODE_8321_length_922_cov_38.549210	126	177	420	1	51	0.0196078
NODE_8321_length_922_cov_38.549210	126	177	422	1	51	0.0196078
NODE_8321_length_922_cov_38.549210	126	177	424	1	51	0.0196078
NODE_8321_length_922_cov_38.549210	126	177	428	1	51	0.0196078
NODE_8321_length_922_cov_38.549210	126	177	431	1	51	0.0196078
NODE_8321_length_922_cov_38.549210	126	177	433	1	51	0.0196078
NODE_8321_length_922_cov_38.549210	126	177	435	2	51	0.0392157
NODE_8321_length_922_cov_38.549210	126	177	439	1	51	0.0196078
NODE_8321_length_922_cov_38.549210	126	177	445	1	51	0.0196078
NODE_8321_length_922_cov_38.549210	126	177	449	2	51	0.0392157
NODE_8321_length_922_cov_38.549210	126	177	453	1	51	0.0196078
NODE_8321_length_922_cov_38.549210	126	177	473	1	51	0.0196078
NODE_8321_length_922_cov_38.549210	126	177	485	1	51	0.0196078
NODE_8321_length_922_cov_38.549210	126	177	489	1	51	0.0196078
NODE_8321_length_922_cov_38.549210	308	383	0	75	75	1.0000000
NODE_8321_length_922_cov_38.549210	356	393	0	37	37	1.0000000
NODE_8321_length_922_cov_38.549210	818	898	0	80	80	1.0000000
NODE_8321_length_922_cov_38.549210	871	908	0	37	37	1.0000000
NODE_8322_length_922_cov_35.041312	385	465	0	80	80	1.0000000
NODE_8322_length_922_cov_35.041312	438	518	0	80	80	1.0000000
NODE_8323_length_922_cov_30.749696	426	506	0	5	80	0.0625000
NODE_8323_length_922_cov_30.749696	426	506	2	64	80	0.8000000
NODE_8323_length_922_cov_30.749696	426	506	10	11	80	0.1375000
NODE_8323_length_922_cov_30.749696	479	559	2	16	80	0.2000000
NODE_8323_length_922_cov_30.749696	479	559	8	5	80	0.0625000
NODE_8323_length_922_cov_30.749696	479	559	10	59	80	0.7375000
NODE_8324_length_922_cov_25.558931	291	370	0	67	79	0.8481013
NODE_8324_length_922_cov_25.558931	291	370	1	12	79	0.1518987
NODE_8324_length_922_cov_25.558931	344	423	0	14	79	0.1772152
NODE_8324_length_922_cov_25.558931	344	423	1	26	79	0.3291139
NODE_8324_length_922_cov_25.558931	344	423	2	39	79	0.4936709
NODE_8325_length_922_cov_25.527339	391	471	0	80	80	1.0000000
NODE_8325_length_922_cov_25.527339	444	524	0	80	80	1.0000000
NODE_8326_length_922_cov_23.630620	224	304	6	23	80	0.2875000
NODE_8326_length_922_cov_23.630620	224	304	8	3	80	0.0375000
NODE_8326_length_922_cov_23.630620	224	304	10	54	80	0.6750000
NODE_8326_length_922_cov_23.630620	277	357	4	20	80	0.2500000
NODE_8326_length_922_cov_23.630620	277	357	8	36	80	0.4500000
NODE_8326_length_922_cov_23.630620	277	357	10	24	80	0.3000000
NODE_8326_length_922_cov_23.630620	353	433	0	71	80	0.8875000
NODE_8326_length_922_cov_23.630620	353	433	4	9	80	0.1125000
NODE_8326_length_922_cov_23.630620	406	486	0	80	80	1.0000000
NODE_8327_length_922_cov_22.388821	465	545	0	61	80	0.7625000
NODE_8327_length_922_cov_22.388821	465	545	2	15	80	0.1875000
NODE_8327_length_922_cov_22.388821	465	545	6	4	80	0.0500000
NODE_8327_length_922_cov_22.388821	518	598	0	80	80	1.0000000
NODE_8328_length_922_cov_20.320778	421	501	0	80	80	1.0000000
NODE_8328_length_922_cov_20.320778	474	554	0	63	80	0.7875000
NODE_8328_length_922_cov_20.320778	474	554	2	17	80	0.2125000
NODE_8329_length_922_cov_17.645200	413	479	2	66	66	1.0000000
NODE_8330_length_922_cov_12.574727	454	534	2	5	80	0.0625000
NODE_8330_length_922_cov_12.574727	454	534	4	75	80	0.9375000
NODE_8330_length_922_cov_12.574727	507	587	4	29	80	0.3625000
NODE_8330_length_922_cov_12.574727	507	587	8	51	80	0.6375000
NODE_8331_length_922_cov_11.934386	255	335	0	29	80	0.3625000
NODE_8331_length_922_cov_11.934386	255	335	2	51	80	0.6375000
NODE_8331_length_922_cov_11.934386	308	388	0	80	80	1.0000000
NODE_8332_length_922_cov_11.068044	423	503	0	80	80	1.0000000
NODE_8332_length_922_cov_11.068044	476	557	0	81	81	1.0000000
NODE_8333_length_922_cov_7.907655	441	521	0	80	80	1.0000000
NODE_8333_length_922_cov_7.907655	494	574	0	72	80	0.9000000
NODE_8333_length_922_cov_7.907655	494	574	2	8	80	0.1000000
NODE_8334_length_922_cov_7.737546	463	543	0	19	80	0.2375000
NODE_8334_length_922_cov_7.737546	463	543	6	61	80	0.7625000
NODE_8334_length_922_cov_7.737546	516	596	6	80	80	1.0000000
NODE_8335_length_922_cov_7.241798	298	378	0	80	80	1.0000000
NODE_8335_length_922_cov_7.241798	351	431	0	80	80	1.0000000
NODE_8347_length_921_cov_21.317518	457	537	0	80	80	1.0000000
NODE_8347_length_921_cov_21.317518	510	590	0	80	80	1.0000000
NODE_8348_length_921_cov_18.462287	519	599	0	80	80	1.0000000
NODE_8348_length_921_cov_18.462287	572	652	0	80	80	1.0000000
NODE_8349_length_921_cov_15.440389	373	453	2	9	80	0.1125000
NODE_8349_length_921_cov_15.440389	373	453	5	2	80	0.0250000
NODE_8349_length_921_cov_15.440389	373	453	6	11	80	0.1375000
NODE_8349_length_921_cov_15.440389	373	453	9	51	80	0.6375000
NODE_8349_length_921_cov_15.440389	373	453	10	7	80	0.0875000
NODE_8349_length_921_cov_15.440389	426	506	0	23	80	0.2875000
NODE_8349_length_921_cov_15.440389	426	506	4	14	80	0.1750000
NODE_8349_length_921_cov_15.440389	426	506	5	18	80	0.2250000
NODE_8349_length_921_cov_15.440389	426	506	9	25	80	0.3125000
NODE_8350_length_921_cov_13.216545	465	545	0	39	80	0.4875000
NODE_8350_length_921_cov_13.216545	465	545	2	41	80	0.5125000
NODE_8350_length_921_cov_13.216545	518	598	2	80	80	1.0000000
NODE_8351_length_921_cov_9.283455	399	439	0	40	40	1.0000000
NODE_8351_length_921_cov_9.283455	532	612	0	9	80	0.1125000
NODE_8351_length_921_cov_9.283455	532	612	2	35	80	0.4375000
NODE_8351_length_921_cov_9.283455	532	612	4	36	80	0.4500000
NODE_8351_length_921_cov_9.283455	585	665	0	62	80	0.7750000
NODE_8351_length_921_cov_9.283455	585	665	2	13	80	0.1625000
NODE_8351_length_921_cov_9.283455	585	665	4	5	80	0.0625000
NODE_8352_length_921_cov_8.253041	289	369	0	80	80	1.0000000
NODE_8352_length_921_cov_8.253041	342	422	0	80	80	1.0000000
NODE_8364_length_920_cov_47.493301	543	623	0	10	80	0.1250000
NODE_8364_length_920_cov_47.493301	543	623	2	70	80	0.8750000
NODE_8364_length_920_cov_47.493301	596	676	0	61	80	0.7625000
NODE_8364_length_920_cov_47.493301	596	676	2	19	80	0.2375000
NODE_8365_length_920_cov_30.404385	543	623	0	28	80	0.3500000
NODE_8365_length_920_cov_30.404385	543	623	2	52	80	0.6500000
NODE_8365_length_920_cov_30.404385	596	676	0	28	80	0.3500000
NODE_8365_length_920_cov_30.404385	596	676	2	52	80	0.6500000
NODE_8366_length_920_cov_25.360536	413	493	2	10	80	0.1250000
NODE_8366_length_920_cov_25.360536	413	493	6	70	80	0.8750000
NODE_8366_length_920_cov_25.360536	466	546	2	11	80	0.1375000
NODE_8366_length_920_cov_25.360536	466	546	4	28	80	0.3500000
NODE_8366_length_920_cov_25.360536	466	546	6	41	80	0.5125000
NODE_8366_length_920_cov_25.360536	542	615	4	71	73	0.9726027
NODE_8366_length_920_cov_25.360536	542	615	6	2	73	0.0273973
NODE_8366_length_920_cov_25.360536	588	668	0	12	80	0.1500000
NODE_8366_length_920_cov_25.360536	588	668	2	6	80	0.0750000
NODE_8366_length_920_cov_25.360536	588	668	4	62	80	0.7750000
NODE_8367_length_920_cov_24.918392	403	483	0	80	80	1.0000000
NODE_8367_length_920_cov_24.918392	456	536	0	68	80	0.8500000
NODE_8367_length_920_cov_24.918392	456	536	2	12	80	0.1500000
NODE_8368_length_920_cov_18.517661	353	433	0	80	80	1.0000000
NODE_8368_length_920_cov_18.517661	406	486	0	80	80	1.0000000
NODE_8369_length_920_cov_17.710110	310	390	0	74	80	0.9250000
NODE_8369_length_920_cov_17.710110	310	390	4	6	80	0.0750000
NODE_8369_length_920_cov_17.710110	363	443	0	21	80	0.2625000
NODE_8369_length_920_cov_17.710110	363	443	4	59	80	0.7375000
NODE_8370_length_920_cov_15.650426	403	458	4	55	55	1.0000000
NODE_8371_length_920_cov_12.588307	454	534	0	21	80	0.2625000
NODE_8371_length_920_cov_12.588307	454	534	2	59	80	0.7375000
NODE_8371_length_920_cov_12.588307	507	586	0	33	79	0.4177215
NODE_8371_length_920_cov_12.588307	507	586	2	46	79	0.5822785
NODE_8372_length_920_cov_10.822168	354	434	0	80	80	1.0000000
NODE_8372_length_920_cov_10.822168	407	487	0	80	80	1.0000000
NODE_8374_length_920_cov_8.297199	453	533	0	20	80	0.2500000
NODE_8374_length_920_cov_8.297199	453	533	2	44	80	0.5500000
NODE_8374_length_920_cov_8.297199	453	533	4	16	80	0.2000000
NODE_8374_length_920_cov_8.297199	506	583	2	32	77	0.4155844
NODE_8374_length_920_cov_8.297199	506	583	4	45	77	0.5844156
NODE_8378_length_920_cov_2.992692	501	581	0	39	80	0.4875000
NODE_8378_length_920_cov_2.992692	501	581	2	41	80	0.5125000
NODE_8378_length_920_cov_2.992692	554	634	0	15	80	0.1875000
NODE_8378_length_920_cov_2.992692	554	634	2	65	80	0.8125000
NODE_8389_length_919_cov_44.813415	338	418	0	25	80	0.3125000
NODE_8389_length_919_cov_44.813415	338	418	11	1	80	0.0125000
NODE_8389_length_919_cov_44.813415	338	418	12	19	80	0.2375000
NODE_8389_length_919_cov_44.813415	338	418	13	25	80	0.3125000
NODE_8389_length_919_cov_44.813415	338	418	14	10	80	0.1250000
NODE_8389_length_919_cov_44.813415	391	471	0	78	80	0.9750000
NODE_8389_length_919_cov_44.813415	391	471	11	1	80	0.0125000
NODE_8389_length_919_cov_44.813415	391	471	12	1	80	0.0125000
NODE_8389_length_919_cov_44.813415	467	547	0	80	80	1.0000000
NODE_8389_length_919_cov_44.813415	520	600	0	80	80	1.0000000
NODE_8390_length_919_cov_37.459756	389	469	22	32	80	0.4000000
NODE_8390_length_919_cov_37.459756	389	469	23	3	80	0.0375000
NODE_8390_length_919_cov_37.459756	389	469	25	12	80	0.1500000
NODE_8390_length_919_cov_37.459756	389	469	26	9	80	0.1125000
NODE_8390_length_919_cov_37.459756	389	469	27	24	80	0.3000000
NODE_8390_length_919_cov_37.459756	442	522	16	52	80	0.6500000
NODE_8390_length_919_cov_37.459756	442	522	26	4	80	0.0500000
NODE_8390_length_919_cov_37.459756	442	522	27	24	80	0.3000000
NODE_8390_length_919_cov_37.459756	518	598	0	58	80	0.7250000
NODE_8390_length_919_cov_37.459756	518	598	2	10	80	0.1250000
NODE_8390_length_919_cov_37.459756	518	598	12	2	80	0.0250000
NODE_8390_length_919_cov_37.459756	518	598	16	10	80	0.1250000
NODE_8390_length_919_cov_37.459756	571	651	0	17	80	0.2125000
NODE_8390_length_919_cov_37.459756	571	651	2	63	80	0.7875000
NODE_8391_length_919_cov_35.002439	474	554	0	80	80	1.0000000
NODE_8391_length_919_cov_35.002439	527	607	0	80	80	1.0000000
NODE_8392_length_919_cov_29.935366	246	326	0	80	80	1.0000000
NODE_8392_length_919_cov_29.935366	299	379	0	80	80	1.0000000
NODE_8393_length_919_cov_28.190244	470	550	0	38	80	0.4750000
NODE_8393_length_919_cov_28.190244	470	550	2	42	80	0.5250000
NODE_8393_length_919_cov_28.190244	523	603	2	79	80	0.9875000
NODE_8393_length_919_cov_28.190244	523	603	4	1	80	0.0125000
NODE_8394_length_919_cov_27.119512	454	534	0	29	80	0.3625000
NODE_8394_length_919_cov_27.119512	454	534	2	51	80	0.6375000
NODE_8394_length_919_cov_27.119512	507	587	0	39	80	0.4875000
NODE_8394_length_919_cov_27.119512	507	587	2	41	80	0.5125000
NODE_8395_length_919_cov_21.836585	545	625	0	4	80	0.0500000
NODE_8395_length_919_cov_21.836585	545	625	2	7	80	0.0875000
NODE_8395_length_919_cov_21.836585	545	625	4	17	80	0.2125000
NODE_8395_length_919_cov_21.836585	545	625	6	52	80	0.6500000
NODE_8395_length_919_cov_21.836585	598	677	0	56	79	0.7088608
NODE_8395_length_919_cov_21.836585	598	677	4	17	79	0.2151899
NODE_8395_length_919_cov_21.836585	598	677	6	6	79	0.0759494
NODE_8396_length_919_cov_17.442683	385	465	0	80	80	1.0000000
NODE_8396_length_919_cov_17.442683	438	518	0	80	80	1.0000000
NODE_8397_length_919_cov_16.685366	309	389	0	80	80	1.0000000
NODE_8397_length_919_cov_16.685366	362	442	0	80	80	1.0000000
NODE_8398_length_919_cov_14.013415	435	515	0	75	80	0.9375000
NODE_8398_length_919_cov_14.013415	435	515	2	5	80	0.0625000
NODE_8398_length_919_cov_14.013415	488	568	0	80	80	1.0000000
NODE_8399_length_919_cov_12.013415	340	420	0	36	80	0.4500000
NODE_8399_length_919_cov_12.013415	340	420	2	43	80	0.5375000
NODE_8399_length_919_cov_12.013415	340	420	6	1	80	0.0125000
NODE_8399_length_919_cov_12.013415	393	473	2	26	80	0.3250000
NODE_8399_length_919_cov_12.013415	393	473	6	54	80	0.6750000
NODE_8403_length_919_cov_3.529268	424	504	0	11	80	0.1375000
NODE_8403_length_919_cov_3.529268	424	504	2	69	80	0.8625000
NODE_8403_length_919_cov_3.529268	477	557	2	80	80	1.0000000
NODE_8404_length_919_cov_3.200000	444	524	0	80	80	1.0000000
NODE_8404_length_919_cov_3.200000	497	577	0	32	80	0.4000000
NODE_8404_length_919_cov_3.200000	497	577	1	41	80	0.5125000
NODE_8404_length_919_cov_3.200000	497	577	2	7	80	0.0875000
NODE_8415_length_918_cov_41.115995	387	467	0	80	80	1.0000000
NODE_8415_length_918_cov_41.115995	440	520	0	80	80	1.0000000
NODE_8416_length_918_cov_37.405372	427	507	2	20	80	0.2500000
NODE_8416_length_918_cov_37.405372	427	507	4	60	80	0.7500000
NODE_8416_length_918_cov_37.405372	480	560	2	60	80	0.7500000
NODE_8416_length_918_cov_37.405372	480	560	4	20	80	0.2500000
NODE_8417_length_918_cov_31.559219	289	369	8	26	80	0.3250000
NODE_8417_length_918_cov_31.559219	289	369	10	1	80	0.0125000
NODE_8417_length_918_cov_31.559219	289	369	11	53	80	0.6625000
NODE_8417_length_918_cov_31.559219	342	422	0	46	80	0.5750000
NODE_8417_length_918_cov_31.559219	342	422	8	33	80	0.4125000
NODE_8417_length_918_cov_31.559219	342	422	10	1	80	0.0125000
NODE_8417_length_918_cov_31.559219	418	498	0	80	80	1.0000000
NODE_8417_length_918_cov_31.559219	471	551	0	72	80	0.9000000
NODE_8417_length_918_cov_31.559219	471	551	2	8	80	0.1000000
NODE_8418_length_918_cov_25.195360	429	509	0	38	80	0.4750000
NODE_8418_length_918_cov_25.195360	429	509	6	42	80	0.5250000
NODE_8418_length_918_cov_25.195360	482	562	0	17	80	0.2125000
NODE_8418_length_918_cov_25.195360	482	562	6	63	80	0.7875000
NODE_8420_length_918_cov_10.537241	361	441	0	80	80	1.0000000
NODE_8420_length_918_cov_10.537241	414	492	0	78	78	1.0000000
NODE_8421_length_918_cov_9.821734	283	363	0	80	80	1.0000000
NODE_8421_length_918_cov_9.821734	336	416	0	31	80	0.3875000
NODE_8421_length_918_cov_9.821734	336	416	2	43	80	0.5375000
NODE_8421_length_918_cov_9.821734	336	416	4	6	80	0.0750000
NODE_8422_length_918_cov_9.714286	365	445	0	80	80	1.0000000
NODE_8422_length_918_cov_9.714286	418	498	0	80	80	1.0000000
NODE_8441_length_917_cov_38.845966	405	476	0	3	71	0.0422535
NODE_8441_length_917_cov_38.845966	405	476	2	68	71	0.9577465
NODE_8441_length_917_cov_38.845966	458	538	0	18	80	0.2250000
NODE_8441_length_917_cov_38.845966	458	538	2	62	80	0.7750000
NODE_8442_length_917_cov_37.775061	505	585	2	74	80	0.9250000
NODE_8442_length_917_cov_37.775061	505	585	4	6	80	0.0750000
NODE_8442_length_917_cov_37.775061	558	638	0	7	80	0.0875000
NODE_8442_length_917_cov_37.775061	558	638	2	73	80	0.9125000
NODE_8443_length_917_cov_33.195599	335	415	0	80	80	1.0000000
NODE_8443_length_917_cov_33.195599	388	468	0	80	80	1.0000000
NODE_8443_length_917_cov_33.195599	464	544	0	80	80	1.0000000
NODE_8443_length_917_cov_33.195599	517	597	0	62	80	0.7750000
NODE_8443_length_917_cov_33.195599	517	597	1	10	80	0.1250000
NODE_8443_length_917_cov_33.195599	517	597	2	8	80	0.1000000
NODE_8444_length_917_cov_22.871638	463	543	2	13	80	0.1625000
NODE_8444_length_917_cov_22.871638	463	543	6	7	80	0.0875000
NODE_8444_length_917_cov_22.871638	463	543	7	16	80	0.2000000
NODE_8444_length_917_cov_22.871638	463	543	8	25	80	0.3125000
NODE_8444_length_917_cov_22.871638	463	543	9	19	80	0.2375000
NODE_8444_length_917_cov_22.871638	516	593	7	8	77	0.1038961
NODE_8444_length_917_cov_22.871638	516	593	9	69	77	0.8961039
NODE_8445_length_917_cov_16.899756	321	401	0	80	80	1.0000000
NODE_8445_length_917_cov_16.899756	374	454	0	80	80	1.0000000
NODE_8446_length_917_cov_12.283619	397	477	0	29	80	0.3625000
NODE_8446_length_917_cov_12.283619	397	477	6	51	80	0.6375000
NODE_8446_length_917_cov_12.283619	450	530	4	13	80	0.1625000
NODE_8446_length_917_cov_12.283619	450	530	6	67	80	0.8375000
NODE_8447_length_917_cov_12.172372	380	460	0	80	80	1.0000000
NODE_8447_length_917_cov_12.172372	433	513	0	80	80	1.0000000
NODE_8447_length_917_cov_12.172372	545	597	0	52	52	1.0000000
NODE_8448_length_917_cov_8.277506	564	644	1	7	80	0.0875000
NODE_8448_length_917_cov_8.277506	564	644	4	72	80	0.9000000
NODE_8448_length_917_cov_8.277506	564	644	5	1	80	0.0125000
NODE_8448_length_917_cov_8.277506	617	697	1	25	80	0.3125000
NODE_8448_length_917_cov_8.277506	617	697	2	35	80	0.4375000
NODE_8448_length_917_cov_8.277506	617	697	4	19	80	0.2375000
NODE_8448_length_917_cov_8.277506	617	697	5	1	80	0.0125000
NODE_8449_length_917_cov_8.145477	155	235	0	80	80	1.0000000
NODE_8449_length_917_cov_8.145477	208	288	0	80	80	1.0000000
NODE_8451_length_917_cov_6.073350	366	446	0	80	80	1.0000000
NODE_8451_length_917_cov_6.073350	419	499	0	80	80	1.0000000
NODE_8463_length_916_cov_32.867809	347	427	0	30	80	0.3750000
NODE_8463_length_916_cov_32.867809	347	427	4	50	80	0.6250000
NODE_8463_length_916_cov_32.867809	400	480	2	7	80	0.0875000
NODE_8463_length_916_cov_32.867809	400	480	4	29	80	0.3625000
NODE_8463_length_916_cov_32.867809	400	480	6	44	80	0.5500000
NODE_8464_length_916_cov_27.673195	450	530	0	18	80	0.2250000
NODE_8464_length_916_cov_27.673195	450	530	2	54	80	0.6750000
NODE_8464_length_916_cov_27.673195	450	530	4	8	80	0.1000000
NODE_8464_length_916_cov_27.673195	503	583	2	69	80	0.8625000
NODE_8464_length_916_cov_27.673195	503	583	4	11	80	0.1375000
NODE_8465_length_916_cov_27.146879	223	303	7	9	80	0.1125000
NODE_8465_length_916_cov_27.146879	223	303	13	16	80	0.2000000
NODE_8465_length_916_cov_27.146879	223	303	18	4	80	0.0500000
NODE_8465_length_916_cov_27.146879	223	303	19	17	80	0.2125000
NODE_8465_length_916_cov_27.146879	223	303	21	34	80	0.4250000
NODE_8465_length_916_cov_27.146879	276	356	0	16	80	0.2000000
NODE_8465_length_916_cov_27.146879	276	356	5	1	80	0.0125000
NODE_8465_length_916_cov_27.146879	276	356	7	45	80	0.5625000
NODE_8465_length_916_cov_27.146879	276	356	13	16	80	0.2000000
NODE_8465_length_916_cov_27.146879	276	356	18	2	80	0.0250000
NODE_8466_length_916_cov_25.604651	398	478	2	13	80	0.1625000
NODE_8466_length_916_cov_25.604651	398	478	4	67	80	0.8375000
NODE_8466_length_916_cov_25.604651	451	531	0	26	80	0.3250000
NODE_8466_length_916_cov_25.604651	451	531	2	2	80	0.0250000
NODE_8466_length_916_cov_25.604651	451	531	4	52	80	0.6500000
NODE_8467_length_916_cov_18.035496	456	536	0	80	80	1.0000000
NODE_8467_length_916_cov_18.035496	509	589	0	80	80	1.0000000
NODE_8468_length_916_cov_12.651163	500	580	2	4	80	0.0500000
NODE_8468_length_916_cov_12.651163	500	580	6	3	80	0.0375000
NODE_8468_length_916_cov_12.651163	500	580	8	22	80	0.2750000
NODE_8468_length_916_cov_12.651163	500	580	10	51	80	0.6375000
NODE_8468_length_916_cov_12.651163	553	633	0	19	80	0.2375000
NODE_8468_length_916_cov_12.651163	553	633	2	38	80	0.4750000
NODE_8468_length_916_cov_12.651163	553	633	6	3	80	0.0375000
NODE_8468_length_916_cov_12.651163	553	633	8	20	80	0.2500000
NODE_8469_length_916_cov_11.337821	530	610	0	80	80	1.0000000
NODE_8469_length_916_cov_11.337821	583	663	0	80	80	1.0000000
NODE_8470_length_916_cov_9.640147	293	373	2	80	80	1.0000000
NODE_8470_length_916_cov_9.640147	346	426	0	42	80	0.5250000
NODE_8470_length_916_cov_9.640147	346	426	2	38	80	0.4750000
NODE_8472_length_916_cov_8.042840	426	506	0	80	80	1.0000000
NODE_8472_length_916_cov_8.042840	479	559	0	80	80	1.0000000
NODE_8473_length_916_cov_7.123623	785	847	16	1	62	0.0161290
NODE_8473_length_916_cov_7.123623	785	847	20	1	62	0.0161290
NODE_8473_length_916_cov_7.123623	785	847	22	1	62	0.0161290
NODE_8473_length_916_cov_7.123623	785	847	24	3	62	0.0483871
NODE_8473_length_916_cov_7.123623	785	847	28	3	62	0.0483871
NODE_8473_length_916_cov_7.123623	785	847	36	1	62	0.0161290
NODE_8473_length_916_cov_7.123623	785	847	38	2	62	0.0322581
NODE_8473_length_916_cov_7.123623	785	847	54	2	62	0.0322581
NODE_8473_length_916_cov_7.123623	785	847	64	2	62	0.0322581
NODE_8473_length_916_cov_7.123623	785	847	78	2	62	0.0322581
NODE_8473_length_916_cov_7.123623	785	847	82	2	62	0.0322581
NODE_8473_length_916_cov_7.123623	785	847	84	1	62	0.0161290
NODE_8473_length_916_cov_7.123623	785	847	86	41	62	0.6612903
NODE_8473_length_916_cov_7.123623	820	900	62	1	80	0.0125000
NODE_8473_length_916_cov_7.123623	820	900	64	2	80	0.0250000
NODE_8473_length_916_cov_7.123623	820	900	68	1	80	0.0125000
NODE_8473_length_916_cov_7.123623	820	900	72	2	80	0.0250000
NODE_8473_length_916_cov_7.123623	820	900	74	2	80	0.0250000
NODE_8473_length_916_cov_7.123623	820	900	76	2	80	0.0250000
NODE_8473_length_916_cov_7.123623	820	900	78	2	80	0.0250000
NODE_8473_length_916_cov_7.123623	820	900	80	1	80	0.0125000
NODE_8473_length_916_cov_7.123623	820	900	84	13	80	0.1625000
NODE_8473_length_916_cov_7.123623	820	900	86	54	80	0.6750000
NODE_8481_length_915_cov_59.289216	398	478	0	80	80	1.0000000
NODE_8481_length_915_cov_59.289216	451	531	0	80	80	1.0000000
NODE_8481_length_915_cov_59.289216	527	607	0	80	80	1.0000000
NODE_8481_length_915_cov_59.289216	580	660	0	29	80	0.3625000
NODE_8481_length_915_cov_59.289216	580	660	4	51	80	0.6375000
NODE_8482_length_915_cov_45.104167	153	228	2	75	75	1.0000000
NODE_8482_length_915_cov_45.104167	206	286	0	58	80	0.7250000
NODE_8482_length_915_cov_45.104167	206	286	2	22	80	0.2750000
NODE_8482_length_915_cov_45.104167	282	362	0	12	80	0.1500000
NODE_8482_length_915_cov_45.104167	282	362	6	68	80	0.8500000
NODE_8482_length_915_cov_45.104167	335	415	0	34	80	0.4250000
NODE_8482_length_915_cov_45.104167	335	415	6	46	80	0.5750000
NODE_8483_length_915_cov_37.599265	397	477	0	80	80	1.0000000
NODE_8483_length_915_cov_37.599265	450	530	0	80	80	1.0000000
NODE_8485_length_915_cov_20.458333	297	377	2	74	80	0.9250000
NODE_8485_length_915_cov_20.458333	297	377	4	6	80	0.0750000
NODE_8485_length_915_cov_20.458333	350	430	2	74	80	0.9250000
NODE_8485_length_915_cov_20.458333	350	430	4	6	80	0.0750000
NODE_8485_length_915_cov_20.458333	426	506	0	69	80	0.8625000
NODE_8485_length_915_cov_20.458333	426	506	2	11	80	0.1375000
NODE_8485_length_915_cov_20.458333	479	559	0	80	80	1.0000000
NODE_8486_length_915_cov_14.397059	175	255	0	66	80	0.8250000
NODE_8486_length_915_cov_14.397059	175	255	2	14	80	0.1750000
NODE_8486_length_915_cov_14.397059	228	308	0	13	80	0.1625000
NODE_8486_length_915_cov_14.397059	228	308	2	67	80	0.8375000
NODE_8487_length_915_cov_8.741422	295	375	0	80	80	1.0000000
NODE_8487_length_915_cov_8.741422	348	428	0	80	80	1.0000000
NODE_8488_length_915_cov_7.719363	823	894	0	71	71	1.0000000
NODE_8488_length_915_cov_7.719363	828	894	0	66	66	1.0000000
NODE_8488_length_915_cov_7.719363	867	915	0	48	48	1.0000000
NODE_8488_length_915_cov_7.719363	867	915	0	48	48	1.0000000
NODE_8488_length_915_cov_7.719363	867	915	0	48	48	1.0000000
NODE_8489_length_915_cov_7.648284	370	450	0	80	80	1.0000000
NODE_8489_length_915_cov_7.648284	423	503	0	80	80	1.0000000
NODE_8490_length_915_cov_6.848039	434	514	0	5	80	0.0625000
NODE_8490_length_915_cov_6.848039	434	514	2	75	80	0.9375000
NODE_8490_length_915_cov_6.848039	487	567	0	17	80	0.2125000
NODE_8490_length_915_cov_6.848039	487	567	2	63	80	0.7875000
NODE_8497_length_915_cov_2.011029	24	99	12	37	75	0.4933333
NODE_8497_length_915_cov_2.011029	24	99	16	38	75	0.5066667
NODE_8505_length_914_cov_89.814724	0	41	1	1	41	0.0243902
NODE_8505_length_914_cov_89.814724	0	41	3	2	41	0.0487805
NODE_8505_length_914_cov_89.814724	0	41	5	1	41	0.0243902
NODE_8505_length_914_cov_89.814724	0	41	7	1	41	0.0243902
NODE_8505_length_914_cov_89.814724	0	41	9	1	41	0.0243902
NODE_8505_length_914_cov_89.814724	0	41	10	5	41	0.1219512
NODE_8505_length_914_cov_89.814724	0	41	20	2	41	0.0487805
NODE_8505_length_914_cov_89.814724	0	41	27	6	41	0.1463415
NODE_8505_length_914_cov_89.814724	0	41	29	3	41	0.0731707
NODE_8505_length_914_cov_89.814724	0	41	33	1	41	0.0243902
NODE_8505_length_914_cov_89.814724	0	41	37	1	41	0.0243902
NODE_8505_length_914_cov_89.814724	0	41	38	1	41	0.0243902
NODE_8505_length_914_cov_89.814724	0	41	40	3	41	0.0731707
NODE_8505_length_914_cov_89.814724	0	41	42	4	41	0.0975610
NODE_8505_length_914_cov_89.814724	0	41	45	1	41	0.0243902
NODE_8505_length_914_cov_89.814724	0	41	46	1	41	0.0243902
NODE_8505_length_914_cov_89.814724	0	41	48	1	41	0.0243902
NODE_8505_length_914_cov_89.814724	0	41	50	2	41	0.0487805
NODE_8505_length_914_cov_89.814724	0	41	58	2	41	0.0487805
NODE_8505_length_914_cov_89.814724	0	41	62	1	41	0.0243902
NODE_8505_length_914_cov_89.814724	0	41	70	1	41	0.0243902
NODE_8505_length_914_cov_89.814724	19	94	29	3	75	0.0400000
NODE_8505_length_914_cov_89.814724	19	94	33	1	75	0.0133333
NODE_8505_length_914_cov_89.814724	19	94	37	1	75	0.0133333
NODE_8505_length_914_cov_89.814724	19	94	38	1	75	0.0133333
NODE_8505_length_914_cov_89.814724	19	94	40	3	75	0.0400000
NODE_8505_length_914_cov_89.814724	19	94	42	4	75	0.0533333
NODE_8505_length_914_cov_89.814724	19	94	45	1	75	0.0133333
NODE_8505_length_914_cov_89.814724	19	94	46	1	75	0.0133333
NODE_8505_length_914_cov_89.814724	19	94	48	1	75	0.0133333
NODE_8505_length_914_cov_89.814724	19	94	50	2	75	0.0266667
NODE_8505_length_914_cov_89.814724	19	94	58	2	75	0.0266667
NODE_8505_length_914_cov_89.814724	19	94	62	1	75	0.0133333
NODE_8505_length_914_cov_89.814724	19	94	70	1	75	0.0133333
NODE_8505_length_914_cov_89.814724	19	94	74	1	75	0.0133333
NODE_8505_length_914_cov_89.814724	19	94	76	2	75	0.0266667
NODE_8505_length_914_cov_89.814724	19	94	78	4	75	0.0533333
NODE_8505_length_914_cov_89.814724	19	94	79	1	75	0.0133333
NODE_8505_length_914_cov_89.814724	19	94	83	5	75	0.0666667
NODE_8505_length_914_cov_89.814724	19	94	87	2	75	0.0266667
NODE_8505_length_914_cov_89.814724	19	94	90	1	75	0.0133333
NODE_8505_length_914_cov_89.814724	19	94	91	6	75	0.0800000
NODE_8505_length_914_cov_89.814724	19	94	92	4	75	0.0533333
NODE_8505_length_914_cov_89.814724	19	94	94	5	75	0.0666667
NODE_8505_length_914_cov_89.814724	19	94	95	1	75	0.0133333
NODE_8505_length_914_cov_89.814724	19	94	99	5	75	0.0666667
NODE_8505_length_914_cov_89.814724	19	94	101	1	75	0.0133333
NODE_8505_length_914_cov_89.814724	19	94	103	6	75	0.0800000
NODE_8505_length_914_cov_89.814724	19	94	105	3	75	0.0400000
NODE_8505_length_914_cov_89.814724	19	94	107	4	75	0.0533333
NODE_8505_length_914_cov_89.814724	19	94	109	2	75	0.0266667
NODE_8506_length_914_cov_33.755828	400	480	0	28	80	0.3500000
NODE_8506_length_914_cov_33.755828	400	480	6	52	80	0.6500000
NODE_8506_length_914_cov_33.755828	453	533	0	29	80	0.3625000
NODE_8506_length_914_cov_33.755828	453	533	6	51	80	0.6375000
NODE_8507_length_914_cov_31.557055	368	448	0	80	80	1.0000000
NODE_8507_length_914_cov_31.557055	421	501	0	80	80	1.0000000
NODE_8508_length_914_cov_29.087117	331	411	8	5	80	0.0625000
NODE_8508_length_914_cov_29.087117	331	411	9	31	80	0.3875000
NODE_8508_length_914_cov_29.087117	331	411	10	38	80	0.4750000
NODE_8508_length_914_cov_29.087117	331	411	14	6	80	0.0750000
NODE_8508_length_914_cov_29.087117	384	464	6	41	80	0.5125000
NODE_8508_length_914_cov_29.087117	384	464	8	7	80	0.0875000
NODE_8508_length_914_cov_29.087117	384	464	10	32	80	0.4000000
NODE_8509_length_914_cov_28.490798	273	353	0	80	80	1.0000000
NODE_8509_length_914_cov_28.490798	326	406	0	80	80	1.0000000
NODE_8509_length_914_cov_28.490798	402	482	0	80	80	1.0000000
NODE_8509_length_914_cov_28.490798	455	535	0	80	80	1.0000000
NODE_8510_length_914_cov_25.429448	393	473	2	11	80	0.1375000
NODE_8510_length_914_cov_25.429448	393	473	4	16	80	0.2000000
NODE_8510_length_914_cov_25.429448	393	473	5	1	80	0.0125000
NODE_8510_length_914_cov_25.429448	393	473	6	14	80	0.1750000
NODE_8510_length_914_cov_25.429448	393	473	8	29	80	0.3625000
NODE_8510_length_914_cov_25.429448	393	473	10	9	80	0.1125000
NODE_8510_length_914_cov_25.429448	446	526	0	4	80	0.0500000
NODE_8510_length_914_cov_25.429448	446	526	2	60	80	0.7500000
NODE_8510_length_914_cov_25.429448	446	526	4	16	80	0.2000000
NODE_8510_length_914_cov_25.429448	522	602	0	80	80	1.0000000
NODE_8510_length_914_cov_25.429448	575	655	0	80	80	1.0000000
NODE_8511_length_914_cov_19.111656	354	434	6	37	80	0.4625000
NODE_8511_length_914_cov_19.111656	354	434	7	8	80	0.1000000
NODE_8511_length_914_cov_19.111656	354	434	8	34	80	0.4250000
NODE_8511_length_914_cov_19.111656	354	434	9	1	80	0.0125000
NODE_8511_length_914_cov_19.111656	407	487	0	4	80	0.0500000
NODE_8511_length_914_cov_19.111656	407	487	1	9	80	0.1125000
NODE_8511_length_914_cov_19.111656	407	487	4	16	80	0.2000000
NODE_8511_length_914_cov_19.111656	407	487	6	47	80	0.5875000
NODE_8511_length_914_cov_19.111656	407	487	8	4	80	0.0500000
NODE_8512_length_914_cov_13.423313	603	683	0	80	80	1.0000000
NODE_8512_length_914_cov_13.423313	656	736	0	80	80	1.0000000
NODE_8513_length_914_cov_10.947239	341	411	2	4	70	0.0571429
NODE_8513_length_914_cov_10.947239	341	411	4	18	70	0.2571429
NODE_8513_length_914_cov_10.947239	341	411	5	23	70	0.3285714
NODE_8513_length_914_cov_10.947239	341	411	6	25	70	0.3571429
NODE_8513_length_914_cov_10.947239	384	464	0	34	80	0.4250000
NODE_8513_length_914_cov_10.947239	384	464	2	4	80	0.0500000
NODE_8513_length_914_cov_10.947239	384	464	4	25	80	0.3125000
NODE_8513_length_914_cov_10.947239	384	464	5	17	80	0.2125000
NODE_8518_length_914_cov_1.931288	833	873	4	4	40	0.1000000
NODE_8518_length_914_cov_1.931288	833	873	6	8	40	0.2000000
NODE_8518_length_914_cov_1.931288	833	873	8	28	40	0.7000000
NODE_8526_length_913_cov_49.665848	31	111	14	4	80	0.0500000
NODE_8526_length_913_cov_49.665848	31	111	16	2	80	0.0250000
NODE_8526_length_913_cov_49.665848	31	111	18	21	80	0.2625000
NODE_8526_length_913_cov_49.665848	31	111	20	1	80	0.0125000
NODE_8526_length_913_cov_49.665848	31	111	22	19	80	0.2375000
NODE_8526_length_913_cov_49.665848	31	111	24	11	80	0.1375000
NODE_8526_length_913_cov_49.665848	31	111	26	4	80	0.0500000
NODE_8526_length_913_cov_49.665848	31	111	28	1	80	0.0125000
NODE_8526_length_913_cov_49.665848	31	111	29	1	80	0.0125000
NODE_8526_length_913_cov_49.665848	31	111	30	2	80	0.0250000
NODE_8526_length_913_cov_49.665848	31	111	32	7	80	0.0875000
NODE_8526_length_913_cov_49.665848	31	111	34	5	80	0.0625000
NODE_8526_length_913_cov_49.665848	31	111	36	2	80	0.0250000
NODE_8526_length_913_cov_49.665848	136	155	29	3	19	0.1578947
NODE_8526_length_913_cov_49.665848	136	155	31	1	19	0.0526316
NODE_8526_length_913_cov_49.665848	136	155	33	3	19	0.1578947
NODE_8526_length_913_cov_49.665848	136	155	36	2	19	0.1052632
NODE_8526_length_913_cov_49.665848	136	155	38	10	19	0.5263158
NODE_8527_length_913_cov_47.115479	367	447	3	80	80	1.0000000
NODE_8527_length_913_cov_47.115479	420	500	0	8	80	0.1000000
NODE_8527_length_913_cov_47.115479	420	500	1	18	80	0.2250000
NODE_8527_length_913_cov_47.115479	420	500	3	54	80	0.6750000
NODE_8528_length_913_cov_36.541769	502	582	0	4	80	0.0500000
NODE_8528_length_913_cov_36.541769	502	582	2	6	80	0.0750000
NODE_8528_length_913_cov_36.541769	502	582	4	36	80	0.4500000
NODE_8528_length_913_cov_36.541769	502	582	6	34	80	0.4250000
NODE_8528_length_913_cov_36.541769	555	635	2	32	80	0.4000000
NODE_8528_length_913_cov_36.541769	555	635	4	31	80	0.3875000
NODE_8528_length_913_cov_36.541769	555	635	6	17	80	0.2125000
NODE_8529_length_913_cov_33.679361	433	513	0	6	80	0.0750000
NODE_8529_length_913_cov_33.679361	433	513	2	21	80	0.2625000
NODE_8529_length_913_cov_33.679361	433	513	4	53	80	0.6625000
NODE_8529_length_913_cov_33.679361	486	566	0	59	80	0.7375000
NODE_8529_length_913_cov_33.679361	486	566	2	9	80	0.1125000
NODE_8529_length_913_cov_33.679361	486	566	4	12	80	0.1500000
NODE_8530_length_913_cov_29.675676	408	488	0	16	80	0.2000000
NODE_8530_length_913_cov_29.675676	408	488	2	64	80	0.8000000
NODE_8530_length_913_cov_29.675676	461	541	0	69	80	0.8625000
NODE_8530_length_913_cov_29.675676	461	541	2	11	80	0.1375000
NODE_8531_length_913_cov_24.901720	342	422	0	1	80	0.0125000
NODE_8531_length_913_cov_24.901720	342	422	2	79	80	0.9875000
NODE_8531_length_913_cov_24.901720	395	475	0	54	80	0.6750000
NODE_8531_length_913_cov_24.901720	395	475	2	26	80	0.3250000
NODE_8532_length_913_cov_24.625307	396	476	0	74	80	0.9250000
NODE_8532_length_913_cov_24.625307	396	476	2	6	80	0.0750000
NODE_8532_length_913_cov_24.625307	449	529	0	80	80	1.0000000
NODE_8533_length_913_cov_15.094595	525	589	0	64	64	1.0000000
NODE_8533_length_913_cov_15.094595	562	642	0	80	80	1.0000000
NODE_8534_length_913_cov_8.633907	305	385	0	35	80	0.4375000
NODE_8534_length_913_cov_8.633907	305	385	2	45	80	0.5625000
NODE_8534_length_913_cov_8.633907	358	429	2	71	71	1.0000000
NODE_8546_length_912_cov_25.110701	419	499	0	43	80	0.5375000
NODE_8546_length_912_cov_25.110701	419	499	4	37	80	0.4625000
NODE_8546_length_912_cov_25.110701	472	552	0	3	80	0.0375000
NODE_8546_length_912_cov_25.110701	472	552	4	77	80	0.9625000
NODE_8547_length_912_cov_20.045510	306	386	0	4	80	0.0500000
NODE_8547_length_912_cov_20.045510	306	386	2	76	80	0.9500000
NODE_8547_length_912_cov_20.045510	359	439	0	57	80	0.7125000
NODE_8547_length_912_cov_20.045510	359	439	2	23	80	0.2875000
NODE_8548_length_912_cov_19.635916	326	406	0	78	80	0.9750000
NODE_8548_length_912_cov_19.635916	326	406	4	2	80	0.0250000
NODE_8548_length_912_cov_19.635916	379	459	0	25	80	0.3125000
NODE_8548_length_912_cov_19.635916	379	459	4	55	80	0.6875000
NODE_8549_length_912_cov_17.714637	395	475	0	80	80	1.0000000
NODE_8549_length_912_cov_17.714637	448	528	0	80	80	1.0000000
NODE_8550_length_912_cov_15.546125	355	435	0	80	80	1.0000000
NODE_8550_length_912_cov_15.546125	408	488	0	80	80	1.0000000
NODE_8551_length_912_cov_15.077491	255	291	8	29	36	0.8055556
NODE_8551_length_912_cov_15.077491	255	291	10	7	36	0.1944444
NODE_8551_length_912_cov_15.077491	264	328	6	8	64	0.1250000
NODE_8551_length_912_cov_15.077491	264	328	8	56	64	0.8750000
NODE_8551_length_912_cov_15.077491	415	495	2	19	80	0.2375000
NODE_8551_length_912_cov_15.077491	415	495	4	49	80	0.6125000
NODE_8551_length_912_cov_15.077491	415	495	6	12	80	0.1500000
NODE_8551_length_912_cov_15.077491	468	548	4	80	80	1.0000000
NODE_8552_length_912_cov_15.023370	361	441	0	80	80	1.0000000
NODE_8552_length_912_cov_15.023370	414	494	0	80	80	1.0000000
NODE_8553_length_912_cov_13.600246	61	141	2	80	80	1.0000000
NODE_8553_length_912_cov_13.600246	460	540	0	23	80	0.2875000
NODE_8553_length_912_cov_13.600246	460	540	7	28	80	0.3500000
NODE_8553_length_912_cov_13.600246	460	540	8	29	80	0.3625000
NODE_8553_length_912_cov_13.600246	513	593	2	5	80	0.0625000
NODE_8553_length_912_cov_13.600246	513	593	8	31	80	0.3875000
NODE_8553_length_912_cov_13.600246	513	593	9	27	80	0.3375000
NODE_8553_length_912_cov_13.600246	513	593	10	17	80	0.2125000
NODE_8554_length_912_cov_13.113161	385	465	0	80	80	1.0000000
NODE_8554_length_912_cov_13.113161	438	518	0	68	80	0.8500000
NODE_8554_length_912_cov_13.113161	438	518	2	12	80	0.1500000
NODE_8555_length_912_cov_11.110701	353	433	2	32	80	0.4000000
NODE_8555_length_912_cov_11.110701	353	433	4	48	80	0.6000000
NODE_8555_length_912_cov_11.110701	406	486	0	9	80	0.1125000
NODE_8555_length_912_cov_11.110701	406	486	2	45	80	0.5625000
NODE_8555_length_912_cov_11.110701	406	486	4	26	80	0.3250000
NODE_8555_length_912_cov_11.110701	827	907	0	7	80	0.0875000
NODE_8555_length_912_cov_11.110701	827	907	6	4	80	0.0500000
NODE_8555_length_912_cov_11.110701	827	907	8	7	80	0.0875000
NODE_8555_length_912_cov_11.110701	827	907	10	3	80	0.0375000
NODE_8555_length_912_cov_11.110701	827	907	12	59	80	0.7375000
NODE_8555_length_912_cov_11.110701	831	854	12	23	23	1.0000000
NODE_8584_length_911_cov_173.171182	580	660	365	2	80	0.0250000
NODE_8584_length_911_cov_173.171182	580	660	369	1	80	0.0125000
NODE_8584_length_911_cov_173.171182	580	660	371	1	80	0.0125000
NODE_8584_length_911_cov_173.171182	580	660	372	1	80	0.0125000
NODE_8584_length_911_cov_173.171182	580	660	381	1	80	0.0125000
NODE_8584_length_911_cov_173.171182	580	660	394	1	80	0.0125000
NODE_8584_length_911_cov_173.171182	580	660	397	1	80	0.0125000
NODE_8584_length_911_cov_173.171182	580	660	420	1	80	0.0125000
NODE_8584_length_911_cov_173.171182	580	660	424	1	80	0.0125000
NODE_8584_length_911_cov_173.171182	580	660	438	1	80	0.0125000
NODE_8584_length_911_cov_173.171182	580	660	442	1	80	0.0125000
NODE_8584_length_911_cov_173.171182	580	660	455	1	80	0.0125000
NODE_8584_length_911_cov_173.171182	580	660	457	1	80	0.0125000
NODE_8584_length_911_cov_173.171182	580	660	465	1	80	0.0125000
NODE_8584_length_911_cov_173.171182	580	660	482	1	80	0.0125000
NODE_8584_length_911_cov_173.171182	580	660	483	1	80	0.0125000
NODE_8584_length_911_cov_173.171182	580	660	491	1	80	0.0125000
NODE_8584_length_911_cov_173.171182	580	660	492	1	80	0.0125000
NODE_8584_length_911_cov_173.171182	580	660	504	1	80	0.0125000
NODE_8584_length_911_cov_173.171182	580	660	507	1	80	0.0125000
NODE_8584_length_911_cov_173.171182	580	660	542	1	80	0.0125000
NODE_8584_length_911_cov_173.171182	580	660	544	1	80	0.0125000
NODE_8584_length_911_cov_173.171182	580	660	556	3	80	0.0375000
NODE_8584_length_911_cov_173.171182	580	660	558	2	80	0.0250000
NODE_8584_length_911_cov_173.171182	580	660	565	1	80	0.0125000
NODE_8584_length_911_cov_173.171182	580	660	571	1	80	0.0125000
NODE_8584_length_911_cov_173.171182	580	660	593	1	80	0.0125000
NODE_8584_length_911_cov_173.171182	580	660	596	1	80	0.0125000
NODE_8584_length_911_cov_173.171182	580	660	601	1	80	0.0125000
NODE_8584_length_911_cov_173.171182	580	660	602	1	80	0.0125000
NODE_8584_length_911_cov_173.171182	580	660	603	1	80	0.0125000
NODE_8584_length_911_cov_173.171182	580	660	605	1	80	0.0125000
NODE_8584_length_911_cov_173.171182	580	660	629	1	80	0.0125000
NODE_8584_length_911_cov_173.171182	580	660	630	1	80	0.0125000
NODE_8584_length_911_cov_173.171182	580	660	632	1	80	0.0125000
NODE_8584_length_911_cov_173.171182	580	660	642	1	80	0.0125000
NODE_8584_length_911_cov_173.171182	580	660	648	1	80	0.0125000
NODE_8584_length_911_cov_173.171182	580	660	666	1	80	0.0125000
NODE_8584_length_911_cov_173.171182	580	660	673	2	80	0.0250000
NODE_8584_length_911_cov_173.171182	580	660	680	1	80	0.0125000
NODE_8584_length_911_cov_173.171182	580	660	690	1	80	0.0125000
NODE_8584_length_911_cov_173.171182	580	660	727	1	80	0.0125000
NODE_8584_length_911_cov_173.171182	580	660	729	1	80	0.0125000
NODE_8584_length_911_cov_173.171182	580	660	734	1	80	0.0125000
NODE_8584_length_911_cov_173.171182	580	660	749	1	80	0.0125000
NODE_8584_length_911_cov_173.171182	580	660	754	1	80	0.0125000
NODE_8584_length_911_cov_173.171182	580	660	757	1	80	0.0125000
NODE_8584_length_911_cov_173.171182	580	660	761	1	80	0.0125000
NODE_8584_length_911_cov_173.171182	580	660	770	1	80	0.0125000
NODE_8584_length_911_cov_173.171182	580	660	772	1	80	0.0125000
NODE_8584_length_911_cov_173.171182	580	660	774	1	80	0.0125000
NODE_8584_length_911_cov_173.171182	580	660	793	1	80	0.0125000
NODE_8584_length_911_cov_173.171182	580	660	794	1	80	0.0125000
NODE_8584_length_911_cov_173.171182	580	660	797	1	80	0.0125000
NODE_8584_length_911_cov_173.171182	580	660	808	2	80	0.0250000
NODE_8584_length_911_cov_173.171182	580	660	811	1	80	0.0125000
NODE_8584_length_911_cov_173.171182	580	660	817	1	80	0.0125000
NODE_8584_length_911_cov_173.171182	580	660	832	1	80	0.0125000
NODE_8584_length_911_cov_173.171182	580	660	844	1	80	0.0125000
NODE_8584_length_911_cov_173.171182	580	660	845	1	80	0.0125000
NODE_8584_length_911_cov_173.171182	580	660	847	2	80	0.0250000
NODE_8584_length_911_cov_173.171182	580	660	848	1	80	0.0125000
NODE_8584_length_911_cov_173.171182	580	660	849	1	80	0.0125000
NODE_8584_length_911_cov_173.171182	580	660	850	1	80	0.0125000
NODE_8584_length_911_cov_173.171182	580	660	860	2	80	0.0250000
NODE_8584_length_911_cov_173.171182	580	660	871	1	80	0.0125000
NODE_8584_length_911_cov_173.171182	580	660	878	1	80	0.0125000
NODE_8584_length_911_cov_173.171182	580	660	883	2	80	0.0250000
NODE_8584_length_911_cov_173.171182	580	660	885	1	80	0.0125000
NODE_8584_length_911_cov_173.171182	580	660	890	1	80	0.0125000
NODE_8584_length_911_cov_173.171182	580	660	895	1	80	0.0125000
NODE_8584_length_911_cov_173.171182	633	713	770	1	80	0.0125000
NODE_8584_length_911_cov_173.171182	633	713	772	1	80	0.0125000
NODE_8584_length_911_cov_173.171182	633	713	774	1	80	0.0125000
NODE_8584_length_911_cov_173.171182	633	713	793	1	80	0.0125000
NODE_8584_length_911_cov_173.171182	633	713	794	1	80	0.0125000
NODE_8584_length_911_cov_173.171182	633	713	797	1	80	0.0125000
NODE_8584_length_911_cov_173.171182	633	713	808	2	80	0.0250000
NODE_8584_length_911_cov_173.171182	633	713	811	1	80	0.0125000
NODE_8584_length_911_cov_173.171182	633	713	817	1	80	0.0125000
NODE_8584_length_911_cov_173.171182	633	713	832	1	80	0.0125000
NODE_8584_length_911_cov_173.171182	633	713	844	1	80	0.0125000
NODE_8584_length_911_cov_173.171182	633	713	845	1	80	0.0125000
NODE_8584_length_911_cov_173.171182	633	713	847	2	80	0.0250000
NODE_8584_length_911_cov_173.171182	633	713	848	1	80	0.0125000
NODE_8584_length_911_cov_173.171182	633	713	849	1	80	0.0125000
NODE_8584_length_911_cov_173.171182	633	713	850	1	80	0.0125000
NODE_8584_length_911_cov_173.171182	633	713	860	2	80	0.0250000
NODE_8584_length_911_cov_173.171182	633	713	871	1	80	0.0125000
NODE_8584_length_911_cov_173.171182	633	713	878	1	80	0.0125000
NODE_8584_length_911_cov_173.171182	633	713	883	2	80	0.0250000
NODE_8584_length_911_cov_173.171182	633	713	885	1	80	0.0125000
NODE_8584_length_911_cov_173.171182	633	713	890	1	80	0.0125000
NODE_8584_length_911_cov_173.171182	633	713	895	1	80	0.0125000
NODE_8584_length_911_cov_173.171182	633	713	900	1	80	0.0125000
NODE_8584_length_911_cov_173.171182	633	713	904	1	80	0.0125000
NODE_8584_length_911_cov_173.171182	633	713	909	1	80	0.0125000
NODE_8584_length_911_cov_173.171182	633	713	910	1	80	0.0125000
NODE_8584_length_911_cov_173.171182	633	713	911	1	80	0.0125000
NODE_8584_length_911_cov_173.171182	633	713	913	1	80	0.0125000
NODE_8584_length_911_cov_173.171182	633	713	915	1	80	0.0125000
NODE_8584_length_911_cov_173.171182	633	713	916	3	80	0.0375000
NODE_8584_length_911_cov_173.171182	633	713	917	1	80	0.0125000
NODE_8584_length_911_cov_173.171182	633	713	918	1	80	0.0125000
NODE_8584_length_911_cov_173.171182	633	713	919	1	80	0.0125000
NODE_8584_length_911_cov_173.171182	633	713	922	1	80	0.0125000
NODE_8584_length_911_cov_173.171182	633	713	923	1	80	0.0125000
NODE_8584_length_911_cov_173.171182	633	713	924	2	80	0.0250000
NODE_8584_length_911_cov_173.171182	633	713	925	1	80	0.0125000
NODE_8584_length_911_cov_173.171182	633	713	926	1	80	0.0125000
NODE_8584_length_911_cov_173.171182	633	713	929	1	80	0.0125000
NODE_8584_length_911_cov_173.171182	633	713	931	2	80	0.0250000
NODE_8584_length_911_cov_173.171182	633	713	932	2	80	0.0250000
NODE_8584_length_911_cov_173.171182	633	713	933	1	80	0.0125000
NODE_8584_length_911_cov_173.171182	633	713	934	1	80	0.0125000
NODE_8584_length_911_cov_173.171182	633	713	935	1	80	0.0125000
NODE_8584_length_911_cov_173.171182	633	713	938	1	80	0.0125000
NODE_8584_length_911_cov_173.171182	633	713	939	1	80	0.0125000
NODE_8584_length_911_cov_173.171182	633	713	940	1	80	0.0125000
NODE_8584_length_911_cov_173.171182	633	713	945	1	80	0.0125000
NODE_8584_length_911_cov_173.171182	633	713	946	1	80	0.0125000
NODE_8584_length_911_cov_173.171182	633	713	947	1	80	0.0125000
NODE_8584_length_911_cov_173.171182	633	713	955	2	80	0.0250000
NODE_8584_length_911_cov_173.171182	633	713	957	1	80	0.0125000
NODE_8584_length_911_cov_173.171182	633	713	958	1	80	0.0125000
NODE_8584_length_911_cov_173.171182	633	713	959	1	80	0.0125000
NODE_8584_length_911_cov_173.171182	633	713	962	3	80	0.0375000
NODE_8584_length_911_cov_173.171182	633	713	964	6	80	0.0750000
NODE_8584_length_911_cov_173.171182	633	713	965	1	80	0.0125000
NODE_8584_length_911_cov_173.171182	633	713	969	2	80	0.0250000
NODE_8584_length_911_cov_173.171182	633	713	970	3	80	0.0375000
NODE_8585_length_911_cov_88.250000	525	605	0	36	80	0.4500000
NODE_8585_length_911_cov_88.250000	525	605	7	4	80	0.0500000
NODE_8585_length_911_cov_88.250000	525	605	8	7	80	0.0875000
NODE_8585_length_911_cov_88.250000	525	605	9	33	80	0.4125000
NODE_8585_length_911_cov_88.250000	578	658	0	80	80	1.0000000
NODE_8586_length_911_cov_46.854680	255	335	0	80	80	1.0000000
NODE_8586_length_911_cov_46.854680	308	388	0	54	80	0.6750000
NODE_8586_length_911_cov_46.854680	308	388	2	15	80	0.1875000
NODE_8586_length_911_cov_46.854680	308	388	3	11	80	0.1375000
NODE_8586_length_911_cov_46.854680	384	464	3	13	80	0.1625000
NODE_8586_length_911_cov_46.854680	384	464	4	7	80	0.0875000
NODE_8586_length_911_cov_46.854680	384	464	6	13	80	0.1625000
NODE_8586_length_911_cov_46.854680	384	464	12	26	80	0.3250000
NODE_8586_length_911_cov_46.854680	384	464	14	7	80	0.0875000
NODE_8586_length_911_cov_46.854680	384	464	15	1	80	0.0125000
NODE_8586_length_911_cov_46.854680	384	464	16	11	80	0.1375000
NODE_8586_length_911_cov_46.854680	384	464	18	2	80	0.0250000
NODE_8586_length_911_cov_46.854680	437	517	12	6	80	0.0750000
NODE_8586_length_911_cov_46.854680	437	517	14	7	80	0.0875000
NODE_8586_length_911_cov_46.854680	437	517	15	1	80	0.0125000
NODE_8586_length_911_cov_46.854680	437	517	16	63	80	0.7875000
NODE_8586_length_911_cov_46.854680	437	517	18	3	80	0.0375000
NODE_8587_length_911_cov_31.362069	301	381	0	38	80	0.4750000
NODE_8587_length_911_cov_31.362069	301	381	2	42	80	0.5250000
NODE_8587_length_911_cov_31.362069	354	434	0	13	80	0.1625000
NODE_8587_length_911_cov_31.362069	354	434	2	67	80	0.8375000
NODE_8588_length_911_cov_19.235222	445	525	5	80	80	1.0000000
NODE_8588_length_911_cov_19.235222	498	578	2	22	80	0.2750000
NODE_8588_length_911_cov_19.235222	498	578	5	28	80	0.3500000
NODE_8588_length_911_cov_19.235222	498	578	7	30	80	0.3750000
NODE_8589_length_911_cov_16.230296	233	313	2	12	80	0.1500000
NODE_8589_length_911_cov_16.230296	233	313	4	68	80	0.8500000
NODE_8589_length_911_cov_16.230296	286	366	0	37	80	0.4625000
NODE_8589_length_911_cov_16.230296	286	366	2	23	80	0.2875000
NODE_8589_length_911_cov_16.230296	286	366	4	20	80	0.2500000
NODE_8590_length_911_cov_14.979064	472	552	4	6	80	0.0750000
NODE_8590_length_911_cov_14.979064	472	552	8	74	80	0.9250000
NODE_8590_length_911_cov_14.979064	525	605	0	34	80	0.4250000
NODE_8590_length_911_cov_14.979064	525	605	4	20	80	0.2500000
NODE_8590_length_911_cov_14.979064	525	605	8	26	80	0.3250000
NODE_8591_length_911_cov_12.089901	357	409	0	52	52	1.0000000
NODE_8591_length_911_cov_12.089901	401	462	0	61	61	1.0000000
NODE_8606_length_910_cov_27.838471	347	427	0	1	80	0.0125000
NODE_8606_length_910_cov_27.838471	347	427	7	1	80	0.0125000
NODE_8606_length_910_cov_27.838471	347	427	8	78	80	0.9750000
NODE_8606_length_910_cov_27.838471	400	480	0	32	80	0.4000000
NODE_8606_length_910_cov_27.838471	400	480	8	48	80	0.6000000
NODE_8607_length_910_cov_25.895191	361	441	10	80	80	1.0000000
NODE_8607_length_910_cov_25.895191	414	494	0	26	80	0.3250000
NODE_8607_length_910_cov_25.895191	414	494	8	19	80	0.2375000
NODE_8607_length_910_cov_25.895191	414	494	10	35	80	0.4375000
NODE_8608_length_910_cov_25.604192	294	374	0	80	80	1.0000000
NODE_8608_length_910_cov_25.604192	347	427	0	80	80	1.0000000
NODE_8608_length_910_cov_25.604192	423	503	0	80	80	1.0000000
NODE_8608_length_910_cov_25.604192	476	556	0	80	80	1.0000000
NODE_8609_length_910_cov_16.066584	656	736	0	34	80	0.4250000
NODE_8609_length_910_cov_16.066584	656	736	5	1	80	0.0125000
NODE_8609_length_910_cov_16.066584	656	736	6	45	80	0.5625000
NODE_8609_length_910_cov_16.066584	709	789	0	15	80	0.1875000
NODE_8609_length_910_cov_16.066584	709	789	6	65	80	0.8125000
NODE_8610_length_910_cov_14.696671	417	497	0	4	80	0.0500000
NODE_8610_length_910_cov_14.696671	417	497	2	17	80	0.2125000
NODE_8610_length_910_cov_14.696671	417	497	6	59	80	0.7375000
NODE_8610_length_910_cov_14.696671	470	550	0	29	80	0.3625000
NODE_8610_length_910_cov_14.696671	470	550	6	51	80	0.6375000
NODE_8612_length_910_cov_7.114673	442	522	0	17	80	0.2125000
NODE_8612_length_910_cov_7.114673	442	522	2	63	80	0.7875000
NODE_8612_length_910_cov_7.114673	495	575	0	3	80	0.0375000
NODE_8612_length_910_cov_7.114673	495	575	2	77	80	0.9625000
NODE_8614_length_910_cov_2.992602	196	269	23	4	73	0.0547945
NODE_8614_length_910_cov_2.992602	196	269	24	2	73	0.0273973
NODE_8614_length_910_cov_2.992602	196	269	25	18	73	0.2465753
NODE_8614_length_910_cov_2.992602	196	269	27	7	73	0.0958904
NODE_8614_length_910_cov_2.992602	196	269	29	1	73	0.0136986
NODE_8614_length_910_cov_2.992602	196	269	31	3	73	0.0410959
NODE_8614_length_910_cov_2.992602	196	269	33	21	73	0.2876712
NODE_8614_length_910_cov_2.992602	196	269	37	2	73	0.0273973
NODE_8614_length_910_cov_2.992602	196	269	41	6	73	0.0821918
NODE_8614_length_910_cov_2.992602	196	269	43	2	73	0.0273973
NODE_8614_length_910_cov_2.992602	196	269	44	7	73	0.0958904
NODE_8614_length_910_cov_2.992602	249	329	33	3	80	0.0375000
NODE_8614_length_910_cov_2.992602	249	329	37	2	80	0.0250000
NODE_8614_length_910_cov_2.992602	249	329	41	6	80	0.0750000
NODE_8614_length_910_cov_2.992602	249	329	42	4	80	0.0500000
NODE_8614_length_910_cov_2.992602	249	329	43	2	80	0.0250000
NODE_8614_length_910_cov_2.992602	249	329	44	12	80	0.1500000
NODE_8614_length_910_cov_2.992602	249	329	45	2	80	0.0250000
NODE_8614_length_910_cov_2.992602	249	329	46	10	80	0.1250000
NODE_8614_length_910_cov_2.992602	249	329	47	4	80	0.0500000
NODE_8614_length_910_cov_2.992602	249	329	48	6	80	0.0750000
NODE_8614_length_910_cov_2.992602	249	329	49	17	80	0.2125000
NODE_8614_length_910_cov_2.992602	249	329	51	12	80	0.1500000
NODE_8614_length_910_cov_2.992602	386	439	15	3	53	0.0566038
NODE_8614_length_910_cov_2.992602	386	439	17	2	53	0.0377358
NODE_8614_length_910_cov_2.992602	386	439	18	14	53	0.2641509
NODE_8614_length_910_cov_2.992602	386	439	20	6	53	0.1132075
NODE_8614_length_910_cov_2.992602	386	439	21	1	53	0.0188679
NODE_8614_length_910_cov_2.992602	386	439	22	5	53	0.0943396
NODE_8614_length_910_cov_2.992602	386	439	24	10	53	0.1886792
NODE_8614_length_910_cov_2.992602	386	439	26	11	53	0.2075472
NODE_8614_length_910_cov_2.992602	386	439	28	1	53	0.0188679
NODE_8623_length_909_cov_35.291358	426	506	0	80	80	1.0000000
NODE_8623_length_909_cov_35.291358	479	559	0	80	80	1.0000000
NODE_8624_length_909_cov_27.449383	311	391	0	61	80	0.7625000
NODE_8624_length_909_cov_27.449383	311	391	14	19	80	0.2375000
NODE_8624_length_909_cov_27.449383	364	444	0	8	80	0.1000000
NODE_8624_length_909_cov_27.449383	364	444	14	67	80	0.8375000
NODE_8624_length_909_cov_27.449383	364	444	20	5	80	0.0625000
NODE_8625_length_909_cov_25.212346	295	375	0	71	80	0.8875000
NODE_8625_length_909_cov_25.212346	295	375	4	9	80	0.1125000
NODE_8625_length_909_cov_25.212346	348	428	0	18	80	0.2250000
NODE_8625_length_909_cov_25.212346	348	428	4	62	80	0.7750000
NODE_8626_length_909_cov_23.604938	403	483	0	31	80	0.3875000
NODE_8626_length_909_cov_23.604938	403	483	2	49	80	0.6125000
NODE_8626_length_909_cov_23.604938	456	536	0	47	80	0.5875000
NODE_8626_length_909_cov_23.604938	456	536	2	33	80	0.4125000
NODE_8627_length_909_cov_19.070370	441	521	0	13	80	0.1625000
NODE_8627_length_909_cov_19.070370	441	521	2	67	80	0.8375000
NODE_8627_length_909_cov_19.070370	494	574	0	37	80	0.4625000
NODE_8627_length_909_cov_19.070370	494	574	2	43	80	0.5375000
NODE_8628_length_909_cov_11.533333	332	412	0	80	80	1.0000000
NODE_8628_length_909_cov_11.533333	385	465	0	80	80	1.0000000
NODE_8629_length_909_cov_10.229630	497	577	0	80	80	1.0000000
NODE_8629_length_909_cov_10.229630	550	622	0	72	72	1.0000000
NODE_8631_length_909_cov_7.122222	328	408	0	2	80	0.0250000
NODE_8631_length_909_cov_7.122222	328	408	2	17	80	0.2125000
NODE_8631_length_909_cov_7.122222	328	408	4	61	80	0.7625000
NODE_8631_length_909_cov_7.122222	381	461	0	37	80	0.4625000
NODE_8631_length_909_cov_7.122222	381	461	2	3	80	0.0375000
NODE_8631_length_909_cov_7.122222	381	461	4	40	80	0.5000000
NODE_8632_length_909_cov_4.664198	775	855	8	38	80	0.4750000
NODE_8632_length_909_cov_4.664198	775	855	10	2	80	0.0250000
NODE_8632_length_909_cov_4.664198	775	855	11	23	80	0.2875000
NODE_8632_length_909_cov_4.664198	775	855	13	8	80	0.1000000
NODE_8632_length_909_cov_4.664198	775	855	14	1	80	0.0125000
NODE_8632_length_909_cov_4.664198	775	855	16	5	80	0.0625000
NODE_8632_length_909_cov_4.664198	775	855	19	3	80	0.0375000
NODE_8632_length_909_cov_4.664198	828	885	0	3	57	0.0526316
NODE_8632_length_909_cov_4.664198	828	885	4	2	57	0.0350877
NODE_8632_length_909_cov_4.664198	828	885	6	20	57	0.3508772
NODE_8632_length_909_cov_4.664198	828	885	8	32	57	0.5614035
NODE_8644_length_908_cov_55.546354	409	489	0	3	80	0.0375000
NODE_8644_length_908_cov_55.546354	409	489	10	71	80	0.8875000
NODE_8644_length_908_cov_55.546354	409	489	14	6	80	0.0750000
NODE_8644_length_908_cov_55.546354	462	542	4	32	80	0.4000000
NODE_8644_length_908_cov_55.546354	462	542	10	21	80	0.2625000
NODE_8644_length_908_cov_55.546354	462	542	14	27	80	0.3375000
NODE_8645_length_908_cov_18.720643	329	409	0	80	80	1.0000000
NODE_8645_length_908_cov_18.720643	382	462	0	80	80	1.0000000
NODE_8646_length_908_cov_14.640297	430	510	0	80	80	1.0000000
NODE_8646_length_908_cov_14.640297	483	562	0	79	79	1.0000000
NODE_8648_length_908_cov_10.789864	370	450	0	31	80	0.3875000
NODE_8648_length_908_cov_10.789864	370	450	2	49	80	0.6125000
NODE_8648_length_908_cov_10.789864	423	503	0	41	80	0.5125000
NODE_8648_length_908_cov_10.789864	423	503	2	39	80	0.4875000
NODE_8651_length_908_cov_3.737948	251	331	0	58	80	0.7250000
NODE_8651_length_908_cov_3.737948	251	331	4	22	80	0.2750000
NODE_8651_length_908_cov_3.737948	304	384	0	80	80	1.0000000
NODE_8664_length_907_cov_22.110149	459	539	0	80	80	1.0000000
NODE_8664_length_907_cov_22.110149	512	592	0	80	80	1.0000000
NODE_8665_length_907_cov_20.943069	410	490	0	65	80	0.8125000
NODE_8665_length_907_cov_20.943069	410	490	2	15	80	0.1875000
NODE_8665_length_907_cov_20.943069	463	543	0	12	80	0.1500000
NODE_8665_length_907_cov_20.943069	463	543	2	15	80	0.1875000
NODE_8665_length_907_cov_20.943069	463	543	4	53	80	0.6625000
NODE_8666_length_907_cov_19.519802	411	488	0	77	77	1.0000000
NODE_8666_length_907_cov_19.519802	461	541	0	80	80	1.0000000
NODE_8667_length_907_cov_17.928218	329	405	0	76	76	1.0000000
NODE_8667_length_907_cov_17.928218	382	462	0	80	80	1.0000000
NODE_8668_length_907_cov_13.060644	293	373	0	80	80	1.0000000
NODE_8668_length_907_cov_13.060644	346	426	0	80	80	1.0000000
NODE_8669_length_907_cov_11.155941	401	462	8	33	61	0.5409836
NODE_8669_length_907_cov_11.155941	401	462	10	2	61	0.0327869
NODE_8669_length_907_cov_11.155941	401	462	11	12	61	0.1967213
NODE_8669_length_907_cov_11.155941	401	462	12	14	61	0.2295082
NODE_8669_length_907_cov_11.155941	607	687	0	80	80	1.0000000
NODE_8670_length_907_cov_9.237624	247	327	0	9	80	0.1125000
NODE_8670_length_907_cov_9.237624	247	327	2	17	80	0.2125000
NODE_8670_length_907_cov_9.237624	247	327	4	54	80	0.6750000
NODE_8670_length_907_cov_9.237624	300	380	2	12	80	0.1500000
NODE_8670_length_907_cov_9.237624	300	380	4	37	80	0.4625000
NODE_8670_length_907_cov_9.237624	300	380	6	31	80	0.3875000
NODE_8671_length_907_cov_8.686881	275	365	0	86	90	0.9555556
NODE_8671_length_907_cov_8.686881	275	365	2	4	90	0.0444444
NODE_8671_length_907_cov_8.686881	338	418	0	80	80	1.0000000
NODE_8680_length_907_cov_2.949257	503	526	2	23	23	1.0000000
NODE_8686_length_906_cov_32.369269	447	527	0	80	80	1.0000000
NODE_8686_length_906_cov_32.369269	500	580	0	80	80	1.0000000
NODE_8687_length_906_cov_23.594796	196	276	0	80	80	1.0000000
NODE_8687_length_906_cov_23.594796	249	329	0	80	80	1.0000000
NODE_8688_length_906_cov_21.443618	404	484	0	78	80	0.9750000
NODE_8688_length_906_cov_21.443618	404	484	2	2	80	0.0250000
NODE_8688_length_906_cov_21.443618	457	537	0	25	80	0.3125000
NODE_8688_length_906_cov_21.443618	457	537	2	55	80	0.6875000
NODE_8689_length_906_cov_20.596035	593	634	0	41	41	1.0000000
NODE_8690_length_906_cov_20.429988	410	490	1	4	80	0.0500000
NODE_8690_length_906_cov_20.429988	410	490	2	22	80	0.2750000
NODE_8690_length_906_cov_20.429988	410	490	3	54	80	0.6750000
NODE_8690_length_906_cov_20.429988	463	543	1	57	80	0.7125000
NODE_8690_length_906_cov_20.429988	463	543	3	23	80	0.2875000
NODE_8691_length_906_cov_20.395291	523	603	0	6	80	0.0750000
NODE_8691_length_906_cov_20.395291	523	603	1	7	80	0.0875000
NODE_8691_length_906_cov_20.395291	523	603	3	8	80	0.1000000
NODE_8691_length_906_cov_20.395291	523	603	4	59	80	0.7375000
NODE_8691_length_906_cov_20.395291	576	656	2	20	80	0.2500000
NODE_8691_length_906_cov_20.395291	576	656	4	60	80	0.7500000
NODE_8692_length_906_cov_19.297398	255	335	0	80	80	1.0000000
NODE_8692_length_906_cov_19.297398	308	388	0	80	80	1.0000000
NODE_8693_length_906_cov_18.505576	357	437	0	80	80	1.0000000
NODE_8693_length_906_cov_18.505576	410	490	0	80	80	1.0000000
NODE_8694_length_906_cov_10.068154	191	271	0	80	80	1.0000000
NODE_8694_length_906_cov_10.068154	244	324	0	80	80	1.0000000
NODE_8695_length_906_cov_10.006196	304	384	0	80	80	1.0000000
NODE_8695_length_906_cov_10.006196	357	437	0	80	80	1.0000000
NODE_8696_length_906_cov_8.562577	370	454	0	84	84	1.0000000
NODE_8696_length_906_cov_8.562577	423	507	0	84	84	1.0000000
NODE_8716_length_905_cov_39.203474	406	486	0	80	80	1.0000000
NODE_8716_length_905_cov_39.203474	459	539	0	80	80	1.0000000
NODE_8717_length_905_cov_37.053350	411	491	3	14	80	0.1750000
NODE_8717_length_905_cov_37.053350	411	491	6	12	80	0.1500000
NODE_8717_length_905_cov_37.053350	411	491	8	46	80	0.5750000
NODE_8717_length_905_cov_37.053350	411	491	9	8	80	0.1000000
NODE_8717_length_905_cov_37.053350	464	544	1	31	80	0.3875000
NODE_8717_length_905_cov_37.053350	464	544	3	36	80	0.4500000
NODE_8717_length_905_cov_37.053350	464	544	8	5	80	0.0625000
NODE_8717_length_905_cov_37.053350	464	544	9	8	80	0.1000000
NODE_8718_length_905_cov_27.426799	288	368	2	50	80	0.6250000
NODE_8718_length_905_cov_27.426799	288	368	6	1	80	0.0125000
NODE_8718_length_905_cov_27.426799	288	368	16	14	80	0.1750000
NODE_8718_length_905_cov_27.426799	288	368	18	15	80	0.1875000
NODE_8718_length_905_cov_27.426799	341	421	16	67	80	0.8375000
NODE_8718_length_905_cov_27.426799	341	421	18	13	80	0.1625000
NODE_8719_length_905_cov_26.332506	375	455	0	31	80	0.3875000
NODE_8719_length_905_cov_26.332506	375	455	2	49	80	0.6125000
NODE_8719_length_905_cov_26.332506	428	508	0	29	80	0.3625000
NODE_8719_length_905_cov_26.332506	428	508	2	51	80	0.6375000
NODE_8720_length_905_cov_20.651365	377	457	0	3	80	0.0375000
NODE_8720_length_905_cov_20.651365	377	457	2	45	80	0.5625000
NODE_8720_length_905_cov_20.651365	377	457	4	32	80	0.4000000
NODE_8720_length_905_cov_20.651365	430	510	0	20	80	0.2500000
NODE_8720_length_905_cov_20.651365	430	510	2	22	80	0.2750000
NODE_8720_length_905_cov_20.651365	430	510	4	38	80	0.4750000
NODE_8721_length_905_cov_19.718362	365	445	0	80	80	1.0000000
NODE_8721_length_905_cov_19.718362	418	498	0	80	80	1.0000000
NODE_8722_length_905_cov_13.696030	366	420	2	12	54	0.2222222
NODE_8722_length_905_cov_13.696030	366	420	4	11	54	0.2037037
NODE_8722_length_905_cov_13.696030	366	420	6	31	54	0.5740741
NODE_8723_length_905_cov_9.978908	222	302	0	80	80	1.0000000
NODE_8723_length_905_cov_9.978908	275	355	0	80	80	1.0000000
NODE_8725_length_905_cov_7.980149	321	401	0	80	80	1.0000000
NODE_8725_length_905_cov_7.980149	374	454	0	69	80	0.8625000
NODE_8725_length_905_cov_7.980149	374	454	2	11	80	0.1375000
NODE_8727_length_905_cov_6.064516	459	539	0	80	80	1.0000000
NODE_8727_length_905_cov_6.064516	512	592	0	80	80	1.0000000
NODE_8742_length_905_cov_1.040943	73	119	16	5	46	0.1086956
NODE_8742_length_905_cov_1.040943	73	119	18	8	46	0.1739130
NODE_8742_length_905_cov_1.040943	73	119	20	33	46	0.7173913
NODE_8742_length_905_cov_1.040943	126	172	3	1	46	0.0217391
NODE_8742_length_905_cov_1.040943	126	172	5	2	46	0.0434783
NODE_8742_length_905_cov_1.040943	126	172	6	3	46	0.0652174
NODE_8742_length_905_cov_1.040943	126	172	7	1	46	0.0217391
NODE_8742_length_905_cov_1.040943	126	172	8	4	46	0.0869565
NODE_8742_length_905_cov_1.040943	126	172	11	10	46	0.2173913
NODE_8742_length_905_cov_1.040943	126	172	12	1	46	0.0217391
NODE_8742_length_905_cov_1.040943	126	172	13	19	46	0.4130435
NODE_8742_length_905_cov_1.040943	126	172	14	5	46	0.1086956
NODE_8743_length_904_cov_29.532919	338	418	0	48	80	0.6000000
NODE_8743_length_904_cov_29.532919	338	418	2	32	80	0.4000000
NODE_8743_length_904_cov_29.532919	391	471	0	15	80	0.1875000
NODE_8743_length_904_cov_29.532919	391	471	2	65	80	0.8125000
NODE_8743_length_904_cov_29.532919	467	547	0	42	80	0.5250000
NODE_8743_length_904_cov_29.532919	467	547	2	38	80	0.4750000
NODE_8743_length_904_cov_29.532919	520	600	0	32	80	0.4000000
NODE_8743_length_904_cov_29.532919	520	600	2	48	80	0.6000000
NODE_8744_length_904_cov_28.844720	371	451	0	68	80	0.8500000
NODE_8744_length_904_cov_28.844720	371	451	2	12	80	0.1500000
NODE_8744_length_904_cov_28.844720	424	504	0	15	80	0.1875000
NODE_8744_length_904_cov_28.844720	424	504	2	65	80	0.8125000
NODE_8745_length_904_cov_26.977640	488	568	0	34	80	0.4250000
NODE_8745_length_904_cov_26.977640	488	568	4	46	80	0.5750000
NODE_8745_length_904_cov_26.977640	541	621	0	80	80	1.0000000
NODE_8746_length_904_cov_24.529193	464	544	0	80	80	1.0000000
NODE_8746_length_904_cov_24.529193	517	597	0	80	80	1.0000000
NODE_8747_length_904_cov_24.452174	507	587	0	80	80	1.0000000
NODE_8747_length_904_cov_24.452174	560	640	0	80	80	1.0000000
NODE_8748_length_904_cov_19.649689	307	387	0	80	80	1.0000000
NODE_8748_length_904_cov_19.649689	360	440	0	80	80	1.0000000
NODE_8748_length_904_cov_19.649689	595	675	0	80	80	1.0000000
NODE_8748_length_904_cov_19.649689	648	728	0	80	80	1.0000000
NODE_8750_length_904_cov_16.608696	252	332	0	80	80	1.0000000
NODE_8750_length_904_cov_16.608696	305	385	0	30	80	0.3750000
NODE_8750_length_904_cov_16.608696	305	385	2	50	80	0.6250000
NODE_8750_length_904_cov_16.608696	381	461	0	25	80	0.3125000
NODE_8750_length_904_cov_16.608696	381	461	2	55	80	0.6875000
NODE_8750_length_904_cov_16.608696	434	514	0	42	80	0.5250000
NODE_8750_length_904_cov_16.608696	434	514	2	2	80	0.0250000
NODE_8750_length_904_cov_16.608696	434	514	6	36	80	0.4500000
NODE_8751_length_904_cov_15.811180	431	511	0	23	80	0.2875000
NODE_8751_length_904_cov_15.811180	431	511	2	27	80	0.3375000
NODE_8751_length_904_cov_15.811180	431	511	4	30	80	0.3750000
NODE_8751_length_904_cov_15.811180	484	564	2	46	80	0.5750000
NODE_8751_length_904_cov_15.811180	484	564	4	34	80	0.4250000
NODE_8752_length_904_cov_9.249689	581	661	0	80	80	1.0000000
NODE_8752_length_904_cov_9.249689	634	714	0	80	80	1.0000000
NODE_8756_length_904_cov_4.772671	318	398	0	80	80	1.0000000
NODE_8756_length_904_cov_4.772671	371	451	0	80	80	1.0000000
NODE_8773_length_903_cov_58.723881	386	466	10	17	80	0.2125000
NODE_8773_length_903_cov_58.723881	386	466	12	8	80	0.1000000
NODE_8773_length_903_cov_58.723881	386	466	16	12	80	0.1500000
NODE_8773_length_903_cov_58.723881	386	466	18	14	80	0.1750000
NODE_8773_length_903_cov_58.723881	386	466	19	1	80	0.0125000
NODE_8773_length_903_cov_58.723881	386	466	20	16	80	0.2000000
NODE_8773_length_903_cov_58.723881	386	466	22	12	80	0.1500000
NODE_8773_length_903_cov_58.723881	439	519	6	21	80	0.2625000
NODE_8773_length_903_cov_58.723881	439	519	10	12	80	0.1500000
NODE_8773_length_903_cov_58.723881	439	519	12	18	80	0.2250000
NODE_8773_length_903_cov_58.723881	439	519	14	2	80	0.0250000
NODE_8773_length_903_cov_58.723881	439	519	16	2	80	0.0250000
NODE_8773_length_903_cov_58.723881	439	519	18	3	80	0.0375000
NODE_8773_length_903_cov_58.723881	439	519	19	1	80	0.0125000
NODE_8773_length_903_cov_58.723881	439	519	20	16	80	0.2000000
NODE_8773_length_903_cov_58.723881	439	519	22	5	80	0.0625000
NODE_8773_length_903_cov_58.723881	515	595	0	68	80	0.8500000
NODE_8773_length_903_cov_58.723881	515	595	6	12	80	0.1500000
NODE_8773_length_903_cov_58.723881	568	648	0	80	80	1.0000000
NODE_8774_length_903_cov_41.298507	397	477	0	38	80	0.4750000
NODE_8774_length_903_cov_41.298507	397	477	1	8	80	0.1000000
NODE_8774_length_903_cov_41.298507	397	477	2	34	80	0.4250000
NODE_8774_length_903_cov_41.298507	450	530	2	76	80	0.9500000
NODE_8774_length_903_cov_41.298507	450	530	4	4	80	0.0500000
NODE_8775_length_903_cov_28.691542	394	474	0	77	80	0.9625000
NODE_8775_length_903_cov_28.691542	394	474	2	3	80	0.0375000
NODE_8775_length_903_cov_28.691542	447	527	0	80	80	1.0000000
NODE_8776_length_903_cov_26.276119	441	521	0	6	80	0.0750000
NODE_8776_length_903_cov_26.276119	441	521	4	74	80	0.9250000
NODE_8776_length_903_cov_26.276119	494	574	2	33	80	0.4125000
NODE_8776_length_903_cov_26.276119	494	574	4	34	80	0.4250000
NODE_8776_length_903_cov_26.276119	494	574	6	13	80	0.1625000
NODE_8778_length_903_cov_18.166667	351	431	0	80	80	1.0000000
NODE_8778_length_903_cov_18.166667	404	484	0	80	80	1.0000000
NODE_8779_length_903_cov_15.460199	440	520	0	80	80	1.0000000
NODE_8779_length_903_cov_15.460199	493	573	0	80	80	1.0000000
NODE_8780_length_903_cov_15.084577	352	432	0	80	80	1.0000000
NODE_8780_length_903_cov_15.084577	405	485	0	80	80	1.0000000
NODE_8781_length_903_cov_15.070896	367	447	1	80	80	1.0000000
NODE_8781_length_903_cov_15.070896	420	500	0	13	80	0.1625000
NODE_8781_length_903_cov_15.070896	420	500	1	67	80	0.8375000
NODE_8782_length_903_cov_14.004975	318	399	0	81	81	1.0000000
NODE_8782_length_903_cov_14.004975	372	452	0	69	80	0.8625000
NODE_8782_length_903_cov_14.004975	372	452	2	11	80	0.1375000
NODE_8783_length_903_cov_10.546020	150	230	0	39	80	0.4875000
NODE_8783_length_903_cov_10.546020	150	230	4	41	80	0.5125000
NODE_8783_length_903_cov_10.546020	203	283	0	23	80	0.2875000
NODE_8783_length_903_cov_10.546020	203	283	4	57	80	0.7125000
NODE_8784_length_903_cov_9.288557	373	453	4	25	80	0.3125000
NODE_8784_length_903_cov_9.288557	373	453	5	1	80	0.0125000
NODE_8784_length_903_cov_9.288557	373	453	6	1	80	0.0125000
NODE_8784_length_903_cov_9.288557	373	453	8	53	80	0.6625000
NODE_8784_length_903_cov_9.288557	426	506	0	12	80	0.1500000
NODE_8784_length_903_cov_9.288557	426	506	4	66	80	0.8250000
NODE_8784_length_903_cov_9.288557	426	506	5	1	80	0.0125000
NODE_8784_length_903_cov_9.288557	426	506	6	1	80	0.0125000
NODE_8785_length_903_cov_8.052239	439	519	0	80	80	1.0000000
NODE_8785_length_903_cov_8.052239	492	572	0	80	80	1.0000000
NODE_8798_length_902_cov_64.459527	355	435	0	80	80	1.0000000
NODE_8798_length_902_cov_64.459527	408	488	0	80	80	1.0000000
NODE_8798_length_902_cov_64.459527	484	564	0	18	80	0.2250000
NODE_8798_length_902_cov_64.459527	484	564	6	33	80	0.4125000
NODE_8798_length_902_cov_64.459527	484	564	9	15	80	0.1875000
NODE_8798_length_902_cov_64.459527	484	564	10	14	80	0.1750000
NODE_8798_length_902_cov_64.459527	537	617	9	68	80	0.8500000
NODE_8798_length_902_cov_64.459527	537	617	10	12	80	0.1500000
NODE_8799_length_902_cov_60.823163	395	475	0	59	80	0.7375000
NODE_8799_length_902_cov_60.823163	395	475	2	21	80	0.2625000
NODE_8799_length_902_cov_60.823163	448	528	0	6	80	0.0750000
NODE_8799_length_902_cov_60.823163	448	528	2	74	80	0.9250000
NODE_8800_length_902_cov_44.002491	383	463	0	80	80	1.0000000
NODE_8800_length_902_cov_44.002491	436	516	0	80	80	1.0000000
NODE_8801_length_902_cov_41.059776	378	458	0	2	80	0.0250000
NODE_8801_length_902_cov_41.059776	378	458	2	13	80	0.1625000
NODE_8801_length_902_cov_41.059776	378	458	4	7	80	0.0875000
NODE_8801_length_902_cov_41.059776	378	458	6	58	80	0.7250000
NODE_8801_length_902_cov_41.059776	431	511	0	44	80	0.5500000
NODE_8801_length_902_cov_41.059776	431	511	2	22	80	0.2750000
NODE_8801_length_902_cov_41.059776	431	511	6	14	80	0.1750000
NODE_8802_length_902_cov_38.952677	372	452	0	55	80	0.6875000
NODE_8802_length_902_cov_38.952677	372	452	4	25	80	0.3125000
NODE_8802_length_902_cov_38.952677	425	505	0	2	80	0.0250000
NODE_8802_length_902_cov_38.952677	425	505	4	78	80	0.9750000
NODE_8803_length_902_cov_34.156912	373	453	0	80	80	1.0000000
NODE_8803_length_902_cov_34.156912	426	506	0	80	80	1.0000000
NODE_8804_length_902_cov_23.007472	295	375	0	80	80	1.0000000
NODE_8804_length_902_cov_23.007472	348	428	0	80	80	1.0000000
NODE_8805_length_902_cov_19.491905	238	291	0	45	53	0.8490566
NODE_8805_length_902_cov_19.491905	238	291	4	8	53	0.1509434
NODE_8805_length_902_cov_19.491905	264	344	0	19	80	0.2375000
NODE_8805_length_902_cov_19.491905	264	344	4	61	80	0.7625000
NODE_8806_length_902_cov_10.794521	214	294	0	80	80	1.0000000
NODE_8806_length_902_cov_10.794521	267	347	0	80	80	1.0000000
NODE_8807_length_902_cov_9.520548	518	598	0	21	80	0.2625000
NODE_8807_length_902_cov_9.520548	518	598	4	59	80	0.7375000
NODE_8807_length_902_cov_9.520548	571	651	4	80	80	1.0000000
NODE_8808_length_902_cov_8.323786	337	417	2	39	80	0.4875000
NODE_8808_length_902_cov_8.323786	337	417	6	29	80	0.3625000
NODE_8808_length_902_cov_8.323786	337	417	8	12	80	0.1500000
NODE_8808_length_902_cov_8.323786	390	470	2	14	80	0.1750000
NODE_8808_length_902_cov_8.323786	390	470	6	65	80	0.8125000
NODE_8808_length_902_cov_8.323786	390	470	8	1	80	0.0125000
NODE_8811_length_902_cov_7.300125	434	514	0	80	80	1.0000000
NODE_8811_length_902_cov_7.300125	487	567	0	80	80	1.0000000
NODE_8812_length_902_cov_4.185554	505	585	0	80	80	1.0000000
NODE_8812_length_902_cov_4.185554	558	588	0	30	30	1.0000000
NODE_8812_length_902_cov_4.185554	610	662	0	52	52	1.0000000
NODE_8830_length_902_cov_0.963885	82	106	0	24	24	1.0000000
NODE_8832_length_901_cov_36.066085	412	490	0	62	78	0.7948718
NODE_8832_length_901_cov_36.066085	412	490	2	16	78	0.2051282
NODE_8832_length_901_cov_36.066085	463	543	0	80	80	1.0000000
NODE_8833_length_901_cov_28.129676	377	457	0	80	80	1.0000000
NODE_8833_length_901_cov_28.129676	430	510	0	80	80	1.0000000
NODE_8834_length_901_cov_26.763092	272	352	0	80	80	1.0000000
NODE_8834_length_901_cov_26.763092	325	405	0	80	80	1.0000000
NODE_8834_length_901_cov_26.763092	401	481	0	18	80	0.2250000
NODE_8834_length_901_cov_26.763092	401	481	4	62	80	0.7750000
NODE_8834_length_901_cov_26.763092	454	534	0	58	80	0.7250000
NODE_8834_length_901_cov_26.763092	454	534	4	22	80	0.2750000
NODE_8835_length_901_cov_25.628429	369	449	3	17	80	0.2125000
NODE_8835_length_901_cov_25.628429	369	449	7	1	80	0.0125000
NODE_8835_length_901_cov_25.628429	369	449	8	8	80	0.1000000
NODE_8835_length_901_cov_25.628429	369	449	9	54	80	0.6750000
NODE_8835_length_901_cov_25.628429	422	502	0	35	80	0.4375000
NODE_8835_length_901_cov_25.628429	422	502	6	2	80	0.0250000
NODE_8835_length_901_cov_25.628429	422	502	8	24	80	0.3000000
NODE_8835_length_901_cov_25.628429	422	502	9	19	80	0.2375000
NODE_8836_length_901_cov_17.857855	408	488	0	77	80	0.9625000
NODE_8836_length_901_cov_17.857855	408	488	2	3	80	0.0375000
NODE_8836_length_901_cov_17.857855	461	541	0	24	80	0.3000000
NODE_8836_length_901_cov_17.857855	461	541	2	56	80	0.7000000
NODE_8837_length_901_cov_16.254364	362	442	2	80	80	1.0000000
NODE_8837_length_901_cov_16.254364	415	495	0	30	80	0.3750000
NODE_8837_length_901_cov_16.254364	415	495	2	50	80	0.6250000
NODE_8838_length_901_cov_8.346633	321	401	0	1	80	0.0125000
NODE_8838_length_901_cov_8.346633	321	401	2	79	80	0.9875000
NODE_8838_length_901_cov_8.346633	374	454	0	54	80	0.6750000
NODE_8838_length_901_cov_8.346633	374	454	2	26	80	0.3250000
NODE_8840_length_901_cov_6.044888	363	443	0	29	80	0.3625000
NODE_8840_length_901_cov_6.044888	363	443	2	16	80	0.2000000
NODE_8840_length_901_cov_6.044888	363	443	3	5	80	0.0625000
NODE_8840_length_901_cov_6.044888	363	443	7	3	80	0.0375000
NODE_8840_length_901_cov_6.044888	363	443	8	27	80	0.3375000
NODE_8840_length_901_cov_6.044888	416	496	4	8	80	0.1000000
NODE_8840_length_901_cov_6.044888	416	496	8	72	80	0.9000000
NODE_8845_length_901_cov_3.814214	194	274	0	80	80	1.0000000
NODE_8845_length_901_cov_3.814214	247	326	0	79	79	1.0000000
NODE_8857_length_900_cov_30.284644	407	487	1	5	80	0.0625000
NODE_8857_length_900_cov_30.284644	407	487	2	75	80	0.9375000
NODE_8857_length_900_cov_30.284644	460	540	1	2	80	0.0250000
NODE_8857_length_900_cov_30.284644	460	540	2	78	80	0.9750000
NODE_8858_length_900_cov_29.679151	425	505	7	22	80	0.2750000
NODE_8858_length_900_cov_29.679151	425	505	8	16	80	0.2000000
NODE_8858_length_900_cov_29.679151	425	505	9	20	80	0.2500000
NODE_8858_length_900_cov_29.679151	425	505	10	22	80	0.2750000
NODE_8858_length_900_cov_29.679151	478	558	0	15	80	0.1875000
NODE_8858_length_900_cov_29.679151	478	558	4	37	80	0.4625000
NODE_8858_length_900_cov_29.679151	478	558	7	23	80	0.2875000
NODE_8858_length_900_cov_29.679151	478	558	9	5	80	0.0625000
NODE_8859_length_900_cov_25.963795	321	401	0	24	80	0.3000000
NODE_8859_length_900_cov_25.963795	321	401	1	56	80	0.7000000
NODE_8859_length_900_cov_25.963795	374	454	1	35	80	0.4375000
NODE_8859_length_900_cov_25.963795	374	454	2	45	80	0.5625000
NODE_8860_length_900_cov_17.681648	530	606	0	22	76	0.2894737
NODE_8860_length_900_cov_17.681648	530	606	3	1	76	0.0131579
NODE_8860_length_900_cov_17.681648	530	606	4	2	76	0.0263158
NODE_8860_length_900_cov_17.681648	530	606	6	51	76	0.6710526
NODE_8860_length_900_cov_17.681648	583	659	4	1	76	0.0131579
NODE_8860_length_900_cov_17.681648	583	659	6	75	76	0.9868421
NODE_8861_length_900_cov_16.294632	316	396	0	44	80	0.5500000
NODE_8861_length_900_cov_16.294632	316	396	2	36	80	0.4500000
NODE_8861_length_900_cov_16.294632	369	449	0	29	80	0.3625000
NODE_8861_length_900_cov_16.294632	369	449	2	51	80	0.6375000
NODE_8863_length_900_cov_5.962547	0	70	4	1	70	0.0142857
NODE_8863_length_900_cov_5.962547	0	70	6	1	70	0.0142857
NODE_8863_length_900_cov_5.962547	0	70	17	1	70	0.0142857
NODE_8863_length_900_cov_5.962547	0	70	32	1	70	0.0142857
NODE_8863_length_900_cov_5.962547	0	70	38	4	70	0.0571429
NODE_8863_length_900_cov_5.962547	0	70	50	1	70	0.0142857
NODE_8863_length_900_cov_5.962547	0	70	52	1	70	0.0142857
NODE_8863_length_900_cov_5.962547	0	70	58	10	70	0.1428571
NODE_8863_length_900_cov_5.962547	0	70	60	3	70	0.0428571
NODE_8863_length_900_cov_5.962547	0	70	62	21	70	0.3000000
NODE_8863_length_900_cov_5.962547	0	70	64	26	70	0.3714286
NODE_8863_length_900_cov_5.962547	43	108	28	1	65	0.0153846
NODE_8863_length_900_cov_5.962547	43	108	30	1	65	0.0153846
NODE_8863_length_900_cov_5.962547	43	108	32	1	65	0.0153846
NODE_8863_length_900_cov_5.962547	43	108	58	1	65	0.0153846
NODE_8863_length_900_cov_5.962547	43	108	60	2	65	0.0307692
NODE_8863_length_900_cov_5.962547	43	108	62	1	65	0.0153846
NODE_8863_length_900_cov_5.962547	43	108	64	58	65	0.8923077
NODE_8870_length_900_cov_2.521848	85	165	2	76	80	0.9500000
NODE_8870_length_900_cov_2.521848	85	165	4	4	80	0.0500000
NODE_8870_length_900_cov_2.521848	138	218	0	18	80	0.2250000
NODE_8870_length_900_cov_2.521848	138	218	2	62	80	0.7750000
NODE_8879_length_899_cov_45.853750	380	460	0	80	80	1.0000000
NODE_8879_length_899_cov_45.853750	433	516	0	68	83	0.8192771
NODE_8879_length_899_cov_45.853750	433	516	2	15	83	0.1807229
NODE_8880_length_899_cov_37.758750	381	461	0	33	80	0.4125000
NODE_8880_length_899_cov_37.758750	381	461	4	47	80	0.5875000
NODE_8880_length_899_cov_37.758750	434	514	0	80	80	1.0000000
NODE_8881_length_899_cov_27.362500	413	493	0	80	80	1.0000000
NODE_8881_length_899_cov_27.362500	466	546	0	80	80	1.0000000
NODE_8882_length_899_cov_20.563750	379	459	0	80	80	1.0000000
NODE_8882_length_899_cov_20.563750	432	507	0	37	75	0.4933333
NODE_8882_length_899_cov_20.563750	432	507	2	1	75	0.0133333
NODE_8882_length_899_cov_20.563750	432	507	4	37	75	0.4933333
NODE_8884_length_899_cov_17.130000	319	399	4	43	80	0.5375000
NODE_8884_length_899_cov_17.130000	319	399	6	37	80	0.4625000
NODE_8884_length_899_cov_17.130000	372	452	0	3	80	0.0375000
NODE_8884_length_899_cov_17.130000	372	452	2	47	80	0.5875000
NODE_8884_length_899_cov_17.130000	372	452	6	30	80	0.3750000
NODE_8885_length_899_cov_16.317500	270	350	8	38	80	0.4750000
NODE_8885_length_899_cov_16.317500	270	350	9	19	80	0.2375000
NODE_8885_length_899_cov_16.317500	270	350	10	23	80	0.2875000
NODE_8885_length_899_cov_16.317500	323	403	2	11	80	0.1375000
NODE_8885_length_899_cov_16.317500	323	403	9	61	80	0.7625000
NODE_8885_length_899_cov_16.317500	323	403	10	8	80	0.1000000
NODE_8886_length_899_cov_16.190000	284	364	0	12	80	0.1500000
NODE_8886_length_899_cov_16.190000	284	364	2	68	80	0.8500000
NODE_8886_length_899_cov_16.190000	337	417	0	65	80	0.8125000
NODE_8886_length_899_cov_16.190000	337	417	2	15	80	0.1875000
NODE_8887_length_899_cov_13.873750	317	397	0	80	80	1.0000000
NODE_8887_length_899_cov_13.873750	370	450	0	80	80	1.0000000
NODE_8888_length_899_cov_12.957500	240	320	0	14	80	0.1750000
NODE_8888_length_899_cov_12.957500	240	320	2	66	80	0.8250000
NODE_8888_length_899_cov_12.957500	293	373	0	25	80	0.3125000
NODE_8888_length_899_cov_12.957500	293	373	2	55	80	0.6875000
NODE_8889_length_899_cov_12.516250	387	467	2	67	80	0.8375000
NODE_8889_length_899_cov_12.516250	387	467	4	13	80	0.1625000
NODE_8889_length_899_cov_12.516250	440	520	0	37	80	0.4625000
NODE_8889_length_899_cov_12.516250	440	520	2	43	80	0.5375000
NODE_8890_length_899_cov_10.846250	348	428	0	80	80	1.0000000
NODE_8890_length_899_cov_10.846250	401	485	0	84	84	1.0000000
NODE_8891_length_899_cov_9.185000	347	427	0	80	80	1.0000000
NODE_8891_length_899_cov_9.185000	400	480	0	80	80	1.0000000
NODE_8892_length_899_cov_8.655000	498	578	0	33	80	0.4125000
NODE_8892_length_899_cov_8.655000	498	578	2	47	80	0.5875000
NODE_8892_length_899_cov_8.655000	551	631	0	16	80	0.2000000
NODE_8892_length_899_cov_8.655000	551	631	2	64	80	0.8000000
NODE_8893_length_899_cov_3.551250	0	54	8	1	54	0.0185185
NODE_8893_length_899_cov_3.551250	0	54	10	2	54	0.0370370
NODE_8893_length_899_cov_3.551250	0	54	12	2	54	0.0370370
NODE_8893_length_899_cov_3.551250	0	54	14	2	54	0.0370370
NODE_8893_length_899_cov_3.551250	0	54	16	15	54	0.2777778
NODE_8893_length_899_cov_3.551250	0	54	18	1	54	0.0185185
NODE_8893_length_899_cov_3.551250	0	54	20	1	54	0.0185185
NODE_8893_length_899_cov_3.551250	0	54	24	2	54	0.0370370
NODE_8893_length_899_cov_3.551250	0	54	26	4	54	0.0740741
NODE_8893_length_899_cov_3.551250	0	54	28	1	54	0.0185185
NODE_8893_length_899_cov_3.551250	0	54	30	11	54	0.2037037
NODE_8893_length_899_cov_3.551250	0	54	32	12	54	0.2222222
NODE_8893_length_899_cov_3.551250	27	107	26	3	80	0.0375000
NODE_8893_length_899_cov_3.551250	27	107	28	1	80	0.0125000
NODE_8893_length_899_cov_3.551250	27	107	30	11	80	0.1375000
NODE_8893_length_899_cov_3.551250	27	107	32	25	80	0.3125000
NODE_8893_length_899_cov_3.551250	27	107	34	8	80	0.1000000
NODE_8893_length_899_cov_3.551250	27	107	35	3	80	0.0375000
NODE_8893_length_899_cov_3.551250	27	107	36	3	80	0.0375000
NODE_8893_length_899_cov_3.551250	27	107	40	11	80	0.1375000
NODE_8893_length_899_cov_3.551250	27	107	42	15	80	0.1875000
NODE_8893_length_899_cov_3.551250	103	183	4	3	80	0.0375000
NODE_8893_length_899_cov_3.551250	103	183	6	1	80	0.0125000
NODE_8893_length_899_cov_3.551250	103	183	8	2	80	0.0250000
NODE_8893_length_899_cov_3.551250	103	183	12	16	80	0.2000000
NODE_8893_length_899_cov_3.551250	103	183	14	4	80	0.0500000
NODE_8893_length_899_cov_3.551250	103	183	16	1	80	0.0125000
NODE_8893_length_899_cov_3.551250	103	183	18	6	80	0.0750000
NODE_8893_length_899_cov_3.551250	103	183	22	1	80	0.0125000
NODE_8893_length_899_cov_3.551250	103	183	28	2	80	0.0250000
NODE_8893_length_899_cov_3.551250	103	183	32	11	80	0.1375000
NODE_8893_length_899_cov_3.551250	103	183	34	16	80	0.2000000
NODE_8893_length_899_cov_3.551250	103	183	36	3	80	0.0375000
NODE_8893_length_899_cov_3.551250	103	183	38	8	80	0.1000000
NODE_8893_length_899_cov_3.551250	103	183	40	2	80	0.0250000
NODE_8893_length_899_cov_3.551250	103	183	42	4	80	0.0500000
NODE_8893_length_899_cov_3.551250	156	179	8	2	23	0.0869565
NODE_8893_length_899_cov_3.551250	156	179	12	16	23	0.6956522
NODE_8893_length_899_cov_3.551250	156	179	14	4	23	0.1739130
NODE_8893_length_899_cov_3.551250	156	179	16	1	23	0.0434783
NODE_8914_length_898_cov_52.405507	299	379	0	2	80	0.0250000
NODE_8914_length_898_cov_52.405507	299	379	2	78	80	0.9750000
NODE_8914_length_898_cov_52.405507	352	432	0	55	80	0.6875000
NODE_8914_length_898_cov_52.405507	352	432	2	25	80	0.3125000
NODE_8914_length_898_cov_52.405507	428	508	0	80	80	1.0000000
NODE_8914_length_898_cov_52.405507	481	561	0	77	80	0.9625000
NODE_8914_length_898_cov_52.405507	481	561	2	3	80	0.0375000
NODE_8915_length_898_cov_44.973717	363	443	2	23	80	0.2875000
NODE_8915_length_898_cov_44.973717	363	443	4	23	80	0.2875000
NODE_8915_length_898_cov_44.973717	363	443	9	14	80	0.1750000
NODE_8915_length_898_cov_44.973717	363	443	10	20	80	0.2500000
NODE_8915_length_898_cov_44.973717	416	496	0	2	80	0.0250000
NODE_8915_length_898_cov_44.973717	416	496	6	13	80	0.1625000
NODE_8915_length_898_cov_44.973717	416	496	7	14	80	0.1750000
NODE_8915_length_898_cov_44.973717	416	496	9	38	80	0.4750000
NODE_8915_length_898_cov_44.973717	416	496	10	13	80	0.1625000
NODE_8916_length_898_cov_38.269086	425	505	0	29	80	0.3625000
NODE_8916_length_898_cov_38.269086	425	505	2	16	80	0.2000000
NODE_8916_length_898_cov_38.269086	425	505	4	35	80	0.4375000
NODE_8916_length_898_cov_38.269086	478	558	4	79	80	0.9875000
NODE_8916_length_898_cov_38.269086	478	558	6	1	80	0.0125000
NODE_8917_length_898_cov_27.006258	465	545	0	80	80	1.0000000
NODE_8917_length_898_cov_27.006258	518	598	0	80	80	1.0000000
NODE_8918_length_898_cov_25.902378	185	265	2	7	80	0.0875000
NODE_8918_length_898_cov_25.902378	185	265	9	71	80	0.8875000
NODE_8918_length_898_cov_25.902378	185	265	11	2	80	0.0250000
NODE_8918_length_898_cov_25.902378	238	318	2	11	80	0.1375000
NODE_8918_length_898_cov_25.902378	238	318	6	11	80	0.1375000
NODE_8918_length_898_cov_25.902378	238	318	8	32	80	0.4000000
NODE_8918_length_898_cov_25.902378	238	318	9	20	80	0.2500000
NODE_8918_length_898_cov_25.902378	238	318	10	6	80	0.0750000
NODE_8918_length_898_cov_25.902378	314	394	8	12	80	0.1500000
NODE_8918_length_898_cov_25.902378	314	394	10	48	80	0.6000000
NODE_8918_length_898_cov_25.902378	314	394	12	20	80	0.2500000
NODE_8918_length_898_cov_25.902378	367	447	4	8	80	0.1000000
NODE_8918_length_898_cov_25.902378	367	447	6	20	80	0.2500000
NODE_8918_length_898_cov_25.902378	367	447	7	1	80	0.0125000
NODE_8918_length_898_cov_25.902378	367	447	8	7	80	0.0875000
NODE_8918_length_898_cov_25.902378	367	447	10	5	80	0.0625000
NODE_8918_length_898_cov_25.902378	367	447	12	39	80	0.4875000
NODE_8919_length_898_cov_25.209011	368	448	0	9	80	0.1125000
NODE_8919_length_898_cov_25.209011	368	448	1	71	80	0.8875000
NODE_8919_length_898_cov_25.209011	421	501	1	75	80	0.9375000
NODE_8919_length_898_cov_25.209011	421	501	3	2	80	0.0250000
NODE_8919_length_898_cov_25.209011	421	501	5	3	80	0.0375000
NODE_8920_length_898_cov_21.923655	325	405	0	80	80	1.0000000
NODE_8920_length_898_cov_21.923655	378	458	0	42	80	0.5250000
NODE_8920_length_898_cov_21.923655	378	458	1	1	80	0.0125000
NODE_8920_length_898_cov_21.923655	378	458	2	37	80	0.4625000
NODE_8921_length_898_cov_21.065081	306	386	0	12	80	0.1500000
NODE_8921_length_898_cov_21.065081	306	386	2	35	80	0.4375000
NODE_8921_length_898_cov_21.065081	306	386	9	12	80	0.1500000
NODE_8921_length_898_cov_21.065081	306	386	11	21	80	0.2625000
NODE_8921_length_898_cov_21.065081	359	439	9	6	80	0.0750000
NODE_8921_length_898_cov_21.065081	359	439	11	27	80	0.3375000
NODE_8921_length_898_cov_21.065081	359	439	14	22	80	0.2750000
NODE_8921_length_898_cov_21.065081	359	439	15	6	80	0.0750000
NODE_8921_length_898_cov_21.065081	359	439	16	19	80	0.2375000
NODE_8922_length_898_cov_20.954944	374	454	4	80	80	1.0000000
NODE_8922_length_898_cov_20.954944	427	507	0	14	80	0.1750000
NODE_8922_length_898_cov_20.954944	427	507	4	66	80	0.8250000
NODE_8923_length_898_cov_17.387985	398	478	0	80	80	1.0000000
NODE_8923_length_898_cov_17.387985	451	531	0	80	80	1.0000000
NODE_8924_length_898_cov_17.252816	265	345	0	16	80	0.2000000
NODE_8924_length_898_cov_17.252816	265	345	2	64	80	0.8000000
NODE_8924_length_898_cov_17.252816	318	398	2	80	80	1.0000000
NODE_8926_length_898_cov_13.152691	455	535	0	31	80	0.3875000
NODE_8926_length_898_cov_13.152691	455	535	4	4	80	0.0500000
NODE_8926_length_898_cov_13.152691	455	535	6	45	80	0.5625000
NODE_8926_length_898_cov_13.152691	508	588	6	80	80	1.0000000
NODE_8927_length_898_cov_12.612015	375	455	3	7	80	0.0875000
NODE_8927_length_898_cov_12.612015	375	455	4	73	80	0.9125000
NODE_8927_length_898_cov_12.612015	428	508	0	4	80	0.0500000
NODE_8927_length_898_cov_12.612015	428	508	1	41	80	0.5125000
NODE_8927_length_898_cov_12.612015	428	508	3	15	80	0.1875000
NODE_8927_length_898_cov_12.612015	428	508	4	20	80	0.2500000
NODE_8928_length_898_cov_12.498123	428	508	0	22	80	0.2750000
NODE_8928_length_898_cov_12.498123	428	508	2	58	80	0.7250000
NODE_8928_length_898_cov_12.498123	481	561	0	25	80	0.3125000
NODE_8928_length_898_cov_12.498123	481	561	2	55	80	0.6875000
NODE_8932_length_898_cov_1.790989	0	56	0	37	56	0.6607143
NODE_8932_length_898_cov_1.790989	0	56	1	19	56	0.3392857
NODE_8932_length_898_cov_1.790989	29	93	0	8	64	0.1250000
NODE_8932_length_898_cov_1.790989	29	93	1	54	64	0.8437500
NODE_8932_length_898_cov_1.790989	29	93	5	2	64	0.0312500
NODE_8944_length_897_cov_63.921053	350	430	0	3	80	0.0375000
NODE_8944_length_897_cov_63.921053	350	430	2	7	80	0.0875000
NODE_8944_length_897_cov_63.921053	350	430	6	9	80	0.1125000
NODE_8944_length_897_cov_63.921053	350	430	7	29	80	0.3625000
NODE_8944_length_897_cov_63.921053	350	430	8	32	80	0.4000000
NODE_8944_length_897_cov_63.921053	403	483	0	56	80	0.7000000
NODE_8944_length_897_cov_63.921053	403	483	6	9	80	0.1125000
NODE_8944_length_897_cov_63.921053	403	483	7	15	80	0.1875000
NODE_8945_length_897_cov_58.921053	316	396	0	26	80	0.3250000
NODE_8945_length_897_cov_58.921053	316	396	22	1	80	0.0125000
NODE_8945_length_897_cov_58.921053	316	396	23	1	80	0.0125000
NODE_8945_length_897_cov_58.921053	316	396	24	1	80	0.0125000
NODE_8945_length_897_cov_58.921053	316	396	25	45	80	0.5625000
NODE_8945_length_897_cov_58.921053	316	396	29	6	80	0.0750000
NODE_8945_length_897_cov_58.921053	369	449	25	21	80	0.2625000
NODE_8945_length_897_cov_58.921053	369	449	29	59	80	0.7375000
NODE_8946_length_897_cov_35.946115	324	404	0	55	80	0.6875000
NODE_8946_length_897_cov_35.946115	324	404	2	25	80	0.3125000
NODE_8946_length_897_cov_35.946115	377	457	0	68	80	0.8500000
NODE_8946_length_897_cov_35.946115	377	457	2	12	80	0.1500000
NODE_8947_length_897_cov_25.548872	238	318	0	29	80	0.3625000
NODE_8947_length_897_cov_25.548872	238	318	2	51	80	0.6375000
NODE_8947_length_897_cov_25.548872	291	371	0	80	80	1.0000000
NODE_8948_length_897_cov_24.913534	399	479	0	10	80	0.1250000
NODE_8948_length_897_cov_24.913534	399	479	2	28	80	0.3500000
NODE_8948_length_897_cov_24.913534	399	479	4	34	80	0.4250000
NODE_8948_length_897_cov_24.913534	399	479	6	8	80	0.1000000
NODE_8948_length_897_cov_24.913534	452	532	0	8	80	0.1000000
NODE_8948_length_897_cov_24.913534	452	532	2	72	80	0.9000000
NODE_8949_length_897_cov_21.839599	308	388	0	32	80	0.4000000
NODE_8949_length_897_cov_21.839599	308	388	2	48	80	0.6000000
NODE_8949_length_897_cov_21.839599	361	441	0	37	80	0.4625000
NODE_8949_length_897_cov_21.839599	361	441	2	43	80	0.5375000
NODE_8950_length_897_cov_19.355890	489	569	0	38	80	0.4750000
NODE_8950_length_897_cov_19.355890	489	569	8	42	80	0.5250000
NODE_8950_length_897_cov_19.355890	542	622	8	80	80	1.0000000
NODE_8951_length_897_cov_16.295739	209	289	0	12	80	0.1500000
NODE_8951_length_897_cov_16.295739	209	289	16	4	80	0.0500000
NODE_8951_length_897_cov_16.295739	209	289	18	64	80	0.8000000
NODE_8951_length_897_cov_16.295739	262	342	16	19	80	0.2375000
NODE_8951_length_897_cov_16.295739	262	342	18	61	80	0.7625000
NODE_8952_length_897_cov_14.766917	395	475	0	80	80	1.0000000
NODE_8952_length_897_cov_14.766917	448	528	0	80	80	1.0000000
NODE_8953_length_897_cov_14.219298	253	333	0	80	80	1.0000000
NODE_8953_length_897_cov_14.219298	306	386	0	80	80	1.0000000
NODE_8954_length_897_cov_11.116541	182	262	0	80	80	1.0000000
NODE_8954_length_897_cov_11.116541	235	315	0	80	80	1.0000000
NODE_8955_length_897_cov_8.211779	303	383	0	80	80	1.0000000
NODE_8955_length_897_cov_8.211779	356	436	0	80	80	1.0000000
NODE_8973_length_896_cov_48.249686	397	477	0	80	80	1.0000000
NODE_8973_length_896_cov_48.249686	450	530	0	80	80	1.0000000
NODE_8974_length_896_cov_24.824341	213	293	0	80	80	1.0000000
NODE_8974_length_896_cov_24.824341	266	346	0	80	80	1.0000000
NODE_8975_length_896_cov_23.130489	333	413	0	59	80	0.7375000
NODE_8975_length_896_cov_23.130489	333	413	2	21	80	0.2625000
NODE_8975_length_896_cov_23.130489	386	466	0	6	80	0.0750000
NODE_8975_length_896_cov_23.130489	386	466	2	50	80	0.6250000
NODE_8975_length_896_cov_23.130489	386	466	4	24	80	0.3000000
NODE_8975_length_896_cov_23.130489	462	542	2	60	80	0.7500000
NODE_8975_length_896_cov_23.130489	462	542	4	20	80	0.2500000
NODE_8975_length_896_cov_23.130489	515	595	0	17	80	0.2125000
NODE_8975_length_896_cov_23.130489	515	595	2	63	80	0.7875000
NODE_8976_length_896_cov_20.673777	361	441	0	49	80	0.6125000
NODE_8976_length_896_cov_20.673777	361	441	2	31	80	0.3875000
NODE_8976_length_896_cov_20.673777	414	497	0	30	83	0.3614458
NODE_8976_length_896_cov_20.673777	414	497	2	53	83	0.6385542
NODE_8977_length_896_cov_18.979925	418	498	10	80	80	1.0000000
NODE_8977_length_896_cov_18.979925	471	551	0	51	80	0.6375000
NODE_8977_length_896_cov_18.979925	471	551	10	29	80	0.3625000
NODE_8978_length_896_cov_15.875784	340	420	0	16	80	0.2000000
NODE_8978_length_896_cov_15.875784	340	420	2	64	80	0.8000000
NODE_8978_length_896_cov_15.875784	393	473	0	5	80	0.0625000
NODE_8978_length_896_cov_15.875784	393	473	2	75	80	0.9375000
NODE_8980_length_896_cov_10.646173	337	417	2	80	80	1.0000000
NODE_8980_length_896_cov_10.646173	390	470	0	41	80	0.5125000
NODE_8980_length_896_cov_10.646173	390	470	2	39	80	0.4875000
NODE_8981_length_896_cov_10.351317	327	407	0	80	80	1.0000000
NODE_8981_length_896_cov_10.351317	380	460	0	80	80	1.0000000
NODE_8982_length_896_cov_9.754078	411	491	0	80	80	1.0000000
NODE_8982_length_896_cov_9.754078	464	544	0	80	80	1.0000000
NODE_8983_length_896_cov_8.069009	340	422	0	82	82	1.0000000
NODE_8983_length_896_cov_8.069009	395	475	0	80	80	1.0000000
NODE_8986_length_896_cov_4.939774	384	464	2	80	80	1.0000000
NODE_8986_length_896_cov_4.939774	437	517	0	27	80	0.3375000
NODE_8986_length_896_cov_4.939774	437	517	2	53	80	0.6625000
NODE_9005_length_895_cov_54.949749	378	458	2	42	80	0.5250000
NODE_9005_length_895_cov_54.949749	378	458	15	38	80	0.4750000
NODE_9005_length_895_cov_54.949749	431	511	13	16	80	0.2000000
NODE_9005_length_895_cov_54.949749	431	511	14	23	80	0.2875000
NODE_9005_length_895_cov_54.949749	431	511	15	41	80	0.5125000
NODE_9006_length_895_cov_53.945980	306	386	0	80	80	1.0000000
NODE_9006_length_895_cov_53.945980	359	439	0	80	80	1.0000000
NODE_9007_length_895_cov_48.915829	369	449	1	47	80	0.5875000
NODE_9007_length_895_cov_48.915829	369	449	3	4	80	0.0500000
NODE_9007_length_895_cov_48.915829	369	449	4	29	80	0.3625000
NODE_9007_length_895_cov_48.915829	422	502	2	23	80	0.2875000
NODE_9007_length_895_cov_48.915829	422	502	3	1	80	0.0125000
NODE_9007_length_895_cov_48.915829	422	502	4	56	80	0.7000000
NODE_9007_length_895_cov_48.915829	498	578	2	38	80	0.4750000
NODE_9007_length_895_cov_48.915829	498	578	4	26	80	0.3250000
NODE_9007_length_895_cov_48.915829	498	578	5	9	80	0.1125000
NODE_9007_length_895_cov_48.915829	498	578	6	7	80	0.0875000
NODE_9007_length_895_cov_48.915829	551	631	4	51	80	0.6375000
NODE_9007_length_895_cov_48.915829	551	631	5	11	80	0.1375000
NODE_9007_length_895_cov_48.915829	551	631	6	18	80	0.2250000
NODE_9008_length_895_cov_38.347990	452	532	3	48	80	0.6000000
NODE_9008_length_895_cov_38.347990	452	532	11	32	80	0.4000000
NODE_9008_length_895_cov_38.347990	505	585	8	5	80	0.0625000
NODE_9008_length_895_cov_38.347990	505	585	9	16	80	0.2000000
NODE_9008_length_895_cov_38.347990	505	585	10	11	80	0.1375000
NODE_9008_length_895_cov_38.347990	505	585	11	48	80	0.6000000
NODE_9009_length_895_cov_33.716080	418	499	0	81	81	1.0000000
NODE_9009_length_895_cov_33.716080	472	552	0	47	80	0.5875000
NODE_9009_length_895_cov_33.716080	472	552	2	33	80	0.4125000
NODE_9010_length_895_cov_21.630653	392	468	0	76	76	1.0000000
NODE_9010_length_895_cov_21.630653	441	521	0	80	80	1.0000000
NODE_9011_length_895_cov_19.932161	331	411	0	13	80	0.1625000
NODE_9011_length_895_cov_19.932161	331	411	2	43	80	0.5375000
NODE_9011_length_895_cov_19.932161	331	411	4	24	80	0.3000000
NODE_9011_length_895_cov_19.932161	384	464	2	56	80	0.7000000
NODE_9011_length_895_cov_19.932161	384	464	4	24	80	0.3000000
NODE_9011_length_895_cov_19.932161	460	540	0	68	80	0.8500000
NODE_9011_length_895_cov_19.932161	460	540	2	12	80	0.1500000
NODE_9011_length_895_cov_19.932161	513	593	0	80	80	1.0000000
NODE_9012_length_895_cov_16.037688	403	479	0	23	76	0.3026316
NODE_9012_length_895_cov_16.037688	403	479	4	6	76	0.0789474
NODE_9012_length_895_cov_16.037688	403	479	6	47	76	0.6184211
NODE_9012_length_895_cov_16.037688	452	532	4	27	80	0.3375000
NODE_9012_length_895_cov_16.037688	452	532	6	53	80	0.6625000
NODE_9013_length_895_cov_13.003769	372	452	0	80	80	1.0000000
NODE_9013_length_895_cov_13.003769	425	491	0	66	66	1.0000000
NODE_9014_length_895_cov_12.736181	280	360	0	80	80	1.0000000
NODE_9014_length_895_cov_12.736181	333	413	0	80	80	1.0000000
NODE_9015_length_895_cov_11.090452	505	585	0	80	80	1.0000000
NODE_9015_length_895_cov_11.090452	558	638	0	80	80	1.0000000
NODE_9016_length_895_cov_9.266332	468	548	0	80	80	1.0000000
NODE_9016_length_895_cov_9.266332	521	601	0	80	80	1.0000000
NODE_9018_length_895_cov_5.659548	472	552	0	80	80	1.0000000
NODE_9018_length_895_cov_5.659548	525	605	0	80	80	1.0000000
NODE_9019_length_895_cov_5.383166	42	123	0	2	81	0.0246914
NODE_9019_length_895_cov_5.383166	42	123	2	2	81	0.0246914
NODE_9019_length_895_cov_5.383166	42	123	4	77	81	0.9506173
NODE_9030_length_894_cov_60.153459	446	526	0	80	80	1.0000000
NODE_9030_length_894_cov_60.153459	499	579	0	80	80	1.0000000
NODE_9031_length_894_cov_49.618868	373	453	0	80	80	1.0000000
NODE_9031_length_894_cov_49.618868	426	506	0	80	80	1.0000000
NODE_9032_length_894_cov_33.228931	459	539	0	80	80	1.0000000
NODE_9032_length_894_cov_33.228931	512	592	0	80	80	1.0000000
NODE_9033_length_894_cov_31.933333	411	491	0	30	80	0.3750000
NODE_9033_length_894_cov_31.933333	411	491	2	7	80	0.0875000
NODE_9033_length_894_cov_31.933333	411	491	6	43	80	0.5375000
NODE_9033_length_894_cov_31.933333	464	544	0	17	80	0.2125000
NODE_9033_length_894_cov_31.933333	464	544	2	3	80	0.0375000
NODE_9033_length_894_cov_31.933333	464	544	5	6	80	0.0750000
NODE_9033_length_894_cov_31.933333	464	544	6	54	80	0.6750000
NODE_9034_length_894_cov_30.499371	270	350	0	80	80	1.0000000
NODE_9034_length_894_cov_30.499371	323	403	0	80	80	1.0000000
NODE_9034_length_894_cov_30.499371	399	479	0	80	80	1.0000000
NODE_9034_length_894_cov_30.499371	452	532	0	79	80	0.9875000
NODE_9034_length_894_cov_30.499371	452	532	2	1	80	0.0125000
NODE_9035_length_894_cov_23.046541	79	159	0	25	80	0.3125000
NODE_9035_length_894_cov_23.046541	79	159	2	55	80	0.6875000
NODE_9035_length_894_cov_23.046541	132	212	0	50	80	0.6250000
NODE_9035_length_894_cov_23.046541	132	212	2	30	80	0.3750000
NODE_9036_length_894_cov_22.266667	381	461	0	80	80	1.0000000
NODE_9036_length_894_cov_22.266667	434	514	0	80	80	1.0000000
NODE_9037_length_894_cov_21.997484	332	412	0	80	80	1.0000000
NODE_9037_length_894_cov_21.997484	385	465	0	80	80	1.0000000
NODE_9038_length_894_cov_21.205031	319	399	0	51	80	0.6375000
NODE_9038_length_894_cov_21.205031	319	399	2	29	80	0.3625000
NODE_9038_length_894_cov_21.205031	372	452	2	80	80	1.0000000
NODE_9038_length_894_cov_21.205031	448	528	0	64	80	0.8000000
NODE_9038_length_894_cov_21.205031	448	528	2	16	80	0.2000000
NODE_9038_length_894_cov_21.205031	501	581	0	80	80	1.0000000
NODE_9039_length_894_cov_21.132075	422	502	0	80	80	1.0000000
NODE_9039_length_894_cov_21.132075	475	555	0	80	80	1.0000000
NODE_9040_length_894_cov_15.598742	338	418	0	37	80	0.4625000
NODE_9040_length_894_cov_15.598742	338	418	2	43	80	0.5375000
NODE_9040_length_894_cov_15.598742	391	471	0	80	80	1.0000000
NODE_9041_length_894_cov_14.079245	344	424	2	46	80	0.5750000
NODE_9041_length_894_cov_14.079245	344	424	4	34	80	0.4250000
NODE_9041_length_894_cov_14.079245	397	477	0	11	80	0.1375000
NODE_9041_length_894_cov_14.079245	397	477	2	69	80	0.8625000
NODE_9042_length_894_cov_13.031447	336	416	0	80	80	1.0000000
NODE_9042_length_894_cov_13.031447	389	469	0	80	80	1.0000000
NODE_9043_length_894_cov_13.031447	353	433	0	80	80	1.0000000
NODE_9043_length_894_cov_13.031447	406	486	0	80	80	1.0000000
NODE_9044_length_894_cov_9.706918	330	410	10	80	80	1.0000000
NODE_9045_length_894_cov_6.963522	378	458	0	80	80	1.0000000
NODE_9045_length_894_cov_6.963522	431	511	0	80	80	1.0000000
NODE_9046_length_894_cov_4.993711	365	445	0	80	80	1.0000000
NODE_9046_length_894_cov_4.993711	418	498	0	80	80	1.0000000
NODE_9066_length_893_cov_59.134761	261	341	1	80	80	1.0000000
NODE_9066_length_893_cov_59.134761	314	394	1	37	80	0.4625000
NODE_9066_length_893_cov_59.134761	314	394	8	13	80	0.1625000
NODE_9066_length_893_cov_59.134761	314	394	9	30	80	0.3750000
NODE_9067_length_893_cov_58.991184	388	468	0	2	80	0.0250000
NODE_9067_length_893_cov_58.991184	388	468	4	12	80	0.1500000
NODE_9067_length_893_cov_58.991184	388	468	6	36	80	0.4500000
NODE_9067_length_893_cov_58.991184	388	468	8	30	80	0.3750000
NODE_9067_length_893_cov_58.991184	441	521	6	26	80	0.3250000
NODE_9067_length_893_cov_58.991184	441	521	8	54	80	0.6750000
NODE_9067_length_893_cov_58.991184	517	597	0	44	80	0.5500000
NODE_9067_length_893_cov_58.991184	517	597	2	23	80	0.2875000
NODE_9067_length_893_cov_58.991184	517	597	6	13	80	0.1625000
NODE_9067_length_893_cov_58.991184	570	650	0	80	80	1.0000000
NODE_9068_length_893_cov_55.644836	434	514	0	80	80	1.0000000
NODE_9068_length_893_cov_55.644836	487	567	0	68	80	0.8500000
NODE_9068_length_893_cov_55.644836	487	567	25	2	80	0.0250000
NODE_9068_length_893_cov_55.644836	487	567	26	10	80	0.1250000
NODE_9068_length_893_cov_55.644836	563	643	26	18	80	0.2250000
NODE_9068_length_893_cov_55.644836	563	643	27	6	80	0.0750000
NODE_9068_length_893_cov_55.644836	563	643	28	16	80	0.2000000
NODE_9068_length_893_cov_55.644836	563	643	29	18	80	0.2250000
NODE_9068_length_893_cov_55.644836	563	643	30	22	80	0.2750000
NODE_9068_length_893_cov_55.644836	616	696	0	10	80	0.1250000
NODE_9068_length_893_cov_55.644836	616	696	29	5	80	0.0625000
NODE_9068_length_893_cov_55.644836	616	696	30	65	80	0.8125000
NODE_9069_length_893_cov_54.803526	479	559	2	73	80	0.9125000
NODE_9069_length_893_cov_54.803526	479	559	4	2	80	0.0250000
NODE_9069_length_893_cov_54.803526	479	559	6	5	80	0.0625000
NODE_9069_length_893_cov_54.803526	532	612	2	20	80	0.2500000
NODE_9069_length_893_cov_54.803526	532	612	4	54	80	0.6750000
NODE_9069_length_893_cov_54.803526	532	612	6	6	80	0.0750000
NODE_9070_length_893_cov_38.147355	391	471	0	80	80	1.0000000
NODE_9070_length_893_cov_38.147355	444	524	0	80	80	1.0000000
NODE_9071_length_893_cov_33.690176	387	467	2	59	80	0.7375000
NODE_9071_length_893_cov_33.690176	387	467	4	21	80	0.2625000
NODE_9071_length_893_cov_33.690176	440	520	0	30	80	0.3750000
NODE_9071_length_893_cov_33.690176	440	520	2	50	80	0.6250000
NODE_9072_length_893_cov_32.162469	524	604	0	11	80	0.1375000
NODE_9072_length_893_cov_32.162469	524	604	1	6	80	0.0750000
NODE_9072_length_893_cov_32.162469	524	604	2	63	80	0.7875000
NODE_9072_length_893_cov_32.162469	577	657	2	80	80	1.0000000
NODE_9073_length_893_cov_31.916877	344	424	0	20	80	0.2500000
NODE_9073_length_893_cov_31.916877	344	424	2	12	80	0.1500000
NODE_9073_length_893_cov_31.916877	344	424	3	22	80	0.2750000
NODE_9073_length_893_cov_31.916877	344	424	5	10	80	0.1250000
NODE_9073_length_893_cov_31.916877	344	424	6	16	80	0.2000000
NODE_9073_length_893_cov_31.916877	397	477	2	3	80	0.0375000
NODE_9073_length_893_cov_31.916877	397	477	3	1	80	0.0125000
NODE_9073_length_893_cov_31.916877	397	477	4	23	80	0.2875000
NODE_9073_length_893_cov_31.916877	397	477	5	10	80	0.1250000
NODE_9073_length_893_cov_31.916877	397	477	6	43	80	0.5375000
NODE_9074_length_893_cov_28.693955	437	517	0	26	80	0.3250000
NODE_9074_length_893_cov_28.693955	437	517	2	54	80	0.6750000
NODE_9074_length_893_cov_28.693955	490	570	0	79	80	0.9875000
NODE_9074_length_893_cov_28.693955	490	570	2	1	80	0.0125000
NODE_9075_length_893_cov_23.564232	363	443	0	33	80	0.4125000
NODE_9075_length_893_cov_23.564232	363	443	2	47	80	0.5875000
NODE_9075_length_893_cov_23.564232	416	496	0	80	80	1.0000000
NODE_9076_length_893_cov_22.633501	272	352	8	17	80	0.2125000
NODE_9076_length_893_cov_22.633501	272	352	22	63	80	0.7875000
NODE_9076_length_893_cov_22.633501	272	352	8	17	80	0.2125000
NODE_9076_length_893_cov_22.633501	272	352	22	63	80	0.7875000
NODE_9076_length_893_cov_22.633501	272	352	8	17	80	0.2125000
NODE_9076_length_893_cov_22.633501	272	352	22	63	80	0.7875000
NODE_9076_length_893_cov_22.633501	325	405	14	16	80	0.2000000
NODE_9076_length_893_cov_22.633501	325	405	16	35	80	0.4375000
NODE_9076_length_893_cov_22.633501	325	405	21	1	80	0.0125000
NODE_9076_length_893_cov_22.633501	325	405	22	28	80	0.3500000
NODE_9076_length_893_cov_22.633501	325	405	14	16	80	0.2000000
NODE_9076_length_893_cov_22.633501	325	405	16	35	80	0.4375000
NODE_9076_length_893_cov_22.633501	325	405	21	1	80	0.0125000
NODE_9076_length_893_cov_22.633501	325	405	22	28	80	0.3500000
NODE_9076_length_893_cov_22.633501	325	405	14	16	80	0.2000000
NODE_9076_length_893_cov_22.633501	325	405	16	35	80	0.4375000
NODE_9076_length_893_cov_22.633501	325	405	21	1	80	0.0125000
NODE_9076_length_893_cov_22.633501	325	405	22	28	80	0.3500000
NODE_9076_length_893_cov_22.633501	401	481	0	6	80	0.0750000
NODE_9076_length_893_cov_22.633501	401	481	2	69	80	0.8625000
NODE_9076_length_893_cov_22.633501	401	481	16	5	80	0.0625000
NODE_9076_length_893_cov_22.633501	454	534	0	59	80	0.7375000
NODE_9076_length_893_cov_22.633501	454	534	2	21	80	0.2625000
NODE_9077_length_893_cov_22.403023	453	533	14	3	80	0.0375000
NODE_9077_length_893_cov_22.403023	453	533	16	44	80	0.5500000
NODE_9077_length_893_cov_22.403023	453	533	18	33	80	0.4125000
NODE_9077_length_893_cov_22.403023	506	586	0	15	80	0.1875000
NODE_9077_length_893_cov_22.403023	506	586	2	12	80	0.1500000
NODE_9077_length_893_cov_22.403023	506	586	4	2	80	0.0250000
NODE_9077_length_893_cov_22.403023	506	586	13	1	80	0.0125000
NODE_9077_length_893_cov_22.403023	506	586	14	26	80	0.3250000
NODE_9077_length_893_cov_22.403023	506	586	18	24	80	0.3000000
NODE_9078_length_893_cov_19.423174	298	378	0	6	80	0.0750000
NODE_9078_length_893_cov_19.423174	298	378	2	37	80	0.4625000
NODE_9078_length_893_cov_19.423174	298	378	4	37	80	0.4625000
NODE_9078_length_893_cov_19.423174	351	431	0	7	80	0.0875000
NODE_9078_length_893_cov_19.423174	351	431	2	65	80	0.8125000
NODE_9078_length_893_cov_19.423174	351	431	4	8	80	0.1000000
NODE_9078_length_893_cov_19.423174	427	507	0	55	80	0.6875000
NODE_9078_length_893_cov_19.423174	427	507	2	25	80	0.3125000
NODE_9078_length_893_cov_19.423174	480	560	0	2	80	0.0250000
NODE_9078_length_893_cov_19.423174	480	560	2	28	80	0.3500000
NODE_9078_length_893_cov_19.423174	480	560	8	7	80	0.0875000
NODE_9078_length_893_cov_19.423174	480	560	10	6	80	0.0750000
NODE_9078_length_893_cov_19.423174	480	560	12	17	80	0.2125000
NODE_9078_length_893_cov_19.423174	480	560	14	20	80	0.2500000
NODE_9079_length_893_cov_19.389169	360	440	2	39	80	0.4875000
NODE_9079_length_893_cov_19.389169	360	440	6	41	80	0.5125000
NODE_9079_length_893_cov_19.389169	413	493	0	2	80	0.0250000
NODE_9079_length_893_cov_19.389169	413	493	4	13	80	0.1625000
NODE_9079_length_893_cov_19.389169	413	493	5	12	80	0.1500000
NODE_9079_length_893_cov_19.389169	413	493	6	53	80	0.6625000
NODE_9079_length_893_cov_19.389169	489	569	0	32	80	0.4000000
NODE_9079_length_893_cov_19.389169	489	569	2	46	80	0.5750000
NODE_9079_length_893_cov_19.389169	489	569	4	2	80	0.0250000
NODE_9079_length_893_cov_19.389169	542	622	2	59	80	0.7375000
NODE_9079_length_893_cov_19.389169	542	622	4	21	80	0.2625000
NODE_9080_length_893_cov_18.152393	394	474	0	16	80	0.2000000
NODE_9080_length_893_cov_18.152393	394	474	2	4	80	0.0500000
NODE_9080_length_893_cov_18.152393	394	474	8	49	80	0.6125000
NODE_9080_length_893_cov_18.152393	394	474	9	1	80	0.0125000
NODE_9080_length_893_cov_18.152393	394	474	10	10	80	0.1250000
NODE_9080_length_893_cov_18.152393	447	527	0	69	80	0.8625000
NODE_9080_length_893_cov_18.152393	447	527	2	4	80	0.0500000
NODE_9080_length_893_cov_18.152393	447	527	8	7	80	0.0875000
NODE_9081_length_893_cov_15.960957	442	522	1	56	80	0.7000000
NODE_9081_length_893_cov_15.960957	442	522	3	24	80	0.3000000
NODE_9081_length_893_cov_15.960957	495	575	1	3	80	0.0375000
NODE_9081_length_893_cov_15.960957	495	575	2	51	80	0.6375000
NODE_9081_length_893_cov_15.960957	495	575	3	26	80	0.3250000
NODE_9082_length_893_cov_13.119647	473	553	0	80	80	1.0000000
NODE_9082_length_893_cov_13.119647	526	606	0	80	80	1.0000000
NODE_9084_length_893_cov_5.549118	353	415	0	53	62	0.8548387
NODE_9084_length_893_cov_5.549118	353	415	2	9	62	0.1451613
NODE_9100_length_893_cov_1.141058	28	108	4	18	80	0.2250000
NODE_9100_length_893_cov_1.141058	28	108	6	62	80	0.7750000
NODE_9104_length_892_cov_74.968474	333	413	0	80	80	1.0000000
NODE_9104_length_892_cov_74.968474	386	466	0	80	80	1.0000000
NODE_9104_length_892_cov_74.968474	462	542	0	80	80	1.0000000
NODE_9104_length_892_cov_74.968474	515	595	0	80	80	1.0000000
NODE_9105_length_892_cov_54.549811	463	550	0	87	87	1.0000000
NODE_9105_length_892_cov_54.549811	523	603	0	74	80	0.9250000
NODE_9105_length_892_cov_54.549811	523	603	2	6	80	0.0750000
NODE_9105_length_892_cov_54.549811	599	679	2	80	80	1.0000000
NODE_9106_length_892_cov_37.887768	373	453	0	1	80	0.0125000
NODE_9106_length_892_cov_37.887768	373	453	2	40	80	0.5000000
NODE_9106_length_892_cov_37.887768	373	453	5	1	80	0.0125000
NODE_9106_length_892_cov_37.887768	373	453	6	8	80	0.1000000
NODE_9106_length_892_cov_37.887768	373	453	7	18	80	0.2250000
NODE_9106_length_892_cov_37.887768	373	453	8	12	80	0.1500000
NODE_9106_length_892_cov_37.887768	426	506	6	58	80	0.7250000
NODE_9106_length_892_cov_37.887768	426	506	7	10	80	0.1250000
NODE_9106_length_892_cov_37.887768	426	506	8	12	80	0.1500000
NODE_9107_length_892_cov_19.732661	361	441	0	80	80	1.0000000
NODE_9107_length_892_cov_19.732661	414	494	0	80	80	1.0000000
NODE_9108_length_892_cov_19.052963	290	370	0	14	80	0.1750000
NODE_9108_length_892_cov_19.052963	290	370	2	27	80	0.3375000
NODE_9108_length_892_cov_19.052963	290	370	4	39	80	0.4875000
NODE_9108_length_892_cov_19.052963	343	423	2	16	80	0.2000000
NODE_9108_length_892_cov_19.052963	343	423	4	35	80	0.4375000
NODE_9108_length_892_cov_19.052963	343	423	6	29	80	0.3625000
NODE_9108_length_892_cov_19.052963	419	499	0	31	80	0.3875000
NODE_9108_length_892_cov_19.052963	419	499	2	43	80	0.5375000
NODE_9108_length_892_cov_19.052963	419	499	3	6	80	0.0750000
NODE_9108_length_892_cov_19.052963	472	552	0	10	80	0.1250000
NODE_9108_length_892_cov_19.052963	472	552	2	11	80	0.1375000
NODE_9108_length_892_cov_19.052963	472	552	3	20	80	0.2500000
NODE_9108_length_892_cov_19.052963	472	552	5	12	80	0.1500000
NODE_9108_length_892_cov_19.052963	472	552	6	27	80	0.3375000
NODE_9109_length_892_cov_17.276166	341	421	0	46	80	0.5750000
NODE_9109_length_892_cov_17.276166	341	421	2	34	80	0.4250000
NODE_9109_length_892_cov_17.276166	394	474	0	18	80	0.2250000
NODE_9109_length_892_cov_17.276166	394	474	2	62	80	0.7750000
NODE_9110_length_892_cov_16.312736	411	491	1	14	80	0.1750000
NODE_9110_length_892_cov_16.312736	411	491	2	1	80	0.0125000
NODE_9110_length_892_cov_16.312736	411	491	3	65	80	0.8125000
NODE_9110_length_892_cov_16.312736	464	544	1	14	80	0.1750000
NODE_9110_length_892_cov_16.312736	464	544	2	21	80	0.2625000
NODE_9110_length_892_cov_16.312736	464	544	3	12	80	0.1500000
NODE_9110_length_892_cov_16.312736	464	544	4	33	80	0.4125000
NODE_9111_length_892_cov_15.808323	395	475	0	80	80	1.0000000
NODE_9111_length_892_cov_15.808323	448	528	0	80	80	1.0000000
NODE_9112_length_892_cov_14.020177	522	602	0	80	80	1.0000000
NODE_9112_length_892_cov_14.020177	575	655	0	80	80	1.0000000
NODE_9114_length_892_cov_8.798235	400	480	0	80	80	1.0000000
NODE_9114_length_892_cov_8.798235	453	533	0	80	80	1.0000000
NODE_9115_length_892_cov_8.413619	428	508	0	80	80	1.0000000
NODE_9115_length_892_cov_8.413619	481	561	0	80	80	1.0000000
NODE_9116_length_892_cov_6.694830	374	454	0	53	80	0.6625000
NODE_9116_length_892_cov_6.694830	374	454	2	27	80	0.3375000
NODE_9116_length_892_cov_6.694830	427	507	0	5	80	0.0625000
NODE_9116_length_892_cov_6.694830	427	507	2	75	80	0.9375000
NODE_9134_length_891_cov_30.166667	295	375	0	45	80	0.5625000
NODE_9134_length_891_cov_30.166667	295	375	4	35	80	0.4375000
NODE_9134_length_891_cov_30.166667	348	428	0	21	80	0.2625000
NODE_9134_length_891_cov_30.166667	348	428	4	59	80	0.7375000
NODE_9135_length_891_cov_26.333333	319	399	0	80	80	1.0000000
NODE_9135_length_891_cov_26.333333	372	452	0	80	80	1.0000000
NODE_9136_length_891_cov_22.228535	336	416	0	80	80	1.0000000
NODE_9136_length_891_cov_22.228535	389	469	0	80	80	1.0000000
NODE_9137_length_891_cov_20.446970	377	457	12	53	80	0.6625000
NODE_9137_length_891_cov_20.446970	377	457	14	27	80	0.3375000
NODE_9137_length_891_cov_20.446970	430	510	0	4	80	0.0500000
NODE_9137_length_891_cov_20.446970	430	510	8	7	80	0.0875000
NODE_9137_length_891_cov_20.446970	430	510	12	4	80	0.0500000
NODE_9137_length_891_cov_20.446970	430	510	14	65	80	0.8125000
NODE_9138_length_891_cov_20.226010	310	390	0	80	80	1.0000000
NODE_9138_length_891_cov_20.226010	363	443	0	80	80	1.0000000
NODE_9140_length_891_cov_13.207071	392	472	0	47	80	0.5875000
NODE_9140_length_891_cov_13.207071	392	472	6	33	80	0.4125000
NODE_9140_length_891_cov_13.207071	445	525	6	80	80	1.0000000
NODE_9141_length_891_cov_11.579545	379	459	0	80	80	1.0000000
NODE_9141_length_891_cov_11.579545	432	512	0	80	80	1.0000000
NODE_9142_length_891_cov_11.117424	499	579	0	80	80	1.0000000
NODE_9142_length_891_cov_11.117424	552	632	0	80	80	1.0000000
NODE_9153_length_890_cov_29.070796	284	364	0	22	80	0.2750000
NODE_9153_length_890_cov_29.070796	284	364	1	3	80	0.0375000
NODE_9153_length_890_cov_29.070796	284	364	2	55	80	0.6875000
NODE_9153_length_890_cov_29.070796	337	417	0	17	80	0.2125000
NODE_9153_length_890_cov_29.070796	337	417	2	63	80	0.7875000
NODE_9153_length_890_cov_29.070796	413	497	0	84	84	1.0000000
NODE_9153_length_890_cov_29.070796	470	550	0	80	80	1.0000000
NODE_9154_length_890_cov_27.295828	550	630	0	80	80	1.0000000
NODE_9154_length_890_cov_27.295828	603	683	0	80	80	1.0000000
NODE_9155_length_890_cov_18.088496	80	135	0	55	55	1.0000000
NODE_9155_length_890_cov_18.088496	276	356	2	29	80	0.3625000
NODE_9155_length_890_cov_18.088496	276	356	4	51	80	0.6375000
NODE_9155_length_890_cov_18.088496	329	406	2	16	77	0.2077922
NODE_9155_length_890_cov_18.088496	329	406	4	61	77	0.7922078
NODE_9156_length_890_cov_16.831858	402	482	2	28	80	0.3500000
NODE_9156_length_890_cov_16.831858	402	482	4	26	80	0.3250000
NODE_9156_length_890_cov_16.831858	402	482	8	12	80	0.1500000
NODE_9156_length_890_cov_16.831858	402	482	12	14	80	0.1750000
NODE_9156_length_890_cov_16.831858	455	535	4	1	80	0.0125000
NODE_9156_length_890_cov_16.831858	455	535	8	12	80	0.1500000
NODE_9156_length_890_cov_16.831858	455	535	10	46	80	0.5750000
NODE_9156_length_890_cov_16.831858	455	535	12	21	80	0.2625000
NODE_9157_length_890_cov_11.881163	222	302	0	80	80	1.0000000
NODE_9157_length_890_cov_11.881163	275	355	0	42	80	0.5250000
NODE_9157_length_890_cov_11.881163	275	355	1	2	80	0.0250000
NODE_9157_length_890_cov_11.881163	275	355	2	36	80	0.4500000
NODE_9158_length_890_cov_8.676359	335	415	0	63	80	0.7875000
NODE_9158_length_890_cov_8.676359	335	415	2	17	80	0.2125000
NODE_9158_length_890_cov_8.676359	388	468	0	10	80	0.1250000
NODE_9158_length_890_cov_8.676359	388	468	2	70	80	0.8750000
NODE_9183_length_889_cov_61.520253	334	414	1	80	80	1.0000000
NODE_9183_length_889_cov_61.520253	387	467	0	28	80	0.3500000
NODE_9183_length_889_cov_61.520253	387	467	1	42	80	0.5250000
NODE_9183_length_889_cov_61.520253	387	467	4	10	80	0.1250000
NODE_9183_length_889_cov_61.520253	463	543	4	4	80	0.0500000
NODE_9183_length_889_cov_61.520253	463	543	5	26	80	0.3250000
NODE_9183_length_889_cov_61.520253	463	543	9	50	80	0.6250000
NODE_9183_length_889_cov_61.520253	516	596	5	43	80	0.5375000
NODE_9183_length_889_cov_61.520253	516	596	9	37	80	0.4625000
NODE_9184_length_889_cov_30.012658	311	391	0	80	80	1.0000000
NODE_9184_length_889_cov_30.012658	364	444	0	80	80	1.0000000
NODE_9185_length_889_cov_28.217722	413	483	0	4	70	0.0571429
NODE_9185_length_889_cov_28.217722	413	483	12	47	70	0.6714286
NODE_9185_length_889_cov_28.217722	413	483	14	19	70	0.2714286
NODE_9185_length_889_cov_28.217722	466	542	14	76	76	1.0000000
NODE_9186_length_889_cov_27.924051	379	449	0	70	70	1.0000000
NODE_9186_length_889_cov_27.924051	432	512	0	80	80	1.0000000
NODE_9187_length_889_cov_25.887342	227	285	2	4	58	0.0689655
NODE_9187_length_889_cov_25.887342	227	285	4	10	58	0.1724138
NODE_9187_length_889_cov_25.887342	227	285	6	44	58	0.7586207
NODE_9187_length_889_cov_25.887342	258	337	4	62	79	0.7848101
NODE_9187_length_889_cov_25.887342	258	337	6	17	79	0.2151899
NODE_9188_length_889_cov_22.992405	451	531	8	80	80	1.0000000
NODE_9188_length_889_cov_22.992405	504	584	0	38	80	0.4750000
NODE_9188_length_889_cov_22.992405	504	584	8	42	80	0.5250000
NODE_9189_length_889_cov_20.703797	331	411	0	80	80	1.0000000
NODE_9189_length_889_cov_20.703797	384	464	0	80	80	1.0000000
NODE_9190_length_889_cov_20.226582	234	314	0	18	80	0.2250000
NODE_9190_length_889_cov_20.226582	234	314	2	62	80	0.7750000
NODE_9190_length_889_cov_20.226582	287	367	0	71	80	0.8875000
NODE_9190_length_889_cov_20.226582	287	367	2	9	80	0.1125000
NODE_9191_length_889_cov_15.587342	407	487	0	80	80	1.0000000
NODE_9191_length_889_cov_15.587342	460	540	0	60	80	0.7500000
NODE_9191_length_889_cov_15.587342	460	540	2	20	80	0.2500000
NODE_9192_length_889_cov_12.669620	313	393	0	2	80	0.0250000
NODE_9192_length_889_cov_12.669620	313	393	1	5	80	0.0625000
NODE_9192_length_889_cov_12.669620	313	393	2	31	80	0.3875000
NODE_9192_length_889_cov_12.669620	313	393	6	12	80	0.1500000
NODE_9192_length_889_cov_12.669620	313	393	8	30	80	0.3750000
NODE_9192_length_889_cov_12.669620	366	446	8	80	80	1.0000000
NODE_9193_length_889_cov_12.198734	399	479	0	6	80	0.0750000
NODE_9193_length_889_cov_12.198734	399	479	2	6	80	0.0750000
NODE_9193_length_889_cov_12.198734	399	479	4	3	80	0.0375000
NODE_9193_length_889_cov_12.198734	399	479	6	65	80	0.8125000
NODE_9193_length_889_cov_12.198734	452	532	0	53	80	0.6625000
NODE_9193_length_889_cov_12.198734	452	532	4	3	80	0.0375000
NODE_9193_length_889_cov_12.198734	452	532	6	24	80	0.3000000
NODE_9197_length_889_cov_3.841772	187	267	0	80	80	1.0000000
NODE_9197_length_889_cov_3.841772	240	320	0	80	80	1.0000000
NODE_9213_length_888_cov_37.102662	490	570	0	80	80	1.0000000
NODE_9213_length_888_cov_37.102662	543	623	0	80	80	1.0000000
NODE_9214_length_888_cov_28.230672	366	446	0	71	80	0.8875000
NODE_9214_length_888_cov_28.230672	366	446	6	9	80	0.1125000
NODE_9214_length_888_cov_28.230672	419	499	0	18	80	0.2250000
NODE_9214_length_888_cov_28.230672	419	499	6	62	80	0.7750000
NODE_9215_length_888_cov_25.243346	391	471	1	22	80	0.2750000
NODE_9215_length_888_cov_25.243346	391	471	4	1	80	0.0125000
NODE_9215_length_888_cov_25.243346	391	471	5	1	80	0.0125000
NODE_9215_length_888_cov_25.243346	391	471	6	4	80	0.0500000
NODE_9215_length_888_cov_25.243346	391	471	9	33	80	0.4125000
NODE_9215_length_888_cov_25.243346	391	471	10	19	80	0.2375000
NODE_9215_length_888_cov_25.243346	444	524	9	8	80	0.1000000
NODE_9215_length_888_cov_25.243346	444	524	10	24	80	0.3000000
NODE_9215_length_888_cov_25.243346	444	524	11	18	80	0.2250000
NODE_9215_length_888_cov_25.243346	444	524	12	30	80	0.3750000
NODE_9216_length_888_cov_21.045627	236	316	0	10	80	0.1250000
NODE_9216_length_888_cov_21.045627	236	316	2	70	80	0.8750000
NODE_9216_length_888_cov_21.045627	289	367	0	61	78	0.7820513
NODE_9216_length_888_cov_21.045627	289	367	2	17	78	0.2179487
NODE_9218_length_888_cov_13.447402	515	595	0	26	80	0.3250000
NODE_9218_length_888_cov_13.447402	515	595	1	54	80	0.6750000
NODE_9218_length_888_cov_13.447402	568	648	0	79	80	0.9875000
NODE_9218_length_888_cov_13.447402	568	648	1	1	80	0.0125000
NODE_9219_length_888_cov_12.806084	179	259	0	80	80	1.0000000
NODE_9219_length_888_cov_12.806084	232	312	0	80	80	1.0000000
NODE_9219_length_888_cov_12.806084	308	388	0	80	80	1.0000000
NODE_9219_length_888_cov_12.806084	361	441	0	80	80	1.0000000
NODE_9220_length_888_cov_12.551331	365	445	0	80	80	1.0000000
NODE_9220_length_888_cov_12.551331	418	498	0	61	80	0.7625000
NODE_9220_length_888_cov_12.551331	418	498	2	19	80	0.2375000
NODE_9228_length_888_cov_2.041825	42	102	0	60	60	1.0000000
NODE_9237_length_887_cov_32.927665	514	594	0	8	80	0.1000000
NODE_9237_length_887_cov_32.927665	514	594	4	42	80	0.5250000
NODE_9237_length_887_cov_32.927665	514	594	6	2	80	0.0250000
NODE_9237_length_887_cov_32.927665	514	594	7	14	80	0.1750000
NODE_9237_length_887_cov_32.927665	514	594	8	14	80	0.1750000
NODE_9237_length_887_cov_32.927665	567	647	4	57	80	0.7125000
NODE_9237_length_887_cov_32.927665	567	647	7	9	80	0.1125000
NODE_9237_length_887_cov_32.927665	567	647	8	14	80	0.1750000
NODE_9238_length_887_cov_26.920051	358	438	2	80	80	1.0000000
NODE_9238_length_887_cov_26.920051	411	491	1	14	80	0.1750000
NODE_9238_length_887_cov_26.920051	411	491	2	66	80	0.8250000
NODE_9239_length_887_cov_20.714467	304	384	0	80	80	1.0000000
NODE_9239_length_887_cov_20.714467	357	433	0	76	76	1.0000000
NODE_9240_length_887_cov_19.771574	407	487	0	80	80	1.0000000
NODE_9240_length_887_cov_19.771574	460	540	0	80	80	1.0000000
NODE_9241_length_887_cov_14.535533	333	413	2	80	80	1.0000000
NODE_9241_length_887_cov_14.535533	386	466	0	37	80	0.4625000
NODE_9241_length_887_cov_14.535533	386	466	2	43	80	0.5375000
NODE_9242_length_887_cov_14.114213	345	425	0	49	80	0.6125000
NODE_9242_length_887_cov_14.114213	345	425	2	2	80	0.0250000
NODE_9242_length_887_cov_14.114213	345	425	4	29	80	0.3625000
NODE_9242_length_887_cov_14.114213	398	478	0	80	80	1.0000000
NODE_9243_length_887_cov_9.451777	406	486	0	33	80	0.4125000
NODE_9243_length_887_cov_9.451777	406	486	2	30	80	0.3750000
NODE_9243_length_887_cov_9.451777	406	486	4	17	80	0.2125000
NODE_9243_length_887_cov_9.451777	459	539	2	27	80	0.3375000
NODE_9243_length_887_cov_9.451777	459	539	4	53	80	0.6625000
NODE_9245_length_887_cov_6.656091	473	553	0	80	80	1.0000000
NODE_9245_length_887_cov_6.656091	526	606	0	80	80	1.0000000
NODE_9246_length_887_cov_4.719543	420	500	0	80	80	1.0000000
NODE_9246_length_887_cov_4.719543	473	553	0	80	80	1.0000000
NODE_9250_length_887_cov_2.583756	385	429	0	44	44	1.0000000
NODE_9250_length_887_cov_2.583756	393	428	0	35	35	1.0000000
NODE_9261_length_887_cov_1.087563	754	829	0	7	75	0.0933333
NODE_9261_length_887_cov_1.087563	754	829	1	1	75	0.0133333
NODE_9261_length_887_cov_1.087563	754	829	2	4	75	0.0533333
NODE_9261_length_887_cov_1.087563	754	829	4	63	75	0.8400000
NODE_9264_length_886_cov_35.482846	365	445	10	80	80	1.0000000
NODE_9264_length_886_cov_35.482846	418	498	0	14	80	0.1750000
NODE_9264_length_886_cov_35.482846	418	498	10	66	80	0.8250000
NODE_9265_length_886_cov_31.939009	438	518	0	22	80	0.2750000
NODE_9265_length_886_cov_31.939009	438	518	2	13	80	0.1625000
NODE_9265_length_886_cov_31.939009	438	518	4	45	80	0.5625000
NODE_9265_length_886_cov_31.939009	491	571	0	4	80	0.0500000
NODE_9265_length_886_cov_31.939009	491	571	2	17	80	0.2125000
NODE_9265_length_886_cov_31.939009	491	571	4	59	80	0.7375000
NODE_9266_length_886_cov_25.301144	326	406	9	43	80	0.5375000
NODE_9266_length_886_cov_25.301144	326	406	11	37	80	0.4625000
NODE_9266_length_886_cov_25.301144	326	406	9	43	80	0.5375000
NODE_9266_length_886_cov_25.301144	326	406	11	37	80	0.4625000
NODE_9266_length_886_cov_25.301144	379	459	2	13	80	0.1625000
NODE_9266_length_886_cov_25.301144	379	459	4	3	80	0.0375000
NODE_9266_length_886_cov_25.301144	379	459	8	1	80	0.0125000
NODE_9266_length_886_cov_25.301144	379	459	9	6	80	0.0750000
NODE_9266_length_886_cov_25.301144	379	459	11	57	80	0.7125000
NODE_9266_length_886_cov_25.301144	379	459	2	13	80	0.1625000
NODE_9266_length_886_cov_25.301144	379	459	4	3	80	0.0375000
NODE_9266_length_886_cov_25.301144	379	459	8	1	80	0.0125000
NODE_9266_length_886_cov_25.301144	379	459	9	6	80	0.0750000
NODE_9266_length_886_cov_25.301144	379	459	11	57	80	0.7125000
NODE_9267_length_886_cov_14.463787	327	407	0	80	80	1.0000000
NODE_9267_length_886_cov_14.463787	380	460	0	80	80	1.0000000
NODE_9286_length_885_cov_35.510178	373	453	4	23	80	0.2875000
NODE_9286_length_885_cov_35.510178	373	453	5	3	80	0.0375000
NODE_9286_length_885_cov_35.510178	373	453	6	30	80	0.3750000
NODE_9286_length_885_cov_35.510178	373	453	7	2	80	0.0250000
NODE_9286_length_885_cov_35.510178	373	453	8	22	80	0.2750000
NODE_9286_length_885_cov_35.510178	426	506	3	35	80	0.4375000
NODE_9286_length_885_cov_35.510178	426	506	4	41	80	0.5125000
NODE_9286_length_885_cov_35.510178	426	506	7	2	80	0.0250000
NODE_9286_length_885_cov_35.510178	426	506	8	2	80	0.0250000
NODE_9287_length_885_cov_31.857506	368	448	0	10	80	0.1250000
NODE_9287_length_885_cov_31.857506	368	448	2	54	80	0.6750000
NODE_9287_length_885_cov_31.857506	368	448	4	16	80	0.2000000
NODE_9287_length_885_cov_31.857506	421	501	0	63	80	0.7875000
NODE_9287_length_885_cov_31.857506	421	501	2	17	80	0.2125000
NODE_9288_length_885_cov_31.195929	395	475	0	20	80	0.2500000
NODE_9288_length_885_cov_31.195929	395	475	1	12	80	0.1500000
NODE_9288_length_885_cov_31.195929	395	475	2	48	80	0.6000000
NODE_9288_length_885_cov_31.195929	448	528	2	80	80	1.0000000
NODE_9289_length_885_cov_23.735369	356	436	0	80	80	1.0000000
NODE_9289_length_885_cov_23.735369	409	489	0	80	80	1.0000000
NODE_9289_length_885_cov_23.735369	485	565	0	80	80	1.0000000
NODE_9289_length_885_cov_23.735369	538	618	0	80	80	1.0000000
NODE_9290_length_885_cov_22.174300	340	420	0	33	80	0.4125000
NODE_9290_length_885_cov_22.174300	340	420	2	47	80	0.5875000
NODE_9290_length_885_cov_22.174300	393	473	0	23	80	0.2875000
NODE_9290_length_885_cov_22.174300	393	473	2	57	80	0.7125000
NODE_9290_length_885_cov_22.174300	469	549	0	80	80	1.0000000
NODE_9290_length_885_cov_22.174300	522	602	0	80	80	1.0000000
NODE_9291_length_885_cov_17.852417	413	493	0	2	80	0.0250000
NODE_9291_length_885_cov_17.852417	413	493	4	78	80	0.9750000
NODE_9291_length_885_cov_17.852417	466	546	0	24	80	0.3000000
NODE_9291_length_885_cov_17.852417	466	546	4	56	80	0.7000000
NODE_9292_length_885_cov_15.652672	346	426	0	21	80	0.2625000
NODE_9292_length_885_cov_15.652672	346	426	2	59	80	0.7375000
NODE_9292_length_885_cov_15.652672	399	479	0	74	80	0.9250000
NODE_9292_length_885_cov_15.652672	399	479	2	6	80	0.0750000
NODE_9292_length_885_cov_15.652672	475	555	0	80	80	1.0000000
NODE_9292_length_885_cov_15.652672	528	608	0	80	80	1.0000000
NODE_9293_length_885_cov_11.648855	530	610	0	80	80	1.0000000
NODE_9293_length_885_cov_11.648855	583	663	0	80	80	1.0000000
NODE_9294_length_885_cov_9.707379	611	691	2	80	80	1.0000000
NODE_9294_length_885_cov_9.707379	664	744	0	42	80	0.5250000
NODE_9294_length_885_cov_9.707379	664	744	2	38	80	0.4750000
NODE_9311_length_884_cov_73.050955	536	616	4	10	80	0.1250000
NODE_9311_length_884_cov_73.050955	536	616	9	16	80	0.2000000
NODE_9311_length_884_cov_73.050955	536	616	10	6	80	0.0750000
NODE_9311_length_884_cov_73.050955	536	616	11	30	80	0.3750000
NODE_9311_length_884_cov_73.050955	536	616	13	18	80	0.2250000
NODE_9311_length_884_cov_73.050955	589	669	1	3	80	0.0375000
NODE_9311_length_884_cov_73.050955	589	669	2	16	80	0.2000000
NODE_9311_length_884_cov_73.050955	589	669	3	9	80	0.1125000
NODE_9311_length_884_cov_73.050955	589	669	9	40	80	0.5000000
NODE_9311_length_884_cov_73.050955	589	669	13	12	80	0.1500000
NODE_9312_length_884_cov_28.373248	381	461	0	80	80	1.0000000
NODE_9312_length_884_cov_28.373248	434	514	0	80	80	1.0000000
NODE_9313_length_884_cov_20.649682	463	543	0	8	80	0.1000000
NODE_9313_length_884_cov_20.649682	463	543	6	8	80	0.1000000
NODE_9313_length_884_cov_20.649682	463	543	15	2	80	0.0250000
NODE_9313_length_884_cov_20.649682	463	543	16	7	80	0.0875000
NODE_9313_length_884_cov_20.649682	463	543	25	1	80	0.0125000
NODE_9313_length_884_cov_20.649682	463	543	26	54	80	0.6750000
NODE_9313_length_884_cov_20.649682	516	596	20	30	80	0.3750000
NODE_9313_length_884_cov_20.649682	516	596	26	50	80	0.6250000
NODE_9314_length_884_cov_13.391083	225	305	0	67	80	0.8375000
NODE_9314_length_884_cov_13.391083	225	305	2	13	80	0.1625000
NODE_9314_length_884_cov_13.391083	278	358	0	80	80	1.0000000
NODE_9315_length_884_cov_9.192357	278	358	0	80	80	1.0000000
NODE_9315_length_884_cov_9.192357	331	411	0	35	80	0.4375000
NODE_9315_length_884_cov_9.192357	331	411	2	45	80	0.5625000
NODE_9315_length_884_cov_9.192357	407	487	2	36	80	0.4500000
NODE_9315_length_884_cov_9.192357	407	487	4	44	80	0.5500000
NODE_9315_length_884_cov_9.192357	460	540	2	62	80	0.7750000
NODE_9315_length_884_cov_9.192357	460	540	4	18	80	0.2250000
NODE_9335_length_883_cov_46.780612	344	424	0	80	80	1.0000000
NODE_9335_length_883_cov_46.780612	397	477	0	80	80	1.0000000
NODE_9336_length_883_cov_46.304847	387	467	0	5	80	0.0625000
NODE_9336_length_883_cov_46.304847	387	467	4	75	80	0.9375000
NODE_9336_length_883_cov_46.304847	440	520	0	26	80	0.3250000
NODE_9336_length_883_cov_46.304847	440	520	4	54	80	0.6750000
NODE_9337_length_883_cov_39.579082	410	490	0	80	80	1.0000000
NODE_9337_length_883_cov_39.579082	463	543	0	80	80	1.0000000
NODE_9338_length_883_cov_28.307398	379	459	0	45	80	0.5625000
NODE_9338_length_883_cov_28.307398	379	459	2	35	80	0.4375000
NODE_9338_length_883_cov_28.307398	432	512	2	80	80	1.0000000
NODE_9339_length_883_cov_24.927296	429	509	2	20	80	0.2500000
NODE_9339_length_883_cov_24.927296	429	509	5	33	80	0.4125000
NODE_9339_length_883_cov_24.927296	429	509	7	2	80	0.0250000
NODE_9339_length_883_cov_24.927296	429	509	8	25	80	0.3125000
NODE_9339_length_883_cov_24.927296	482	562	6	47	80	0.5875000
NODE_9339_length_883_cov_24.927296	482	562	7	2	80	0.0250000
NODE_9339_length_883_cov_24.927296	482	562	8	31	80	0.3875000
NODE_9341_length_883_cov_17.445153	326	406	2	12	80	0.1500000
NODE_9341_length_883_cov_17.445153	326	406	4	5	80	0.0625000
NODE_9341_length_883_cov_17.445153	326	406	6	63	80	0.7875000
NODE_9341_length_883_cov_17.445153	379	459	0	36	80	0.4500000
NODE_9341_length_883_cov_17.445153	379	459	2	29	80	0.3625000
NODE_9341_length_883_cov_17.445153	379	459	6	15	80	0.1875000
NODE_9342_length_883_cov_14.660714	319	395	0	76	76	1.0000000
NODE_9342_length_883_cov_14.660714	740	816	0	76	76	1.0000000
NODE_9343_length_883_cov_11.052296	223	303	8	30	80	0.3750000
NODE_9343_length_883_cov_11.052296	223	303	10	50	80	0.6250000
NODE_9343_length_883_cov_11.052296	276	356	2	17	80	0.2125000
NODE_9343_length_883_cov_11.052296	276	356	3	21	80	0.2625000
NODE_9343_length_883_cov_11.052296	276	356	9	5	80	0.0625000
NODE_9343_length_883_cov_11.052296	276	356	10	27	80	0.3375000
NODE_9343_length_883_cov_11.052296	276	356	11	4	80	0.0500000
NODE_9343_length_883_cov_11.052296	276	356	12	6	80	0.0750000
NODE_9344_length_883_cov_6.873724	0	66	0	7	66	0.1060606
NODE_9344_length_883_cov_6.873724	0	66	2	3	66	0.0454545
NODE_9344_length_883_cov_6.873724	0	66	4	1	66	0.0151515
NODE_9344_length_883_cov_6.873724	0	66	6	5	66	0.0757576
NODE_9344_length_883_cov_6.873724	0	66	8	17	66	0.2575758
NODE_9344_length_883_cov_6.873724	0	66	12	3	66	0.0454545
NODE_9344_length_883_cov_6.873724	0	66	18	3	66	0.0454545
NODE_9344_length_883_cov_6.873724	0	66	19	8	66	0.1212121
NODE_9344_length_883_cov_6.873724	0	66	20	4	66	0.0606061
NODE_9344_length_883_cov_6.873724	0	66	30	8	66	0.1212121
NODE_9344_length_883_cov_6.873724	0	66	33	7	66	0.1060606
NODE_9345_length_883_cov_3.873724	471	551	0	80	80	1.0000000
NODE_9345_length_883_cov_3.873724	524	604	0	80	80	1.0000000
NODE_9346_length_883_cov_3.247449	294	374	0	14	80	0.1750000
NODE_9346_length_883_cov_3.247449	294	374	2	66	80	0.8250000
NODE_9346_length_883_cov_3.247449	347	427	0	67	80	0.8375000
NODE_9346_length_883_cov_3.247449	347	427	2	13	80	0.1625000
NODE_9370_length_882_cov_24.241379	438	518	0	8	80	0.1000000
NODE_9370_length_882_cov_24.241379	438	518	4	31	80	0.3875000
NODE_9370_length_882_cov_24.241379	438	518	6	39	80	0.4875000
NODE_9370_length_882_cov_24.241379	438	518	8	2	80	0.0250000
NODE_9370_length_882_cov_24.241379	491	571	2	24	80	0.3000000
NODE_9370_length_882_cov_24.241379	491	571	4	11	80	0.1375000
NODE_9370_length_882_cov_24.241379	491	571	6	25	80	0.3125000
NODE_9370_length_882_cov_24.241379	491	571	8	20	80	0.2500000
NODE_9371_length_882_cov_23.145594	355	435	0	80	80	1.0000000
NODE_9371_length_882_cov_23.145594	408	488	0	32	80	0.4000000
NODE_9371_length_882_cov_23.145594	408	488	1	10	80	0.1250000
NODE_9371_length_882_cov_23.145594	408	488	2	38	80	0.4750000
NODE_9372_length_882_cov_21.401022	335	415	0	60	80	0.7500000
NODE_9372_length_882_cov_21.401022	335	415	4	20	80	0.2500000
NODE_9372_length_882_cov_21.401022	388	468	0	7	80	0.0875000
NODE_9372_length_882_cov_21.401022	388	468	4	73	80	0.9125000
NODE_9373_length_882_cov_19.579821	456	511	0	11	55	0.2000000
NODE_9373_length_882_cov_19.579821	456	511	3	16	55	0.2909091
NODE_9373_length_882_cov_19.579821	456	511	6	28	55	0.5090909
NODE_9373_length_882_cov_19.579821	506	586	6	80	80	1.0000000
NODE_9373_length_882_cov_19.579821	559	639	0	6	80	0.0750000
NODE_9373_length_882_cov_19.579821	559	639	3	16	80	0.2000000
NODE_9373_length_882_cov_19.579821	559	639	6	58	80	0.7250000
NODE_9374_length_882_cov_19.342273	298	378	0	32	80	0.4000000
NODE_9374_length_882_cov_19.342273	298	378	8	48	80	0.6000000
NODE_9374_length_882_cov_19.342273	351	431	0	80	80	1.0000000
NODE_9374_length_882_cov_19.342273	427	508	0	81	81	1.0000000
NODE_9374_length_882_cov_19.342273	481	561	0	54	80	0.6750000
NODE_9374_length_882_cov_19.342273	481	561	2	26	80	0.3250000
NODE_9375_length_882_cov_11.873563	267	347	0	80	80	1.0000000
NODE_9375_length_882_cov_11.873563	320	400	0	80	80	1.0000000
NODE_9376_length_882_cov_8.794381	430	510	0	80	80	1.0000000
NODE_9376_length_882_cov_8.794381	483	563	0	80	80	1.0000000
NODE_9377_length_882_cov_7.537676	527	608	0	81	81	1.0000000
NODE_9379_length_882_cov_6.696041	355	435	0	80	80	1.0000000
NODE_9379_length_882_cov_6.696041	408	488	0	80	80	1.0000000
NODE_9380_length_882_cov_4.734355	585	665	0	9	80	0.1125000
NODE_9380_length_882_cov_4.734355	585	665	5	52	80	0.6500000
NODE_9380_length_882_cov_4.734355	585	665	7	19	80	0.2375000
NODE_9380_length_882_cov_4.734355	638	718	2	19	80	0.2375000
NODE_9380_length_882_cov_4.734355	638	718	5	8	80	0.1000000
NODE_9380_length_882_cov_4.734355	638	718	7	53	80	0.6625000
NODE_9398_length_881_cov_32.875959	444	524	4	46	80	0.5750000
NODE_9398_length_881_cov_32.875959	444	524	6	34	80	0.4250000
NODE_9398_length_881_cov_32.875959	497	577	0	45	80	0.5625000
NODE_9398_length_881_cov_32.875959	497	577	4	35	80	0.4375000
NODE_9399_length_881_cov_25.750639	43	117	0	62	74	0.8378378
NODE_9399_length_881_cov_25.750639	43	117	4	12	74	0.1621622
NODE_9399_length_881_cov_25.750639	116	193	4	11	77	0.1428571
NODE_9399_length_881_cov_25.750639	116	193	14	14	77	0.1818182
NODE_9399_length_881_cov_25.750639	116	193	44	1	77	0.0129870
NODE_9399_length_881_cov_25.750639	116	193	50	5	77	0.0649351
NODE_9399_length_881_cov_25.750639	116	193	71	1	77	0.0129870
NODE_9399_length_881_cov_25.750639	116	193	72	8	77	0.1038961
NODE_9399_length_881_cov_25.750639	116	193	73	2	77	0.0259740
NODE_9399_length_881_cov_25.750639	116	193	74	21	77	0.2727273
NODE_9399_length_881_cov_25.750639	116	193	75	4	77	0.0519481
NODE_9399_length_881_cov_25.750639	116	193	77	4	77	0.0519481
NODE_9399_length_881_cov_25.750639	116	193	79	6	77	0.0779221
NODE_9400_length_881_cov_23.897698	286	365	0	62	79	0.7848101
NODE_9400_length_881_cov_23.897698	286	365	2	17	79	0.2151899
NODE_9400_length_881_cov_23.897698	338	418	0	10	80	0.1250000
NODE_9400_length_881_cov_23.897698	338	418	2	70	80	0.8750000
NODE_9401_length_881_cov_20.656010	359	439	0	80	80	1.0000000
NODE_9401_length_881_cov_20.656010	412	492	0	80	80	1.0000000
NODE_9402_length_881_cov_20.340153	242	322	0	24	80	0.3000000
NODE_9402_length_881_cov_20.340153	242	322	2	56	80	0.7000000
NODE_9402_length_881_cov_20.340153	295	375	0	21	80	0.2625000
NODE_9402_length_881_cov_20.340153	295	375	2	59	80	0.7375000
NODE_9403_length_881_cov_18.234015	420	500	0	80	80	1.0000000
NODE_9403_length_881_cov_18.234015	473	553	0	80	80	1.0000000
NODE_9404_length_881_cov_17.748082	291	371	0	49	80	0.6125000
NODE_9404_length_881_cov_17.748082	291	371	2	12	80	0.1500000
NODE_9404_length_881_cov_17.748082	291	371	4	19	80	0.2375000
NODE_9404_length_881_cov_17.748082	344	424	2	8	80	0.1000000
NODE_9404_length_881_cov_17.748082	344	424	4	72	80	0.9000000
NODE_9405_length_881_cov_12.884910	332	412	0	23	80	0.2875000
NODE_9405_length_881_cov_12.884910	332	412	2	12	80	0.1500000
NODE_9405_length_881_cov_12.884910	332	412	4	45	80	0.5625000
NODE_9405_length_881_cov_12.884910	385	465	2	21	80	0.2625000
NODE_9405_length_881_cov_12.884910	385	465	4	51	80	0.6375000
NODE_9405_length_881_cov_12.884910	385	465	6	8	80	0.1000000
NODE_9406_length_881_cov_6.473146	474	553	0	5	79	0.0632911
NODE_9406_length_881_cov_6.473146	474	553	2	67	79	0.8481013
NODE_9406_length_881_cov_6.473146	474	553	4	7	79	0.0886076
NODE_9406_length_881_cov_6.473146	514	594	2	32	80	0.4000000
NODE_9406_length_881_cov_6.473146	514	594	4	46	80	0.5750000
NODE_9406_length_881_cov_6.473146	514	594	6	2	80	0.0250000
NODE_9406_length_881_cov_6.473146	526	565	2	20	39	0.5128205
NODE_9406_length_881_cov_6.473146	526	565	4	17	39	0.4358974
NODE_9406_length_881_cov_6.473146	526	565	6	2	39	0.0512821
NODE_9406_length_881_cov_6.473146	555	606	4	49	51	0.9607843
NODE_9406_length_881_cov_6.473146	555	606	6	2	51	0.0392157
NODE_9406_length_881_cov_6.473146	567	647	3	14	80	0.1750000
NODE_9406_length_881_cov_6.473146	567	647	4	66	80	0.8250000
NODE_9407_length_881_cov_5.615090	547	627	1	50	80	0.6250000
NODE_9407_length_881_cov_5.615090	547	627	2	30	80	0.3750000
NODE_9407_length_881_cov_5.615090	600	680	0	20	80	0.2500000
NODE_9407_length_881_cov_5.615090	600	680	1	60	80	0.7500000
NODE_9424_length_880_cov_26.663252	320	400	0	80	80	1.0000000
NODE_9424_length_880_cov_26.663252	373	453	0	80	80	1.0000000
NODE_9425_length_880_cov_21.828425	328	408	0	22	80	0.2750000
NODE_9425_length_880_cov_21.828425	328	408	2	58	80	0.7250000
NODE_9425_length_880_cov_21.828425	381	461	0	75	80	0.9375000
NODE_9425_length_880_cov_21.828425	381	461	2	5	80	0.0625000
NODE_9426_length_880_cov_20.245839	427	507	2	19	80	0.2375000
NODE_9426_length_880_cov_20.245839	427	507	4	15	80	0.1875000
NODE_9426_length_880_cov_20.245839	427	507	6	46	80	0.5750000
NODE_9426_length_880_cov_20.245839	480	560	0	49	80	0.6125000
NODE_9426_length_880_cov_20.245839	480	560	2	23	80	0.2875000
NODE_9426_length_880_cov_20.245839	480	560	6	8	80	0.1000000
NODE_9427_length_880_cov_19.434059	0	69	0	69	69	1.0000000
NODE_9428_length_880_cov_11.843790	363	430	4	67	67	1.0000000
NODE_9429_length_880_cov_11.544174	185	265	0	54	80	0.6750000
NODE_9429_length_880_cov_11.544174	185	265	2	26	80	0.3250000
NODE_9429_length_880_cov_11.544174	238	318	0	1	80	0.0125000
NODE_9429_length_880_cov_11.544174	238	318	2	79	80	0.9875000
NODE_9430_length_880_cov_10.956466	354	434	0	53	80	0.6625000
NODE_9430_length_880_cov_10.956466	354	434	2	27	80	0.3375000
NODE_9430_length_880_cov_10.956466	407	487	2	37	80	0.4625000
NODE_9430_length_880_cov_10.956466	407	487	4	43	80	0.5375000
NODE_9431_length_880_cov_10.008963	395	474	10	79	79	1.0000000
NODE_9431_length_880_cov_10.008963	448	527	0	21	79	0.2658228
NODE_9431_length_880_cov_10.008963	448	527	10	58	79	0.7341772
NODE_9453_length_879_cov_23.565385	326	406	0	80	80	1.0000000
NODE_9453_length_879_cov_23.565385	379	459	0	80	80	1.0000000
NODE_9453_length_879_cov_23.565385	455	535	0	80	80	1.0000000
NODE_9453_length_879_cov_23.565385	508	586	0	78	78	1.0000000
NODE_9454_length_879_cov_20.758974	355	439	0	84	84	1.0000000
NODE_9454_length_879_cov_20.758974	412	492	0	80	80	1.0000000
NODE_9455_length_879_cov_19.685897	295	375	0	8	80	0.1000000
NODE_9455_length_879_cov_19.685897	295	375	2	64	80	0.8000000
NODE_9455_length_879_cov_19.685897	295	375	4	8	80	0.1000000
NODE_9455_length_879_cov_19.685897	348	428	0	12	80	0.1500000
NODE_9455_length_879_cov_19.685897	348	428	2	68	80	0.8500000
NODE_9456_length_879_cov_17.738462	413	488	0	75	75	1.0000000
NODE_9456_length_879_cov_17.738462	569	649	0	80	80	1.0000000
NODE_9456_length_879_cov_17.738462	569	649	0	80	80	1.0000000
NODE_9456_length_879_cov_17.738462	569	649	0	80	80	1.0000000
NODE_9456_length_879_cov_17.738462	622	676	0	54	54	1.0000000
NODE_9458_length_879_cov_10.756410	335	415	2	36	80	0.4500000
NODE_9458_length_879_cov_10.756410	335	415	6	6	80	0.0750000
NODE_9458_length_879_cov_10.756410	335	415	10	7	80	0.0875000
NODE_9458_length_879_cov_10.756410	335	415	12	6	80	0.0750000
NODE_9458_length_879_cov_10.756410	335	415	16	13	80	0.1625000
NODE_9458_length_879_cov_10.756410	335	415	18	8	80	0.1000000
NODE_9458_length_879_cov_10.756410	335	415	20	4	80	0.0500000
NODE_9458_length_879_cov_10.756410	388	468	12	2	80	0.0250000
NODE_9458_length_879_cov_10.756410	388	468	16	13	80	0.1625000
NODE_9458_length_879_cov_10.756410	388	468	18	15	80	0.1875000
NODE_9458_length_879_cov_10.756410	388	468	19	27	80	0.3375000
NODE_9458_length_879_cov_10.756410	388	468	20	17	80	0.2125000
NODE_9458_length_879_cov_10.756410	388	468	21	6	80	0.0750000
NODE_9459_length_879_cov_7.432051	234	314	0	10	80	0.1250000
NODE_9459_length_879_cov_7.432051	234	314	2	4	80	0.0500000
NODE_9459_length_879_cov_7.432051	234	314	4	66	80	0.8250000
NODE_9459_length_879_cov_7.432051	288	367	0	63	79	0.7974684
NODE_9459_length_879_cov_7.432051	288	367	2	4	79	0.0506329
NODE_9459_length_879_cov_7.432051	288	367	4	12	79	0.1518987
NODE_9473_length_878_cov_230.436457	415	495	0	28	80	0.3500000
NODE_9473_length_878_cov_230.436457	415	495	2	52	80	0.6500000
NODE_9473_length_878_cov_230.436457	468	548	0	38	80	0.4750000
NODE_9473_length_878_cov_230.436457	468	548	2	42	80	0.5250000
NODE_9474_length_878_cov_49.514763	410	490	0	14	80	0.1750000
NODE_9474_length_878_cov_49.514763	410	490	2	66	80	0.8250000
NODE_9474_length_878_cov_49.514763	463	543	0	31	80	0.3875000
NODE_9474_length_878_cov_49.514763	463	543	2	49	80	0.6125000
NODE_9475_length_878_cov_38.862644	365	445	0	23	80	0.2875000
NODE_9475_length_878_cov_38.862644	365	445	3	36	80	0.4500000
NODE_9475_length_878_cov_38.862644	365	445	4	21	80	0.2625000
NODE_9475_length_878_cov_38.862644	418	498	0	10	80	0.1250000
NODE_9475_length_878_cov_38.862644	418	498	4	70	80	0.8750000
NODE_9476_length_878_cov_36.517330	346	426	0	80	80	1.0000000
NODE_9476_length_878_cov_36.517330	399	479	0	80	80	1.0000000
NODE_9476_length_878_cov_36.517330	475	555	0	80	80	1.0000000
NODE_9476_length_878_cov_36.517330	528	608	0	80	80	1.0000000
NODE_9477_length_878_cov_34.404365	627	707	34	2	80	0.0250000
NODE_9477_length_878_cov_34.404365	627	707	38	5	80	0.0625000
NODE_9477_length_878_cov_34.404365	627	707	40	3	80	0.0375000
NODE_9477_length_878_cov_34.404365	627	707	46	2	80	0.0250000
NODE_9477_length_878_cov_34.404365	627	707	48	1	80	0.0125000
NODE_9477_length_878_cov_34.404365	627	707	50	2	80	0.0250000
NODE_9477_length_878_cov_34.404365	627	707	52	17	80	0.2125000
NODE_9477_length_878_cov_34.404365	627	707	69	2	80	0.0250000
NODE_9477_length_878_cov_34.404365	627	707	71	1	80	0.0125000
NODE_9477_length_878_cov_34.404365	627	707	72	1	80	0.0125000
NODE_9477_length_878_cov_34.404365	627	707	73	21	80	0.2625000
NODE_9477_length_878_cov_34.404365	627	707	75	10	80	0.1250000
NODE_9477_length_878_cov_34.404365	627	707	76	9	80	0.1125000
NODE_9477_length_878_cov_34.404365	627	707	77	4	80	0.0500000
NODE_9477_length_878_cov_34.404365	627	695	34	2	68	0.0294118
NODE_9477_length_878_cov_34.404365	627	695	38	5	68	0.0735294
NODE_9477_length_878_cov_34.404365	627	695	40	3	68	0.0441176
NODE_9477_length_878_cov_34.404365	627	695	46	2	68	0.0294118
NODE_9477_length_878_cov_34.404365	627	695	48	1	68	0.0147059
NODE_9477_length_878_cov_34.404365	627	695	50	2	68	0.0294118
NODE_9477_length_878_cov_34.404365	627	695	52	17	68	0.2500000
NODE_9477_length_878_cov_34.404365	627	695	72	1	68	0.0147059
NODE_9477_length_878_cov_34.404365	627	695	73	21	68	0.3088235
NODE_9477_length_878_cov_34.404365	627	695	75	5	68	0.0735294
NODE_9477_length_878_cov_34.404365	627	695	76	5	68	0.0735294
NODE_9477_length_878_cov_34.404365	627	695	77	4	68	0.0588235
NODE_9477_length_878_cov_34.404365	680	760	56	1	80	0.0125000
NODE_9477_length_878_cov_34.404365	680	760	57	1	80	0.0125000
NODE_9477_length_878_cov_34.404365	680	760	59	1	80	0.0125000
NODE_9477_length_878_cov_34.404365	680	760	60	4	80	0.0500000
NODE_9477_length_878_cov_34.404365	680	760	61	9	80	0.1125000
NODE_9477_length_878_cov_34.404365	680	760	63	1	80	0.0125000
NODE_9477_length_878_cov_34.404365	680	760	64	4	80	0.0500000
NODE_9477_length_878_cov_34.404365	680	760	65	2	80	0.0250000
NODE_9477_length_878_cov_34.404365	680	760	66	1	80	0.0125000
NODE_9477_length_878_cov_34.404365	680	760	67	1	80	0.0125000
NODE_9477_length_878_cov_34.404365	680	760	68	2	80	0.0250000
NODE_9477_length_878_cov_34.404365	680	760	69	2	80	0.0250000
NODE_9477_length_878_cov_34.404365	680	760	71	3	80	0.0375000
NODE_9477_length_878_cov_34.404365	680	760	72	3	80	0.0375000
NODE_9477_length_878_cov_34.404365	680	760	73	6	80	0.0750000
NODE_9477_length_878_cov_34.404365	680	760	75	10	80	0.1250000
NODE_9477_length_878_cov_34.404365	680	760	76	11	80	0.1375000
NODE_9477_length_878_cov_34.404365	680	760	77	4	80	0.0500000
NODE_9477_length_878_cov_34.404365	680	760	78	1	80	0.0125000
NODE_9477_length_878_cov_34.404365	680	760	79	1	80	0.0125000
NODE_9477_length_878_cov_34.404365	680	760	83	4	80	0.0500000
NODE_9477_length_878_cov_34.404365	680	760	85	5	80	0.0625000
NODE_9477_length_878_cov_34.404365	680	760	87	2	80	0.0250000
NODE_9477_length_878_cov_34.404365	680	760	89	1	80	0.0125000
NODE_9478_length_878_cov_28.761232	467	547	0	80	80	1.0000000
NODE_9478_length_878_cov_28.761232	520	600	0	80	80	1.0000000
NODE_9479_length_878_cov_24.899872	316	396	0	80	80	1.0000000
NODE_9479_length_878_cov_24.899872	369	449	0	80	80	1.0000000
NODE_9479_length_878_cov_24.899872	445	525	0	10	80	0.1250000
NODE_9479_length_878_cov_24.899872	445	525	1	70	80	0.8750000
NODE_9479_length_878_cov_24.899872	498	578	1	80	80	1.0000000
NODE_9480_length_878_cov_21.446727	377	457	0	80	80	1.0000000
NODE_9480_length_878_cov_21.446727	430	510	0	80	80	1.0000000
NODE_9481_length_878_cov_20.553273	424	504	4	66	80	0.8250000
NODE_9481_length_878_cov_20.553273	424	504	8	14	80	0.1750000
NODE_9481_length_878_cov_20.553273	477	557	4	25	80	0.3125000
NODE_9481_length_878_cov_20.553273	477	557	8	55	80	0.6875000
NODE_9482_length_878_cov_14.016688	214	294	0	80	80	1.0000000
NODE_9482_length_878_cov_14.016688	267	347	0	80	80	1.0000000
NODE_9483_length_878_cov_9.252888	423	503	0	80	80	1.0000000
NODE_9483_length_878_cov_9.252888	476	556	0	80	80	1.0000000
NODE_9484_length_878_cov_8.695764	333	413	0	80	80	1.0000000
NODE_9484_length_878_cov_8.695764	386	466	0	80	80	1.0000000
NODE_9485_length_878_cov_6.686778	65	145	0	11	80	0.1375000
NODE_9485_length_878_cov_6.686778	65	145	2	2	80	0.0250000
NODE_9485_length_878_cov_6.686778	65	145	6	67	80	0.8375000
NODE_9485_length_878_cov_6.686778	118	198	0	28	80	0.3500000
NODE_9485_length_878_cov_6.686778	118	198	4	8	80	0.1000000
NODE_9485_length_878_cov_6.686778	118	198	6	44	80	0.5500000
NODE_9487_length_878_cov_6.328626	426	506	0	80	80	1.0000000
NODE_9487_length_878_cov_6.328626	479	559	0	80	80	1.0000000
NODE_9488_length_878_cov_5.771502	470	513	0	43	43	1.0000000
NODE_9490_length_878_cov_2.672657	499	579	0	23	80	0.2875000
NODE_9490_length_878_cov_2.672657	499	579	2	57	80	0.7125000
NODE_9490_length_878_cov_2.672657	552	631	0	13	79	0.1645570
NODE_9490_length_878_cov_2.672657	552	631	2	66	79	0.8354430
NODE_9507_length_877_cov_59.021851	324	404	0	58	80	0.7250000
NODE_9507_length_877_cov_59.021851	324	404	4	22	80	0.2750000
NODE_9507_length_877_cov_59.021851	377	457	0	5	80	0.0625000
NODE_9507_length_877_cov_59.021851	377	457	4	75	80	0.9375000
NODE_9508_length_877_cov_54.422879	418	498	0	80	80	1.0000000
NODE_9508_length_877_cov_54.422879	471	551	0	80	80	1.0000000
NODE_9509_length_877_cov_47.672237	451	527	0	42	76	0.5526316
NODE_9509_length_877_cov_47.672237	451	527	4	34	76	0.4473684
NODE_9509_length_877_cov_47.672237	500	580	4	80	80	1.0000000
NODE_9510_length_877_cov_29.884319	349	429	20	31	80	0.3875000
NODE_9510_length_877_cov_29.884319	349	429	22	16	80	0.2000000
NODE_9510_length_877_cov_29.884319	349	429	26	33	80	0.4125000
NODE_9510_length_877_cov_29.884319	402	482	2	8	80	0.1000000
NODE_9510_length_877_cov_29.884319	402	482	6	16	80	0.2000000
NODE_9510_length_877_cov_29.884319	402	482	9	2	80	0.0250000
NODE_9510_length_877_cov_29.884319	402	482	10	22	80	0.2750000
NODE_9510_length_877_cov_29.884319	402	482	20	11	80	0.1375000
NODE_9510_length_877_cov_29.884319	402	482	22	21	80	0.2625000
NODE_9511_length_877_cov_17.681234	423	503	2	34	80	0.4250000
NODE_9511_length_877_cov_17.681234	423	503	4	46	80	0.5750000
NODE_9511_length_877_cov_17.681234	476	556	0	49	80	0.6125000
NODE_9511_length_877_cov_17.681234	476	556	2	31	80	0.3875000
NODE_9512_length_877_cov_17.520566	228	308	0	80	80	1.0000000
NODE_9512_length_877_cov_17.520566	281	361	0	45	80	0.5625000
NODE_9512_length_877_cov_17.520566	281	361	2	35	80	0.4375000
NODE_9513_length_877_cov_17.374036	362	442	0	68	80	0.8500000
NODE_9513_length_877_cov_17.374036	362	442	2	12	80	0.1500000
NODE_9513_length_877_cov_17.374036	415	495	0	26	80	0.3250000
NODE_9513_length_877_cov_17.374036	415	495	2	54	80	0.6750000
NODE_9515_length_877_cov_9.320051	395	475	0	80	80	1.0000000
NODE_9515_length_877_cov_9.320051	448	528	0	80	80	1.0000000
NODE_9517_length_877_cov_6.755784	222	302	2	80	80	1.0000000
NODE_9517_length_877_cov_6.755784	275	354	0	41	79	0.5189874
NODE_9517_length_877_cov_6.755784	275	354	2	38	79	0.4810127
NODE_9537_length_876_cov_46.021879	389	469	0	16	80	0.2000000
NODE_9537_length_876_cov_46.021879	389	469	2	64	80	0.8000000
NODE_9537_length_876_cov_46.021879	442	522	0	66	80	0.8250000
NODE_9537_length_876_cov_46.021879	442	522	2	14	80	0.1750000
NODE_9538_length_876_cov_34.441441	379	459	4	29	80	0.3625000
NODE_9538_length_876_cov_34.441441	379	459	6	31	80	0.3875000
NODE_9538_length_876_cov_34.441441	379	459	10	20	80	0.2500000
NODE_9538_length_876_cov_34.441441	432	512	6	30	80	0.3750000
NODE_9538_length_876_cov_34.441441	432	512	8	50	80	0.6250000
NODE_9539_length_876_cov_30.742600	344	424	0	80	80	1.0000000
NODE_9539_length_876_cov_30.742600	397	477	0	80	80	1.0000000
NODE_9540_length_876_cov_28.476190	345	425	0	5	80	0.0625000
NODE_9540_length_876_cov_28.476190	345	425	2	75	80	0.9375000
NODE_9540_length_876_cov_28.476190	398	478	0	5	80	0.0625000
NODE_9540_length_876_cov_28.476190	398	478	2	75	80	0.9375000
NODE_9541_length_876_cov_22.722008	324	404	2	35	80	0.4375000
NODE_9541_length_876_cov_22.722008	324	404	4	24	80	0.3000000
NODE_9541_length_876_cov_22.722008	324	404	6	21	80	0.2625000
NODE_9541_length_876_cov_22.722008	377	457	4	77	80	0.9625000
NODE_9541_length_876_cov_22.722008	377	457	6	3	80	0.0375000
NODE_9542_length_876_cov_17.458172	367	447	0	13	80	0.1625000
NODE_9542_length_876_cov_17.458172	367	447	2	67	80	0.8375000
NODE_9542_length_876_cov_17.458172	420	500	0	39	80	0.4875000
NODE_9542_length_876_cov_17.458172	420	500	2	41	80	0.5125000
NODE_9561_length_875_cov_52.965206	190	270	8	80	80	1.0000000
NODE_9561_length_875_cov_52.965206	243	323	0	39	80	0.4875000
NODE_9561_length_875_cov_52.965206	243	323	8	41	80	0.5125000
NODE_9561_length_875_cov_52.965206	319	399	0	40	80	0.5000000
NODE_9561_length_875_cov_52.965206	319	399	4	40	80	0.5000000
NODE_9561_length_875_cov_52.965206	372	447	0	23	75	0.3066667
NODE_9561_length_875_cov_52.965206	372	447	4	52	75	0.6933333
NODE_9562_length_875_cov_35.634021	260	340	0	80	80	1.0000000
NODE_9562_length_875_cov_35.634021	313	393	0	80	80	1.0000000
NODE_9562_length_875_cov_35.634021	389	469	0	80	80	1.0000000
NODE_9562_length_875_cov_35.634021	442	522	0	29	80	0.3625000
NODE_9562_length_875_cov_35.634021	442	522	2	51	80	0.6375000
NODE_9563_length_875_cov_33.771907	363	441	0	51	78	0.6538461
NODE_9563_length_875_cov_33.771907	363	441	2	27	78	0.3461539
NODE_9563_length_875_cov_33.771907	414	494	2	80	80	1.0000000
NODE_9564_length_875_cov_29.698454	322	402	0	80	80	1.0000000
NODE_9564_length_875_cov_29.698454	375	455	0	80	80	1.0000000
NODE_9565_length_875_cov_23.041237	364	444	0	80	80	1.0000000
NODE_9565_length_875_cov_23.041237	417	497	0	80	80	1.0000000
NODE_9565_length_875_cov_23.041237	493	573	0	80	80	1.0000000
NODE_9565_length_875_cov_23.041237	546	626	0	80	80	1.0000000
NODE_9566_length_875_cov_9.800258	242	322	0	12	80	0.1500000
NODE_9566_length_875_cov_9.800258	242	322	4	68	80	0.8500000
NODE_9566_length_875_cov_9.800258	295	376	0	66	81	0.8148148
NODE_9566_length_875_cov_9.800258	295	376	4	15	81	0.1851852
NODE_9567_length_875_cov_8.195876	407	487	0	80	80	1.0000000
NODE_9567_length_875_cov_8.195876	460	540	0	80	80	1.0000000
NODE_9585_length_874_cov_48.925161	185	265	0	71	80	0.8875000
NODE_9585_length_874_cov_48.925161	185	265	2	9	80	0.1125000
NODE_9585_length_874_cov_48.925161	238	318	0	21	80	0.2625000
NODE_9585_length_874_cov_48.925161	238	318	2	59	80	0.7375000
NODE_9587_length_874_cov_37.354839	199	279	0	67	80	0.8375000
NODE_9587_length_874_cov_37.354839	199	279	2	13	80	0.1625000
NODE_9587_length_874_cov_37.354839	252	332	0	14	80	0.1750000
NODE_9587_length_874_cov_37.354839	252	332	2	66	80	0.8250000
NODE_9588_length_874_cov_35.040000	231	311	3	3	80	0.0375000
NODE_9588_length_874_cov_35.040000	231	311	7	34	80	0.4250000
NODE_9588_length_874_cov_35.040000	231	311	8	10	80	0.1250000
NODE_9588_length_874_cov_35.040000	231	311	9	33	80	0.4125000
NODE_9588_length_874_cov_35.040000	284	364	2	33	80	0.4125000
NODE_9588_length_874_cov_35.040000	284	364	3	23	80	0.2875000
NODE_9588_length_874_cov_35.040000	284	364	8	1	80	0.0125000
NODE_9588_length_874_cov_35.040000	284	364	9	23	80	0.2875000
NODE_9589_length_874_cov_23.415484	327	407	0	80	80	1.0000000
NODE_9589_length_874_cov_23.415484	380	460	0	80	80	1.0000000
NODE_9589_length_874_cov_23.415484	456	536	0	80	80	1.0000000
NODE_9589_length_874_cov_23.415484	509	589	0	70	80	0.8750000
NODE_9589_length_874_cov_23.415484	509	589	2	10	80	0.1250000
NODE_9590_length_874_cov_21.885161	279	359	0	19	80	0.2375000
NODE_9590_length_874_cov_21.885161	279	359	2	61	80	0.7625000
NODE_9590_length_874_cov_21.885161	332	412	0	13	80	0.1625000
NODE_9590_length_874_cov_21.885161	332	412	2	67	80	0.8375000
NODE_9591_length_874_cov_11.172903	67	147	0	80	80	1.0000000
NODE_9591_length_874_cov_11.172903	120	200	0	80	80	1.0000000
NODE_9592_length_874_cov_9.645161	424	504	0	80	80	1.0000000
NODE_9592_length_874_cov_9.645161	477	557	0	80	80	1.0000000
NODE_9593_length_874_cov_8.637419	359	439	0	80	80	1.0000000
NODE_9593_length_874_cov_8.637419	412	499	0	87	87	1.0000000
NODE_9596_length_874_cov_4.785806	829	874	0	45	45	1.0000000
NODE_9618_length_873_cov_100.625323	50	130	68	1	80	0.0125000
NODE_9618_length_873_cov_100.625323	50	130	72	6	80	0.0750000
NODE_9618_length_873_cov_100.625323	50	130	82	73	80	0.9125000
NODE_9619_length_873_cov_45.633075	226	306	0	25	80	0.3125000
NODE_9619_length_873_cov_45.633075	226	306	5	1	80	0.0125000
NODE_9619_length_873_cov_45.633075	226	306	6	54	80	0.6750000
NODE_9619_length_873_cov_45.633075	279	359	5	10	80	0.1250000
NODE_9619_length_873_cov_45.633075	279	359	6	35	80	0.4375000
NODE_9619_length_873_cov_45.633075	279	359	7	23	80	0.2875000
NODE_9619_length_873_cov_45.633075	279	359	9	12	80	0.1500000
NODE_9619_length_873_cov_45.633075	693	773	0	80	80	1.0000000
NODE_9619_length_873_cov_45.633075	746	826	0	80	80	1.0000000
NODE_9620_length_873_cov_39.224806	190	270	0	1	80	0.0125000
NODE_9620_length_873_cov_39.224806	190	270	4	61	80	0.7625000
NODE_9620_length_873_cov_39.224806	190	270	8	18	80	0.2250000
NODE_9620_length_873_cov_39.224806	243	307	0	38	64	0.5937500
NODE_9620_length_873_cov_39.224806	243	307	4	26	64	0.4062500
NODE_9620_length_873_cov_39.224806	390	470	6	80	80	1.0000000
NODE_9620_length_873_cov_39.224806	443	523	0	48	80	0.6000000
NODE_9620_length_873_cov_39.224806	443	523	6	32	80	0.4000000
NODE_9620_length_873_cov_39.224806	504	523	0	19	19	1.0000000
NODE_9620_length_873_cov_39.224806	519	599	0	80	80	1.0000000
NODE_9620_length_873_cov_39.224806	572	652	0	80	80	1.0000000
NODE_9621_length_873_cov_27.992248	372	452	0	80	80	1.0000000
NODE_9621_length_873_cov_27.992248	425	505	0	80	80	1.0000000
NODE_9622_length_873_cov_23.270026	390	470	12	8	80	0.1000000
NODE_9622_length_873_cov_23.270026	390	470	16	72	80	0.9000000
NODE_9622_length_873_cov_23.270026	443	528	0	31	85	0.3647059
NODE_9622_length_873_cov_23.270026	443	528	2	3	85	0.0352941
NODE_9622_length_873_cov_23.270026	443	528	4	1	85	0.0117647
NODE_9622_length_873_cov_23.270026	443	528	9	1	85	0.0117647
NODE_9622_length_873_cov_23.270026	443	528	10	3	85	0.0352941
NODE_9622_length_873_cov_23.270026	443	528	16	46	85	0.5411765
NODE_9623_length_873_cov_23.197674	293	373	0	80	80	1.0000000
NODE_9623_length_873_cov_23.197674	346	426	0	80	80	1.0000000
NODE_9624_length_873_cov_20.432817	347	427	3	26	80	0.3250000
NODE_9624_length_873_cov_20.432817	347	427	4	4	80	0.0500000
NODE_9624_length_873_cov_20.432817	347	427	6	39	80	0.4875000
NODE_9624_length_873_cov_20.432817	347	427	8	11	80	0.1375000
NODE_9624_length_873_cov_20.432817	400	480	2	17	80	0.2125000
NODE_9624_length_873_cov_20.432817	400	480	3	45	80	0.5625000
NODE_9624_length_873_cov_20.432817	400	480	4	18	80	0.2250000
NODE_9624_length_873_cov_20.432817	476	556	2	45	80	0.5625000
NODE_9624_length_873_cov_20.432817	476	556	4	35	80	0.4375000
NODE_9624_length_873_cov_20.432817	529	609	0	43	80	0.5375000
NODE_9624_length_873_cov_20.432817	529	609	2	37	80	0.4625000
NODE_9625_length_873_cov_19.913437	445	525	0	16	80	0.2000000
NODE_9625_length_873_cov_19.913437	445	525	2	21	80	0.2625000
NODE_9625_length_873_cov_19.913437	445	525	6	43	80	0.5375000
NODE_9625_length_873_cov_19.913437	498	578	4	25	80	0.3125000
NODE_9625_length_873_cov_19.913437	498	578	6	55	80	0.6875000
NODE_9626_length_873_cov_16.718346	276	356	0	80	80	1.0000000
NODE_9626_length_873_cov_16.718346	329	409	0	80	80	1.0000000
NODE_9627_length_873_cov_16.422481	423	503	0	80	80	1.0000000
NODE_9627_length_873_cov_16.422481	476	556	0	80	80	1.0000000
NODE_9628_length_873_cov_11.198966	410	490	0	80	80	1.0000000
NODE_9628_length_873_cov_11.198966	463	543	0	61	80	0.7625000
NODE_9628_length_873_cov_11.198966	463	543	2	6	80	0.0750000
NODE_9628_length_873_cov_11.198966	463	543	4	13	80	0.1625000
NODE_9629_length_873_cov_9.799742	334	414	0	80	80	1.0000000
NODE_9629_length_873_cov_9.799742	387	467	0	80	80	1.0000000
NODE_9632_length_873_cov_3.828165	490	570	0	80	80	1.0000000
NODE_9632_length_873_cov_3.828165	543	583	0	40	40	1.0000000
NODE_9632_length_873_cov_3.828165	690	735	0	37	45	0.8222222
NODE_9632_length_873_cov_3.828165	690	735	2	8	45	0.1777778
NODE_9633_length_873_cov_3.443152	716	746	0	30	30	1.0000000
NODE_9647_length_873_cov_1.239018	593	658	4	1	65	0.0153846
NODE_9647_length_873_cov_1.239018	593	658	6	3	65	0.0461538
NODE_9647_length_873_cov_1.239018	593	658	8	4	65	0.0615385
NODE_9647_length_873_cov_1.239018	593	658	10	3	65	0.0461538
NODE_9647_length_873_cov_1.239018	593	658	12	8	65	0.1230769
NODE_9647_length_873_cov_1.239018	593	658	14	4	65	0.0615385
NODE_9647_length_873_cov_1.239018	593	658	16	23	65	0.3538462
NODE_9647_length_873_cov_1.239018	593	658	18	19	65	0.2923077
NODE_9651_length_872_cov_47.732212	432	512	0	80	80	1.0000000
NODE_9651_length_872_cov_47.732212	484	564	0	80	80	1.0000000
NODE_9651_length_872_cov_47.732212	560	640	0	80	80	1.0000000
NODE_9651_length_872_cov_47.732212	613	693	0	80	80	1.0000000
NODE_9652_length_872_cov_16.204398	349	429	0	80	80	1.0000000
NODE_9652_length_872_cov_16.204398	402	482	0	53	80	0.6625000
NODE_9652_length_872_cov_16.204398	402	482	2	21	80	0.2625000
NODE_9652_length_872_cov_16.204398	402	482	9	6	80	0.0750000
NODE_9652_length_872_cov_16.204398	478	558	8	6	80	0.0750000
NODE_9652_length_872_cov_16.204398	478	558	9	5	80	0.0625000
NODE_9652_length_872_cov_16.204398	478	558	10	69	80	0.8625000
NODE_9652_length_872_cov_16.204398	531	611	0	13	80	0.1625000
NODE_9652_length_872_cov_16.204398	531	611	7	1	80	0.0125000
NODE_9652_length_872_cov_16.204398	531	611	8	45	80	0.5625000
NODE_9652_length_872_cov_16.204398	531	611	10	21	80	0.2625000
NODE_9653_length_872_cov_12.835705	376	456	0	19	80	0.2375000
NODE_9653_length_872_cov_12.835705	376	456	2	61	80	0.7625000
NODE_9653_length_872_cov_12.835705	429	509	0	35	80	0.4375000
NODE_9653_length_872_cov_12.835705	429	509	2	45	80	0.5625000
NODE_9654_length_872_cov_9.657180	356	431	0	75	75	1.0000000
NODE_9660_length_872_cov_3.531695	425	505	0	80	80	1.0000000
NODE_9660_length_872_cov_3.531695	478	559	0	81	81	1.0000000
NODE_9673_length_871_cov_56.841969	265	345	0	76	80	0.9500000
NODE_9673_length_871_cov_56.841969	265	345	2	4	80	0.0500000
NODE_9673_length_871_cov_56.841969	318	398	0	80	80	1.0000000
NODE_9673_length_871_cov_56.841969	394	474	0	67	80	0.8375000
NODE_9673_length_871_cov_56.841969	394	474	2	13	80	0.1625000
NODE_9673_length_871_cov_56.841969	447	527	0	35	80	0.4375000
NODE_9673_length_871_cov_56.841969	447	527	2	45	80	0.5625000
NODE_9674_length_871_cov_47.528497	461	541	0	80	80	1.0000000
NODE_9674_length_871_cov_47.528497	514	594	0	80	80	1.0000000
NODE_9675_length_871_cov_31.145078	326	406	0	15	80	0.1875000
NODE_9675_length_871_cov_31.145078	326	406	4	65	80	0.8125000
NODE_9675_length_871_cov_31.145078	379	459	0	17	80	0.2125000
NODE_9675_length_871_cov_31.145078	379	459	3	1	80	0.0125000
NODE_9675_length_871_cov_31.145078	379	459	4	62	80	0.7750000
NODE_9676_length_871_cov_27.993523	379	459	0	80	80	1.0000000
NODE_9676_length_871_cov_27.993523	432	512	0	70	80	0.8750000
NODE_9676_length_871_cov_27.993523	432	512	2	10	80	0.1250000
NODE_9677_length_871_cov_25.954663	463	543	0	6	80	0.0750000
NODE_9677_length_871_cov_25.954663	463	543	4	74	80	0.9250000
NODE_9677_length_871_cov_25.954663	516	596	0	59	80	0.7375000
NODE_9677_length_871_cov_25.954663	516	596	4	21	80	0.2625000
NODE_9678_length_871_cov_24.069948	492	558	0	66	66	1.0000000
NODE_9678_length_871_cov_24.069948	558	634	0	76	76	1.0000000
NODE_9679_length_871_cov_23.953368	445	522	2	7	77	0.0909091
NODE_9679_length_871_cov_23.953368	445	522	3	3	77	0.0389610
NODE_9679_length_871_cov_23.953368	445	522	4	17	77	0.2207792
NODE_9679_length_871_cov_23.953368	445	522	5	2	77	0.0259740
NODE_9679_length_871_cov_23.953368	445	522	6	5	77	0.0649351
NODE_9679_length_871_cov_23.953368	445	522	7	11	77	0.1428571
NODE_9679_length_871_cov_23.953368	445	522	8	32	77	0.4155844
NODE_9680_length_871_cov_19.304404	335	415	2	80	80	1.0000000
NODE_9680_length_871_cov_19.304404	388	468	0	24	80	0.3000000
NODE_9680_length_871_cov_19.304404	388	468	1	17	80	0.2125000
NODE_9680_length_871_cov_19.304404	388	468	2	39	80	0.4875000
NODE_9682_length_871_cov_18.108808	370	450	0	80	80	1.0000000
NODE_9682_length_871_cov_18.108808	423	503	0	80	80	1.0000000
NODE_9683_length_871_cov_17.034974	362	442	1	25	80	0.3125000
NODE_9683_length_871_cov_17.034974	362	442	2	55	80	0.6875000
NODE_9683_length_871_cov_17.034974	415	495	1	52	80	0.6500000
NODE_9683_length_871_cov_17.034974	415	495	2	28	80	0.3500000
NODE_9684_length_871_cov_16.768135	374	454	0	41	80	0.5125000
NODE_9684_length_871_cov_16.768135	374	454	2	39	80	0.4875000
NODE_9685_length_871_cov_14.196891	267	347	0	57	80	0.7125000
NODE_9685_length_871_cov_14.196891	267	347	2	23	80	0.2875000
NODE_9685_length_871_cov_14.196891	320	400	0	8	80	0.1000000
NODE_9685_length_871_cov_14.196891	320	400	2	72	80	0.9000000
NODE_9686_length_871_cov_13.443005	246	326	0	16	80	0.2000000
NODE_9686_length_871_cov_13.443005	246	326	2	64	80	0.8000000
NODE_9686_length_871_cov_13.443005	299	322	0	12	23	0.5217391
NODE_9686_length_871_cov_13.443005	299	322	2	11	23	0.4782609
NODE_9687_length_871_cov_11.839378	29	109	0	80	80	1.0000000
NODE_9687_length_871_cov_11.839378	82	149	0	67	67	1.0000000
NODE_9687_length_871_cov_11.839378	331	411	0	80	80	1.0000000
NODE_9687_length_871_cov_11.839378	384	464	0	80	80	1.0000000
NODE_9689_length_871_cov_5.730570	316	373	0	40	57	0.7017544
NODE_9689_length_871_cov_5.730570	316	373	2	17	57	0.2982456
NODE_9694_length_871_cov_3.544041	428	508	0	80	80	1.0000000
NODE_9694_length_871_cov_3.544041	481	561	0	80	80	1.0000000
NODE_9716_length_870_cov_43.400778	542	622	0	80	80	1.0000000
NODE_9716_length_870_cov_43.400778	595	675	0	80	80	1.0000000
NODE_9719_length_870_cov_28.249027	442	524	0	3	82	0.0365854
NODE_9719_length_870_cov_28.249027	442	524	2	15	82	0.1829268
NODE_9719_length_870_cov_28.249027	442	524	4	2	82	0.0243902
NODE_9719_length_870_cov_28.249027	442	524	6	12	82	0.1463415
NODE_9719_length_870_cov_28.249027	442	524	8	50	82	0.6097561
NODE_9719_length_870_cov_28.249027	497	577	4	49	80	0.6125000
NODE_9719_length_870_cov_28.249027	497	577	6	6	80	0.0750000
NODE_9719_length_870_cov_28.249027	497	577	8	25	80	0.3125000
NODE_9720_length_870_cov_26.992218	240	320	0	80	80	1.0000000
NODE_9720_length_870_cov_26.992218	293	373	0	80	80	1.0000000
NODE_9720_length_870_cov_26.992218	369	449	0	80	80	1.0000000
NODE_9720_length_870_cov_26.992218	422	502	0	80	80	1.0000000
NODE_9721_length_870_cov_25.806744	186	237	0	28	51	0.5490196
NODE_9721_length_870_cov_25.806744	186	237	2	16	51	0.3137255
NODE_9721_length_870_cov_25.806744	186	237	6	7	51	0.1372549
NODE_9721_length_870_cov_25.806744	391	471	0	44	80	0.5500000
NODE_9721_length_870_cov_25.806744	391	471	2	24	80	0.3000000
NODE_9721_length_870_cov_25.806744	391	471	4	12	80	0.1500000
NODE_9721_length_870_cov_25.806744	444	524	2	30	80	0.3750000
NODE_9721_length_870_cov_25.806744	444	524	4	50	80	0.6250000
NODE_9722_length_870_cov_18.862516	345	425	0	80	80	1.0000000
NODE_9722_length_870_cov_18.862516	398	478	0	80	80	1.0000000
NODE_9723_length_870_cov_15.686122	330	410	0	80	80	1.0000000
NODE_9723_length_870_cov_15.686122	383	463	0	48	80	0.6000000
NODE_9723_length_870_cov_15.686122	383	463	2	32	80	0.4000000
NODE_9725_length_870_cov_13.334630	479	559	0	61	80	0.7625000
NODE_9725_length_870_cov_13.334630	479	559	2	19	80	0.2375000
NODE_9725_length_870_cov_13.334630	532	612	0	80	80	1.0000000
NODE_9726_length_870_cov_9.712062	410	490	0	43	80	0.5375000
NODE_9726_length_870_cov_9.712062	410	490	2	37	80	0.4625000
NODE_9726_length_870_cov_9.712062	463	542	0	4	79	0.0506329
NODE_9726_length_870_cov_9.712062	463	542	2	75	79	0.9493671
NODE_9728_length_870_cov_7.556420	448	528	0	10	80	0.1250000
NODE_9728_length_870_cov_7.556420	448	528	6	70	80	0.8750000
NODE_9728_length_870_cov_7.556420	501	581	0	33	80	0.4125000
NODE_9728_length_870_cov_7.556420	501	581	6	47	80	0.5875000
NODE_9746_length_869_cov_42.784416	395	475	0	12	80	0.1500000
NODE_9746_length_869_cov_42.784416	395	475	2	68	80	0.8500000
NODE_9746_length_869_cov_42.784416	448	528	0	55	80	0.6875000
NODE_9746_length_869_cov_42.784416	448	528	2	25	80	0.3125000
NODE_9747_length_869_cov_29.525974	211	291	0	80	80	1.0000000
NODE_9747_length_869_cov_29.525974	264	344	0	80	80	1.0000000
NODE_9748_length_869_cov_16.258442	389	469	0	8	80	0.1000000
NODE_9748_length_869_cov_16.258442	389	469	2	72	80	0.9000000
NODE_9748_length_869_cov_16.258442	442	522	0	28	80	0.3500000
NODE_9748_length_869_cov_16.258442	442	522	2	52	80	0.6500000
NODE_9749_length_869_cov_15.940260	321	401	0	33	80	0.4125000
NODE_9749_length_869_cov_15.940260	321	401	4	1	80	0.0125000
NODE_9749_length_869_cov_15.940260	321	401	5	46	80	0.5750000
NODE_9749_length_869_cov_15.940260	374	454	0	80	80	1.0000000
NODE_9750_length_869_cov_9.619481	402	442	193	1	40	0.0250000
NODE_9750_length_869_cov_9.619481	402	442	197	1	40	0.0250000
NODE_9750_length_869_cov_9.619481	402	442	203	2	40	0.0500000
NODE_9750_length_869_cov_9.619481	402	442	206	2	40	0.0500000
NODE_9750_length_869_cov_9.619481	402	442	207	2	40	0.0500000
NODE_9750_length_869_cov_9.619481	402	442	208	2	40	0.0500000
NODE_9750_length_869_cov_9.619481	402	442	211	1	40	0.0250000
NODE_9750_length_869_cov_9.619481	402	442	213	1	40	0.0250000
NODE_9750_length_869_cov_9.619481	402	442	214	1	40	0.0250000
NODE_9750_length_869_cov_9.619481	402	442	217	1	40	0.0250000
NODE_9750_length_869_cov_9.619481	402	442	223	1	40	0.0250000
NODE_9750_length_869_cov_9.619481	402	442	225	1	40	0.0250000
NODE_9750_length_869_cov_9.619481	402	442	227	1	40	0.0250000
NODE_9750_length_869_cov_9.619481	402	442	231	1	40	0.0250000
NODE_9750_length_869_cov_9.619481	402	442	233	1	40	0.0250000
NODE_9750_length_869_cov_9.619481	402	442	234	1	40	0.0250000
NODE_9750_length_869_cov_9.619481	402	442	242	1	40	0.0250000
NODE_9750_length_869_cov_9.619481	402	442	246	3	40	0.0750000
NODE_9750_length_869_cov_9.619481	402	442	255	1	40	0.0250000
NODE_9750_length_869_cov_9.619481	402	442	257	1	40	0.0250000
NODE_9750_length_869_cov_9.619481	402	442	258	1	40	0.0250000
NODE_9750_length_869_cov_9.619481	402	442	260	2	40	0.0500000
NODE_9750_length_869_cov_9.619481	402	442	262	1	40	0.0250000
NODE_9750_length_869_cov_9.619481	402	442	264	1	40	0.0250000
NODE_9750_length_869_cov_9.619481	402	442	267	1	40	0.0250000
NODE_9750_length_869_cov_9.619481	402	442	279	1	40	0.0250000
NODE_9750_length_869_cov_9.619481	402	442	281	2	40	0.0500000
NODE_9750_length_869_cov_9.619481	402	442	290	1	40	0.0250000
NODE_9750_length_869_cov_9.619481	402	442	302	1	40	0.0250000
NODE_9750_length_869_cov_9.619481	402	442	321	1	40	0.0250000
NODE_9750_length_869_cov_9.619481	402	442	324	1	40	0.0250000
NODE_9750_length_869_cov_9.619481	402	442	327	1	40	0.0250000
NODE_9751_length_869_cov_7.123377	392	472	0	65	80	0.8125000
NODE_9751_length_869_cov_7.123377	392	472	2	15	80	0.1875000
NODE_9751_length_869_cov_7.123377	445	525	0	12	80	0.1500000
NODE_9751_length_869_cov_7.123377	445	525	2	68	80	0.8500000
NODE_9753_length_869_cov_3.658442	310	378	0	68	68	1.0000000
NODE_9777_length_868_cov_57.465540	355	435	0	80	80	1.0000000
NODE_9778_length_868_cov_46.509753	0	65	0	65	65	1.0000000
NODE_9778_length_868_cov_46.509753	0	65	0	65	65	1.0000000
NODE_9778_length_868_cov_46.509753	0	65	0	65	65	1.0000000
NODE_9778_length_868_cov_46.509753	0	65	0	65	65	1.0000000
NODE_9778_length_868_cov_46.509753	61	141	0	80	80	1.0000000
NODE_9778_length_868_cov_46.509753	61	141	0	80	80	1.0000000
NODE_9778_length_868_cov_46.509753	114	194	0	80	80	1.0000000
NODE_9778_length_868_cov_46.509753	114	194	0	80	80	1.0000000
NODE_9779_length_868_cov_26.092328	318	398	0	80	80	1.0000000
NODE_9779_length_868_cov_26.092328	371	451	0	80	80	1.0000000
NODE_9781_length_868_cov_22.555267	377	457	6	6	80	0.0750000
NODE_9781_length_868_cov_22.555267	377	457	12	1	80	0.0125000
NODE_9781_length_868_cov_22.555267	377	457	13	1	80	0.0125000
NODE_9781_length_868_cov_22.555267	377	457	14	19	80	0.2375000
NODE_9781_length_868_cov_22.555267	377	457	16	17	80	0.2125000
NODE_9781_length_868_cov_22.555267	377	457	20	36	80	0.4500000
NODE_9781_length_868_cov_22.555267	430	510	12	26	80	0.3250000
NODE_9781_length_868_cov_22.555267	430	510	14	22	80	0.2750000
NODE_9781_length_868_cov_22.555267	430	510	16	1	80	0.0125000
NODE_9781_length_868_cov_22.555267	430	510	20	31	80	0.3875000
NODE_9782_length_868_cov_20.466840	259	339	0	80	80	1.0000000
NODE_9782_length_868_cov_20.466840	312	392	0	80	80	1.0000000
NODE_9782_length_868_cov_20.466840	388	468	0	80	80	1.0000000
NODE_9782_length_868_cov_20.466840	441	521	0	80	80	1.0000000
NODE_9783_length_868_cov_20.414824	311	391	2	12	80	0.1500000
NODE_9783_length_868_cov_20.414824	311	391	4	22	80	0.2750000
NODE_9783_length_868_cov_20.414824	311	391	6	46	80	0.5750000
NODE_9783_length_868_cov_20.414824	364	444	0	10	80	0.1250000
NODE_9783_length_868_cov_20.414824	364	444	2	55	80	0.6875000
NODE_9783_length_868_cov_20.414824	364	444	6	15	80	0.1875000
NODE_9784_length_868_cov_17.613784	340	420	2	35	80	0.4375000
NODE_9784_length_868_cov_17.613784	340	420	4	45	80	0.5625000
NODE_9784_length_868_cov_17.613784	393	473	2	45	80	0.5625000
NODE_9784_length_868_cov_17.613784	393	473	4	35	80	0.4375000
NODE_9785_length_868_cov_15.768531	353	433	0	80	80	1.0000000
NODE_9785_length_868_cov_15.768531	406	486	0	80	80	1.0000000
NODE_9786_length_868_cov_13.997399	611	691	0	80	80	1.0000000
NODE_9786_length_868_cov_13.997399	664	744	0	80	80	1.0000000
NODE_9787_length_868_cov_13.224967	451	531	0	80	80	1.0000000
NODE_9787_length_868_cov_13.224967	504	583	0	79	79	1.0000000
NODE_9788_length_868_cov_11.851756	363	422	0	59	59	1.0000000
NODE_9788_length_868_cov_11.851756	395	475	0	80	80	1.0000000
NODE_9789_length_868_cov_11.352406	361	441	0	80	80	1.0000000
NODE_9789_length_868_cov_11.352406	414	494	0	64	80	0.8000000
NODE_9789_length_868_cov_11.352406	414	494	2	16	80	0.2000000
NODE_9790_length_868_cov_11.335501	289	369	0	80	80	1.0000000
NODE_9790_length_868_cov_11.335501	342	422	0	80	80	1.0000000
NODE_9791_length_868_cov_8.455137	401	481	0	80	80	1.0000000
NODE_9791_length_868_cov_8.455137	454	534	0	80	80	1.0000000
NODE_9816_length_867_cov_27.756510	333	376	0	43	43	1.0000000
NODE_9816_length_867_cov_27.756510	349	429	0	80	80	1.0000000
NODE_9816_length_867_cov_27.756510	425	505	0	80	80	1.0000000
NODE_9816_length_867_cov_27.756510	478	542	0	64	64	1.0000000
NODE_9817_length_867_cov_25.354167	280	345	0	32	65	0.4923077
NODE_9817_length_867_cov_25.354167	280	345	2	32	65	0.4923077
NODE_9817_length_867_cov_25.354167	280	345	4	1	65	0.0153846
NODE_9817_length_867_cov_25.354167	325	397	0	19	72	0.2638889
NODE_9817_length_867_cov_25.354167	325	397	4	34	72	0.4722222
NODE_9817_length_867_cov_25.354167	325	397	6	19	72	0.2638889
NODE_9818_length_867_cov_23.968750	369	449	0	14	80	0.1750000
NODE_9818_length_867_cov_23.968750	369	449	2	19	80	0.2375000
NODE_9818_length_867_cov_23.968750	369	449	4	47	80	0.5875000
NODE_9818_length_867_cov_23.968750	422	502	0	67	80	0.8375000
NODE_9818_length_867_cov_23.968750	422	502	2	13	80	0.1625000
NODE_9819_length_867_cov_21.220052	524	604	0	80	80	1.0000000
NODE_9819_length_867_cov_21.220052	577	657	0	80	80	1.0000000
NODE_9820_length_867_cov_15.042969	287	364	0	8	77	0.1038961
NODE_9820_length_867_cov_15.042969	287	364	2	7	77	0.0909091
NODE_9820_length_867_cov_15.042969	287	364	4	43	77	0.5584416
NODE_9820_length_867_cov_15.042969	287	364	6	4	77	0.0519481
NODE_9820_length_867_cov_15.042969	287	364	8	15	77	0.1948052
NODE_9821_length_867_cov_11.057292	305	373	0	38	68	0.5588235
NODE_9821_length_867_cov_11.057292	305	373	1	10	68	0.1470588
NODE_9821_length_867_cov_11.057292	305	373	4	20	68	0.2941177
NODE_9821_length_867_cov_11.057292	346	426	1	7	80	0.0875000
NODE_9821_length_867_cov_11.057292	346	426	4	61	80	0.7625000
NODE_9821_length_867_cov_11.057292	346	426	6	12	80	0.1500000
NODE_9821_length_867_cov_11.057292	475	555	0	31	80	0.3875000
NODE_9821_length_867_cov_11.057292	475	555	2	21	80	0.2625000
NODE_9821_length_867_cov_11.057292	475	555	3	10	80	0.1250000
NODE_9821_length_867_cov_11.057292	475	555	4	18	80	0.2250000
NODE_9822_length_867_cov_8.127604	347	427	0	18	80	0.2250000
NODE_9822_length_867_cov_8.127604	347	427	2	62	80	0.7750000
NODE_9822_length_867_cov_8.127604	400	480	0	3	80	0.0375000
NODE_9822_length_867_cov_8.127604	400	480	2	40	80	0.5000000
NODE_9822_length_867_cov_8.127604	400	480	4	37	80	0.4625000
NODE_9823_length_867_cov_7.621094	292	372	0	16	80	0.2000000
NODE_9823_length_867_cov_7.621094	292	372	2	64	80	0.8000000
NODE_9823_length_867_cov_7.621094	345	425	0	31	80	0.3875000
NODE_9823_length_867_cov_7.621094	345	425	2	49	80	0.6125000
NODE_9826_length_867_cov_5.494792	445	525	0	26	80	0.3250000
NODE_9826_length_867_cov_5.494792	445	525	4	54	80	0.6750000
NODE_9826_length_867_cov_5.494792	498	578	0	79	80	0.9875000
NODE_9826_length_867_cov_5.494792	498	578	4	1	80	0.0125000
NODE_9857_length_866_cov_49.224250	269	349	0	52	80	0.6500000
NODE_9857_length_866_cov_49.224250	269	349	4	28	80	0.3500000
NODE_9857_length_866_cov_49.224250	322	402	4	42	80	0.5250000
NODE_9857_length_866_cov_49.224250	322	402	6	38	80	0.4750000
NODE_9858_length_866_cov_47.160365	428	508	0	29	80	0.3625000
NODE_9858_length_866_cov_47.160365	428	508	2	51	80	0.6375000
NODE_9858_length_866_cov_47.160365	481	561	0	47	80	0.5875000
NODE_9858_length_866_cov_47.160365	481	561	2	33	80	0.4125000
NODE_9858_length_866_cov_47.160365	557	637	0	80	80	1.0000000
NODE_9858_length_866_cov_47.160365	610	690	0	80	80	1.0000000
NODE_9859_length_866_cov_23.398957	281	361	0	70	80	0.8750000
NODE_9859_length_866_cov_23.398957	281	361	2	10	80	0.1250000
NODE_9859_length_866_cov_23.398957	334	414	0	17	80	0.2125000
NODE_9859_length_866_cov_23.398957	334	414	2	63	80	0.7875000
NODE_9860_length_866_cov_22.186441	455	535	0	80	80	1.0000000
NODE_9860_length_866_cov_22.186441	508	588	0	80	80	1.0000000
NODE_9861_length_866_cov_18.362451	451	531	2	13	80	0.1625000
NODE_9861_length_866_cov_18.362451	451	531	3	16	80	0.2000000
NODE_9861_length_866_cov_18.362451	451	531	4	51	80	0.6375000
NODE_9861_length_866_cov_18.362451	504	584	1	37	80	0.4625000
NODE_9861_length_866_cov_18.362451	504	584	2	29	80	0.3625000
NODE_9861_length_866_cov_18.362451	504	584	4	14	80	0.1750000
NODE_9862_length_866_cov_16.830508	372	452	2	75	80	0.9375000
NODE_9862_length_866_cov_16.830508	372	452	4	5	80	0.0625000
NODE_9862_length_866_cov_16.830508	425	505	2	80	80	1.0000000
NODE_9882_length_865_cov_63.137076	288	368	0	80	80	1.0000000
NODE_9882_length_865_cov_63.137076	341	421	0	80	80	1.0000000
NODE_9883_length_865_cov_19.882507	335	415	0	80	80	1.0000000
NODE_9883_length_865_cov_19.882507	388	468	0	80	80	1.0000000
NODE_9884_length_865_cov_17.784595	306	386	0	80	80	1.0000000
NODE_9884_length_865_cov_17.784595	359	439	0	80	80	1.0000000
NODE_9885_length_865_cov_16.150131	451	531	6	80	80	1.0000000
NODE_9885_length_865_cov_16.150131	504	584	0	34	80	0.4250000
NODE_9885_length_865_cov_16.150131	504	584	6	46	80	0.5750000
NODE_9886_length_865_cov_14.751958	473	553	0	80	80	1.0000000
NODE_9886_length_865_cov_14.751958	473	553	0	80	80	1.0000000
NODE_9886_length_865_cov_14.751958	526	589	0	63	63	1.0000000
NODE_9886_length_865_cov_14.751958	526	606	0	80	80	1.0000000
NODE_9887_length_865_cov_10.937337	422	502	6	80	80	1.0000000
NODE_9887_length_865_cov_10.937337	475	555	0	40	80	0.5000000
NODE_9887_length_865_cov_10.937337	475	555	6	40	80	0.5000000
NODE_9889_length_865_cov_9.167102	389	469	0	80	80	1.0000000
NODE_9889_length_865_cov_9.167102	442	522	0	80	80	1.0000000
NODE_9912_length_864_cov_13.398693	491	571	0	45	80	0.5625000
NODE_9912_length_864_cov_13.398693	491	571	2	35	80	0.4375000
NODE_9912_length_864_cov_13.398693	544	624	0	80	80	1.0000000
NODE_9913_length_864_cov_8.466667	308	388	0	80	80	1.0000000
NODE_9913_length_864_cov_8.466667	361	441	0	80	80	1.0000000
NODE_9917_length_864_cov_3.947712	651	676	0	5	25	0.2000000
NODE_9917_length_864_cov_3.947712	651	676	1	16	25	0.6400000
NODE_9917_length_864_cov_3.947712	651	676	6	4	25	0.1600000
NODE_9917_length_864_cov_3.947712	725	805	8	80	80	1.0000000
NODE_9917_length_864_cov_3.947712	778	844	0	19	66	0.2878788
NODE_9917_length_864_cov_3.947712	778	844	4	14	66	0.2121212
NODE_9917_length_864_cov_3.947712	778	844	5	1	66	0.0151515
NODE_9917_length_864_cov_3.947712	778	844	6	4	66	0.0606061
NODE_9917_length_864_cov_3.947712	778	844	8	28	66	0.4242424
NODE_9931_length_863_cov_72.856021	241	321	0	80	80	1.0000000
NODE_9931_length_863_cov_72.856021	294	374	0	28	80	0.3500000
NODE_9931_length_863_cov_72.856021	294	374	2	52	80	0.6500000
NODE_9931_length_863_cov_72.856021	370	450	0	37	80	0.4625000
NODE_9931_length_863_cov_72.856021	370	450	2	43	80	0.5375000
NODE_9931_length_863_cov_72.856021	423	503	0	80	80	1.0000000
NODE_9932_length_863_cov_37.130890	363	443	0	80	80	1.0000000
NODE_9932_length_863_cov_37.130890	416	496	0	80	80	1.0000000
NODE_9932_length_863_cov_37.130890	492	572	0	80	80	1.0000000
NODE_9932_length_863_cov_37.130890	545	617	0	71	72	0.9861111
NODE_9932_length_863_cov_37.130890	545	617	2	1	72	0.0138889
NODE_9933_length_863_cov_33.159686	287	367	0	56	80	0.7000000
NODE_9933_length_863_cov_33.159686	287	367	8	24	80	0.3000000
NODE_9933_length_863_cov_33.159686	340	420	0	3	80	0.0375000
NODE_9933_length_863_cov_33.159686	340	420	8	77	80	0.9625000
NODE_9934_length_863_cov_24.714660	370	450	0	53	80	0.6625000
NODE_9934_length_863_cov_24.714660	370	450	2	27	80	0.3375000
NODE_9934_length_863_cov_24.714660	423	503	2	80	80	1.0000000
NODE_9935_length_863_cov_21.945026	341	421	0	80	80	1.0000000
NODE_9935_length_863_cov_21.945026	394	474	0	80	80	1.0000000
NODE_9936_length_863_cov_19.794503	393	473	0	25	80	0.3125000
NODE_9936_length_863_cov_19.794503	393	473	2	55	80	0.6875000
NODE_9936_length_863_cov_19.794503	446	526	0	78	80	0.9750000
NODE_9936_length_863_cov_19.794503	446	526	2	2	80	0.0250000
NODE_9937_length_863_cov_11.778796	303	383	0	43	80	0.5375000
NODE_9937_length_863_cov_11.778796	303	383	2	2	80	0.0250000
NODE_9937_length_863_cov_11.778796	303	383	6	35	80	0.4375000
NODE_9937_length_863_cov_11.778796	356	436	4	13	80	0.1625000
NODE_9937_length_863_cov_11.778796	356	436	6	67	80	0.8375000
NODE_9938_length_863_cov_10.026178	283	363	0	2	80	0.0250000
NODE_9938_length_863_cov_10.026178	283	363	1	78	80	0.9750000
NODE_9938_length_863_cov_10.026178	336	416	0	55	80	0.6875000
NODE_9938_length_863_cov_10.026178	336	416	1	25	80	0.3125000
NODE_9957_length_862_cov_46.811271	272	352	0	80	80	1.0000000
NODE_9957_length_862_cov_46.811271	325	405	0	80	80	1.0000000
NODE_9957_length_862_cov_46.811271	401	481	0	80	80	1.0000000
NODE_9957_length_862_cov_46.811271	454	534	0	80	80	1.0000000
NODE_9958_length_862_cov_34.638270	259	339	0	68	80	0.8500000
NODE_9958_length_862_cov_34.638270	259	339	1	12	80	0.1500000
NODE_9958_length_862_cov_34.638270	312	392	0	80	80	1.0000000
NODE_9958_length_862_cov_34.638270	388	468	0	31	80	0.3875000
NODE_9958_length_862_cov_34.638270	388	468	2	8	80	0.1000000
NODE_9958_length_862_cov_34.638270	388	468	4	21	80	0.2625000
NODE_9958_length_862_cov_34.638270	388	468	12	20	80	0.2500000
NODE_9958_length_862_cov_34.638270	441	521	4	7	80	0.0875000
NODE_9958_length_862_cov_34.638270	441	521	10	20	80	0.2500000
NODE_9958_length_862_cov_34.638270	441	521	12	53	80	0.6625000
NODE_9959_length_862_cov_32.068152	468	548	0	30	80	0.3750000
NODE_9959_length_862_cov_32.068152	468	548	4	50	80	0.6250000
NODE_9959_length_862_cov_32.068152	521	601	0	32	80	0.4000000
NODE_9959_length_862_cov_32.068152	521	601	4	48	80	0.6000000
NODE_9960_length_862_cov_23.584535	526	606	0	31	80	0.3875000
NODE_9960_length_862_cov_23.584535	526	606	2	45	80	0.5625000
NODE_9960_length_862_cov_23.584535	526	606	4	4	80	0.0500000
NODE_9960_length_862_cov_23.584535	579	659	0	80	80	1.0000000
NODE_9961_length_862_cov_19.980341	347	427	0	62	80	0.7750000
NODE_9961_length_862_cov_19.980341	347	427	2	18	80	0.2250000
NODE_9961_length_862_cov_19.980341	400	480	0	27	80	0.3375000
NODE_9961_length_862_cov_19.980341	400	480	2	53	80	0.6625000
NODE_9962_length_862_cov_19.079948	379	459	0	80	80	1.0000000
NODE_9962_length_862_cov_19.079948	432	512	0	80	80	1.0000000
NODE_9963_length_862_cov_18.425950	94	174	0	80	80	1.0000000
NODE_9963_length_862_cov_18.425950	147	201	0	54	54	1.0000000
NODE_9963_length_862_cov_18.425950	392	472	0	64	80	0.8000000
NODE_9963_length_862_cov_18.425950	392	472	4	16	80	0.2000000
NODE_9963_length_862_cov_18.425950	445	525	0	11	80	0.1375000
NODE_9963_length_862_cov_18.425950	445	525	4	69	80	0.8625000
NODE_9964_length_862_cov_11.740498	348	428	2	49	80	0.6125000
NODE_9964_length_862_cov_11.740498	348	428	4	31	80	0.3875000
NODE_9964_length_862_cov_11.740498	401	481	2	13	80	0.1625000
NODE_9964_length_862_cov_11.740498	401	481	4	59	80	0.7375000
NODE_9964_length_862_cov_11.740498	401	481	6	8	80	0.1000000
NODE_9965_length_862_cov_11.685452	292	372	0	26	80	0.3250000
NODE_9965_length_862_cov_11.685452	292	372	2	1	80	0.0125000
NODE_9965_length_862_cov_11.685452	292	372	4	53	80	0.6625000
NODE_9965_length_862_cov_11.685452	345	425	0	1	80	0.0125000
NODE_9965_length_862_cov_11.685452	345	425	2	36	80	0.4500000
NODE_9965_length_862_cov_11.685452	345	425	4	43	80	0.5375000
NODE_9966_length_862_cov_8.259502	385	465	4	80	80	1.0000000
NODE_9966_length_862_cov_8.259502	438	518	0	15	80	0.1875000
NODE_9966_length_862_cov_8.259502	438	518	2	26	80	0.3250000
NODE_9966_length_862_cov_8.259502	438	518	4	39	80	0.4875000
NODE_9970_length_862_cov_2.895151	388	468	0	80	80	1.0000000
NODE_9970_length_862_cov_2.895151	441	521	0	80	80	1.0000000
NODE_9984_length_861_cov_52.679790	450	530	0	41	80	0.5125000
NODE_9984_length_861_cov_52.679790	450	530	2	39	80	0.4875000
NODE_9984_length_861_cov_52.679790	503	583	0	4	80	0.0500000
NODE_9984_length_861_cov_52.679790	503	583	2	76	80	0.9500000
NODE_9985_length_861_cov_34.868766	470	550	0	80	80	1.0000000
NODE_9985_length_861_cov_34.868766	523	603	0	80	80	1.0000000
NODE_9986_length_861_cov_25.622047	145	225	0	61	80	0.7625000
NODE_9986_length_861_cov_25.622047	145	225	2	19	80	0.2375000
NODE_9986_length_861_cov_25.622047	198	278	0	8	80	0.1000000
NODE_9986_length_861_cov_25.622047	198	278	2	72	80	0.9000000
NODE_9987_length_861_cov_22.052493	401	481	0	80	80	1.0000000
NODE_9987_length_861_cov_22.052493	454	534	0	80	80	1.0000000
NODE_9988_length_861_cov_19.913386	400	480	0	80	80	1.0000000
NODE_9988_length_861_cov_19.913386	453	533	0	80	80	1.0000000
NODE_9989_length_861_cov_15.237533	492	572	0	66	80	0.8250000
NODE_9989_length_861_cov_15.237533	492	572	2	14	80	0.1750000
NODE_9989_length_861_cov_15.237533	545	625	0	80	80	1.0000000
NODE_9990_length_861_cov_12.460630	451	531	0	34	80	0.4250000
NODE_9990_length_861_cov_12.460630	451	531	4	46	80	0.5750000
NODE_9990_length_861_cov_12.460630	504	584	0	80	80	1.0000000
NODE_9991_length_861_cov_9.463255	446	526	0	40	80	0.5000000
NODE_9991_length_861_cov_9.463255	446	526	1	40	80	0.5000000
NODE_9991_length_861_cov_9.463255	499	579	0	80	80	1.0000000
NODE_9992_length_861_cov_9.435696	348	423	0	75	75	1.0000000
NODE_9993_length_861_cov_7.009186	51	91	0	40	40	1.0000000
NODE_9993_length_861_cov_7.009186	185	265	0	79	80	0.9875000
NODE_9993_length_861_cov_7.009186	185	265	1	1	80	0.0125000
NODE_9993_length_861_cov_7.009186	238	318	0	26	80	0.3250000
NODE_9993_length_861_cov_7.009186	238	318	1	15	80	0.1875000
NODE_9993_length_861_cov_7.009186	238	318	2	39	80	0.4875000
NODE_10019_length_860_cov_54.315375	245	325	0	69	80	0.8625000
NODE_10019_length_860_cov_54.315375	245	325	2	11	80	0.1375000
NODE_10019_length_860_cov_54.315375	298	378	0	16	80	0.2000000
NODE_10019_length_860_cov_54.315375	298	378	2	64	80	0.8000000
NODE_10019_length_860_cov_54.315375	374	454	0	29	80	0.3625000
NODE_10019_length_860_cov_54.315375	374	454	2	51	80	0.6375000
NODE_10019_length_860_cov_54.315375	427	507	0	80	80	1.0000000
NODE_10020_length_860_cov_29.618922	356	436	0	80	80	1.0000000
NODE_10020_length_860_cov_29.618922	409	489	0	80	80	1.0000000
NODE_10021_length_860_cov_15.152431	393	473	2	25	80	0.3125000
NODE_10021_length_860_cov_15.152431	393	473	4	55	80	0.6875000
NODE_10021_length_860_cov_15.152431	446	526	0	31	80	0.3875000
NODE_10021_length_860_cov_15.152431	446	526	2	44	80	0.5500000
NODE_10021_length_860_cov_15.152431	446	526	4	5	80	0.0625000
NODE_10022_length_860_cov_11.320631	343	423	0	46	80	0.5750000
NODE_10022_length_860_cov_11.320631	343	423	2	6	80	0.0750000
NODE_10022_length_860_cov_11.320631	343	423	3	28	80	0.3500000
NODE_10022_length_860_cov_11.320631	396	476	2	59	80	0.7375000
NODE_10022_length_860_cov_11.320631	396	476	3	21	80	0.2625000
NODE_10049_length_859_cov_48.173684	432	512	0	80	80	1.0000000
NODE_10049_length_859_cov_48.173684	485	565	0	80	80	1.0000000
NODE_10050_length_859_cov_24.957895	402	482	0	80	80	1.0000000
NODE_10050_length_859_cov_24.957895	455	535	0	80	80	1.0000000
NODE_10051_length_859_cov_23.431579	251	331	0	45	80	0.5625000
NODE_10051_length_859_cov_23.431579	251	331	2	35	80	0.4375000
NODE_10051_length_859_cov_23.431579	304	384	2	75	80	0.9375000
NODE_10051_length_859_cov_23.431579	304	384	4	5	80	0.0625000
NODE_10052_length_859_cov_20.523684	341	421	0	80	80	1.0000000
NODE_10052_length_859_cov_20.523684	394	474	0	80	80	1.0000000
NODE_10053_length_859_cov_17.996053	316	396	0	80	80	1.0000000
NODE_10053_length_859_cov_17.996053	369	449	0	80	80	1.0000000
NODE_10054_length_859_cov_16.757895	404	484	0	80	80	1.0000000
NODE_10054_length_859_cov_16.757895	457	537	0	80	80	1.0000000
NODE_10055_length_859_cov_15.852632	346	426	4	80	80	1.0000000
NODE_10055_length_859_cov_15.852632	399	479	0	52	80	0.6500000
NODE_10055_length_859_cov_15.852632	399	479	4	28	80	0.3500000
NODE_10056_length_859_cov_11.584211	407	487	0	8	80	0.1000000
NODE_10056_length_859_cov_11.584211	407	487	4	32	80	0.4000000
NODE_10056_length_859_cov_11.584211	407	487	6	40	80	0.5000000
NODE_10056_length_859_cov_11.584211	460	540	4	21	80	0.2625000
NODE_10056_length_859_cov_11.584211	460	540	6	59	80	0.7375000
NODE_10057_length_859_cov_10.296053	368	448	0	20	80	0.2500000
NODE_10057_length_859_cov_10.296053	368	448	1	60	80	0.7500000
NODE_10057_length_859_cov_10.296053	421	501	1	54	80	0.6750000
NODE_10057_length_859_cov_10.296053	421	501	2	26	80	0.3250000
NODE_10066_length_859_cov_2.359211	498	578	0	80	80	1.0000000
NODE_10066_length_859_cov_2.359211	551	631	0	80	80	1.0000000
NODE_10079_length_858_cov_54.677207	277	357	0	80	80	1.0000000
NODE_10079_length_858_cov_54.677207	330	410	0	80	80	1.0000000
NODE_10080_length_858_cov_40.584980	500	580	0	80	80	1.0000000
NODE_10080_length_858_cov_40.584980	553	633	0	80	80	1.0000000
NODE_10081_length_858_cov_30.177866	363	443	0	36	80	0.4500000
NODE_10081_length_858_cov_30.177866	363	443	4	44	80	0.5500000
NODE_10081_length_858_cov_30.177866	416	496	4	80	80	1.0000000
NODE_10081_length_858_cov_30.177866	492	572	0	63	80	0.7875000
NODE_10081_length_858_cov_30.177866	492	572	4	17	80	0.2125000
NODE_10081_length_858_cov_30.177866	545	625	0	80	80	1.0000000
NODE_10082_length_858_cov_18.534914	371	451	0	80	80	1.0000000
NODE_10082_length_858_cov_18.534914	424	504	0	80	80	1.0000000
NODE_10083_length_858_cov_15.378129	232	312	0	80	80	1.0000000
NODE_10083_length_858_cov_15.378129	285	365	0	80	80	1.0000000
NODE_10084_length_858_cov_12.310935	335	415	0	80	80	1.0000000
NODE_10084_length_858_cov_12.310935	388	468	0	80	80	1.0000000
NODE_10085_length_858_cov_7.835310	396	479	2	83	83	1.0000000
NODE_10085_length_858_cov_7.835310	452	532	0	26	80	0.3250000
NODE_10085_length_858_cov_7.835310	452	532	2	54	80	0.6750000
NODE_10088_length_858_cov_4.953887	474	554	0	23	80	0.2875000
NODE_10088_length_858_cov_4.953887	474	554	2	57	80	0.7125000
NODE_10088_length_858_cov_4.953887	527	607	0	76	80	0.9500000
NODE_10088_length_858_cov_4.953887	527	607	2	4	80	0.0500000
NODE_10091_length_858_cov_3.475626	428	502	0	74	74	1.0000000
NODE_10091_length_858_cov_3.475626	498	578	0	38	80	0.4750000
NODE_10091_length_858_cov_3.475626	498	578	2	42	80	0.5250000
NODE_10091_length_858_cov_3.475626	551	631	0	21	80	0.2625000
NODE_10091_length_858_cov_3.475626	551	631	2	59	80	0.7375000
NODE_10108_length_857_cov_33.449868	384	455	0	71	71	1.0000000
NODE_10108_length_857_cov_33.449868	437	518	0	81	81	1.0000000
NODE_10109_length_857_cov_32.527704	391	471	0	66	80	0.8250000
NODE_10109_length_857_cov_32.527704	391	471	2	11	80	0.1375000
NODE_10109_length_857_cov_32.527704	391	471	6	1	80	0.0125000
NODE_10109_length_857_cov_32.527704	391	471	8	2	80	0.0250000
NODE_10109_length_857_cov_32.527704	444	524	0	80	80	1.0000000
NODE_10110_length_857_cov_27.853562	310	390	0	32	80	0.4000000
NODE_10110_length_857_cov_27.853562	310	390	1	48	80	0.6000000
NODE_10110_length_857_cov_27.853562	363	443	1	80	80	1.0000000
NODE_10111_length_857_cov_24.654354	282	362	0	80	80	1.0000000
NODE_10111_length_857_cov_24.654354	335	415	0	80	80	1.0000000
NODE_10112_length_857_cov_22.604222	374	456	0	70	82	0.8536586
NODE_10112_length_857_cov_22.604222	374	456	2	12	82	0.1463415
NODE_10112_length_857_cov_22.604222	427	509	0	17	82	0.2073171
NODE_10112_length_857_cov_22.604222	427	509	2	65	82	0.7926829
NODE_10113_length_857_cov_17.399736	320	400	4	53	80	0.6625000
NODE_10113_length_857_cov_17.399736	320	400	6	27	80	0.3375000
NODE_10113_length_857_cov_17.399736	373	453	2	35	80	0.4375000
NODE_10113_length_857_cov_17.399736	373	453	4	1	80	0.0125000
NODE_10113_length_857_cov_17.399736	373	453	6	44	80	0.5500000
NODE_10114_length_857_cov_17.069921	388	468	0	80	80	1.0000000
NODE_10114_length_857_cov_17.069921	441	521	0	80	80	1.0000000
NODE_10115_length_857_cov_11.816623	433	513	0	2	80	0.0250000
NODE_10115_length_857_cov_11.816623	433	513	2	17	80	0.2125000
NODE_10115_length_857_cov_11.816623	433	513	4	61	80	0.7625000
NODE_10115_length_857_cov_11.816623	486	566	0	55	80	0.6875000
NODE_10115_length_857_cov_11.816623	486	566	4	25	80	0.3125000
NODE_10116_length_857_cov_6.733509	513	593	0	14	80	0.1750000
NODE_10116_length_857_cov_6.733509	513	593	2	66	80	0.8250000
NODE_10117_length_857_cov_6.251979	298	378	0	80	80	1.0000000
NODE_10117_length_857_cov_6.251979	351	431	0	80	80	1.0000000
NODE_10118_length_857_cov_5.827177	323	403	0	80	80	1.0000000
NODE_10118_length_857_cov_5.827177	376	456	0	80	80	1.0000000
NODE_10120_length_857_cov_4.530343	362	442	2	33	80	0.4125000
NODE_10120_length_857_cov_4.530343	362	442	4	47	80	0.5875000
NODE_10120_length_857_cov_4.530343	415	495	0	20	80	0.2500000
NODE_10120_length_857_cov_4.530343	415	495	2	34	80	0.4250000
NODE_10120_length_857_cov_4.530343	415	495	4	26	80	0.3250000
NODE_10128_length_857_cov_1.464380	179	249	8	10	70	0.1428571
NODE_10128_length_857_cov_1.464380	179	249	14	11	70	0.1571429
NODE_10128_length_857_cov_1.464380	179	249	16	2	70	0.0285714
NODE_10128_length_857_cov_1.464380	179	249	18	47	70	0.6714286
NODE_10128_length_857_cov_1.464380	222	288	14	31	66	0.4696970
NODE_10128_length_857_cov_1.464380	222	288	18	35	66	0.5303030
NODE_10138_length_856_cov_39.147952	157	237	0	10	80	0.1250000
NODE_10138_length_856_cov_39.147952	157	237	4	43	80	0.5375000
NODE_10138_length_856_cov_39.147952	157	237	6	27	80	0.3375000
NODE_10138_length_856_cov_39.147952	210	290	0	19	80	0.2375000
NODE_10138_length_856_cov_39.147952	210	290	2	16	80	0.2000000
NODE_10138_length_856_cov_39.147952	210	290	6	45	80	0.5625000
NODE_10138_length_856_cov_39.147952	286	366	0	80	80	1.0000000
NODE_10138_length_856_cov_39.147952	339	419	0	80	80	1.0000000
NODE_10139_length_856_cov_21.937913	353	433	0	80	80	1.0000000
NODE_10139_length_856_cov_21.937913	406	486	0	32	80	0.4000000
NODE_10139_length_856_cov_21.937913	406	486	2	48	80	0.6000000
NODE_10140_length_856_cov_20.227213	375	459	0	45	84	0.5357143
NODE_10140_length_856_cov_20.227213	375	459	2	39	84	0.4642857
NODE_10140_length_856_cov_20.227213	432	512	2	80	80	1.0000000
NODE_10141_length_856_cov_18.445178	340	420	0	54	80	0.6750000
NODE_10141_length_856_cov_18.445178	340	420	1	1	80	0.0125000
NODE_10141_length_856_cov_18.445178	340	420	2	25	80	0.3125000
NODE_10141_length_856_cov_18.445178	393	473	0	12	80	0.1500000
NODE_10141_length_856_cov_18.445178	393	473	1	1	80	0.0125000
NODE_10141_length_856_cov_18.445178	393	473	2	67	80	0.8375000
NODE_10142_length_856_cov_16.564069	462	543	0	81	81	1.0000000
NODE_10142_length_856_cov_16.564069	516	596	0	80	80	1.0000000
NODE_10142_length_856_cov_16.564069	516	593	0	77	77	1.0000000
NODE_10143_length_856_cov_15.803170	403	483	0	4	80	0.0500000
NODE_10143_length_856_cov_15.803170	403	483	2	19	80	0.2375000
NODE_10143_length_856_cov_15.803170	403	483	4	19	80	0.2375000
NODE_10143_length_856_cov_15.803170	403	483	5	16	80	0.2000000
NODE_10143_length_856_cov_15.803170	403	483	6	22	80	0.2750000
NODE_10143_length_856_cov_15.803170	456	536	0	57	80	0.7125000
NODE_10143_length_856_cov_15.803170	456	536	2	19	80	0.2375000
NODE_10143_length_856_cov_15.803170	456	536	4	4	80	0.0500000
NODE_10144_length_856_cov_12.904888	345	425	0	80	80	1.0000000
NODE_10144_length_856_cov_12.904888	398	478	0	80	80	1.0000000
NODE_10145_length_856_cov_9.881110	338	418	0	80	80	1.0000000
NODE_10145_length_856_cov_9.881110	391	471	0	80	80	1.0000000
NODE_10146_length_856_cov_5.875826	405	485	0	80	80	1.0000000
NODE_10146_length_856_cov_5.875826	458	538	0	34	80	0.4250000
NODE_10146_length_856_cov_5.875826	458	538	2	31	80	0.3875000
NODE_10146_length_856_cov_5.875826	458	538	3	3	80	0.0375000
NODE_10146_length_856_cov_5.875826	458	538	4	12	80	0.1500000
NODE_10149_length_856_cov_4.821664	466	546	0	80	80	1.0000000
NODE_10149_length_856_cov_4.821664	519	599	0	80	80	1.0000000
NODE_10151_length_856_cov_4.195509	248	328	0	76	80	0.9500000
NODE_10151_length_856_cov_4.195509	248	328	2	4	80	0.0500000
NODE_10151_length_856_cov_4.195509	301	381	0	59	80	0.7375000
NODE_10151_length_856_cov_4.195509	301	381	3	9	80	0.1125000
NODE_10151_length_856_cov_4.195509	301	381	4	12	80	0.1500000
NODE_10152_length_856_cov_3.899604	262	339	0	77	77	1.0000000
NODE_10152_length_856_cov_3.899604	312	392	0	80	80	1.0000000
NODE_10176_length_855_cov_28.312169	541	621	0	73	80	0.9125000
NODE_10176_length_855_cov_28.312169	541	621	4	7	80	0.0875000
NODE_10176_length_855_cov_28.312169	594	674	0	20	80	0.2500000
NODE_10176_length_855_cov_28.312169	594	674	4	60	80	0.7500000
NODE_10177_length_855_cov_19.392857	692	772	0	80	80	1.0000000
NODE_10177_length_855_cov_19.392857	745	825	0	80	80	1.0000000
NODE_10178_length_855_cov_13.402116	343	423	4	5	80	0.0625000
NODE_10178_length_855_cov_13.402116	343	423	6	26	80	0.3250000
NODE_10178_length_855_cov_13.402116	343	423	8	36	80	0.4500000
NODE_10178_length_855_cov_13.402116	343	423	10	13	80	0.1625000
NODE_10178_length_855_cov_13.402116	396	476	4	46	80	0.5750000
NODE_10178_length_855_cov_13.402116	396	476	6	2	80	0.0250000
NODE_10178_length_855_cov_13.402116	396	476	8	32	80	0.4000000
NODE_10179_length_855_cov_13.116402	295	375	0	80	80	1.0000000
NODE_10179_length_855_cov_13.116402	348	428	0	37	80	0.4625000
NODE_10179_length_855_cov_13.116402	348	428	2	43	80	0.5375000
NODE_10180_length_855_cov_11.179894	360	436	0	8	76	0.1052632
NODE_10180_length_855_cov_11.179894	360	436	2	68	76	0.8947368
NODE_10180_length_855_cov_11.179894	409	489	0	24	80	0.3000000
NODE_10180_length_855_cov_11.179894	409	489	2	56	80	0.7000000
NODE_10183_length_855_cov_8.593915	339	419	0	11	80	0.1375000
NODE_10183_length_855_cov_8.593915	339	419	2	69	80	0.8625000
NODE_10183_length_855_cov_8.593915	392	472	0	64	80	0.8000000
NODE_10183_length_855_cov_8.593915	392	472	2	16	80	0.2000000
NODE_10206_length_854_cov_64.200000	586	666	0	4	80	0.0500000
NODE_10206_length_854_cov_64.200000	586	666	2	46	80	0.5750000
NODE_10206_length_854_cov_64.200000	586	666	4	30	80	0.3750000
NODE_10206_length_854_cov_64.200000	639	719	0	9	80	0.1125000
NODE_10206_length_854_cov_64.200000	639	719	2	49	80	0.6125000
NODE_10206_length_854_cov_64.200000	639	719	4	22	80	0.2750000
NODE_10207_length_854_cov_46.037086	348	428	4	63	80	0.7875000
NODE_10207_length_854_cov_46.037086	348	428	6	17	80	0.2125000
NODE_10207_length_854_cov_46.037086	401	481	2	13	80	0.1625000
NODE_10207_length_854_cov_46.037086	401	481	4	10	80	0.1250000
NODE_10207_length_854_cov_46.037086	401	481	5	1	80	0.0125000
NODE_10207_length_854_cov_46.037086	401	481	6	56	80	0.7000000
NODE_10207_length_854_cov_46.037086	458	481	2	13	23	0.5652174
NODE_10207_length_854_cov_46.037086	458	481	5	1	23	0.0434783
NODE_10207_length_854_cov_46.037086	458	481	6	9	23	0.3913043
NODE_10208_length_854_cov_45.633113	393	473	10	19	80	0.2375000
NODE_10208_length_854_cov_45.633113	393	473	12	61	80	0.7625000
NODE_10208_length_854_cov_45.633113	446	526	0	26	80	0.3250000
NODE_10208_length_854_cov_45.633113	446	526	10	46	80	0.5750000
NODE_10208_length_854_cov_45.633113	446	526	12	8	80	0.1000000
NODE_10209_length_854_cov_40.407947	489	569	0	52	80	0.6500000
NODE_10209_length_854_cov_40.407947	489	569	2	28	80	0.3500000
NODE_10209_length_854_cov_40.407947	542	622	0	6	80	0.0750000
NODE_10209_length_854_cov_40.407947	542	622	2	74	80	0.9250000
NODE_10210_length_854_cov_29.773510	450	530	4	72	80	0.9000000
NODE_10210_length_854_cov_29.773510	450	530	6	8	80	0.1000000
NODE_10210_length_854_cov_29.773510	503	583	0	7	80	0.0875000
NODE_10210_length_854_cov_29.773510	503	583	2	13	80	0.1625000
NODE_10210_length_854_cov_29.773510	503	583	4	52	80	0.6500000
NODE_10210_length_854_cov_29.773510	503	583	6	8	80	0.1000000
NODE_10211_length_854_cov_22.968212	318	398	0	80	80	1.0000000
NODE_10211_length_854_cov_22.968212	371	451	0	80	80	1.0000000
NODE_10212_length_854_cov_18.038411	387	467	0	80	80	1.0000000
NODE_10212_length_854_cov_18.038411	440	520	0	80	80	1.0000000
NODE_10213_length_854_cov_13.774834	330	410	0	80	80	1.0000000
NODE_10213_length_854_cov_13.774834	383	463	0	80	80	1.0000000
NODE_10214_length_854_cov_11.998675	366	446	0	80	80	1.0000000
NODE_10214_length_854_cov_11.998675	419	499	0	80	80	1.0000000
NODE_10215_length_854_cov_7.600000	298	378	0	80	80	1.0000000
NODE_10215_length_854_cov_7.600000	351	431	0	47	80	0.5875000
NODE_10215_length_854_cov_7.600000	351	431	2	33	80	0.4125000
NODE_10218_length_854_cov_4.939073	603	633	0	4	30	0.1333333
NODE_10218_length_854_cov_4.939073	603	633	2	26	30	0.8666667
NODE_10226_length_854_cov_2.354967	613	633	0	20	20	1.0000000
NODE_10239_length_853_cov_61.988064	380	460	2	80	80	1.0000000
NODE_10239_length_853_cov_61.988064	433	513	0	51	80	0.6375000
NODE_10239_length_853_cov_61.988064	433	513	2	29	80	0.3625000
NODE_10240_length_853_cov_33.683024	384	464	4	19	80	0.2375000
NODE_10240_length_853_cov_33.683024	384	464	6	39	80	0.4875000
NODE_10240_length_853_cov_33.683024	384	464	8	22	80	0.2750000
NODE_10240_length_853_cov_33.683024	437	517	1	18	80	0.2250000
NODE_10240_length_853_cov_33.683024	437	517	3	10	80	0.1250000
NODE_10240_length_853_cov_33.683024	437	517	5	4	80	0.0500000
NODE_10240_length_853_cov_33.683024	437	517	6	5	80	0.0625000
NODE_10240_length_853_cov_33.683024	437	517	7	9	80	0.1125000
NODE_10240_length_853_cov_33.683024	437	517	8	34	80	0.4250000
NODE_10241_length_853_cov_31.965517	224	305	0	51	81	0.6296296
NODE_10241_length_853_cov_31.965517	224	305	2	30	81	0.3703704
NODE_10241_length_853_cov_31.965517	278	358	0	14	80	0.1750000
NODE_10241_length_853_cov_31.965517	278	358	2	66	80	0.8250000
NODE_10241_length_853_cov_31.965517	354	434	0	2	80	0.0250000
NODE_10241_length_853_cov_31.965517	354	434	2	2	80	0.0250000
NODE_10241_length_853_cov_31.965517	354	434	6	29	80	0.3625000
NODE_10241_length_853_cov_31.965517	354	434	8	16	80	0.2000000
NODE_10241_length_853_cov_31.965517	354	434	10	31	80	0.3875000
NODE_10241_length_853_cov_31.965517	407	466	6	34	59	0.5762712
NODE_10241_length_853_cov_31.965517	407	466	10	25	59	0.4237288
NODE_10242_length_853_cov_16.551724	247	327	2	12	80	0.1500000
NODE_10242_length_853_cov_16.551724	247	327	4	68	80	0.8500000
NODE_10242_length_853_cov_16.551724	300	380	0	49	80	0.6125000
NODE_10242_length_853_cov_16.551724	300	380	2	16	80	0.2000000
NODE_10242_length_853_cov_16.551724	300	380	4	15	80	0.1875000
NODE_10242_length_853_cov_16.551724	376	456	0	80	80	1.0000000
NODE_10242_length_853_cov_16.551724	429	509	0	80	80	1.0000000
NODE_10243_length_853_cov_15.395225	395	475	0	80	80	1.0000000
NODE_10243_length_853_cov_15.395225	448	528	0	80	80	1.0000000
NODE_10244_length_853_cov_15.086207	355	434	11	21	79	0.2658228
NODE_10244_length_853_cov_15.086207	355	434	12	37	79	0.4683544
NODE_10244_length_853_cov_15.086207	355	434	13	19	79	0.2405063
NODE_10244_length_853_cov_15.086207	355	434	14	2	79	0.0253165
NODE_10244_length_853_cov_15.086207	408	488	0	12	80	0.1500000
NODE_10244_length_853_cov_15.086207	408	488	4	8	80	0.1000000
NODE_10244_length_853_cov_15.086207	408	488	8	2	80	0.0250000
NODE_10244_length_853_cov_15.086207	408	488	10	25	80	0.3125000
NODE_10244_length_853_cov_15.086207	408	488	11	1	80	0.0125000
NODE_10244_length_853_cov_15.086207	408	488	12	32	80	0.4000000
NODE_10245_length_853_cov_14.929708	160	240	0	80	80	1.0000000
NODE_10245_length_853_cov_14.929708	213	293	0	80	80	1.0000000
NODE_10246_length_853_cov_11.299735	395	475	0	80	80	1.0000000
NODE_10246_length_853_cov_11.299735	448	528	0	68	80	0.8500000
NODE_10246_length_853_cov_11.299735	448	528	2	12	80	0.1500000
NODE_10247_length_853_cov_9.571618	479	559	0	11	80	0.1375000
NODE_10247_length_853_cov_9.571618	479	559	2	67	80	0.8375000
NODE_10247_length_853_cov_9.571618	479	559	4	2	80	0.0250000
NODE_10247_length_853_cov_9.571618	532	612	2	67	80	0.8375000
NODE_10247_length_853_cov_9.571618	532	612	4	13	80	0.1625000
NODE_10248_length_853_cov_7.828912	265	345	0	18	80	0.2250000
NODE_10248_length_853_cov_7.828912	265	345	2	30	80	0.3750000
NODE_10248_length_853_cov_7.828912	265	345	4	32	80	0.4000000
NODE_10248_length_853_cov_7.828912	318	398	0	16	80	0.2000000
NODE_10248_length_853_cov_7.828912	318	398	2	14	80	0.1750000
NODE_10248_length_853_cov_7.828912	318	398	4	50	80	0.6250000
NODE_10249_length_853_cov_7.623342	255	335	0	80	80	1.0000000
NODE_10249_length_853_cov_7.623342	308	388	0	80	80	1.0000000
NODE_10253_length_853_cov_3.173740	212	292	0	15	80	0.1875000
NODE_10253_length_853_cov_3.173740	212	292	2	65	80	0.8125000
NODE_10253_length_853_cov_3.173740	265	343	0	66	78	0.8461539
NODE_10253_length_853_cov_3.173740	265	343	2	12	78	0.1538462
NODE_10258_length_853_cov_1.823607	710	773	0	63	63	1.0000000
NODE_10258_length_853_cov_1.823607	711	773	0	62	62	1.0000000
NODE_10258_length_853_cov_1.823607	711	773	0	62	62	1.0000000
NODE_10258_length_853_cov_1.823607	746	826	0	80	80	1.0000000
NODE_10267_length_852_cov_30.022576	279	359	0	77	80	0.9625000
NODE_10267_length_852_cov_30.022576	279	359	2	3	80	0.0375000
NODE_10267_length_852_cov_30.022576	332	412	0	24	80	0.3000000
NODE_10267_length_852_cov_30.022576	332	412	2	56	80	0.7000000
NODE_10268_length_852_cov_19.373174	353	433	0	24	80	0.3000000
NODE_10268_length_852_cov_19.373174	353	433	1	5	80	0.0625000
NODE_10268_length_852_cov_19.373174	353	433	2	40	80	0.5000000
NODE_10268_length_852_cov_19.373174	353	433	4	11	80	0.1375000
NODE_10268_length_852_cov_19.373174	406	486	2	16	80	0.2000000
NODE_10268_length_852_cov_19.373174	406	486	4	64	80	0.8000000
NODE_10269_length_852_cov_18.853918	297	377	0	7	80	0.0875000
NODE_10269_length_852_cov_18.853918	297	377	2	6	80	0.0750000
NODE_10269_length_852_cov_18.853918	297	377	4	4	80	0.0500000
NODE_10269_length_852_cov_18.853918	297	377	11	1	80	0.0125000
NODE_10269_length_852_cov_18.853918	297	377	12	21	80	0.2625000
NODE_10269_length_852_cov_18.853918	297	377	14	41	80	0.5125000
NODE_10269_length_852_cov_18.853918	350	430	0	60	80	0.7500000
NODE_10269_length_852_cov_18.853918	350	430	2	6	80	0.0750000
NODE_10269_length_852_cov_18.853918	350	430	4	4	80	0.0500000
NODE_10269_length_852_cov_18.853918	350	430	11	1	80	0.0125000
NODE_10269_length_852_cov_18.853918	350	430	12	9	80	0.1125000
NODE_10269_length_852_cov_18.853918	426	506	0	80	80	1.0000000
NODE_10269_length_852_cov_18.853918	489	559	0	70	70	1.0000000
NODE_10270_length_852_cov_17.391766	472	552	0	80	80	1.0000000
NODE_10270_length_852_cov_17.391766	525	605	0	80	80	1.0000000
NODE_10271_length_852_cov_8.818061	513	593	0	80	80	1.0000000
NODE_10271_length_852_cov_8.818061	566	646	0	80	80	1.0000000
NODE_10274_length_852_cov_4.403718	493	573	0	80	80	1.0000000
NODE_10274_length_852_cov_4.403718	546	626	0	38	80	0.4750000
NODE_10274_length_852_cov_4.403718	546	626	2	19	80	0.2375000
NODE_10274_length_852_cov_4.403718	546	626	4	23	80	0.2875000
NODE_10285_length_851_cov_33.953457	329	409	0	47	80	0.5875000
NODE_10285_length_851_cov_33.953457	329	409	2	33	80	0.4125000
NODE_10285_length_851_cov_33.953457	382	462	0	80	80	1.0000000
NODE_10286_length_851_cov_30.488032	395	475	2	62	80	0.7750000
NODE_10286_length_851_cov_30.488032	395	475	6	18	80	0.2250000
NODE_10286_length_851_cov_30.488032	448	528	0	8	80	0.1000000
NODE_10286_length_851_cov_30.488032	448	528	2	9	80	0.1125000
NODE_10286_length_851_cov_30.488032	448	528	4	29	80	0.3625000
NODE_10286_length_851_cov_30.488032	448	528	6	34	80	0.4250000
NODE_10287_length_851_cov_27.481383	353	433	0	46	80	0.5750000
NODE_10287_length_851_cov_27.481383	353	433	2	34	80	0.4250000
NODE_10287_length_851_cov_27.481383	406	486	2	37	80	0.4625000
NODE_10287_length_851_cov_27.481383	406	486	4	24	80	0.3000000
NODE_10287_length_851_cov_27.481383	406	486	6	11	80	0.1375000
NODE_10287_length_851_cov_27.481383	406	486	8	8	80	0.1000000
NODE_10288_length_851_cov_23.656915	345	425	0	65	80	0.8125000
NODE_10288_length_851_cov_23.656915	345	425	2	15	80	0.1875000
NODE_10288_length_851_cov_23.656915	398	478	0	80	80	1.0000000
NODE_10289_length_851_cov_19.769947	298	378	0	19	80	0.2375000
NODE_10289_length_851_cov_19.769947	298	378	2	61	80	0.7625000
NODE_10289_length_851_cov_19.769947	351	431	0	72	80	0.9000000
NODE_10289_length_851_cov_19.769947	351	431	2	8	80	0.1000000
NODE_10290_length_851_cov_17.386968	459	539	0	80	80	1.0000000
NODE_10290_length_851_cov_17.386968	512	592	0	80	80	1.0000000
NODE_10291_length_851_cov_13.519947	323	403	0	26	80	0.3250000
NODE_10291_length_851_cov_13.519947	323	403	1	14	80	0.1750000
NODE_10291_length_851_cov_13.519947	323	403	4	40	80	0.5000000
NODE_10291_length_851_cov_13.519947	376	456	2	18	80	0.2250000
NODE_10291_length_851_cov_13.519947	376	456	4	39	80	0.4875000
NODE_10291_length_851_cov_13.519947	376	456	6	23	80	0.2875000
NODE_10292_length_851_cov_11.771277	403	483	0	1	80	0.0125000
NODE_10292_length_851_cov_11.771277	403	483	4	79	80	0.9875000
NODE_10292_length_851_cov_11.771277	456	536	0	44	80	0.5500000
NODE_10292_length_851_cov_11.771277	456	536	4	36	80	0.4500000
NODE_10293_length_851_cov_11.698138	227	307	0	80	80	1.0000000
NODE_10293_length_851_cov_11.698138	280	360	0	32	80	0.4000000
NODE_10293_length_851_cov_11.698138	280	360	2	13	80	0.1625000
NODE_10293_length_851_cov_11.698138	280	360	6	31	80	0.3875000
NODE_10293_length_851_cov_11.698138	280	360	8	4	80	0.0500000
NODE_10293_length_851_cov_11.698138	356	436	4	5	80	0.0625000
NODE_10293_length_851_cov_11.698138	356	436	6	34	80	0.4250000
NODE_10293_length_851_cov_11.698138	356	436	8	17	80	0.2125000
NODE_10293_length_851_cov_11.698138	356	436	9	1	80	0.0125000
NODE_10293_length_851_cov_11.698138	356	436	10	1	80	0.0125000
NODE_10293_length_851_cov_11.698138	356	436	12	22	80	0.2750000
NODE_10293_length_851_cov_11.698138	409	489	0	44	80	0.5500000
NODE_10293_length_851_cov_11.698138	409	489	4	14	80	0.1750000
NODE_10293_length_851_cov_11.698138	409	489	6	22	80	0.2750000
NODE_10294_length_851_cov_11.672872	372	452	0	80	80	1.0000000
NODE_10294_length_851_cov_11.672872	425	505	0	80	80	1.0000000
NODE_10295_length_851_cov_10.938830	418	499	1	2	81	0.0246914
NODE_10295_length_851_cov_10.938830	418	499	2	13	81	0.1604938
NODE_10295_length_851_cov_10.938830	418	499	6	66	81	0.8148148
NODE_10296_length_851_cov_10.074468	454	534	0	80	80	1.0000000
NODE_10296_length_851_cov_10.074468	507	587	0	80	80	1.0000000
NODE_10297_length_851_cov_7.599734	330	410	0	18	80	0.2250000
NODE_10297_length_851_cov_7.599734	330	410	1	12	80	0.1500000
NODE_10297_length_851_cov_7.599734	330	410	2	50	80	0.6250000
NODE_10297_length_851_cov_7.599734	383	463	0	46	80	0.5750000
NODE_10297_length_851_cov_7.599734	383	463	1	19	80	0.2375000
NODE_10297_length_851_cov_7.599734	383	463	2	15	80	0.1875000
NODE_10298_length_851_cov_5.639628	379	459	0	80	80	1.0000000
NODE_10298_length_851_cov_5.639628	432	512	0	80	80	1.0000000
NODE_10300_length_851_cov_3.880319	729	765	0	36	36	1.0000000
NODE_10300_length_851_cov_3.880319	743	824	0	81	81	1.0000000
NODE_10301_length_851_cov_3.823138	380	460	6	80	80	1.0000000
NODE_10301_length_851_cov_3.823138	433	513	0	25	80	0.3125000
NODE_10301_length_851_cov_3.823138	433	513	6	55	80	0.6875000
NODE_10318_length_851_cov_1.130319	33	103	0	70	70	1.0000000
NODE_10326_length_850_cov_36.527297	360	440	0	63	80	0.7875000
NODE_10326_length_850_cov_36.527297	360	440	2	17	80	0.2125000
NODE_10326_length_850_cov_36.527297	413	493	0	80	80	1.0000000
NODE_10327_length_850_cov_31.006658	330	410	0	80	80	1.0000000
NODE_10327_length_850_cov_31.006658	383	463	0	38	80	0.4750000
NODE_10327_length_850_cov_31.006658	383	463	2	42	80	0.5250000
NODE_10328_length_850_cov_30.460719	251	331	0	16	80	0.2000000
NODE_10328_length_850_cov_30.460719	251	331	2	64	80	0.8000000
NODE_10328_length_850_cov_30.460719	304	384	0	69	80	0.8625000
NODE_10328_length_850_cov_30.460719	304	384	2	11	80	0.1375000
NODE_10329_length_850_cov_25.263648	355	435	0	80	80	1.0000000
NODE_10329_length_850_cov_25.263648	408	488	0	80	80	1.0000000
NODE_10330_length_850_cov_21.368842	290	370	0	50	80	0.6250000
NODE_10330_length_850_cov_21.368842	290	370	1	8	80	0.1000000
NODE_10330_length_850_cov_21.368842	290	370	3	8	80	0.1000000
NODE_10330_length_850_cov_21.368842	290	370	4	14	80	0.1750000
NODE_10330_length_850_cov_21.368842	343	423	1	5	80	0.0625000
NODE_10330_length_850_cov_21.368842	343	423	3	8	80	0.1000000
NODE_10330_length_850_cov_21.368842	343	423	4	33	80	0.4125000
NODE_10330_length_850_cov_21.368842	343	423	8	34	80	0.4250000
NODE_10331_length_850_cov_20.500666	318	398	2	80	80	1.0000000
NODE_10331_length_850_cov_20.500666	371	451	0	41	80	0.5125000
NODE_10331_length_850_cov_20.500666	371	451	2	39	80	0.4875000
NODE_10332_length_850_cov_17.268975	398	478	0	80	80	1.0000000
NODE_10332_length_850_cov_17.268975	451	531	0	80	80	1.0000000
NODE_10333_length_850_cov_14.728362	379	459	0	12	80	0.1500000
NODE_10333_length_850_cov_14.728362	379	459	10	22	80	0.2750000
NODE_10333_length_850_cov_14.728362	379	459	11	6	80	0.0750000
NODE_10333_length_850_cov_14.728362	379	459	13	6	80	0.0750000
NODE_10333_length_850_cov_14.728362	379	459	14	34	80	0.4250000
NODE_10333_length_850_cov_14.728362	432	512	8	4	80	0.0500000
NODE_10333_length_850_cov_14.728362	432	512	10	71	80	0.8875000
NODE_10333_length_850_cov_14.728362	432	512	11	5	80	0.0625000
NODE_10334_length_850_cov_14.230360	313	393	0	80	80	1.0000000
NODE_10334_length_850_cov_14.230360	366	446	0	80	80	1.0000000
NODE_10335_length_850_cov_12.387483	337	417	0	80	80	1.0000000
NODE_10335_length_850_cov_12.387483	390	470	0	80	80	1.0000000
NODE_10335_length_850_cov_12.387483	466	545	0	79	79	1.0000000
NODE_10335_length_850_cov_12.387483	518	598	0	80	80	1.0000000
NODE_10336_length_850_cov_11.402130	329	409	0	29	80	0.3625000
NODE_10336_length_850_cov_11.402130	329	409	2	42	80	0.5250000
NODE_10336_length_850_cov_11.402130	329	409	4	9	80	0.1125000
NODE_10336_length_850_cov_11.402130	382	462	2	70	80	0.8750000
NODE_10336_length_850_cov_11.402130	382	462	4	10	80	0.1250000
NODE_10337_length_850_cov_10.326232	330	410	0	80	80	1.0000000
NODE_10337_length_850_cov_10.326232	383	463	0	80	80	1.0000000
NODE_10338_length_850_cov_9.675100	464	544	0	24	80	0.3000000
NODE_10338_length_850_cov_9.675100	464	544	2	56	80	0.7000000
NODE_10338_length_850_cov_9.675100	517	597	0	77	80	0.9625000
NODE_10338_length_850_cov_9.675100	517	597	2	3	80	0.0375000
NODE_10367_length_849_cov_43.137333	336	416	1	20	80	0.2500000
NODE_10367_length_849_cov_43.137333	336	416	2	57	80	0.7125000
NODE_10367_length_849_cov_43.137333	336	416	7	1	80	0.0125000
NODE_10367_length_849_cov_43.137333	336	416	8	2	80	0.0250000
NODE_10367_length_849_cov_43.137333	389	469	1	73	80	0.9125000
NODE_10367_length_849_cov_43.137333	389	469	2	7	80	0.0875000
NODE_10368_length_849_cov_36.562667	326	406	0	80	80	1.0000000
NODE_10368_length_849_cov_36.562667	379	459	0	80	80	1.0000000
NODE_10369_length_849_cov_35.449333	408	488	0	31	80	0.3875000
NODE_10369_length_849_cov_35.449333	408	488	18	49	80	0.6125000
NODE_10369_length_849_cov_35.449333	461	541	18	43	80	0.5375000
NODE_10369_length_849_cov_35.449333	461	541	20	37	80	0.4625000
NODE_10370_length_849_cov_29.989333	332	412	0	19	80	0.2375000
NODE_10370_length_849_cov_29.989333	332	412	8	10	80	0.1250000
NODE_10370_length_849_cov_29.989333	332	412	10	51	80	0.6375000
NODE_10370_length_849_cov_29.989333	385	465	0	21	80	0.2625000
NODE_10370_length_849_cov_29.989333	385	465	2	51	80	0.6375000
NODE_10370_length_849_cov_29.989333	385	465	8	8	80	0.1000000
NODE_10371_length_849_cov_17.974667	343	423	0	41	80	0.5125000
NODE_10371_length_849_cov_17.974667	343	423	3	3	80	0.0375000
NODE_10371_length_849_cov_17.974667	343	423	5	36	80	0.4500000
NODE_10371_length_849_cov_17.974667	396	476	5	49	80	0.6125000
NODE_10371_length_849_cov_17.974667	396	476	6	31	80	0.3875000
NODE_10372_length_849_cov_17.018667	360	440	0	80	80	1.0000000
NODE_10372_length_849_cov_17.018667	416	493	0	77	77	1.0000000
NODE_10373_length_849_cov_15.581333	287	367	6	12	80	0.1500000
NODE_10373_length_849_cov_15.581333	287	367	10	52	80	0.6500000
NODE_10373_length_849_cov_15.581333	287	367	12	16	80	0.2000000
NODE_10373_length_849_cov_15.581333	340	420	0	28	80	0.3500000
NODE_10373_length_849_cov_15.581333	340	420	2	11	80	0.1375000
NODE_10373_length_849_cov_15.581333	340	420	6	26	80	0.3250000
NODE_10373_length_849_cov_15.581333	340	420	12	15	80	0.1875000
NODE_10373_length_849_cov_15.581333	416	496	0	80	80	1.0000000
NODE_10373_length_849_cov_15.581333	469	549	0	80	80	1.0000000
NODE_10374_length_849_cov_9.460000	370	450	0	5	80	0.0625000
NODE_10374_length_849_cov_9.460000	370	450	2	75	80	0.9375000
NODE_10374_length_849_cov_9.460000	423	503	0	4	80	0.0500000
NODE_10374_length_849_cov_9.460000	423	503	2	76	80	0.9500000
NODE_10375_length_849_cov_4.893333	427	507	0	33	80	0.4125000
NODE_10375_length_849_cov_4.893333	427	507	2	47	80	0.5875000
NODE_10375_length_849_cov_4.893333	480	560	2	80	80	1.0000000
NODE_10376_length_849_cov_4.860000	380	460	0	80	80	1.0000000
NODE_10376_length_849_cov_4.860000	433	513	0	62	80	0.7750000
NODE_10376_length_849_cov_4.860000	433	513	2	18	80	0.2250000
NODE_10379_length_849_cov_2.761333	254	334	0	80	80	1.0000000
NODE_10396_length_848_cov_27.287049	253	333	0	25	80	0.3125000
NODE_10396_length_848_cov_27.287049	253	333	2	55	80	0.6875000
NODE_10396_length_848_cov_27.287049	306	386	0	78	80	0.9750000
NODE_10396_length_848_cov_27.287049	306	386	2	2	80	0.0250000
NODE_10396_length_848_cov_27.287049	382	458	0	76	76	1.0000000
NODE_10396_length_848_cov_27.287049	435	513	0	78	78	1.0000000
NODE_10397_length_848_cov_23.511348	248	328	0	80	80	1.0000000
NODE_10397_length_848_cov_23.511348	301	381	0	80	80	1.0000000
NODE_10397_length_848_cov_23.511348	377	457	0	80	80	1.0000000
NODE_10397_length_848_cov_23.511348	430	508	0	78	78	1.0000000
NODE_10398_length_848_cov_21.939920	295	375	0	80	80	1.0000000
NODE_10398_length_848_cov_21.939920	348	428	0	80	80	1.0000000
NODE_10399_length_848_cov_21.937250	434	514	0	64	80	0.8000000
NODE_10399_length_848_cov_21.937250	434	514	2	16	80	0.2000000
NODE_10399_length_848_cov_21.937250	487	567	0	80	80	1.0000000
NODE_10400_length_848_cov_19.500668	367	392	0	25	25	1.0000000
NODE_10400_length_848_cov_19.500668	388	468	0	80	80	1.0000000
NODE_10400_length_848_cov_19.500668	441	521	0	80	80	1.0000000
NODE_10400_length_848_cov_19.500668	443	512	0	69	69	1.0000000
NODE_10400_length_848_cov_19.500668	443	472	0	29	29	1.0000000
NODE_10401_length_848_cov_16.566088	323	403	13	68	80	0.8500000
NODE_10401_length_848_cov_16.566088	323	403	14	2	80	0.0250000
NODE_10401_length_848_cov_16.566088	323	403	15	10	80	0.1250000
NODE_10401_length_848_cov_16.566088	376	456	0	3	80	0.0375000
NODE_10401_length_848_cov_16.566088	376	456	2	5	80	0.0625000
NODE_10401_length_848_cov_16.566088	376	456	4	1	80	0.0125000
NODE_10401_length_848_cov_16.566088	376	456	11	18	80	0.2250000
NODE_10401_length_848_cov_16.566088	376	456	13	34	80	0.4250000
NODE_10401_length_848_cov_16.566088	376	456	14	12	80	0.1500000
NODE_10401_length_848_cov_16.566088	376	456	15	7	80	0.0875000
NODE_10402_length_848_cov_16.109479	256	336	0	33	80	0.4125000
NODE_10402_length_848_cov_16.109479	256	336	2	47	80	0.5875000
NODE_10402_length_848_cov_16.109479	309	389	0	12	80	0.1500000
NODE_10402_length_848_cov_16.109479	309	389	2	68	80	0.8500000
NODE_10402_length_848_cov_16.109479	385	465	0	80	80	1.0000000
NODE_10402_length_848_cov_16.109479	438	518	0	80	80	1.0000000
NODE_10403_length_848_cov_15.919893	492	568	2	76	76	1.0000000
NODE_10403_length_848_cov_15.919893	541	621	0	40	80	0.5000000
NODE_10403_length_848_cov_15.919893	541	621	2	40	80	0.5000000
NODE_10404_length_848_cov_13.979973	269	349	0	80	80	1.0000000
NODE_10404_length_848_cov_13.979973	322	402	0	80	80	1.0000000
NODE_10405_length_848_cov_13.073431	343	423	4	42	80	0.5250000
NODE_10405_length_848_cov_13.073431	343	423	6	13	80	0.1625000
NODE_10405_length_848_cov_13.073431	343	423	8	25	80	0.3125000
NODE_10405_length_848_cov_13.073431	396	476	0	11	80	0.1375000
NODE_10405_length_848_cov_13.073431	396	476	4	15	80	0.1875000
NODE_10405_length_848_cov_13.073431	396	476	6	17	80	0.2125000
NODE_10405_length_848_cov_13.073431	396	476	8	37	80	0.4625000
NODE_10406_length_848_cov_8.523364	232	312	0	40	80	0.5000000
NODE_10406_length_848_cov_8.523364	232	312	2	40	80	0.5000000
NODE_10406_length_848_cov_8.523364	285	365	0	13	80	0.1625000
NODE_10406_length_848_cov_8.523364	285	365	2	67	80	0.8375000
NODE_10406_length_848_cov_8.523364	361	441	0	80	80	1.0000000
NODE_10406_length_848_cov_8.523364	414	494	0	29	80	0.3625000
NODE_10406_length_848_cov_8.523364	414	494	2	51	80	0.6375000
NODE_10408_length_848_cov_5.903872	251	331	0	44	80	0.5500000
NODE_10408_length_848_cov_5.903872	251	331	2	14	80	0.1750000
NODE_10408_length_848_cov_5.903872	251	331	4	22	80	0.2750000
NODE_10408_length_848_cov_5.903872	304	383	2	5	79	0.0632911
NODE_10408_length_848_cov_5.903872	304	383	4	74	79	0.9367089
NODE_10409_length_848_cov_5.236315	378	458	0	15	80	0.1875000
NODE_10409_length_848_cov_5.236315	378	458	8	65	80	0.8125000
NODE_10409_length_848_cov_5.236315	431	507	8	76	76	1.0000000
NODE_10424_length_847_cov_56.417112	576	656	0	9	80	0.1125000
NODE_10424_length_847_cov_56.417112	576	656	2	71	80	0.8875000
NODE_10424_length_847_cov_56.417112	629	709	0	21	80	0.2625000
NODE_10424_length_847_cov_56.417112	629	709	2	59	80	0.7375000
NODE_10425_length_847_cov_27.292781	390	470	0	56	80	0.7000000
NODE_10425_length_847_cov_27.292781	390	470	2	24	80	0.3000000
NODE_10425_length_847_cov_27.292781	443	523	0	80	80	1.0000000
NODE_10426_length_847_cov_24.954545	342	422	0	80	80	1.0000000
NODE_10426_length_847_cov_24.954545	395	475	0	65	80	0.8125000
NODE_10426_length_847_cov_24.954545	395	475	2	15	80	0.1875000
NODE_10427_length_847_cov_20.310160	341	421	0	35	80	0.4375000
NODE_10427_length_847_cov_20.310160	341	421	4	16	80	0.2000000
NODE_10427_length_847_cov_20.310160	341	421	6	29	80	0.3625000
NODE_10427_length_847_cov_20.310160	394	474	2	17	80	0.2125000
NODE_10427_length_847_cov_20.310160	394	474	6	63	80	0.7875000
NODE_10428_length_847_cov_19.002674	368	448	3	25	80	0.3125000
NODE_10428_length_847_cov_19.002674	368	448	4	55	80	0.6875000
NODE_10428_length_847_cov_19.002674	421	501	0	50	80	0.6250000
NODE_10428_length_847_cov_19.002674	421	501	3	28	80	0.3500000
NODE_10428_length_847_cov_19.002674	421	501	4	2	80	0.0250000
NODE_10429_length_847_cov_16.879679	218	298	0	35	80	0.4375000
NODE_10429_length_847_cov_16.879679	218	298	2	45	80	0.5625000
NODE_10429_length_847_cov_16.879679	271	351	0	41	80	0.5125000
NODE_10429_length_847_cov_16.879679	271	351	2	39	80	0.4875000
NODE_10431_length_847_cov_11.784759	298	378	0	80	80	1.0000000
NODE_10431_length_847_cov_11.784759	351	431	0	80	80	1.0000000
NODE_10431_length_847_cov_11.784759	427	507	0	44	80	0.5500000
NODE_10431_length_847_cov_11.784759	427	507	2	25	80	0.3125000
NODE_10431_length_847_cov_11.784759	427	507	4	11	80	0.1375000
NODE_10431_length_847_cov_11.784759	480	560	2	16	80	0.2000000
NODE_10431_length_847_cov_11.784759	480	560	4	23	80	0.2875000
NODE_10431_length_847_cov_11.784759	480	560	10	41	80	0.5125000
NODE_10432_length_847_cov_11.604278	407	487	0	80	80	1.0000000
NODE_10432_length_847_cov_11.604278	460	540	0	80	80	1.0000000
NODE_10433_length_847_cov_10.221925	395	475	0	80	80	1.0000000
NODE_10433_length_847_cov_10.221925	448	528	0	80	80	1.0000000
NODE_10434_length_847_cov_4.602941	97	154	20	1	57	0.0175439
NODE_10434_length_847_cov_4.602941	97	154	22	6	57	0.1052632
NODE_10434_length_847_cov_4.602941	97	154	26	5	57	0.0877193
NODE_10434_length_847_cov_4.602941	97	154	28	16	57	0.2807018
NODE_10434_length_847_cov_4.602941	97	154	30	21	57	0.3684210
NODE_10434_length_847_cov_4.602941	97	154	34	2	57	0.0350877
NODE_10434_length_847_cov_4.602941	97	154	36	6	57	0.1052632
NODE_10434_length_847_cov_4.602941	127	207	4	9	80	0.1125000
NODE_10434_length_847_cov_4.602941	127	207	6	4	80	0.0500000
NODE_10434_length_847_cov_4.602941	127	207	8	4	80	0.0500000
NODE_10434_length_847_cov_4.602941	127	207	10	1	80	0.0125000
NODE_10434_length_847_cov_4.602941	127	207	12	11	80	0.1375000
NODE_10434_length_847_cov_4.602941	127	207	14	10	80	0.1250000
NODE_10434_length_847_cov_4.602941	127	207	15	6	80	0.0750000
NODE_10434_length_847_cov_4.602941	127	207	19	6	80	0.0750000
NODE_10434_length_847_cov_4.602941	127	207	20	3	80	0.0375000
NODE_10434_length_847_cov_4.602941	127	207	22	6	80	0.0750000
NODE_10434_length_847_cov_4.602941	127	207	26	5	80	0.0625000
NODE_10434_length_847_cov_4.602941	127	207	28	13	80	0.1625000
NODE_10434_length_847_cov_4.602941	127	207	30	2	80	0.0250000
NODE_10456_length_846_cov_39.476573	336	416	8	31	80	0.3875000
NODE_10456_length_846_cov_39.476573	336	416	10	2	80	0.0250000
NODE_10456_length_846_cov_39.476573	336	416	11	1	80	0.0125000
NODE_10456_length_846_cov_39.476573	336	416	12	46	80	0.5750000
NODE_10456_length_846_cov_39.476573	389	469	4	4	80	0.0500000
NODE_10456_length_846_cov_39.476573	389	469	8	63	80	0.7875000
NODE_10456_length_846_cov_39.476573	389	469	10	2	80	0.0250000
NODE_10456_length_846_cov_39.476573	389	469	11	1	80	0.0125000
NODE_10456_length_846_cov_39.476573	389	469	12	10	80	0.1250000
NODE_10456_length_846_cov_39.476573	465	545	0	70	80	0.8750000
NODE_10456_length_846_cov_39.476573	465	545	3	1	80	0.0125000
NODE_10456_length_846_cov_39.476573	465	545	4	9	80	0.1125000
NODE_10456_length_846_cov_39.476573	518	598	0	80	80	1.0000000
NODE_10457_length_846_cov_37.297189	312	392	0	66	80	0.8250000
NODE_10457_length_846_cov_37.297189	312	392	3	5	80	0.0625000
NODE_10457_length_846_cov_37.297189	312	392	9	9	80	0.1125000
NODE_10457_length_846_cov_37.297189	365	445	0	13	80	0.1625000
NODE_10457_length_846_cov_37.297189	365	445	3	5	80	0.0625000
NODE_10457_length_846_cov_37.297189	365	445	9	26	80	0.3250000
NODE_10457_length_846_cov_37.297189	365	445	11	36	80	0.4500000
NODE_10458_length_846_cov_32.852744	279	359	8	14	80	0.1750000
NODE_10458_length_846_cov_32.852744	279	359	9	18	80	0.2250000
NODE_10458_length_846_cov_32.852744	279	359	10	48	80	0.6000000
NODE_10458_length_846_cov_32.852744	332	412	1	5	80	0.0625000
NODE_10458_length_846_cov_32.852744	332	412	2	26	80	0.3250000
NODE_10458_length_846_cov_32.852744	332	412	7	20	80	0.2500000
NODE_10458_length_846_cov_32.852744	332	412	8	10	80	0.1250000
NODE_10458_length_846_cov_32.852744	332	412	9	19	80	0.2375000
NODE_10459_length_846_cov_31.717537	290	370	0	32	80	0.4000000
NODE_10459_length_846_cov_31.717537	290	370	6	41	80	0.5125000
NODE_10459_length_846_cov_31.717537	290	370	7	2	80	0.0250000
NODE_10459_length_846_cov_31.717537	290	370	8	5	80	0.0625000
NODE_10459_length_846_cov_31.717537	343	423	0	17	80	0.2125000
NODE_10459_length_846_cov_31.717537	343	423	6	20	80	0.2500000
NODE_10459_length_846_cov_31.717537	343	423	7	2	80	0.0250000
NODE_10459_length_846_cov_31.717537	343	423	8	41	80	0.5125000
NODE_10460_length_846_cov_24.380187	350	430	0	29	80	0.3625000
NODE_10460_length_846_cov_24.380187	350	430	2	35	80	0.4375000
NODE_10460_length_846_cov_24.380187	350	430	4	16	80	0.2000000
NODE_10460_length_846_cov_24.380187	403	483	2	11	80	0.1375000
NODE_10460_length_846_cov_24.380187	403	483	4	42	80	0.5250000
NODE_10460_length_846_cov_24.380187	403	483	6	27	80	0.3375000
NODE_10461_length_846_cov_16.155288	364	444	0	9	80	0.1125000
NODE_10461_length_846_cov_16.155288	364	444	2	14	80	0.1750000
NODE_10461_length_846_cov_16.155288	364	444	12	57	80	0.7125000
NODE_10461_length_846_cov_16.155288	417	497	0	27	80	0.3375000
NODE_10461_length_846_cov_16.155288	417	497	10	7	80	0.0875000
NODE_10461_length_846_cov_16.155288	417	497	12	46	80	0.5750000
NODE_10462_length_846_cov_15.917001	398	478	0	1	80	0.0125000
NODE_10462_length_846_cov_15.917001	398	478	4	79	80	0.9875000
NODE_10462_length_846_cov_15.917001	451	531	0	54	80	0.6750000
NODE_10462_length_846_cov_15.917001	451	531	4	26	80	0.3250000
NODE_10463_length_846_cov_15.275770	355	435	0	15	80	0.1875000
NODE_10463_length_846_cov_15.275770	355	435	2	65	80	0.8125000
NODE_10463_length_846_cov_15.275770	408	488	0	68	80	0.8500000
NODE_10463_length_846_cov_15.275770	408	488	2	12	80	0.1500000
NODE_10464_length_846_cov_13.618474	216	296	0	39	80	0.4875000
NODE_10464_length_846_cov_13.618474	216	296	2	41	80	0.5125000
NODE_10464_length_846_cov_13.618474	269	349	0	80	80	1.0000000
NODE_10464_length_846_cov_13.618474	345	425	0	12	80	0.1500000
NODE_10464_length_846_cov_13.618474	345	425	6	40	80	0.5000000
NODE_10464_length_846_cov_13.618474	345	425	10	28	80	0.3500000
NODE_10464_length_846_cov_13.618474	398	478	4	24	80	0.3000000
NODE_10464_length_846_cov_13.618474	398	478	10	56	80	0.7000000
NODE_10465_length_846_cov_12.878179	425	505	0	58	80	0.7250000
NODE_10465_length_846_cov_12.878179	425	505	4	22	80	0.2750000
NODE_10465_length_846_cov_12.878179	478	558	0	5	80	0.0625000
NODE_10465_length_846_cov_12.878179	478	558	2	1	80	0.0125000
NODE_10465_length_846_cov_12.878179	478	558	4	33	80	0.4125000
NODE_10465_length_846_cov_12.878179	478	558	6	41	80	0.5125000
NODE_10467_length_846_cov_7.232932	407	487	0	2	80	0.0250000
NODE_10467_length_846_cov_7.232932	407	487	2	78	80	0.9750000
NODE_10467_length_846_cov_7.232932	460	540	2	51	80	0.6375000
NODE_10467_length_846_cov_7.232932	460	540	4	29	80	0.3625000
NODE_10468_length_846_cov_6.776439	320	400	0	80	80	1.0000000
NODE_10468_length_846_cov_6.776439	373	453	0	80	80	1.0000000
NODE_10472_length_846_cov_3.025435	190	270	1	19	80	0.2375000
NODE_10472_length_846_cov_3.025435	190	270	2	61	80	0.7625000
NODE_10472_length_846_cov_3.025435	243	323	2	80	80	1.0000000
NODE_10488_length_845_cov_34.458445	213	293	0	46	80	0.5750000
NODE_10488_length_845_cov_34.458445	213	293	2	34	80	0.4250000
NODE_10488_length_845_cov_34.458445	266	346	2	57	80	0.7125000
NODE_10488_length_845_cov_34.458445	266	346	4	23	80	0.2875000
NODE_10489_length_845_cov_33.025469	309	389	0	25	80	0.3125000
NODE_10489_length_845_cov_33.025469	309	389	2	55	80	0.6875000
NODE_10489_length_845_cov_33.025469	362	442	0	4	80	0.0500000
NODE_10489_length_845_cov_33.025469	362	442	2	76	80	0.9500000
NODE_10490_length_845_cov_30.331099	288	368	0	32	80	0.4000000
NODE_10490_length_845_cov_30.331099	288	368	8	7	80	0.0875000
NODE_10490_length_845_cov_30.331099	288	368	10	38	80	0.4750000
NODE_10490_length_845_cov_30.331099	288	368	12	3	80	0.0375000
NODE_10490_length_845_cov_30.331099	341	421	2	8	80	0.1000000
NODE_10490_length_845_cov_30.331099	341	421	10	46	80	0.5750000
NODE_10490_length_845_cov_30.331099	341	421	12	26	80	0.3250000
NODE_10491_length_845_cov_22.042895	455	535	2	32	80	0.4000000
NODE_10491_length_845_cov_22.042895	455	535	9	31	80	0.3875000
NODE_10491_length_845_cov_22.042895	455	535	11	17	80	0.2125000
NODE_10491_length_845_cov_22.042895	508	588	0	32	80	0.4000000
NODE_10491_length_845_cov_22.042895	508	588	2	48	80	0.6000000
NODE_10492_length_845_cov_20.662198	325	406	0	10	81	0.1234568
NODE_10492_length_845_cov_20.662198	325	406	2	8	81	0.0987654
NODE_10492_length_845_cov_20.662198	325	406	10	42	81	0.5185185
NODE_10492_length_845_cov_20.662198	325	406	13	12	81	0.1481481
NODE_10492_length_845_cov_20.662198	325	406	14	9	81	0.1111111
NODE_10492_length_845_cov_20.662198	379	459	10	6	80	0.0750000
NODE_10492_length_845_cov_20.662198	379	459	13	12	80	0.1500000
NODE_10492_length_845_cov_20.662198	379	459	14	62	80	0.7750000
NODE_10493_length_845_cov_17.214477	352	432	0	80	80	1.0000000
NODE_10493_length_845_cov_17.214477	405	485	0	80	80	1.0000000
NODE_10494_length_845_cov_15.805630	409	489	0	80	80	1.0000000
NODE_10494_length_845_cov_15.805630	462	542	0	80	80	1.0000000
NODE_10495_length_845_cov_13.443700	329	409	0	80	80	1.0000000
NODE_10495_length_845_cov_13.443700	382	462	0	80	80	1.0000000
NODE_10496_length_845_cov_12.301609	334	414	0	45	80	0.5625000
NODE_10496_length_845_cov_12.301609	334	414	2	35	80	0.4375000
NODE_10496_length_845_cov_12.301609	387	467	2	80	80	1.0000000
NODE_10497_length_845_cov_11.836461	389	469	0	47	80	0.5875000
NODE_10497_length_845_cov_11.836461	389	469	2	33	80	0.4125000
NODE_10497_length_845_cov_11.836461	442	522	2	80	80	1.0000000
NODE_10499_length_845_cov_8.140751	439	519	0	10	80	0.1250000
NODE_10499_length_845_cov_8.140751	439	519	2	68	80	0.8500000
NODE_10499_length_845_cov_8.140751	439	519	6	2	80	0.0250000
NODE_10499_length_845_cov_8.140751	492	572	0	55	80	0.6875000
NODE_10499_length_845_cov_8.140751	492	572	2	25	80	0.3125000
NODE_10516_length_845_cov_1.680965	447	491	0	44	44	1.0000000
NODE_10528_length_844_cov_43.778523	313	393	6	4	80	0.0500000
NODE_10528_length_844_cov_43.778523	313	393	8	76	80	0.9500000
NODE_10528_length_844_cov_43.778523	366	446	0	42	80	0.5250000
NODE_10528_length_844_cov_43.778523	366	446	5	4	80	0.0500000
NODE_10528_length_844_cov_43.778523	366	446	6	11	80	0.1375000
NODE_10528_length_844_cov_43.778523	366	446	8	23	80	0.2875000
NODE_10528_length_844_cov_43.778523	442	522	0	4	80	0.0500000
NODE_10528_length_844_cov_43.778523	442	522	6	76	80	0.9500000
NODE_10528_length_844_cov_43.778523	495	575	0	19	80	0.2375000
NODE_10528_length_844_cov_43.778523	495	575	6	61	80	0.7625000
NODE_10529_length_844_cov_36.762416	381	461	0	25	80	0.3125000
NODE_10529_length_844_cov_36.762416	381	461	2	55	80	0.6875000
NODE_10529_length_844_cov_36.762416	434	514	0	78	80	0.9750000
NODE_10529_length_844_cov_36.762416	434	514	2	2	80	0.0250000
NODE_10529_length_844_cov_36.762416	510	590	0	80	80	1.0000000
NODE_10529_length_844_cov_36.762416	563	644	0	69	81	0.8518519
NODE_10529_length_844_cov_36.762416	563	644	2	12	81	0.1481481
NODE_10530_length_844_cov_35.765101	424	504	4	23	80	0.2875000
NODE_10530_length_844_cov_35.765101	424	504	6	20	80	0.2500000
NODE_10530_length_844_cov_35.765101	424	504	8	19	80	0.2375000
NODE_10530_length_844_cov_35.765101	424	504	10	18	80	0.2250000
NODE_10530_length_844_cov_35.765101	477	557	0	39	80	0.4875000
NODE_10530_length_844_cov_35.765101	477	557	4	37	80	0.4625000
NODE_10530_length_844_cov_35.765101	477	557	8	4	80	0.0500000
NODE_10531_length_844_cov_18.445638	353	420	4	33	67	0.4925373
NODE_10531_length_844_cov_18.445638	353	420	6	27	67	0.4029851
NODE_10531_length_844_cov_18.445638	353	420	8	7	67	0.1044776
NODE_10531_length_844_cov_18.445638	393	473	6	64	80	0.8000000
NODE_10531_length_844_cov_18.445638	393	473	8	16	80	0.2000000
NODE_10532_length_844_cov_12.616107	363	443	0	80	80	1.0000000
NODE_10532_length_844_cov_12.616107	416	496	0	80	80	1.0000000
NODE_10533_length_844_cov_12.092617	171	251	0	15	80	0.1875000
NODE_10533_length_844_cov_12.092617	171	251	2	65	80	0.8125000
NODE_10533_length_844_cov_12.092617	224	304	0	39	80	0.4875000
NODE_10533_length_844_cov_12.092617	224	304	2	41	80	0.5125000
NODE_10534_length_844_cov_11.883221	341	421	0	80	80	1.0000000
NODE_10534_length_844_cov_11.883221	394	474	0	80	80	1.0000000
NODE_10535_length_844_cov_10.571812	390	448	2	24	58	0.4137931
NODE_10535_length_844_cov_10.571812	390	448	4	34	58	0.5862069
NODE_10537_length_844_cov_9.357047	370	450	0	80	80	1.0000000
NODE_10537_length_844_cov_9.357047	423	503	0	80	80	1.0000000
NODE_10538_length_844_cov_8.975839	355	435	0	80	80	1.0000000
NODE_10538_length_844_cov_8.975839	408	488	0	80	80	1.0000000
NODE_10539_length_844_cov_7.347651	357	438	0	62	81	0.7654321
NODE_10539_length_844_cov_7.347651	357	438	2	19	81	0.2345679
NODE_10539_length_844_cov_7.347651	410	491	0	36	81	0.4444444
NODE_10539_length_844_cov_7.347651	410	491	2	45	81	0.5555556
NODE_10540_length_844_cov_6.975839	444	524	0	80	80	1.0000000
NODE_10540_length_844_cov_6.975839	497	577	0	80	80	1.0000000
NODE_10567_length_843_cov_48.258065	203	262	400	1	59	0.0169492
NODE_10567_length_843_cov_48.258065	203	262	404	3	59	0.0508475
NODE_10567_length_843_cov_48.258065	203	262	405	1	59	0.0169492
NODE_10567_length_843_cov_48.258065	203	262	406	1	59	0.0169492
NODE_10567_length_843_cov_48.258065	203	262	407	2	59	0.0338983
NODE_10567_length_843_cov_48.258065	203	262	408	2	59	0.0338983
NODE_10567_length_843_cov_48.258065	203	262	410	2	59	0.0338983
NODE_10567_length_843_cov_48.258065	203	262	411	2	59	0.0338983
NODE_10567_length_843_cov_48.258065	203	262	413	2	59	0.0338983
NODE_10567_length_843_cov_48.258065	203	262	414	1	59	0.0169492
NODE_10567_length_843_cov_48.258065	203	262	416	2	59	0.0338983
NODE_10567_length_843_cov_48.258065	203	262	418	1	59	0.0169492
NODE_10567_length_843_cov_48.258065	203	262	419	2	59	0.0338983
NODE_10567_length_843_cov_48.258065	203	262	420	1	59	0.0169492
NODE_10567_length_843_cov_48.258065	203	262	421	1	59	0.0169492
NODE_10567_length_843_cov_48.258065	203	262	425	1	59	0.0169492
NODE_10567_length_843_cov_48.258065	203	262	429	2	59	0.0338983
NODE_10567_length_843_cov_48.258065	203	262	433	1	59	0.0169492
NODE_10567_length_843_cov_48.258065	203	262	435	1	59	0.0169492
NODE_10567_length_843_cov_48.258065	203	262	440	2	59	0.0338983
NODE_10567_length_843_cov_48.258065	203	262	441	2	59	0.0338983
NODE_10567_length_843_cov_48.258065	203	262	442	4	59	0.0677966
NODE_10567_length_843_cov_48.258065	203	262	444	2	59	0.0338983
NODE_10567_length_843_cov_48.258065	203	262	445	1	59	0.0169492
NODE_10567_length_843_cov_48.258065	203	262	446	2	59	0.0338983
NODE_10567_length_843_cov_48.258065	203	262	447	1	59	0.0169492
NODE_10567_length_843_cov_48.258065	203	262	448	1	59	0.0169492
NODE_10567_length_843_cov_48.258065	203	262	449	1	59	0.0169492
NODE_10567_length_843_cov_48.258065	203	262	450	5	59	0.0847458
NODE_10567_length_843_cov_48.258065	203	262	451	1	59	0.0169492
NODE_10567_length_843_cov_48.258065	203	262	452	2	59	0.0338983
NODE_10567_length_843_cov_48.258065	203	262	453	2	59	0.0338983
NODE_10567_length_843_cov_48.258065	203	262	454	1	59	0.0169492
NODE_10567_length_843_cov_48.258065	203	262	455	2	59	0.0338983
NODE_10567_length_843_cov_48.258065	203	262	457	1	59	0.0169492
NODE_10568_length_843_cov_31.279570	351	431	0	47	80	0.5875000
NODE_10568_length_843_cov_31.279570	351	431	2	33	80	0.4125000
NODE_10568_length_843_cov_31.279570	404	484	0	80	80	1.0000000
NODE_10569_length_843_cov_27.060484	423	503	2	80	80	1.0000000
NODE_10569_length_843_cov_27.060484	476	556	1	1	80	0.0125000
NODE_10569_length_843_cov_27.060484	476	556	2	79	80	0.9875000
NODE_10570_length_843_cov_22.725806	334	414	0	80	80	1.0000000
NODE_10570_length_843_cov_22.725806	339	396	0	57	57	1.0000000
NODE_10570_length_843_cov_22.725806	356	427	0	71	71	1.0000000
NODE_10570_length_843_cov_22.725806	387	455	0	68	68	1.0000000
NODE_10570_length_843_cov_22.725806	401	476	0	75	75	1.0000000
NODE_10570_length_843_cov_22.725806	418	486	0	68	68	1.0000000
NODE_10570_length_843_cov_22.725806	449	529	0	80	80	1.0000000
NODE_10571_length_843_cov_22.387097	412	492	8	80	80	1.0000000
NODE_10571_length_843_cov_22.387097	465	545	0	18	80	0.2250000
NODE_10571_length_843_cov_22.387097	465	545	7	1	80	0.0125000
NODE_10571_length_843_cov_22.387097	465	545	8	61	80	0.7625000
NODE_10572_length_843_cov_16.326613	551	631	0	18	80	0.2250000
NODE_10572_length_843_cov_16.326613	551	631	2	62	80	0.7750000
NODE_10572_length_843_cov_16.326613	604	684	2	55	80	0.6875000
NODE_10572_length_843_cov_16.326613	604	684	4	25	80	0.3125000
NODE_10573_length_843_cov_13.478495	381	461	0	80	80	1.0000000
NODE_10573_length_843_cov_13.478495	434	514	0	80	80	1.0000000
NODE_10574_length_843_cov_13.150538	448	528	0	80	80	1.0000000
NODE_10574_length_843_cov_13.150538	501	581	0	80	80	1.0000000
NODE_10575_length_843_cov_12.510753	360	440	0	80	80	1.0000000
NODE_10575_length_843_cov_12.510753	413	493	0	80	80	1.0000000
NODE_10576_length_843_cov_11.090054	457	537	2	59	80	0.7375000
NODE_10576_length_843_cov_11.090054	457	537	5	21	80	0.2625000
NODE_10576_length_843_cov_11.090054	510	590	0	29	80	0.3625000
NODE_10576_length_843_cov_11.090054	510	590	2	51	80	0.6375000
NODE_10577_length_843_cov_7.672043	472	552	0	44	80	0.5500000
NODE_10577_length_843_cov_7.672043	472	552	2	36	80	0.4500000
NODE_10577_length_843_cov_7.672043	525	605	0	5	80	0.0625000
NODE_10577_length_843_cov_7.672043	525	605	2	75	80	0.9375000
NODE_10601_length_842_cov_39.518170	390	470	4	60	80	0.7500000
NODE_10601_length_842_cov_39.518170	390	470	6	20	80	0.2500000
NODE_10601_length_842_cov_39.518170	443	523	0	39	80	0.4875000
NODE_10601_length_842_cov_39.518170	443	523	4	41	80	0.5125000
NODE_10602_length_842_cov_21.567968	331	411	0	80	80	1.0000000
NODE_10602_length_842_cov_21.567968	384	464	0	38	80	0.4750000
NODE_10602_length_842_cov_21.567968	384	464	2	3	80	0.0375000
NODE_10602_length_842_cov_21.567968	384	464	4	39	80	0.4875000
NODE_10603_length_842_cov_19.761777	228	308	0	24	80	0.3000000
NODE_10603_length_842_cov_19.761777	228	308	4	56	80	0.7000000
NODE_10603_length_842_cov_19.761777	281	361	0	43	80	0.5375000
NODE_10603_length_842_cov_19.761777	281	361	4	37	80	0.4625000
NODE_10605_length_842_cov_8.703903	641	722	0	81	81	1.0000000
NODE_10608_length_842_cov_5.305518	287	367	2	80	80	1.0000000
NODE_10608_length_842_cov_5.305518	340	420	0	44	80	0.5500000
NODE_10608_length_842_cov_5.305518	340	420	2	36	80	0.4500000
NODE_10617_length_842_cov_1.751009	35	66	0	31	31	1.0000000
NODE_10622_length_841_cov_23.815364	292	372	0	80	80	1.0000000
NODE_10622_length_841_cov_23.815364	345	425	0	80	80	1.0000000
NODE_10623_length_841_cov_18.871968	338	418	0	39	80	0.4875000
NODE_10623_length_841_cov_18.871968	338	418	2	41	80	0.5125000
NODE_10623_length_841_cov_18.871968	391	471	0	80	80	1.0000000
NODE_10624_length_841_cov_14.663073	345	425	0	65	80	0.8125000
NODE_10624_length_841_cov_14.663073	345	425	4	15	80	0.1875000
NODE_10624_length_841_cov_14.663073	398	478	0	12	80	0.1500000
NODE_10624_length_841_cov_14.663073	398	478	4	51	80	0.6375000
NODE_10624_length_841_cov_14.663073	398	478	6	17	80	0.2125000
NODE_10625_length_841_cov_14.149596	341	421	0	80	80	1.0000000
NODE_10625_length_841_cov_14.149596	394	474	0	80	80	1.0000000
NODE_10626_length_841_cov_12.452830	240	320	0	80	80	1.0000000
NODE_10626_length_841_cov_12.452830	293	373	0	67	80	0.8375000
NODE_10626_length_841_cov_12.452830	293	373	2	13	80	0.1625000
NODE_10628_length_841_cov_9.925876	394	474	0	14	80	0.1750000
NODE_10628_length_841_cov_9.925876	394	474	4	66	80	0.8250000
NODE_10628_length_841_cov_9.925876	447	527	0	41	80	0.5125000
NODE_10628_length_841_cov_9.925876	447	527	4	39	80	0.4875000
NODE_10629_length_841_cov_7.407008	317	397	0	80	80	1.0000000
NODE_10629_length_841_cov_7.407008	370	450	0	80	80	1.0000000
NODE_10632_length_841_cov_3.865229	305	356	0	51	51	1.0000000
NODE_10651_length_840_cov_63.726046	461	541	0	80	80	1.0000000
NODE_10651_length_840_cov_63.726046	514	594	0	80	80	1.0000000
NODE_10652_length_840_cov_35.874494	486	566	2	80	80	1.0000000
NODE_10652_length_840_cov_35.874494	539	619	2	48	80	0.6000000
NODE_10652_length_840_cov_35.874494	539	619	3	17	80	0.2125000
NODE_10652_length_840_cov_35.874494	539	619	4	15	80	0.1875000
NODE_10653_length_840_cov_24.499325	224	304	0	61	80	0.7625000
NODE_10653_length_840_cov_24.499325	224	304	1	6	80	0.0750000
NODE_10653_length_840_cov_24.499325	224	304	2	13	80	0.1625000
NODE_10653_length_840_cov_24.499325	277	357	0	8	80	0.1000000
NODE_10653_length_840_cov_24.499325	277	357	1	6	80	0.0750000
NODE_10653_length_840_cov_24.499325	277	357	2	66	80	0.8250000
NODE_10653_length_840_cov_24.499325	353	433	2	80	80	1.0000000
NODE_10653_length_840_cov_24.499325	406	486	0	45	80	0.5625000
NODE_10653_length_840_cov_24.499325	406	486	1	6	80	0.0750000
NODE_10653_length_840_cov_24.499325	406	486	2	29	80	0.3625000
NODE_10654_length_840_cov_23.272605	309	389	0	80	80	1.0000000
NODE_10654_length_840_cov_23.272605	362	442	0	80	80	1.0000000
NODE_10655_length_840_cov_22.221323	293	373	0	80	80	1.0000000
NODE_10655_length_840_cov_22.221323	346	426	0	80	80	1.0000000
NODE_10656_length_840_cov_17.026991	348	432	0	84	84	1.0000000
NODE_10656_length_840_cov_17.026991	405	485	0	80	80	1.0000000
NODE_10657_length_840_cov_16.635628	347	427	0	80	80	1.0000000
NODE_10657_length_840_cov_16.635628	400	480	0	80	80	1.0000000
NODE_10658_length_840_cov_12.133603	336	416	0	80	80	1.0000000
NODE_10658_length_840_cov_12.133603	389	469	0	80	80	1.0000000
NODE_10659_length_840_cov_12.041835	332	412	0	17	80	0.2125000
NODE_10659_length_840_cov_12.041835	332	412	2	63	80	0.7875000
NODE_10659_length_840_cov_12.041835	385	465	0	9	80	0.1125000
NODE_10659_length_840_cov_12.041835	385	465	2	71	80	0.8875000
NODE_10660_length_840_cov_10.719298	275	354	0	15	79	0.1898734
NODE_10660_length_840_cov_10.719298	275	354	2	15	79	0.1898734
NODE_10660_length_840_cov_10.719298	275	354	4	13	79	0.1645570
NODE_10660_length_840_cov_10.719298	275	354	8	35	79	0.4430380
NODE_10660_length_840_cov_10.719298	275	354	10	1	79	0.0126582
NODE_10660_length_840_cov_10.719298	327	407	6	31	80	0.3875000
NODE_10660_length_840_cov_10.719298	327	407	8	31	80	0.3875000
NODE_10660_length_840_cov_10.719298	327	407	10	12	80	0.1500000
NODE_10660_length_840_cov_10.719298	327	407	11	3	80	0.0375000
NODE_10660_length_840_cov_10.719298	327	407	12	3	80	0.0375000
NODE_10663_length_840_cov_5.207827	427	507	0	80	80	1.0000000
NODE_10663_length_840_cov_5.207827	480	560	0	80	80	1.0000000
NODE_10683_length_839_cov_274.987838	450	530	19	5	80	0.0625000
NODE_10683_length_839_cov_274.987838	450	530	21	1	80	0.0125000
NODE_10683_length_839_cov_274.987838	450	530	25	2	80	0.0250000
NODE_10683_length_839_cov_274.987838	450	530	29	1	80	0.0125000
NODE_10683_length_839_cov_274.987838	450	530	32	3	80	0.0375000
NODE_10683_length_839_cov_274.987838	450	530	33	1	80	0.0125000
NODE_10683_length_839_cov_274.987838	450	530	36	2	80	0.0250000
NODE_10683_length_839_cov_274.987838	450	530	37	3	80	0.0375000
NODE_10683_length_839_cov_274.987838	450	530	39	5	80	0.0625000
NODE_10683_length_839_cov_274.987838	450	530	57	1	80	0.0125000
NODE_10683_length_839_cov_274.987838	450	530	58	1	80	0.0125000
NODE_10683_length_839_cov_274.987838	450	530	60	2	80	0.0250000
NODE_10683_length_839_cov_274.987838	450	530	72	1	80	0.0125000
NODE_10683_length_839_cov_274.987838	450	530	73	4	80	0.0500000
NODE_10683_length_839_cov_274.987838	450	530	74	1	80	0.0125000
NODE_10683_length_839_cov_274.987838	450	530	75	3	80	0.0375000
NODE_10683_length_839_cov_274.987838	450	530	76	1	80	0.0125000
NODE_10683_length_839_cov_274.987838	450	530	78	3	80	0.0375000
NODE_10683_length_839_cov_274.987838	450	530	81	1	80	0.0125000
NODE_10683_length_839_cov_274.987838	450	530	89	7	80	0.0875000
NODE_10683_length_839_cov_274.987838	450	530	90	1	80	0.0125000
NODE_10683_length_839_cov_274.987838	450	530	95	7	80	0.0875000
NODE_10683_length_839_cov_274.987838	450	530	99	1	80	0.0125000
NODE_10683_length_839_cov_274.987838	450	530	102	1	80	0.0125000
NODE_10683_length_839_cov_274.987838	450	530	103	1	80	0.0125000
NODE_10683_length_839_cov_274.987838	450	530	104	4	80	0.0500000
NODE_10683_length_839_cov_274.987838	450	530	105	1	80	0.0125000
NODE_10683_length_839_cov_274.987838	450	530	108	1	80	0.0125000
NODE_10683_length_839_cov_274.987838	450	530	109	2	80	0.0250000
NODE_10683_length_839_cov_274.987838	450	530	110	2	80	0.0250000
NODE_10683_length_839_cov_274.987838	450	530	112	3	80	0.0375000
NODE_10683_length_839_cov_274.987838	450	530	113	1	80	0.0125000
NODE_10683_length_839_cov_274.987838	450	530	114	2	80	0.0250000
NODE_10683_length_839_cov_274.987838	450	530	116	3	80	0.0375000
NODE_10683_length_839_cov_274.987838	450	530	117	1	80	0.0125000
NODE_10683_length_839_cov_274.987838	450	530	129	1	80	0.0125000
NODE_10683_length_839_cov_274.987838	503	583	95	3	80	0.0375000
NODE_10683_length_839_cov_274.987838	503	583	99	1	80	0.0125000
NODE_10683_length_839_cov_274.987838	503	583	102	1	80	0.0125000
NODE_10683_length_839_cov_274.987838	503	583	103	1	80	0.0125000
NODE_10683_length_839_cov_274.987838	503	583	104	4	80	0.0500000
NODE_10683_length_839_cov_274.987838	503	583	105	1	80	0.0125000
NODE_10683_length_839_cov_274.987838	503	583	108	1	80	0.0125000
NODE_10683_length_839_cov_274.987838	503	583	109	2	80	0.0250000
NODE_10683_length_839_cov_274.987838	503	583	110	2	80	0.0250000
NODE_10683_length_839_cov_274.987838	503	583	112	3	80	0.0375000
NODE_10683_length_839_cov_274.987838	503	583	113	1	80	0.0125000
NODE_10683_length_839_cov_274.987838	503	583	114	2	80	0.0250000
NODE_10683_length_839_cov_274.987838	503	583	116	3	80	0.0375000
NODE_10683_length_839_cov_274.987838	503	583	117	1	80	0.0125000
NODE_10683_length_839_cov_274.987838	503	583	129	1	80	0.0125000
NODE_10683_length_839_cov_274.987838	503	583	130	3	80	0.0375000
NODE_10683_length_839_cov_274.987838	503	583	137	1	80	0.0125000
NODE_10683_length_839_cov_274.987838	503	583	138	1	80	0.0125000
NODE_10683_length_839_cov_274.987838	503	583	146	1	80	0.0125000
NODE_10683_length_839_cov_274.987838	503	583	150	1	80	0.0125000
NODE_10683_length_839_cov_274.987838	503	583	167	2	80	0.0250000
NODE_10683_length_839_cov_274.987838	503	583	169	1	80	0.0125000
NODE_10683_length_839_cov_274.987838	503	583	172	1	80	0.0125000
NODE_10683_length_839_cov_274.987838	503	583	176	1	80	0.0125000
NODE_10683_length_839_cov_274.987838	503	583	186	1	80	0.0125000
NODE_10683_length_839_cov_274.987838	503	583	189	1	80	0.0125000
NODE_10683_length_839_cov_274.987838	503	583	191	1	80	0.0125000
NODE_10683_length_839_cov_274.987838	503	583	195	1	80	0.0125000
NODE_10683_length_839_cov_274.987838	503	583	197	3	80	0.0375000
NODE_10683_length_839_cov_274.987838	503	583	199	2	80	0.0250000
NODE_10683_length_839_cov_274.987838	503	583	201	4	80	0.0500000
NODE_10683_length_839_cov_274.987838	503	583	202	1	80	0.0125000
NODE_10683_length_839_cov_274.987838	503	583	208	1	80	0.0125000
NODE_10683_length_839_cov_274.987838	503	583	210	2	80	0.0250000
NODE_10683_length_839_cov_274.987838	503	583	213	1	80	0.0125000
NODE_10683_length_839_cov_274.987838	503	583	215	3	80	0.0375000
NODE_10683_length_839_cov_274.987838	503	583	217	6	80	0.0750000
NODE_10683_length_839_cov_274.987838	503	583	219	3	80	0.0375000
NODE_10683_length_839_cov_274.987838	503	583	221	3	80	0.0375000
NODE_10683_length_839_cov_274.987838	503	583	225	1	80	0.0125000
NODE_10683_length_839_cov_274.987838	503	583	226	6	80	0.0750000
NODE_10683_length_839_cov_274.987838	503	583	227	1	80	0.0125000
NODE_10684_length_839_cov_24.500000	303	383	0	9	80	0.1125000
NODE_10684_length_839_cov_24.500000	303	383	2	48	80	0.6000000
NODE_10684_length_839_cov_24.500000	303	383	4	23	80	0.2875000
NODE_10684_length_839_cov_24.500000	356	436	0	4	80	0.0500000
NODE_10684_length_839_cov_24.500000	356	436	4	76	80	0.9500000
NODE_10685_length_839_cov_16.390541	477	557	0	80	80	1.0000000
NODE_10685_length_839_cov_16.390541	530	610	0	80	80	1.0000000
NODE_10686_length_839_cov_10.006757	383	463	0	80	80	1.0000000
NODE_10686_length_839_cov_10.006757	436	516	0	80	80	1.0000000
NODE_10688_length_839_cov_7.612162	308	388	0	80	80	1.0000000
NODE_10688_length_839_cov_7.612162	361	441	0	80	80	1.0000000
NODE_10689_length_839_cov_6.693243	343	423	0	14	80	0.1750000
NODE_10689_length_839_cov_6.693243	343	423	2	66	80	0.8250000
NODE_10706_length_838_cov_39.263870	383	463	0	80	80	1.0000000
NODE_10706_length_838_cov_39.263870	436	516	0	80	80	1.0000000
NODE_10707_length_838_cov_27.843031	473	553	0	22	80	0.2750000
NODE_10707_length_838_cov_27.843031	473	553	2	58	80	0.7250000
NODE_10707_length_838_cov_27.843031	526	606	0	75	80	0.9375000
NODE_10707_length_838_cov_27.843031	526	606	2	5	80	0.0625000
NODE_10708_length_838_cov_27.238160	432	512	7	15	80	0.1875000
NODE_10708_length_838_cov_27.238160	432	512	8	57	80	0.7125000
NODE_10708_length_838_cov_27.238160	432	512	9	8	80	0.1000000
NODE_10708_length_838_cov_27.238160	485	565	1	3	80	0.0375000
NODE_10708_length_838_cov_27.238160	485	565	2	25	80	0.3125000
NODE_10708_length_838_cov_27.238160	485	565	6	12	80	0.1500000
NODE_10708_length_838_cov_27.238160	485	565	8	40	80	0.5000000
NODE_10709_length_838_cov_22.691475	380	460	0	80	80	1.0000000
NODE_10709_length_838_cov_22.691475	433	513	0	80	80	1.0000000
NODE_10710_length_838_cov_16.169147	312	392	0	80	80	1.0000000
NODE_10710_length_838_cov_16.169147	365	445	0	80	80	1.0000000
NODE_10711_length_838_cov_15.753721	328	408	2	9	80	0.1125000
NODE_10711_length_838_cov_15.753721	328	408	6	45	80	0.5625000
NODE_10711_length_838_cov_15.753721	328	408	8	26	80	0.3250000
NODE_10711_length_838_cov_15.753721	381	461	2	62	80	0.7750000
NODE_10711_length_838_cov_15.753721	381	461	8	18	80	0.2250000
NODE_10712_length_838_cov_15.514208	294	374	0	4	80	0.0500000
NODE_10712_length_838_cov_15.514208	294	374	2	76	80	0.9500000
NODE_10712_length_838_cov_15.514208	347	427	0	56	80	0.7000000
NODE_10712_length_838_cov_15.514208	347	427	2	24	80	0.3000000
NODE_10713_length_838_cov_7.733424	350	430	0	6	80	0.0750000
NODE_10713_length_838_cov_7.733424	350	430	1	18	80	0.2250000
NODE_10713_length_838_cov_7.733424	350	430	2	56	80	0.7000000
NODE_10713_length_838_cov_7.733424	403	483	0	59	80	0.7375000
NODE_10713_length_838_cov_7.733424	403	483	1	18	80	0.2250000
NODE_10713_length_838_cov_7.733424	403	483	2	3	80	0.0375000
NODE_10716_length_838_cov_4.511502	131	213	0	82	82	1.0000000
NODE_10716_length_838_cov_4.511502	184	252	0	68	68	1.0000000
NODE_10722_length_838_cov_2.247632	359	405	0	46	46	1.0000000
NODE_10727_length_838_cov_1.843031	732	752	0	20	20	1.0000000
NODE_10740_length_837_cov_32.691057	401	481	2	18	80	0.2250000
NODE_10740_length_837_cov_32.691057	401	481	4	62	80	0.7750000
NODE_10740_length_837_cov_32.691057	454	534	2	34	80	0.4250000
NODE_10740_length_837_cov_32.691057	454	534	4	46	80	0.5750000
NODE_10741_length_837_cov_30.995935	399	479	0	56	80	0.7000000
NODE_10741_length_837_cov_30.995935	399	479	2	14	80	0.1750000
NODE_10741_length_837_cov_30.995935	399	479	4	10	80	0.1250000
NODE_10741_length_837_cov_30.995935	452	532	0	3	80	0.0375000
NODE_10741_length_837_cov_30.995935	452	532	2	14	80	0.1750000
NODE_10741_length_837_cov_30.995935	452	532	4	45	80	0.5625000
NODE_10741_length_837_cov_30.995935	452	532	6	18	80	0.2250000
NODE_10742_length_837_cov_30.883469	278	358	6	80	80	1.0000000
NODE_10742_length_837_cov_30.883469	331	411	0	19	80	0.2375000
NODE_10742_length_837_cov_30.883469	331	411	3	1	80	0.0125000
NODE_10742_length_837_cov_30.883469	331	411	4	17	80	0.2125000
NODE_10742_length_837_cov_30.883469	331	411	6	43	80	0.5375000
NODE_10742_length_837_cov_30.883469	407	487	0	80	80	1.0000000
NODE_10742_length_837_cov_30.883469	460	540	0	80	80	1.0000000
NODE_10743_length_837_cov_14.573171	205	280	0	75	75	1.0000000
NODE_10743_length_837_cov_14.573171	258	337	0	79	79	1.0000000
NODE_10743_length_837_cov_14.573171	333	413	0	80	80	1.0000000
NODE_10743_length_837_cov_14.573171	386	466	0	80	80	1.0000000
NODE_10744_length_837_cov_12.582656	226	306	0	10	80	0.1250000
NODE_10744_length_837_cov_12.582656	226	306	2	21	80	0.2625000
NODE_10744_length_837_cov_12.582656	226	306	3	8	80	0.1000000
NODE_10744_length_837_cov_12.582656	226	306	4	41	80	0.5125000
NODE_10744_length_837_cov_12.582656	279	359	2	51	80	0.6375000
NODE_10744_length_837_cov_12.582656	279	359	4	29	80	0.3625000
NODE_10745_length_837_cov_6.998645	389	474	0	85	85	1.0000000
NODE_10745_length_837_cov_6.998645	447	527	0	80	80	1.0000000
NODE_10750_length_837_cov_3.119241	373	453	0	80	80	1.0000000
NODE_10750_length_837_cov_3.119241	426	506	0	28	80	0.3500000
NODE_10750_length_837_cov_3.119241	426	506	6	52	80	0.6500000
NODE_10769_length_836_cov_40.141113	224	304	0	21	80	0.2625000
NODE_10769_length_836_cov_40.141113	224	304	4	32	80	0.4000000
NODE_10769_length_836_cov_40.141113	224	304	6	27	80	0.3375000
NODE_10769_length_836_cov_40.141113	277	357	2	28	80	0.3500000
NODE_10769_length_836_cov_40.141113	277	357	6	52	80	0.6500000
NODE_10769_length_836_cov_40.141113	353	433	0	36	80	0.4500000
NODE_10769_length_836_cov_40.141113	353	433	2	44	80	0.5500000
NODE_10769_length_836_cov_40.141113	406	486	0	39	80	0.4875000
NODE_10769_length_836_cov_40.141113	406	486	2	41	80	0.5125000
NODE_10770_length_836_cov_27.610583	344	424	0	12	80	0.1500000
NODE_10770_length_836_cov_27.610583	344	424	2	7	80	0.0875000
NODE_10770_length_836_cov_27.610583	344	424	4	61	80	0.7625000
NODE_10770_length_836_cov_27.610583	397	477	0	65	80	0.8125000
NODE_10770_length_836_cov_27.610583	397	477	2	7	80	0.0875000
NODE_10770_length_836_cov_27.610583	397	477	4	8	80	0.1000000
NODE_10771_length_836_cov_15.719132	295	375	0	2	80	0.0250000
NODE_10771_length_836_cov_15.719132	295	375	2	78	80	0.9750000
NODE_10771_length_836_cov_15.719132	348	428	0	55	80	0.6875000
NODE_10771_length_836_cov_15.719132	348	428	2	25	80	0.3125000
NODE_10772_length_836_cov_9.309362	295	375	0	80	80	1.0000000
NODE_10772_length_836_cov_9.309362	348	428	0	80	80	1.0000000
NODE_10773_length_836_cov_6.283582	336	416	2	80	80	1.0000000
NODE_10773_length_836_cov_6.283582	389	469	0	13	80	0.1625000
NODE_10773_length_836_cov_6.283582	389	469	1	5	80	0.0625000
NODE_10773_length_836_cov_6.283582	389	469	2	62	80	0.7750000
NODE_10774_length_836_cov_4.979647	371	451	0	80	80	1.0000000
NODE_10774_length_836_cov_4.979647	424	504	0	80	80	1.0000000
NODE_10787_length_835_cov_61.033967	253	333	0	80	80	1.0000000
NODE_10787_length_835_cov_61.033967	306	386	0	80	80	1.0000000
NODE_10788_length_835_cov_32.380435	390	470	0	80	80	1.0000000
NODE_10788_length_835_cov_32.380435	443	523	0	80	80	1.0000000
NODE_10789_length_835_cov_20.779891	415	495	3	7	80	0.0875000
NODE_10789_length_835_cov_20.779891	415	495	4	4	80	0.0500000
NODE_10789_length_835_cov_20.779891	415	495	5	19	80	0.2375000
NODE_10789_length_835_cov_20.779891	415	495	9	23	80	0.2875000
NODE_10789_length_835_cov_20.779891	415	495	11	9	80	0.1125000
NODE_10789_length_835_cov_20.779891	415	495	12	7	80	0.0875000
NODE_10789_length_835_cov_20.779891	415	495	13	11	80	0.1375000
NODE_10789_length_835_cov_20.779891	468	548	6	9	80	0.1125000
NODE_10789_length_835_cov_20.779891	468	548	11	10	80	0.1250000
NODE_10789_length_835_cov_20.779891	468	548	12	50	80	0.6250000
NODE_10789_length_835_cov_20.779891	468	548	13	11	80	0.1375000
NODE_10808_length_835_cov_1.694293	18	80	0	62	62	1.0000000
NODE_10820_length_834_cov_13.689796	213	293	0	80	80	1.0000000
NODE_10820_length_834_cov_13.689796	266	346	0	62	80	0.7750000
NODE_10820_length_834_cov_13.689796	266	346	2	18	80	0.2250000
NODE_10822_length_834_cov_12.609524	406	486	0	26	80	0.3250000
NODE_10822_length_834_cov_12.609524	406	486	4	54	80	0.6750000
NODE_10822_length_834_cov_12.609524	459	539	0	21	80	0.2625000
NODE_10822_length_834_cov_12.609524	459	539	4	59	80	0.7375000
NODE_10823_length_834_cov_11.492517	248	328	0	80	80	1.0000000
NODE_10823_length_834_cov_11.492517	301	381	0	36	80	0.4500000
NODE_10823_length_834_cov_11.492517	301	381	2	44	80	0.5500000
NODE_10824_length_834_cov_9.957823	212	292	0	64	80	0.8000000
NODE_10824_length_834_cov_9.957823	212	292	4	16	80	0.2000000
NODE_10824_length_834_cov_9.957823	265	345	0	11	80	0.1375000
NODE_10824_length_834_cov_9.957823	265	345	4	65	80	0.8125000
NODE_10824_length_834_cov_9.957823	265	345	6	4	80	0.0500000
NODE_10825_length_834_cov_6.448980	482	546	0	55	64	0.8593750
NODE_10825_length_834_cov_6.448980	482	546	4	9	64	0.1406250
NODE_10833_length_834_cov_2.658503	589	641	2	52	52	1.0000000
NODE_10846_length_833_cov_57.702997	338	418	6	80	80	1.0000000
NODE_10846_length_833_cov_57.702997	391	471	0	35	80	0.4375000
NODE_10846_length_833_cov_57.702997	391	471	2	11	80	0.1375000
NODE_10846_length_833_cov_57.702997	391	471	6	34	80	0.4250000
NODE_10847_length_833_cov_38.153951	364	444	0	18	80	0.2250000
NODE_10847_length_833_cov_38.153951	364	444	4	62	80	0.7750000
NODE_10847_length_833_cov_38.153951	417	497	0	66	80	0.8250000
NODE_10847_length_833_cov_38.153951	417	497	4	14	80	0.1750000
NODE_10848_length_833_cov_34.302452	368	448	0	80	80	1.0000000
NODE_10848_length_833_cov_34.302452	421	501	0	80	80	1.0000000
NODE_10849_length_833_cov_20.452316	311	392	0	81	81	1.0000000
NODE_10849_length_833_cov_20.452316	365	445	0	80	80	1.0000000
NODE_10850_length_833_cov_16.643052	238	318	4	15	80	0.1875000
NODE_10850_length_833_cov_16.643052	238	318	6	65	80	0.8125000
NODE_10851_length_833_cov_16.536785	84	164	0	80	80	1.0000000
NODE_10851_length_833_cov_16.536785	137	217	0	80	80	1.0000000
NODE_10865_length_833_cov_3.089918	467	547	0	2	80	0.0250000
NODE_10865_length_833_cov_3.089918	467	547	2	78	80	0.9750000
NODE_10865_length_833_cov_3.089918	520	600	0	34	80	0.4250000
NODE_10865_length_833_cov_3.089918	520	600	2	46	80	0.5750000
NODE_10891_length_832_cov_35.728513	460	540	0	27	80	0.3375000
NODE_10891_length_832_cov_35.728513	460	540	2	53	80	0.6625000
NODE_10891_length_832_cov_35.728513	513	593	2	80	80	1.0000000
NODE_10892_length_832_cov_25.450205	292	372	0	15	80	0.1875000
NODE_10892_length_832_cov_25.450205	292	372	2	58	80	0.7250000
NODE_10892_length_832_cov_25.450205	292	372	3	7	80	0.0875000
NODE_10892_length_832_cov_25.450205	345	425	2	20	80	0.2500000
NODE_10892_length_832_cov_25.450205	345	425	3	60	80	0.7500000
NODE_10893_length_832_cov_18.858117	428	508	0	56	80	0.7000000
NODE_10893_length_832_cov_18.858117	428	508	2	15	80	0.1875000
NODE_10893_length_832_cov_18.858117	428	508	3	9	80	0.1125000
NODE_10893_length_832_cov_18.858117	481	561	0	12	80	0.1500000
NODE_10893_length_832_cov_18.858117	481	561	2	68	80	0.8500000
NODE_10894_length_832_cov_17.799454	314	394	0	80	80	1.0000000
NODE_10894_length_832_cov_17.799454	367	447	0	80	80	1.0000000
NODE_10895_length_832_cov_14.811733	353	433	0	59	80	0.7375000
NODE_10895_length_832_cov_14.811733	353	433	4	3	80	0.0375000
NODE_10895_length_832_cov_14.811733	353	433	8	15	80	0.1875000
NODE_10895_length_832_cov_14.811733	353	433	10	3	80	0.0375000
NODE_10896_length_832_cov_14.770805	259	339	0	20	80	0.2500000
NODE_10896_length_832_cov_14.770805	259	339	2	60	80	0.7500000
NODE_10896_length_832_cov_14.770805	312	392	0	73	80	0.9125000
NODE_10896_length_832_cov_14.770805	312	392	2	7	80	0.0875000
NODE_10897_length_832_cov_8.305593	266	346	0	43	80	0.5375000
NODE_10897_length_832_cov_8.305593	266	346	2	37	80	0.4625000
NODE_10897_length_832_cov_8.305593	319	399	2	80	80	1.0000000
NODE_10918_length_831_cov_18.403005	371	451	0	27	80	0.3375000
NODE_10918_length_831_cov_18.403005	371	451	4	53	80	0.6625000
NODE_10918_length_831_cov_18.403005	424	504	0	80	80	1.0000000
NODE_10919_length_831_cov_16.017760	357	437	0	66	80	0.8250000
NODE_10919_length_831_cov_16.017760	357	437	2	5	80	0.0625000
NODE_10919_length_831_cov_16.017760	357	437	4	9	80	0.1125000
NODE_10919_length_831_cov_16.017760	410	490	0	13	80	0.1625000
NODE_10919_length_831_cov_16.017760	410	490	2	5	80	0.0625000
NODE_10919_length_831_cov_16.017760	410	490	4	62	80	0.7750000
NODE_10920_length_831_cov_13.740437	405	485	0	80	80	1.0000000
NODE_10920_length_831_cov_13.740437	458	538	0	80	80	1.0000000
NODE_10921_length_831_cov_9.595628	281	361	0	80	80	1.0000000
NODE_10921_length_831_cov_9.595628	334	414	0	80	80	1.0000000
NODE_10922_length_831_cov_8.199454	433	482	4	49	49	1.0000000
NODE_10923_length_831_cov_7.607923	216	296	0	32	80	0.4000000
NODE_10923_length_831_cov_7.607923	216	296	2	48	80	0.6000000
NODE_10923_length_831_cov_7.607923	269	349	0	28	80	0.3500000
NODE_10923_length_831_cov_7.607923	269	349	2	52	80	0.6500000
NODE_10924_length_831_cov_6.454918	334	409	0	27	75	0.3600000
NODE_10924_length_831_cov_6.454918	334	409	6	45	75	0.6000000
NODE_10924_length_831_cov_6.454918	334	409	8	3	75	0.0400000
NODE_10924_length_831_cov_6.454918	382	462	6	24	80	0.3000000
NODE_10924_length_831_cov_6.454918	382	462	8	56	80	0.7000000
NODE_10960_length_830_cov_40.856361	238	318	0	80	80	1.0000000
NODE_10960_length_830_cov_40.856361	291	371	0	80	80	1.0000000
NODE_10961_length_830_cov_32.170999	302	378	0	55	76	0.7236842
NODE_10961_length_830_cov_32.170999	302	378	1	21	76	0.2763158
NODE_10961_length_830_cov_32.170999	303	383	0	54	80	0.6750000
NODE_10961_length_830_cov_32.170999	303	383	1	26	80	0.3250000
NODE_10961_length_830_cov_32.170999	356	436	0	1	80	0.0125000
NODE_10961_length_830_cov_32.170999	356	436	1	79	80	0.9875000
NODE_10962_length_830_cov_28.041040	393	473	0	80	80	1.0000000
NODE_10962_length_830_cov_28.041040	446	526	0	80	80	1.0000000
NODE_10963_length_830_cov_20.280438	360	440	0	80	80	1.0000000
NODE_10963_length_830_cov_20.280438	413	492	0	79	79	1.0000000
NODE_10964_length_830_cov_19.495212	274	354	0	80	80	1.0000000
NODE_10964_length_830_cov_19.495212	327	407	0	80	80	1.0000000
NODE_10965_length_830_cov_18.522572	368	448	0	9	80	0.1125000
NODE_10965_length_830_cov_18.522572	368	448	2	71	80	0.8875000
NODE_10965_length_830_cov_18.522572	421	501	2	36	80	0.4500000
NODE_10965_length_830_cov_18.522572	421	501	4	44	80	0.5500000
NODE_10966_length_830_cov_13.830369	278	358	2	1	80	0.0125000
NODE_10966_length_830_cov_13.830369	278	358	4	5	80	0.0625000
NODE_10966_length_830_cov_13.830369	278	358	8	1	80	0.0125000
NODE_10966_length_830_cov_13.830369	278	358	10	62	80	0.7750000
NODE_10966_length_830_cov_13.830369	278	358	12	11	80	0.1375000
NODE_10966_length_830_cov_13.830369	331	411	0	37	80	0.4625000
NODE_10966_length_830_cov_13.830369	331	411	2	17	80	0.2125000
NODE_10966_length_830_cov_13.830369	331	411	4	5	80	0.0625000
NODE_10966_length_830_cov_13.830369	331	411	8	1	80	0.0125000
NODE_10966_length_830_cov_13.830369	331	411	10	20	80	0.2500000
NODE_10967_length_830_cov_12.459644	201	281	0	80	80	1.0000000
NODE_10967_length_830_cov_12.459644	254	334	0	74	80	0.9250000
NODE_10967_length_830_cov_12.459644	254	334	2	6	80	0.0750000
NODE_10968_length_830_cov_8.344733	450	530	0	36	80	0.4500000
NODE_10968_length_830_cov_8.344733	450	530	2	44	80	0.5500000
NODE_10968_length_830_cov_8.344733	503	583	0	80	80	1.0000000
NODE_10969_length_830_cov_8.227086	634	714	0	17	80	0.2125000
NODE_10969_length_830_cov_8.227086	634	714	2	23	80	0.2875000
NODE_10969_length_830_cov_8.227086	634	714	4	40	80	0.5000000
NODE_10969_length_830_cov_8.227086	687	767	2	50	80	0.6250000
NODE_10969_length_830_cov_8.227086	687	767	4	30	80	0.3750000
NODE_10995_length_829_cov_74.910959	271	351	0	15	80	0.1875000
NODE_10995_length_829_cov_74.910959	271	351	4	65	80	0.8125000
NODE_10995_length_829_cov_74.910959	324	404	0	29	80	0.3625000
NODE_10995_length_829_cov_74.910959	324	404	4	51	80	0.6375000
NODE_10996_length_829_cov_34.068493	302	382	0	80	80	1.0000000
NODE_10996_length_829_cov_34.068493	355	435	0	80	80	1.0000000
NODE_10997_length_829_cov_24.027397	441	521	0	5	80	0.0625000
NODE_10997_length_829_cov_24.027397	441	521	5	1	80	0.0125000
NODE_10997_length_829_cov_24.027397	441	521	6	1	80	0.0125000
NODE_10997_length_829_cov_24.027397	441	521	7	3	80	0.0375000
NODE_10997_length_829_cov_24.027397	441	521	8	70	80	0.8750000
NODE_10997_length_829_cov_24.027397	494	574	0	40	80	0.5000000
NODE_10997_length_829_cov_24.027397	494	574	8	40	80	0.5000000
NODE_10998_length_829_cov_21.735616	420	500	0	80	80	1.0000000
NODE_10998_length_829_cov_21.735616	473	553	0	80	80	1.0000000
NODE_10999_length_829_cov_18.446575	407	487	0	80	80	1.0000000
NODE_10999_length_829_cov_18.446575	460	540	0	80	80	1.0000000
NODE_11000_length_829_cov_10.971233	368	448	0	5	80	0.0625000
NODE_11000_length_829_cov_10.971233	368	448	2	75	80	0.9375000
NODE_11000_length_829_cov_10.971233	421	501	0	36	80	0.4500000
NODE_11000_length_829_cov_10.971233	421	501	2	22	80	0.2750000
NODE_11000_length_829_cov_10.971233	421	501	4	22	80	0.2750000
NODE_11001_length_829_cov_10.035616	387	467	0	80	80	1.0000000
NODE_11001_length_829_cov_10.035616	440	520	0	80	80	1.0000000
NODE_11002_length_829_cov_9.906849	326	406	0	80	80	1.0000000
NODE_11002_length_829_cov_9.906849	379	459	0	80	80	1.0000000
NODE_11003_length_829_cov_8.809589	450	530	0	80	80	1.0000000
NODE_11003_length_829_cov_8.809589	503	583	0	80	80	1.0000000
NODE_11006_length_829_cov_4.310959	473	553	0	42	80	0.5250000
NODE_11006_length_829_cov_4.310959	473	553	2	38	80	0.4750000
NODE_11006_length_829_cov_4.310959	526	606	0	10	80	0.1250000
NODE_11006_length_829_cov_4.310959	526	606	2	70	80	0.8750000
NODE_11008_length_829_cov_3.079452	507	587	0	80	80	1.0000000
NODE_11008_length_829_cov_3.079452	507	587	0	80	80	1.0000000
NODE_11008_length_829_cov_3.079452	560	640	0	80	80	1.0000000
NODE_11025_length_828_cov_41.116598	436	516	0	80	80	1.0000000
NODE_11025_length_828_cov_41.116598	489	569	0	80	80	1.0000000
NODE_11026_length_828_cov_36.459534	372	452	12	11	80	0.1375000
NODE_11026_length_828_cov_36.459534	372	452	13	35	80	0.4375000
NODE_11026_length_828_cov_36.459534	372	452	15	34	80	0.4250000
NODE_11026_length_828_cov_36.459534	425	505	2	2	80	0.0250000
NODE_11026_length_828_cov_36.459534	425	505	5	7	80	0.0875000
NODE_11026_length_828_cov_36.459534	425	505	7	4	80	0.0500000
NODE_11026_length_828_cov_36.459534	425	505	10	35	80	0.4375000
NODE_11026_length_828_cov_36.459534	425	505	14	1	80	0.0125000
NODE_11026_length_828_cov_36.459534	425	505	15	31	80	0.3875000
NODE_11027_length_828_cov_33.515775	443	523	0	80	80	1.0000000
NODE_11027_length_828_cov_33.515775	496	576	0	80	80	1.0000000
NODE_11028_length_828_cov_21.123457	380	460	0	80	80	1.0000000
NODE_11028_length_828_cov_21.123457	433	513	0	80	80	1.0000000
NODE_11029_length_828_cov_17.406036	304	392	0	88	88	1.0000000
NODE_11029_length_828_cov_17.406036	369	445	0	76	76	1.0000000
NODE_11030_length_828_cov_14.606310	287	367	0	12	80	0.1500000
NODE_11030_length_828_cov_14.606310	287	367	2	68	80	0.8500000
NODE_11030_length_828_cov_14.606310	340	420	0	65	80	0.8125000
NODE_11030_length_828_cov_14.606310	340	420	2	15	80	0.1875000
NODE_11031_length_828_cov_14.493827	326	406	0	64	80	0.8000000
NODE_11031_length_828_cov_14.493827	326	406	2	16	80	0.2000000
NODE_11031_length_828_cov_14.493827	379	459	0	80	80	1.0000000
NODE_11031_length_828_cov_14.493827	455	535	0	80	80	1.0000000
NODE_11031_length_828_cov_14.493827	508	588	0	80	80	1.0000000
NODE_11032_length_828_cov_10.550069	280	360	0	11	80	0.1375000
NODE_11032_length_828_cov_10.550069	280	360	2	69	80	0.8625000
NODE_11032_length_828_cov_10.550069	333	413	0	23	80	0.2875000
NODE_11032_length_828_cov_10.550069	333	413	2	57	80	0.7125000
NODE_11033_length_828_cov_9.292181	594	674	0	51	80	0.6375000
NODE_11033_length_828_cov_9.292181	594	674	2	29	80	0.3625000
NODE_11033_length_828_cov_9.292181	647	727	0	58	80	0.7250000
NODE_11033_length_828_cov_9.292181	647	727	2	22	80	0.2750000
NODE_11034_length_828_cov_8.747599	298	378	0	80	80	1.0000000
NODE_11034_length_828_cov_8.747599	351	431	0	80	80	1.0000000
NODE_11035_length_828_cov_8.098765	199	279	0	80	80	1.0000000
NODE_11035_length_828_cov_8.098765	252	332	0	80	80	1.0000000
NODE_11037_length_828_cov_7.473251	300	380	0	80	80	1.0000000
NODE_11037_length_828_cov_7.473251	353	433	0	80	80	1.0000000
NODE_11039_length_828_cov_5.481481	543	623	2	80	80	1.0000000
NODE_11039_length_828_cov_5.481481	596	676	0	44	80	0.5500000
NODE_11039_length_828_cov_5.481481	596	676	2	36	80	0.4500000
NODE_11041_length_828_cov_5.069959	259	339	0	80	80	1.0000000
NODE_11066_length_827_cov_34.567308	269	349	0	80	80	1.0000000
NODE_11066_length_827_cov_34.567308	322	402	0	80	80	1.0000000
NODE_11066_length_827_cov_34.567308	398	478	0	47	80	0.5875000
NODE_11066_length_827_cov_34.567308	398	478	2	33	80	0.4125000
NODE_11066_length_827_cov_34.567308	451	531	0	5	80	0.0625000
NODE_11066_length_827_cov_34.567308	451	531	2	75	80	0.9375000
NODE_11067_length_827_cov_31.538462	320	400	0	6	80	0.0750000
NODE_11067_length_827_cov_31.538462	320	400	6	9	80	0.1125000
NODE_11067_length_827_cov_31.538462	320	400	8	25	80	0.3125000
NODE_11067_length_827_cov_31.538462	320	400	10	39	80	0.4875000
NODE_11067_length_827_cov_31.538462	320	400	12	1	80	0.0125000
NODE_11067_length_827_cov_31.538462	373	453	4	22	80	0.2750000
NODE_11067_length_827_cov_31.538462	373	453	10	50	80	0.6250000
NODE_11067_length_827_cov_31.538462	373	453	12	8	80	0.1000000
NODE_11068_length_827_cov_19.548077	464	544	0	80	80	1.0000000
NODE_11068_length_827_cov_19.548077	517	597	0	80	80	1.0000000
NODE_11069_length_827_cov_17.490385	320	400	0	80	80	1.0000000
NODE_11069_length_827_cov_17.490385	373	453	0	80	80	1.0000000
NODE_11070_length_827_cov_15.247253	205	285	0	80	80	1.0000000
NODE_11070_length_827_cov_15.247253	258	338	0	70	80	0.8750000
NODE_11070_length_827_cov_15.247253	258	338	2	10	80	0.1250000
NODE_11071_length_827_cov_14.151099	372	452	4	80	80	1.0000000
NODE_11071_length_827_cov_14.151099	425	505	0	20	80	0.2500000
NODE_11071_length_827_cov_14.151099	425	505	4	60	80	0.7500000
NODE_11072_length_827_cov_12.157967	262	342	0	80	80	1.0000000
NODE_11072_length_827_cov_12.157967	315	395	0	80	80	1.0000000
NODE_11073_length_827_cov_11.777473	316	396	0	80	80	1.0000000
NODE_11073_length_827_cov_11.777473	369	449	0	66	80	0.8250000
NODE_11073_length_827_cov_11.777473	369	449	2	14	80	0.1750000
NODE_11074_length_827_cov_11.651099	393	473	0	7	80	0.0875000
NODE_11074_length_827_cov_11.651099	393	473	4	73	80	0.9125000
NODE_11074_length_827_cov_11.651099	446	526	0	60	80	0.7500000
NODE_11074_length_827_cov_11.651099	446	526	4	20	80	0.2500000
NODE_11075_length_827_cov_10.711538	286	366	2	80	80	1.0000000
NODE_11075_length_827_cov_10.711538	339	419	0	47	80	0.5875000
NODE_11075_length_827_cov_10.711538	339	419	2	33	80	0.4125000
NODE_11076_length_827_cov_10.262363	273	353	0	80	80	1.0000000
NODE_11076_length_827_cov_10.262363	326	406	0	80	80	1.0000000
NODE_11077_length_827_cov_10.221154	256	336	0	70	80	0.8750000
NODE_11077_length_827_cov_10.221154	256	336	2	10	80	0.1250000
NODE_11078_length_827_cov_9.576923	359	439	0	61	80	0.7625000
NODE_11078_length_827_cov_9.576923	359	439	2	19	80	0.2375000
NODE_11078_length_827_cov_9.576923	412	492	0	8	80	0.1000000
NODE_11078_length_827_cov_9.576923	412	492	2	72	80	0.9000000
NODE_11079_length_827_cov_8.780220	361	441	0	80	80	1.0000000
NODE_11079_length_827_cov_8.780220	414	494	0	80	80	1.0000000
NODE_11093_length_827_cov_1.412088	736	784	2	48	48	1.0000000
NODE_11106_length_826_cov_34.026135	211	291	0	80	80	1.0000000
NODE_11106_length_826_cov_34.026135	264	344	0	80	80	1.0000000
NODE_11107_length_826_cov_24.093535	282	362	2	9	80	0.1125000
NODE_11107_length_826_cov_24.093535	282	362	4	1	80	0.0125000
NODE_11107_length_826_cov_24.093535	282	362	7	4	80	0.0500000
NODE_11107_length_826_cov_24.093535	282	362	8	33	80	0.4125000
NODE_11107_length_826_cov_24.093535	282	362	9	33	80	0.4125000
NODE_11107_length_826_cov_24.093535	335	415	1	18	80	0.2250000
NODE_11107_length_826_cov_24.093535	335	415	2	28	80	0.3500000
NODE_11107_length_826_cov_24.093535	335	415	5	1	80	0.0125000
NODE_11107_length_826_cov_24.093535	335	415	6	1	80	0.0125000
NODE_11107_length_826_cov_24.093535	335	415	7	9	80	0.1125000
NODE_11107_length_826_cov_24.093535	335	415	9	23	80	0.2875000
NODE_11108_length_826_cov_20.943604	207	287	0	80	80	1.0000000
NODE_11108_length_826_cov_20.943604	260	340	0	80	80	1.0000000
NODE_11109_length_826_cov_20.437414	413	493	0	80	80	1.0000000
NODE_11109_length_826_cov_20.437414	466	546	0	80	80	1.0000000
NODE_11110_length_826_cov_20.200825	432	512	0	80	80	1.0000000
NODE_11110_length_826_cov_20.200825	485	565	0	80	80	1.0000000
NODE_11111_length_826_cov_18.489684	345	425	0	80	80	1.0000000
NODE_11111_length_826_cov_18.489684	398	478	0	80	80	1.0000000
NODE_11112_length_826_cov_17.998624	336	416	0	80	80	1.0000000
NODE_11112_length_826_cov_17.998624	389	469	0	80	80	1.0000000
NODE_11113_length_826_cov_17.038514	358	438	0	80	80	1.0000000
NODE_11113_length_826_cov_17.038514	411	491	0	80	80	1.0000000
NODE_11114_length_826_cov_16.777166	514	603	0	89	89	1.0000000
NODE_11115_length_826_cov_16.177442	361	441	0	80	80	1.0000000
NODE_11115_length_826_cov_16.177442	414	494	0	80	80	1.0000000
NODE_11116_length_826_cov_15.134801	346	426	0	80	80	1.0000000
NODE_11116_length_826_cov_15.134801	399	479	0	80	80	1.0000000
NODE_11117_length_826_cov_9.943604	320	400	0	80	80	1.0000000
NODE_11117_length_826_cov_9.943604	373	453	0	80	80	1.0000000
NODE_11120_length_826_cov_4.852820	501	579	0	40	78	0.5128205
NODE_11120_length_826_cov_4.852820	501	579	4	34	78	0.4358974
NODE_11120_length_826_cov_4.852820	501	579	6	4	78	0.0512821
NODE_11120_length_826_cov_4.852820	552	632	2	15	80	0.1875000
NODE_11120_length_826_cov_4.852820	552	632	4	23	80	0.2875000
NODE_11120_length_826_cov_4.852820	552	632	6	42	80	0.5250000
NODE_11161_length_825_cov_61.804408	382	462	0	80	80	1.0000000
NODE_11161_length_825_cov_61.804408	435	514	0	79	79	1.0000000
NODE_11162_length_825_cov_43.825069	488	568	0	80	80	1.0000000
NODE_11162_length_825_cov_43.825069	541	621	0	74	80	0.9250000
NODE_11162_length_825_cov_43.825069	541	621	2	1	80	0.0125000
NODE_11162_length_825_cov_43.825069	541	621	6	5	80	0.0625000
NODE_11162_length_825_cov_43.825069	617	697	6	15	80	0.1875000
NODE_11162_length_825_cov_43.825069	617	697	8	28	80	0.3500000
NODE_11162_length_825_cov_43.825069	617	697	18	37	80	0.4625000
NODE_11162_length_825_cov_43.825069	670	750	2	4	80	0.0500000
NODE_11162_length_825_cov_43.825069	670	750	12	8	80	0.1000000
NODE_11162_length_825_cov_43.825069	670	750	16	18	80	0.2250000
NODE_11162_length_825_cov_43.825069	670	750	18	50	80	0.6250000
NODE_11163_length_825_cov_43.389807	496	576	2	6	80	0.0750000
NODE_11163_length_825_cov_43.389807	496	576	4	67	80	0.8375000
NODE_11163_length_825_cov_43.389807	496	576	6	7	80	0.0875000
NODE_11163_length_825_cov_43.389807	549	629	2	59	80	0.7375000
NODE_11163_length_825_cov_43.389807	549	629	4	14	80	0.1750000
NODE_11163_length_825_cov_43.389807	549	629	6	7	80	0.0875000
NODE_11164_length_825_cov_39.603306	386	466	0	11	80	0.1375000
NODE_11164_length_825_cov_39.603306	386	466	2	69	80	0.8625000
NODE_11164_length_825_cov_39.603306	439	519	2	78	80	0.9750000
NODE_11164_length_825_cov_39.603306	439	519	4	2	80	0.0250000
NODE_11165_length_825_cov_32.205234	354	434	32	21	80	0.2625000
NODE_11165_length_825_cov_32.205234	354	434	33	5	80	0.0625000
NODE_11165_length_825_cov_32.205234	354	434	34	8	80	0.1000000
NODE_11165_length_825_cov_32.205234	354	434	39	10	80	0.1250000
NODE_11165_length_825_cov_32.205234	354	434	40	12	80	0.1500000
NODE_11165_length_825_cov_32.205234	354	434	41	3	80	0.0375000
NODE_11165_length_825_cov_32.205234	354	434	44	4	80	0.0500000
NODE_11165_length_825_cov_32.205234	354	434	45	2	80	0.0250000
NODE_11165_length_825_cov_32.205234	354	434	46	15	80	0.1875000
NODE_11165_length_825_cov_32.205234	407	487	8	15	80	0.1875000
NODE_11165_length_825_cov_32.205234	407	487	9	1	80	0.0125000
NODE_11165_length_825_cov_32.205234	407	487	39	3	80	0.0375000
NODE_11165_length_825_cov_32.205234	407	487	40	43	80	0.5375000
NODE_11165_length_825_cov_32.205234	407	487	44	1	80	0.0125000
NODE_11165_length_825_cov_32.205234	407	487	45	2	80	0.0250000
NODE_11165_length_825_cov_32.205234	407	487	46	15	80	0.1875000
NODE_11166_length_825_cov_29.411846	503	583	0	80	80	1.0000000
NODE_11166_length_825_cov_29.411846	556	636	0	31	80	0.3875000
NODE_11166_length_825_cov_29.411846	556	636	2	49	80	0.6125000
NODE_11167_length_825_cov_22.428375	312	392	6	27	80	0.3375000
NODE_11167_length_825_cov_22.428375	312	392	10	7	80	0.0875000
NODE_11167_length_825_cov_22.428375	312	392	20	46	80	0.5750000
NODE_11167_length_825_cov_22.428375	365	445	9	5	80	0.0625000
NODE_11167_length_825_cov_22.428375	365	445	13	1	80	0.0125000
NODE_11167_length_825_cov_22.428375	365	445	15	25	80	0.3125000
NODE_11167_length_825_cov_22.428375	365	445	19	20	80	0.2500000
NODE_11167_length_825_cov_22.428375	365	445	20	29	80	0.3625000
NODE_11167_length_825_cov_22.428375	441	521	0	56	80	0.7000000
NODE_11167_length_825_cov_22.428375	441	521	8	1	80	0.0125000
NODE_11167_length_825_cov_22.428375	441	521	9	23	80	0.2875000
NODE_11167_length_825_cov_22.428375	494	574	0	36	80	0.4500000
NODE_11167_length_825_cov_22.428375	494	574	4	44	80	0.5500000
NODE_11168_length_825_cov_19.964187	249	329	0	9	80	0.1125000
NODE_11168_length_825_cov_19.964187	249	329	1	24	80	0.3000000
NODE_11168_length_825_cov_19.964187	249	329	2	47	80	0.5875000
NODE_11168_length_825_cov_19.964187	302	382	2	80	80	1.0000000
NODE_11169_length_825_cov_13.790634	273	353	0	80	80	1.0000000
NODE_11169_length_825_cov_13.790634	326	406	0	80	80	1.0000000
NODE_11170_length_825_cov_11.834711	331	411	0	22	80	0.2750000
NODE_11170_length_825_cov_11.834711	331	411	2	58	80	0.7250000
NODE_11170_length_825_cov_11.834711	384	464	0	75	80	0.9375000
NODE_11170_length_825_cov_11.834711	384	464	2	5	80	0.0625000
NODE_11171_length_825_cov_11.477961	392	472	2	3	80	0.0375000
NODE_11171_length_825_cov_11.477961	392	472	4	4	80	0.0500000
NODE_11171_length_825_cov_11.477961	392	472	5	7	80	0.0875000
NODE_11171_length_825_cov_11.477961	392	472	6	2	80	0.0250000
NODE_11171_length_825_cov_11.477961	392	472	7	3	80	0.0375000
NODE_11171_length_825_cov_11.477961	392	472	9	18	80	0.2250000
NODE_11171_length_825_cov_11.477961	392	472	11	4	80	0.0500000
NODE_11171_length_825_cov_11.477961	392	472	12	28	80	0.3500000
NODE_11171_length_825_cov_11.477961	392	472	13	2	80	0.0250000
NODE_11171_length_825_cov_11.477961	392	472	14	9	80	0.1125000
NODE_11172_length_825_cov_8.947658	259	339	0	80	80	1.0000000
NODE_11172_length_825_cov_8.947658	312	392	0	80	80	1.0000000
NODE_11173_length_825_cov_7.811295	379	459	0	28	80	0.3500000
NODE_11173_length_825_cov_7.811295	379	459	2	52	80	0.6500000
NODE_11173_length_825_cov_7.811295	432	512	0	8	80	0.1000000
NODE_11173_length_825_cov_7.811295	432	512	2	72	80	0.9000000
NODE_11174_length_825_cov_7.104683	464	544	0	18	80	0.2250000
NODE_11174_length_825_cov_7.104683	464	544	2	62	80	0.7750000
NODE_11174_length_825_cov_7.104683	517	597	0	71	80	0.8875000
NODE_11174_length_825_cov_7.104683	517	597	2	9	80	0.1125000
NODE_11176_length_825_cov_6.252066	542	622	0	30	80	0.3750000
NODE_11176_length_825_cov_6.252066	542	622	6	50	80	0.6250000
NODE_11176_length_825_cov_6.252066	595	675	0	15	80	0.1875000
NODE_11176_length_825_cov_6.252066	595	675	6	65	80	0.8125000
NODE_11178_length_825_cov_5.230028	264	344	0	80	80	1.0000000
NODE_11178_length_825_cov_5.230028	317	372	0	55	55	1.0000000
NODE_11178_length_825_cov_5.230028	383	463	0	80	80	1.0000000
NODE_11178_length_825_cov_5.230028	436	516	0	80	80	1.0000000
NODE_11205_length_825_cov_0.765840	0	50	0	50	50	1.0000000
NODE_11207_length_824_cov_27.074483	337	412	0	75	75	1.0000000
NODE_11207_length_824_cov_27.074483	390	470	0	23	80	0.2875000
NODE_11207_length_824_cov_27.074483	390	470	4	57	80	0.7125000
NODE_11208_length_824_cov_23.936552	365	445	0	13	80	0.1625000
NODE_11208_length_824_cov_23.936552	365	445	2	24	80	0.3000000
NODE_11208_length_824_cov_23.936552	365	445	4	43	80	0.5375000
NODE_11208_length_824_cov_23.936552	418	493	0	49	75	0.6533333
NODE_11208_length_824_cov_23.936552	418	493	1	8	75	0.1066667
NODE_11208_length_824_cov_23.936552	418	493	2	4	75	0.0533333
NODE_11208_length_824_cov_23.936552	418	493	4	14	75	0.1866667
NODE_11209_length_824_cov_22.129655	377	457	2	80	80	1.0000000
NODE_11209_length_824_cov_22.129655	430	510	1	25	80	0.3125000
NODE_11209_length_824_cov_22.129655	430	510	2	55	80	0.6875000
NODE_11210_length_824_cov_17.914483	387	467	0	16	80	0.2000000
NODE_11210_length_824_cov_17.914483	387	467	1	64	80	0.8000000
NODE_11210_length_824_cov_17.914483	440	520	1	28	80	0.3500000
NODE_11210_length_824_cov_17.914483	440	520	2	52	80	0.6500000
NODE_11211_length_824_cov_16.662069	362	442	0	80	80	1.0000000
NODE_11211_length_824_cov_16.662069	415	495	0	80	80	1.0000000
NODE_11212_length_824_cov_16.306207	352	432	4	54	80	0.6750000
NODE_11212_length_824_cov_16.306207	352	432	8	10	80	0.1250000
NODE_11212_length_824_cov_16.306207	352	432	10	16	80	0.2000000
NODE_11212_length_824_cov_16.306207	405	485	4	1	80	0.0125000
NODE_11212_length_824_cov_16.306207	405	485	6	33	80	0.4125000
NODE_11212_length_824_cov_16.306207	405	485	8	10	80	0.1250000
NODE_11212_length_824_cov_16.306207	405	485	10	36	80	0.4500000
NODE_11213_length_824_cov_15.891034	342	422	0	80	80	1.0000000
NODE_11213_length_824_cov_15.891034	395	475	0	80	80	1.0000000
NODE_11214_length_824_cov_12.485517	280	360	0	47	80	0.5875000
NODE_11214_length_824_cov_12.485517	280	360	2	12	80	0.1500000
NODE_11214_length_824_cov_12.485517	280	360	4	21	80	0.2625000
NODE_11214_length_824_cov_12.485517	333	413	2	6	80	0.0750000
NODE_11214_length_824_cov_12.485517	333	413	4	74	80	0.9250000
NODE_11216_length_824_cov_5.924138	269	349	0	80	80	1.0000000
NODE_11216_length_824_cov_5.924138	322	402	0	62	80	0.7750000
NODE_11216_length_824_cov_5.924138	322	402	2	16	80	0.2000000
NODE_11216_length_824_cov_5.924138	322	402	4	2	80	0.0250000
NODE_11222_length_824_cov_3.849655	191	271	0	80	80	1.0000000
NODE_11251_length_823_cov_75.169890	207	287	0	80	80	1.0000000
NODE_11251_length_823_cov_75.169890	260	340	0	80	80	1.0000000
NODE_11251_length_823_cov_75.169890	336	416	0	80	80	1.0000000
NODE_11251_length_823_cov_75.169890	389	469	0	80	80	1.0000000
NODE_11253_length_823_cov_37.738950	332	412	0	43	80	0.5375000
NODE_11253_length_823_cov_37.738950	332	412	2	37	80	0.4625000
NODE_11253_length_823_cov_37.738950	385	466	0	29	81	0.3580247
NODE_11253_length_823_cov_37.738950	385	466	2	52	81	0.6419753
NODE_11254_length_823_cov_29.349448	400	480	0	80	80	1.0000000
NODE_11254_length_823_cov_29.349448	453	533	0	80	80	1.0000000
NODE_11255_length_823_cov_25.730663	338	418	0	80	80	1.0000000
NODE_11255_length_823_cov_25.730663	391	471	0	33	80	0.4125000
NODE_11255_length_823_cov_25.730663	391	471	2	47	80	0.5875000
NODE_11256_length_823_cov_24.599448	349	429	0	39	80	0.4875000
NODE_11256_length_823_cov_24.599448	349	429	2	2	80	0.0250000
NODE_11256_length_823_cov_24.599448	349	429	5	1	80	0.0125000
NODE_11256_length_823_cov_24.599448	349	429	6	38	80	0.4750000
NODE_11256_length_823_cov_24.599448	402	482	0	25	80	0.3125000
NODE_11256_length_823_cov_24.599448	402	482	2	43	80	0.5375000
NODE_11256_length_823_cov_24.599448	402	482	4	12	80	0.1500000
NODE_11257_length_823_cov_22.149171	356	436	0	31	80	0.3875000
NODE_11257_length_823_cov_22.149171	356	436	2	7	80	0.0875000
NODE_11257_length_823_cov_22.149171	356	436	4	42	80	0.5250000
NODE_11257_length_823_cov_22.149171	409	489	4	27	80	0.3375000
NODE_11257_length_823_cov_22.149171	409	489	6	25	80	0.3125000
NODE_11257_length_823_cov_22.149171	409	489	8	28	80	0.3500000
NODE_11257_length_823_cov_22.149171	485	565	0	23	80	0.2875000
NODE_11257_length_823_cov_22.149171	485	565	2	9	80	0.1125000
NODE_11257_length_823_cov_22.149171	485	565	6	48	80	0.6000000
NODE_11257_length_823_cov_22.149171	538	618	0	76	80	0.9500000
NODE_11257_length_823_cov_22.149171	538	618	2	4	80	0.0500000
NODE_11258_length_823_cov_20.892265	329	409	0	80	80	1.0000000
NODE_11258_length_823_cov_20.892265	382	462	0	80	80	1.0000000
NODE_11259_length_823_cov_19.281768	305	385	4	52	80	0.6500000
NODE_11259_length_823_cov_19.281768	305	385	6	28	80	0.3500000
NODE_11259_length_823_cov_19.281768	358	438	0	6	80	0.0750000
NODE_11259_length_823_cov_19.281768	358	438	2	12	80	0.1500000
NODE_11259_length_823_cov_19.281768	358	438	6	62	80	0.7750000
NODE_11260_length_823_cov_15.738950	409	489	0	80	80	1.0000000
NODE_11260_length_823_cov_15.738950	462	542	0	80	80	1.0000000
NODE_11261_length_823_cov_10.729282	362	437	0	75	75	1.0000000
NODE_11261_length_823_cov_10.729282	410	484	0	74	74	1.0000000
NODE_11262_length_823_cov_9.110497	394	474	4	2	80	0.0250000
NODE_11262_length_823_cov_9.110497	394	474	6	13	80	0.1625000
NODE_11262_length_823_cov_9.110497	394	474	8	65	80	0.8125000
NODE_11262_length_823_cov_9.110497	447	527	0	45	80	0.5625000
NODE_11262_length_823_cov_9.110497	447	527	4	10	80	0.1250000
NODE_11262_length_823_cov_9.110497	447	527	6	13	80	0.1625000
NODE_11262_length_823_cov_9.110497	447	527	8	12	80	0.1500000
NODE_11265_length_823_cov_5.511050	168	248	0	54	80	0.6750000
NODE_11265_length_823_cov_5.511050	168	248	1	5	80	0.0625000
NODE_11265_length_823_cov_5.511050	168	248	3	9	80	0.1125000
NODE_11265_length_823_cov_5.511050	168	248	4	12	80	0.1500000
NODE_11265_length_823_cov_5.511050	434	485	0	26	51	0.5098040
NODE_11265_length_823_cov_5.511050	434	485	2	25	51	0.4901961
NODE_11292_length_823_cov_0.968232	86	154	7	4	68	0.0588235
NODE_11292_length_823_cov_0.968232	86	154	9	5	68	0.0735294
NODE_11292_length_823_cov_0.968232	86	154	11	16	68	0.2352941
NODE_11292_length_823_cov_0.968232	86	154	13	43	68	0.6323529
NODE_11298_length_822_cov_25.423237	377	459	0	82	82	1.0000000
NODE_11298_length_822_cov_25.423237	432	512	0	80	80	1.0000000
NODE_11299_length_822_cov_16.381743	394	474	0	5	80	0.0625000
NODE_11299_length_822_cov_16.381743	394	474	2	10	80	0.1250000
NODE_11299_length_822_cov_16.381743	394	474	4	65	80	0.8125000
NODE_11299_length_822_cov_16.381743	447	527	0	16	80	0.2000000
NODE_11299_length_822_cov_16.381743	447	527	2	17	80	0.2125000
NODE_11299_length_822_cov_16.381743	447	527	4	47	80	0.5875000
NODE_11300_length_822_cov_12.426003	223	296	0	67	73	0.9178082
NODE_11300_length_822_cov_12.426003	223	296	2	6	73	0.0821918
NODE_11300_length_822_cov_12.426003	278	349	0	25	71	0.3521127
NODE_11300_length_822_cov_12.426003	278	349	2	46	71	0.6478873
NODE_11301_length_822_cov_10.608575	464	544	0	14	80	0.1750000
NODE_11301_length_822_cov_10.608575	464	544	2	12	80	0.1500000
NODE_11301_length_822_cov_10.608575	464	544	4	39	80	0.4875000
NODE_11301_length_822_cov_10.608575	464	544	5	7	80	0.0875000
NODE_11301_length_822_cov_10.608575	464	544	6	8	80	0.1000000
NODE_11301_length_822_cov_10.608575	517	597	4	55	80	0.6875000
NODE_11301_length_822_cov_10.608575	517	597	5	7	80	0.0875000
NODE_11301_length_822_cov_10.608575	517	597	6	18	80	0.2250000
NODE_11302_length_822_cov_9.496542	363	443	2	36	80	0.4500000
NODE_11302_length_822_cov_9.496542	363	443	4	44	80	0.5500000
NODE_11302_length_822_cov_9.496542	416	496	0	46	80	0.5750000
NODE_11302_length_822_cov_9.496542	416	496	2	32	80	0.4000000
NODE_11302_length_822_cov_9.496542	416	496	4	2	80	0.0250000
NODE_11333_length_821_cov_39.818560	341	420	0	48	79	0.6075949
NODE_11333_length_821_cov_39.818560	341	420	6	31	79	0.3924051
NODE_11333_length_821_cov_39.818560	393	473	6	80	80	1.0000000
NODE_11334_length_821_cov_27.721607	299	379	0	80	80	1.0000000
NODE_11334_length_821_cov_27.721607	352	432	0	80	80	1.0000000
NODE_11335_length_821_cov_26.252078	386	466	2	56	80	0.7000000
NODE_11335_length_821_cov_26.252078	386	466	4	24	80	0.3000000
NODE_11335_length_821_cov_26.252078	439	519	2	36	80	0.4500000
NODE_11335_length_821_cov_26.252078	439	519	4	44	80	0.5500000
NODE_11336_length_821_cov_19.603878	353	433	0	49	80	0.6125000
NODE_11336_length_821_cov_19.603878	353	433	2	31	80	0.3875000
NODE_11336_length_821_cov_19.603878	406	486	2	80	80	1.0000000
NODE_11337_length_821_cov_15.945983	310	390	0	80	80	1.0000000
NODE_11337_length_821_cov_15.945983	363	443	0	80	80	1.0000000
NODE_11339_length_821_cov_8.711911	288	368	0	80	80	1.0000000
NODE_11339_length_821_cov_8.711911	341	421	0	80	80	1.0000000
NODE_11349_length_821_cov_3.026316	310	390	0	80	80	1.0000000
NODE_11349_length_821_cov_3.026316	363	443	0	80	80	1.0000000
NODE_11361_length_820_cov_67.292649	328	408	2	31	80	0.3875000
NODE_11361_length_820_cov_67.292649	328	408	15	12	80	0.1500000
NODE_11361_length_820_cov_67.292649	328	408	17	37	80	0.4625000
NODE_11361_length_820_cov_67.292649	381	461	15	3	80	0.0375000
NODE_11361_length_820_cov_67.292649	381	461	17	49	80	0.6125000
NODE_11361_length_820_cov_67.292649	381	461	18	6	80	0.0750000
NODE_11361_length_820_cov_67.292649	381	461	19	22	80	0.2750000
NODE_11362_length_820_cov_26.915395	308	388	10	7	80	0.0875000
NODE_11362_length_820_cov_26.915395	308	388	11	2	80	0.0250000
NODE_11362_length_820_cov_26.915395	308	388	13	2	80	0.0250000
NODE_11362_length_820_cov_26.915395	308	388	14	9	80	0.1125000
NODE_11362_length_820_cov_26.915395	308	388	15	16	80	0.2000000
NODE_11362_length_820_cov_26.915395	308	388	16	21	80	0.2625000
NODE_11362_length_820_cov_26.915395	308	388	17	6	80	0.0750000
NODE_11362_length_820_cov_26.915395	308	388	18	13	80	0.1625000
NODE_11362_length_820_cov_26.915395	308	388	20	4	80	0.0500000
NODE_11363_length_820_cov_25.253814	301	381	0	15	80	0.1875000
NODE_11363_length_820_cov_25.253814	301	381	2	12	80	0.1500000
NODE_11363_length_820_cov_25.253814	301	381	4	53	80	0.6625000
NODE_11363_length_820_cov_25.253814	354	434	0	11	80	0.1375000
NODE_11363_length_820_cov_25.253814	354	434	2	10	80	0.1250000
NODE_11363_length_820_cov_25.253814	354	434	4	43	80	0.5375000
NODE_11363_length_820_cov_25.253814	354	434	6	16	80	0.2000000
NODE_11363_length_820_cov_25.253814	430	510	6	80	80	1.0000000
NODE_11363_length_820_cov_25.253814	483	563	0	29	80	0.3625000
NODE_11363_length_820_cov_25.253814	483	563	6	51	80	0.6375000
NODE_11364_length_820_cov_16.015257	325	405	0	80	80	1.0000000
NODE_11364_length_820_cov_16.015257	378	458	0	80	80	1.0000000
NODE_11365_length_820_cov_14.703190	371	451	0	9	80	0.1125000
NODE_11365_length_820_cov_14.703190	371	451	2	71	80	0.8875000
NODE_11365_length_820_cov_14.703190	424	504	0	23	80	0.2875000
NODE_11365_length_820_cov_14.703190	424	504	2	57	80	0.7125000
NODE_11366_length_820_cov_14.527046	249	329	0	27	80	0.3375000
NODE_11366_length_820_cov_14.527046	249	329	4	42	80	0.5250000
NODE_11366_length_820_cov_14.527046	249	329	8	11	80	0.1375000
NODE_11366_length_820_cov_14.527046	302	382	4	37	80	0.4625000
NODE_11366_length_820_cov_14.527046	302	382	8	43	80	0.5375000
NODE_11367_length_820_cov_14.284327	286	366	0	65	80	0.8125000
NODE_11367_length_820_cov_14.284327	286	366	6	15	80	0.1875000
NODE_11367_length_820_cov_14.284327	339	419	0	12	80	0.1500000
NODE_11367_length_820_cov_14.284327	339	419	6	68	80	0.8500000
NODE_11367_length_820_cov_14.284327	619	699	0	80	80	1.0000000
NODE_11368_length_820_cov_13.036061	364	444	4	80	80	1.0000000
NODE_11368_length_820_cov_13.036061	417	497	0	32	80	0.4000000
NODE_11368_length_820_cov_13.036061	417	497	4	48	80	0.6000000
NODE_11369_length_820_cov_12.830791	313	393	0	14	80	0.1750000
NODE_11369_length_820_cov_12.830791	313	393	4	25	80	0.3125000
NODE_11369_length_820_cov_12.830791	313	393	6	35	80	0.4375000
NODE_11369_length_820_cov_12.830791	313	393	8	6	80	0.0750000
NODE_11369_length_820_cov_12.830791	366	446	2	1	80	0.0125000
NODE_11369_length_820_cov_12.830791	366	446	6	47	80	0.5875000
NODE_11369_length_820_cov_12.830791	366	446	8	32	80	0.4000000
NODE_11370_length_820_cov_12.768377	366	443	0	77	77	1.0000000
NODE_11370_length_820_cov_12.768377	496	525	0	29	29	1.0000000
NODE_11371_length_820_cov_12.223301	452	519	0	67	67	1.0000000
NODE_11371_length_820_cov_12.223301	492	572	0	80	80	1.0000000
NODE_11396_length_819_cov_43.027778	403	483	0	25	80	0.3125000
NODE_11396_length_819_cov_43.027778	403	483	5	4	80	0.0500000
NODE_11396_length_819_cov_43.027778	403	483	6	1	80	0.0125000
NODE_11396_length_819_cov_43.027778	403	483	8	50	80	0.6250000
NODE_11396_length_819_cov_43.027778	456	536	0	32	80	0.4000000
NODE_11396_length_819_cov_43.027778	456	536	6	18	80	0.2250000
NODE_11396_length_819_cov_43.027778	456	536	8	30	80	0.3750000
NODE_11396_length_819_cov_43.027778	532	612	0	70	80	0.8750000
NODE_11396_length_819_cov_43.027778	532	612	10	10	80	0.1250000
NODE_11396_length_819_cov_43.027778	585	665	0	17	80	0.2125000
NODE_11396_length_819_cov_43.027778	585	665	10	24	80	0.3000000
NODE_11396_length_819_cov_43.027778	585	665	20	39	80	0.4875000
NODE_11397_length_819_cov_42.758333	391	471	0	80	80	1.0000000
NODE_11397_length_819_cov_42.758333	444	524	0	80	80	1.0000000
NODE_11398_length_819_cov_41.341667	86	166	4	43	80	0.5375000
NODE_11398_length_819_cov_41.341667	86	166	6	37	80	0.4625000
NODE_11398_length_819_cov_41.341667	139	219	0	13	80	0.1625000
NODE_11398_length_819_cov_41.341667	139	219	2	13	80	0.1625000
NODE_11398_length_819_cov_41.341667	139	219	5	1	80	0.0125000
NODE_11398_length_819_cov_41.341667	139	219	6	53	80	0.6625000
NODE_11398_length_819_cov_41.341667	215	295	0	80	80	1.0000000
NODE_11398_length_819_cov_41.341667	268	348	0	80	80	1.0000000
NODE_11399_length_819_cov_23.656944	335	415	2	58	80	0.7250000
NODE_11399_length_819_cov_23.656944	335	415	4	22	80	0.2750000
NODE_11399_length_819_cov_23.656944	388	468	0	17	80	0.2125000
NODE_11399_length_819_cov_23.656944	388	468	2	21	80	0.2625000
NODE_11399_length_819_cov_23.656944	388	468	4	42	80	0.5250000
NODE_11400_length_819_cov_20.633333	475	555	0	80	80	1.0000000
NODE_11400_length_819_cov_20.633333	528	608	0	80	80	1.0000000
NODE_11401_length_819_cov_18.941667	307	387	0	33	80	0.4125000
NODE_11401_length_819_cov_18.941667	307	387	2	47	80	0.5875000
NODE_11401_length_819_cov_18.941667	360	440	0	6	80	0.0750000
NODE_11401_length_819_cov_18.941667	360	440	2	74	80	0.9250000
NODE_11401_length_819_cov_18.941667	436	516	0	4	80	0.0500000
NODE_11401_length_819_cov_18.941667	436	516	6	62	80	0.7750000
NODE_11401_length_819_cov_18.941667	436	516	8	14	80	0.1750000
NODE_11401_length_819_cov_18.941667	489	569	0	6	80	0.0750000
NODE_11401_length_819_cov_18.941667	489	569	2	23	80	0.2875000
NODE_11401_length_819_cov_18.941667	489	569	6	37	80	0.4625000
NODE_11401_length_819_cov_18.941667	489	569	8	14	80	0.1750000
NODE_11402_length_819_cov_12.225000	431	511	0	35	80	0.4375000
NODE_11402_length_819_cov_12.225000	431	511	2	45	80	0.5625000
NODE_11402_length_819_cov_12.225000	484	564	0	80	80	1.0000000
NODE_11403_length_819_cov_11.562500	273	353	0	80	80	1.0000000
NODE_11403_length_819_cov_11.562500	326	406	0	80	80	1.0000000
NODE_11404_length_819_cov_8.905556	477	557	0	18	80	0.2250000
NODE_11404_length_819_cov_8.905556	477	557	2	62	80	0.7750000
NODE_11404_length_819_cov_8.905556	530	610	0	71	80	0.8875000
NODE_11404_length_819_cov_8.905556	530	610	2	9	80	0.1125000
NODE_11405_length_819_cov_5.675000	232	312	0	80	80	1.0000000
NODE_11405_length_819_cov_5.675000	285	365	0	80	80	1.0000000
NODE_11431_length_818_cov_21.979138	342	422	0	80	80	1.0000000
NODE_11431_length_818_cov_21.979138	395	475	0	80	80	1.0000000
NODE_11432_length_818_cov_15.326843	334	414	0	26	80	0.3250000
NODE_11432_length_818_cov_15.326843	334	414	1	54	80	0.6750000
NODE_11432_length_818_cov_15.326843	387	467	1	34	80	0.4250000
NODE_11432_length_818_cov_15.326843	387	467	2	46	80	0.5750000
NODE_11433_length_818_cov_14.880389	392	472	0	67	80	0.8375000
NODE_11433_length_818_cov_14.880389	392	472	2	13	80	0.1625000
NODE_11433_length_818_cov_14.880389	445	525	0	14	80	0.1750000
NODE_11433_length_818_cov_14.880389	445	525	2	66	80	0.8250000
NODE_11434_length_818_cov_12.369958	390	470	0	80	80	1.0000000
NODE_11434_length_818_cov_12.369958	443	523	0	80	80	1.0000000
NODE_11436_length_818_cov_8.421419	370	450	0	41	80	0.5125000
NODE_11436_length_818_cov_8.421419	370	450	2	39	80	0.4875000
NODE_11436_length_818_cov_8.421419	423	503	0	31	80	0.3875000
NODE_11436_length_818_cov_8.421419	423	503	2	49	80	0.6125000
NODE_11437_length_818_cov_6.439499	706	741	0	33	35	0.9428571
NODE_11437_length_818_cov_6.439499	706	741	2	1	35	0.0285714
NODE_11437_length_818_cov_6.439499	706	741	4	1	35	0.0285714
NODE_11439_length_818_cov_4.098748	320	390	0	70	70	1.0000000
NODE_11439_length_818_cov_4.098748	416	472	0	56	56	1.0000000
NODE_11457_length_817_cov_7.238162	494	574	0	80	80	1.0000000
NODE_11457_length_817_cov_7.238162	547	627	0	80	80	1.0000000
NODE_11458_length_817_cov_5.789694	400	480	4	4	80	0.0500000
NODE_11458_length_817_cov_5.789694	400	480	6	18	80	0.2250000
NODE_11458_length_817_cov_5.789694	400	480	8	23	80	0.2875000
NODE_11458_length_817_cov_5.789694	400	480	9	1	80	0.0125000
NODE_11458_length_817_cov_5.789694	400	480	10	34	80	0.4250000
NODE_11458_length_817_cov_5.789694	476	555	0	45	79	0.5696203
NODE_11458_length_817_cov_5.789694	476	555	2	23	79	0.2911392
NODE_11458_length_817_cov_5.789694	476	555	4	11	79	0.1392405
NODE_11458_length_817_cov_5.789694	528	608	0	22	80	0.2750000
NODE_11458_length_817_cov_5.789694	528	608	2	58	80	0.7250000
NODE_11462_length_817_cov_4.357939	433	513	0	11	80	0.1375000
NODE_11462_length_817_cov_4.357939	433	513	4	69	80	0.8625000
NODE_11462_length_817_cov_4.357939	486	566	0	49	80	0.6125000
NODE_11462_length_817_cov_4.357939	486	566	4	31	80	0.3875000
NODE_11486_length_817_cov_0.692201	626	696	5	1	70	0.0142857
NODE_11486_length_817_cov_0.692201	626	696	10	2	70	0.0285714
NODE_11486_length_817_cov_0.692201	626	696	14	14	70	0.2000000
NODE_11486_length_817_cov_0.692201	626	696	16	2	70	0.0285714
NODE_11486_length_817_cov_0.692201	626	696	20	21	70	0.3000000
NODE_11486_length_817_cov_0.692201	626	696	22	5	70	0.0714286
NODE_11486_length_817_cov_0.692201	626	696	26	8	70	0.1142857
NODE_11486_length_817_cov_0.692201	626	696	28	12	70	0.1714286
NODE_11486_length_817_cov_0.692201	626	696	30	5	70	0.0714286
NODE_11488_length_816_cov_69.800558	395	475	0	80	80	1.0000000
NODE_11488_length_816_cov_69.800558	448	520	0	72	72	1.0000000
NODE_11489_length_816_cov_19.044630	77	154	0	77	77	1.0000000
NODE_11489_length_816_cov_19.044630	130	212	0	82	82	1.0000000
NODE_11490_length_816_cov_16.418410	381	461	0	80	80	1.0000000
NODE_11490_length_816_cov_16.418410	434	514	0	80	80	1.0000000
NODE_11491_length_816_cov_15.945607	319	399	0	7	80	0.0875000
NODE_11491_length_816_cov_15.945607	319	399	6	73	80	0.9125000
NODE_11491_length_816_cov_15.945607	372	452	0	13	80	0.1625000
NODE_11491_length_816_cov_15.945607	372	452	6	67	80	0.8375000
NODE_11492_length_816_cov_12.797768	358	438	0	80	80	1.0000000
NODE_11492_length_816_cov_12.797768	411	491	0	27	80	0.3375000
NODE_11492_length_816_cov_12.797768	411	491	2	53	80	0.6625000
NODE_11493_length_816_cov_12.086471	242	322	0	80	80	1.0000000
NODE_11493_length_816_cov_12.086471	295	375	0	80	80	1.0000000
NODE_11495_length_816_cov_3.873082	412	492	0	5	80	0.0625000
NODE_11495_length_816_cov_3.873082	412	492	2	75	80	0.9375000
NODE_11495_length_816_cov_3.873082	465	545	0	5	80	0.0625000
NODE_11495_length_816_cov_3.873082	465	545	2	75	80	0.9375000
NODE_11516_length_815_cov_48.090782	334	414	0	80	80	1.0000000
NODE_11516_length_815_cov_48.090782	387	467	0	80	80	1.0000000
NODE_11517_length_815_cov_27.748603	290	370	0	80	80	1.0000000
NODE_11517_length_815_cov_27.748603	343	423	0	80	80	1.0000000
NODE_11518_length_815_cov_23.748603	429	509	0	28	80	0.3500000
NODE_11518_length_815_cov_23.748603	429	509	4	52	80	0.6500000
NODE_11518_length_815_cov_23.748603	482	562	4	80	80	1.0000000
NODE_11519_length_815_cov_14.870112	318	398	0	80	80	1.0000000
NODE_11519_length_815_cov_14.870112	371	451	0	33	80	0.4125000
NODE_11519_length_815_cov_14.870112	371	451	2	47	80	0.5875000
NODE_11520_length_815_cov_13.317039	338	418	4	80	80	1.0000000
NODE_11520_length_815_cov_13.317039	391	471	0	21	80	0.2625000
NODE_11520_length_815_cov_13.317039	391	471	4	59	80	0.7375000
NODE_11521_length_815_cov_12.270950	315	395	0	33	80	0.4125000
NODE_11521_length_815_cov_12.270950	315	395	2	47	80	0.5875000
NODE_11521_length_815_cov_12.270950	368	448	2	80	80	1.0000000
NODE_11522_length_815_cov_9.304469	150	230	0	10	80	0.1250000
NODE_11522_length_815_cov_9.304469	150	230	4	70	80	0.8750000
NODE_11522_length_815_cov_9.304469	203	283	0	12	80	0.1500000
NODE_11522_length_815_cov_9.304469	203	283	4	68	80	0.8500000
NODE_11524_length_815_cov_8.117318	437	517	0	80	80	1.0000000
NODE_11524_length_815_cov_8.117318	490	570	0	80	80	1.0000000
NODE_11530_length_815_cov_3.963687	275	355	2	80	80	1.0000000
NODE_11530_length_815_cov_3.963687	328	408	0	48	80	0.6000000
NODE_11530_length_815_cov_3.963687	328	408	2	32	80	0.4000000
NODE_11532_length_815_cov_2.976257	441	508	0	67	67	1.0000000
NODE_11554_length_814_cov_55.545455	304	384	5	25	80	0.3125000
NODE_11554_length_814_cov_55.545455	304	384	6	46	80	0.5750000
NODE_11554_length_814_cov_55.545455	304	384	8	9	80	0.1125000
NODE_11554_length_814_cov_55.545455	357	437	0	27	80	0.3375000
NODE_11554_length_814_cov_55.545455	357	437	5	51	80	0.6375000
NODE_11554_length_814_cov_55.545455	357	437	6	2	80	0.0250000
NODE_11554_length_814_cov_55.545455	517	559	0	42	42	1.0000000
NODE_11554_length_814_cov_55.545455	724	804	4	3	80	0.0375000
NODE_11554_length_814_cov_55.545455	724	804	5	2	80	0.0250000
NODE_11554_length_814_cov_55.545455	724	804	9	2	80	0.0250000
NODE_11554_length_814_cov_55.545455	724	804	11	3	80	0.0375000
NODE_11554_length_814_cov_55.545455	724	804	14	6	80	0.0750000
NODE_11554_length_814_cov_55.545455	724	804	19	5	80	0.0625000
NODE_11554_length_814_cov_55.545455	724	804	20	1	80	0.0125000
NODE_11554_length_814_cov_55.545455	724	804	22	2	80	0.0250000
NODE_11554_length_814_cov_55.545455	724	804	26	1	80	0.0125000
NODE_11554_length_814_cov_55.545455	724	804	32	1	80	0.0125000
NODE_11554_length_814_cov_55.545455	724	804	34	2	80	0.0250000
NODE_11554_length_814_cov_55.545455	724	804	36	7	80	0.0875000
NODE_11554_length_814_cov_55.545455	724	804	38	11	80	0.1375000
NODE_11554_length_814_cov_55.545455	724	804	40	34	80	0.4250000
NODE_11555_length_814_cov_32.216783	317	397	0	78	80	0.9750000
NODE_11555_length_814_cov_32.216783	317	397	6	2	80	0.0250000
NODE_11555_length_814_cov_32.216783	370	450	0	25	80	0.3125000
NODE_11555_length_814_cov_32.216783	370	450	6	5	80	0.0625000
NODE_11555_length_814_cov_32.216783	370	450	16	50	80	0.6250000
NODE_11556_length_814_cov_19.507692	174	254	0	80	80	1.0000000
NODE_11556_length_814_cov_19.507692	227	307	0	80	80	1.0000000
NODE_11556_length_814_cov_19.507692	303	383	0	80	80	1.0000000
NODE_11556_length_814_cov_19.507692	356	436	0	80	80	1.0000000
NODE_11557_length_814_cov_18.579021	433	513	0	66	80	0.8250000
NODE_11557_length_814_cov_18.579021	433	513	2	14	80	0.1750000
NODE_11557_length_814_cov_18.579021	486	566	0	13	80	0.1625000
NODE_11557_length_814_cov_18.579021	486	566	2	16	80	0.2000000
NODE_11557_length_814_cov_18.579021	486	566	4	9	80	0.1125000
NODE_11557_length_814_cov_18.579021	486	566	6	42	80	0.5250000
NODE_11558_length_814_cov_17.183217	339	419	2	27	80	0.3375000
NODE_11558_length_814_cov_17.183217	339	419	4	53	80	0.6625000
NODE_11558_length_814_cov_17.183217	392	472	0	47	80	0.5875000
NODE_11558_length_814_cov_17.183217	392	472	2	33	80	0.4125000
NODE_11559_length_814_cov_15.306294	238	318	0	80	80	1.0000000
NODE_11559_length_814_cov_15.306294	291	371	0	80	80	1.0000000
NODE_11560_length_814_cov_11.511888	397	477	2	80	80	1.0000000
NODE_11560_length_814_cov_11.511888	459	530	0	19	71	0.2676056
NODE_11560_length_814_cov_11.511888	459	530	2	52	71	0.7323943
NODE_11561_length_814_cov_10.395804	305	385	0	80	80	1.0000000
NODE_11561_length_814_cov_10.395804	358	438	0	80	80	1.0000000
NODE_11562_length_814_cov_9.692308	347	427	0	22	80	0.2750000
NODE_11562_length_814_cov_9.692308	347	427	6	6	80	0.0750000
NODE_11562_length_814_cov_9.692308	347	427	8	6	80	0.0750000
NODE_11562_length_814_cov_9.692308	347	427	10	46	80	0.5750000
NODE_11562_length_814_cov_9.692308	400	480	0	52	80	0.6500000
NODE_11562_length_814_cov_9.692308	400	480	2	23	80	0.2875000
NODE_11562_length_814_cov_9.692308	400	480	6	5	80	0.0625000
NODE_11564_length_814_cov_9.274126	245	325	0	80	80	1.0000000
NODE_11564_length_814_cov_9.274126	298	378	0	80	80	1.0000000
NODE_11565_length_814_cov_8.973427	271	351	0	9	80	0.1125000
NODE_11565_length_814_cov_8.973427	271	351	1	1	80	0.0125000
NODE_11565_length_814_cov_8.973427	271	351	2	70	80	0.8750000
NODE_11565_length_814_cov_8.973427	324	404	2	80	80	1.0000000
NODE_11573_length_814_cov_2.145455	273	327	0	54	54	1.0000000
NODE_11573_length_814_cov_2.145455	307	371	0	64	64	1.0000000
NODE_11587_length_813_cov_39.228291	225	305	0	37	80	0.4625000
NODE_11587_length_813_cov_39.228291	225	305	2	38	80	0.4750000
NODE_11587_length_813_cov_39.228291	225	305	6	5	80	0.0625000
NODE_11587_length_813_cov_39.228291	278	358	2	22	80	0.2750000
NODE_11587_length_813_cov_39.228291	278	358	6	58	80	0.7250000
NODE_11588_length_813_cov_36.570028	406	486	0	22	80	0.2750000
NODE_11588_length_813_cov_36.570028	406	486	6	58	80	0.7250000
NODE_11588_length_813_cov_36.570028	459	539	0	28	80	0.3500000
NODE_11588_length_813_cov_36.570028	459	539	6	52	80	0.6500000
NODE_11589_length_813_cov_26.718487	209	289	2	80	80	1.0000000
NODE_11589_length_813_cov_26.718487	262	342	0	12	80	0.1500000
NODE_11589_length_813_cov_26.718487	262	342	2	68	80	0.8500000
NODE_11590_length_813_cov_17.537815	335	415	0	80	80	1.0000000
NODE_11590_length_813_cov_17.537815	388	468	0	80	80	1.0000000
NODE_11591_length_813_cov_14.243697	279	359	0	20	80	0.2500000
NODE_11591_length_813_cov_14.243697	279	359	2	60	80	0.7500000
NODE_11591_length_813_cov_14.243697	332	412	0	33	80	0.4125000
NODE_11591_length_813_cov_14.243697	332	412	2	47	80	0.5875000
NODE_11592_length_813_cov_13.984594	307	387	0	80	80	1.0000000
NODE_11592_length_813_cov_13.984594	360	440	0	80	80	1.0000000
NODE_11593_length_813_cov_13.242297	336	416	4	44	80	0.5500000
NODE_11593_length_813_cov_13.242297	336	416	6	35	80	0.4375000
NODE_11593_length_813_cov_13.242297	336	416	8	1	80	0.0125000
NODE_11593_length_813_cov_13.242297	389	469	2	11	80	0.1375000
NODE_11593_length_813_cov_13.242297	389	469	4	7	80	0.0875000
NODE_11593_length_813_cov_13.242297	389	469	6	26	80	0.3250000
NODE_11593_length_813_cov_13.242297	389	469	8	36	80	0.4500000
NODE_11594_length_813_cov_11.985994	374	454	0	80	80	1.0000000
NODE_11594_length_813_cov_11.985994	427	507	0	80	80	1.0000000
NODE_11595_length_813_cov_11.668067	279	359	0	80	80	1.0000000
NODE_11595_length_813_cov_11.668067	332	412	0	80	80	1.0000000
NODE_11596_length_813_cov_8.149860	538	618	0	80	80	1.0000000
NODE_11596_length_813_cov_8.149860	591	671	0	80	80	1.0000000
NODE_11597_length_813_cov_7.098039	234	314	0	80	80	1.0000000
NODE_11597_length_813_cov_7.098039	287	367	0	80	80	1.0000000
NODE_11613_length_812_cov_45.183731	435	515	0	80	80	1.0000000
NODE_11613_length_812_cov_45.183731	488	568	0	80	80	1.0000000
NODE_11614_length_812_cov_23.862553	386	466	0	80	80	1.0000000
NODE_11614_length_812_cov_23.862553	439	519	0	80	80	1.0000000
NODE_11615_length_812_cov_23.516129	295	375	0	19	80	0.2375000
NODE_11615_length_812_cov_23.516129	295	375	2	61	80	0.7625000
NODE_11615_length_812_cov_23.516129	348	428	0	67	80	0.8375000
NODE_11615_length_812_cov_23.516129	348	428	2	13	80	0.1625000
NODE_11616_length_812_cov_15.577840	509	589	0	80	80	1.0000000
NODE_11616_length_812_cov_15.577840	562	644	0	82	82	1.0000000
NODE_11617_length_812_cov_13.277700	257	331	0	74	74	1.0000000
NODE_11617_length_812_cov_13.277700	304	384	0	80	80	1.0000000
NODE_11619_length_812_cov_6.697055	309	389	0	67	80	0.8375000
NODE_11619_length_812_cov_6.697055	309	389	2	13	80	0.1625000
NODE_11619_length_812_cov_6.697055	362	442	0	14	80	0.1750000
NODE_11619_length_812_cov_6.697055	362	442	2	66	80	0.8250000
NODE_11642_length_811_cov_65.762640	418	492	63	4	74	0.0540541
NODE_11642_length_811_cov_65.762640	418	492	64	16	74	0.2162162
NODE_11642_length_811_cov_65.762640	418	492	67	3	74	0.0405405
NODE_11642_length_811_cov_65.762640	418	492	68	4	74	0.0540541
NODE_11642_length_811_cov_65.762640	418	492	72	7	74	0.0945946
NODE_11642_length_811_cov_65.762640	418	492	76	12	74	0.1621622
NODE_11642_length_811_cov_65.762640	418	492	78	16	74	0.2162162
NODE_11642_length_811_cov_65.762640	418	492	84	2	74	0.0270270
NODE_11642_length_811_cov_65.762640	418	492	86	10	74	0.1351351
NODE_11642_length_811_cov_65.762640	471	545	23	7	74	0.0945946
NODE_11642_length_811_cov_65.762640	471	545	25	20	74	0.2702703
NODE_11642_length_811_cov_65.762640	471	545	37	5	74	0.0675676
NODE_11642_length_811_cov_65.762640	471	545	41	2	74	0.0270270
NODE_11642_length_811_cov_65.762640	471	545	45	5	74	0.0675676
NODE_11642_length_811_cov_65.762640	471	545	53	8	74	0.1081081
NODE_11642_length_811_cov_65.762640	471	545	57	2	74	0.0270270
NODE_11642_length_811_cov_65.762640	471	545	61	2	74	0.0270270
NODE_11642_length_811_cov_65.762640	471	545	65	1	74	0.0135135
NODE_11642_length_811_cov_65.762640	471	545	67	2	74	0.0270270
NODE_11642_length_811_cov_65.762640	471	545	72	4	74	0.0540541
NODE_11642_length_811_cov_65.762640	471	545	76	6	74	0.0810811
NODE_11642_length_811_cov_65.762640	471	545	86	10	74	0.1351351
NODE_11643_length_811_cov_62.933989	457	537	0	12	80	0.1500000
NODE_11643_length_811_cov_62.933989	457	537	2	35	80	0.4375000
NODE_11643_length_811_cov_62.933989	457	537	6	26	80	0.3250000
NODE_11643_length_811_cov_62.933989	457	537	8	7	80	0.0875000
NODE_11643_length_811_cov_62.933989	510	590	6	20	80	0.2500000
NODE_11643_length_811_cov_62.933989	510	590	8	60	80	0.7500000
NODE_11644_length_811_cov_26.401685	397	477	2	56	80	0.7000000
NODE_11644_length_811_cov_26.401685	397	477	8	24	80	0.3000000
NODE_11644_length_811_cov_26.401685	450	530	2	3	80	0.0375000
NODE_11644_length_811_cov_26.401685	450	530	5	3	80	0.0375000
NODE_11644_length_811_cov_26.401685	450	530	6	35	80	0.4375000
NODE_11644_length_811_cov_26.401685	450	530	8	39	80	0.4875000
NODE_11645_length_811_cov_23.009831	189	269	1	23	80	0.2875000
NODE_11645_length_811_cov_23.009831	189	269	2	3	80	0.0375000
NODE_11645_length_811_cov_23.009831	189	269	3	42	80	0.5250000
NODE_11645_length_811_cov_23.009831	189	269	5	12	80	0.1500000
NODE_11645_length_811_cov_23.009831	242	322	3	15	80	0.1875000
NODE_11645_length_811_cov_23.009831	242	322	5	53	80	0.6625000
NODE_11645_length_811_cov_23.009831	242	322	6	12	80	0.1500000
NODE_11646_length_811_cov_20.523876	375	455	0	22	80	0.2750000
NODE_11646_length_811_cov_20.523876	375	455	2	58	80	0.7250000
NODE_11646_length_811_cov_20.523876	428	508	0	11	80	0.1375000
NODE_11646_length_811_cov_20.523876	428	508	2	69	80	0.8625000
NODE_11647_length_811_cov_17.386236	421	501	0	80	80	1.0000000
NODE_11647_length_811_cov_17.386236	474	554	0	63	80	0.7875000
NODE_11647_length_811_cov_17.386236	474	554	2	17	80	0.2125000
NODE_11648_length_811_cov_15.279494	368	448	0	16	80	0.2000000
NODE_11648_length_811_cov_15.279494	368	448	2	64	80	0.8000000
NODE_11648_length_811_cov_15.279494	421	502	2	81	81	1.0000000
NODE_11649_length_811_cov_14.543539	222	302	2	3	80	0.0375000
NODE_11649_length_811_cov_14.543539	222	302	4	1	80	0.0125000
NODE_11649_length_811_cov_14.543539	222	302	5	31	80	0.3875000
NODE_11649_length_811_cov_14.543539	222	302	6	42	80	0.5250000
NODE_11649_length_811_cov_14.543539	222	302	7	3	80	0.0375000
NODE_11649_length_811_cov_14.543539	275	355	0	31	80	0.3875000
NODE_11649_length_811_cov_14.543539	275	355	2	25	80	0.3125000
NODE_11649_length_811_cov_14.543539	275	355	4	1	80	0.0125000
NODE_11649_length_811_cov_14.543539	275	355	5	22	80	0.2750000
NODE_11649_length_811_cov_14.543539	275	355	6	1	80	0.0125000
NODE_11650_length_811_cov_12.196629	402	482	0	80	80	1.0000000
NODE_11650_length_811_cov_12.196629	455	535	0	80	80	1.0000000
NODE_11651_length_811_cov_12.117978	289	369	0	80	80	1.0000000
NODE_11651_length_811_cov_12.117978	342	422	0	80	80	1.0000000
NODE_11652_length_811_cov_11.886236	330	410	0	68	80	0.8500000
NODE_11652_length_811_cov_11.886236	330	410	2	12	80	0.1500000
NODE_11652_length_811_cov_11.886236	383	463	0	80	80	1.0000000
NODE_11653_length_811_cov_10.602528	342	422	0	3	80	0.0375000
NODE_11653_length_811_cov_10.602528	342	422	2	13	80	0.1625000
NODE_11653_length_811_cov_10.602528	342	422	5	2	80	0.0250000
NODE_11653_length_811_cov_10.602528	342	422	11	2	80	0.0250000
NODE_11653_length_811_cov_10.602528	342	422	14	60	80	0.7500000
NODE_11653_length_811_cov_10.602528	395	461	0	1	66	0.0151515
NODE_11653_length_811_cov_10.602528	395	461	2	1	66	0.0151515
NODE_11653_length_811_cov_10.602528	395	461	3	3	66	0.0454545
NODE_11653_length_811_cov_10.602528	395	461	4	13	66	0.1969697
NODE_11653_length_811_cov_10.602528	395	461	12	13	66	0.1969697
NODE_11653_length_811_cov_10.602528	395	461	14	35	66	0.5303030
NODE_11653_length_811_cov_10.602528	452	519	0	41	67	0.6119403
NODE_11653_length_811_cov_10.602528	452	519	2	19	67	0.2835821
NODE_11653_length_811_cov_10.602528	452	519	3	3	67	0.0447761
NODE_11653_length_811_cov_10.602528	452	519	4	4	67	0.0597015
NODE_11653_length_811_cov_10.602528	492	572	0	9	80	0.1125000
NODE_11653_length_811_cov_10.602528	492	572	2	71	80	0.8875000
NODE_11654_length_811_cov_7.539326	324	404	0	80	80	1.0000000
NODE_11654_length_811_cov_7.539326	377	457	0	51	80	0.6375000
NODE_11654_length_811_cov_7.539326	377	457	4	29	80	0.3625000
NODE_11655_length_811_cov_6.398876	419	499	0	80	80	1.0000000
NODE_11655_length_811_cov_6.398876	472	552	0	80	80	1.0000000
NODE_11657_length_811_cov_5.939607	496	527	2	22	31	0.7096774
NODE_11657_length_811_cov_5.939607	496	527	4	3	31	0.0967742
NODE_11657_length_811_cov_5.939607	496	527	6	6	31	0.1935484
NODE_11657_length_811_cov_5.939607	528	603	4	27	75	0.3600000
NODE_11657_length_811_cov_5.939607	528	603	6	48	75	0.6400000
NODE_11669_length_811_cov_1.501404	645	676	0	31	31	1.0000000
NODE_11684_length_810_cov_42.358650	484	564	2	80	80	1.0000000
NODE_11684_length_810_cov_42.358650	537	617	0	35	80	0.4375000
NODE_11684_length_810_cov_42.358650	537	617	2	45	80	0.5625000
NODE_11685_length_810_cov_38.604782	370	450	0	4	80	0.0500000
NODE_11685_length_810_cov_38.604782	370	450	2	76	80	0.9500000
NODE_11685_length_810_cov_38.604782	423	499	0	21	76	0.2763158
NODE_11685_length_810_cov_38.604782	423	499	2	55	76	0.7236842
NODE_11686_length_810_cov_20.354430	338	418	2	46	80	0.5750000
NODE_11686_length_810_cov_20.354430	338	418	4	34	80	0.4250000
NODE_11686_length_810_cov_20.354430	391	471	2	13	80	0.1625000
NODE_11686_length_810_cov_20.354430	391	471	4	67	80	0.8375000
NODE_11688_length_810_cov_12.367089	144	224	0	2	80	0.0250000
NODE_11688_length_810_cov_12.367089	144	224	2	78	80	0.9750000
NODE_11688_length_810_cov_12.367089	197	277	0	55	80	0.6875000
NODE_11688_length_810_cov_12.367089	197	277	2	25	80	0.3125000
NODE_11689_length_810_cov_8.886076	333	399	0	49	66	0.7424242
NODE_11689_length_810_cov_8.886076	333	399	2	17	66	0.2575758
NODE_11690_length_810_cov_8.291139	446	526	0	58	80	0.7250000
NODE_11690_length_810_cov_8.291139	446	526	2	22	80	0.2750000
NODE_11690_length_810_cov_8.291139	499	579	0	5	80	0.0625000
NODE_11690_length_810_cov_8.291139	499	579	2	75	80	0.9375000
NODE_11692_length_810_cov_7.213783	335	406	0	29	71	0.4084507
NODE_11692_length_810_cov_7.213783	335	406	1	3	71	0.0422535
NODE_11692_length_810_cov_7.213783	335	406	2	39	71	0.5492958
NODE_11692_length_810_cov_7.213783	335	416	0	29	81	0.3580247
NODE_11692_length_810_cov_7.213783	335	416	1	3	81	0.0370370
NODE_11692_length_810_cov_7.213783	335	416	2	49	81	0.6049383
NODE_11692_length_810_cov_7.213783	379	459	2	80	80	1.0000000
NODE_11714_length_809_cov_40.536620	428	500	0	72	72	1.0000000
NODE_11714_length_809_cov_40.536620	473	553	0	80	80	1.0000000
NODE_11715_length_809_cov_15.871831	385	465	0	80	80	1.0000000
NODE_11715_length_809_cov_15.871831	402	465	0	63	63	1.0000000
NODE_11715_length_809_cov_15.871831	438	518	0	80	80	1.0000000
NODE_11715_length_809_cov_15.871831	438	518	0	80	80	1.0000000
NODE_11716_length_809_cov_15.019718	286	366	0	52	80	0.6500000
NODE_11716_length_809_cov_15.019718	286	366	2	28	80	0.3500000
NODE_11716_length_809_cov_15.019718	339	419	0	28	80	0.3500000
NODE_11716_length_809_cov_15.019718	339	419	2	52	80	0.6500000
NODE_11718_length_809_cov_4.483099	244	324	0	33	80	0.4125000
NODE_11718_length_809_cov_4.483099	244	324	2	47	80	0.5875000
NODE_11718_length_809_cov_4.483099	278	324	2	46	46	1.0000000
NODE_11718_length_809_cov_4.483099	298	377	0	5	79	0.0632911
NODE_11718_length_809_cov_4.483099	298	377	2	74	79	0.9367089
NODE_11718_length_809_cov_4.483099	308	377	0	5	69	0.0724638
NODE_11718_length_809_cov_4.483099	308	377	2	64	69	0.9275362
NODE_11738_length_808_cov_45.023977	325	405	0	78	80	0.9750000
NODE_11738_length_808_cov_45.023977	325	405	4	2	80	0.0250000
NODE_11738_length_808_cov_45.023977	378	458	0	25	80	0.3125000
NODE_11738_length_808_cov_45.023977	378	458	4	24	80	0.3000000
NODE_11738_length_808_cov_45.023977	378	458	8	1	80	0.0125000
NODE_11738_length_808_cov_45.023977	378	458	9	8	80	0.1000000
NODE_11738_length_808_cov_45.023977	378	458	11	22	80	0.2750000
NODE_11739_length_808_cov_24.087447	287	367	0	80	80	1.0000000
NODE_11739_length_808_cov_24.087447	340	420	0	80	80	1.0000000
NODE_11740_length_808_cov_21.867419	324	404	0	5	80	0.0625000
NODE_11740_length_808_cov_21.867419	324	404	2	75	80	0.9375000
NODE_11740_length_808_cov_21.867419	377	457	0	58	80	0.7250000
NODE_11740_length_808_cov_21.867419	377	457	2	22	80	0.2750000
NODE_11741_length_808_cov_16.289140	333	413	0	80	80	1.0000000
NODE_11741_length_808_cov_16.289140	386	466	0	50	80	0.6250000
NODE_11741_length_808_cov_16.289140	386	466	2	30	80	0.3750000
NODE_11742_length_808_cov_14.489422	307	387	0	80	80	1.0000000
NODE_11742_length_808_cov_14.489422	360	440	0	80	80	1.0000000
NODE_11744_length_808_cov_10.507757	317	397	0	80	80	1.0000000
NODE_11744_length_808_cov_10.507757	370	450	0	80	80	1.0000000
NODE_11745_length_808_cov_10.066291	483	563	0	80	80	1.0000000
NODE_11745_length_808_cov_10.066291	536	616	0	80	80	1.0000000
NODE_11746_length_808_cov_7.581100	358	438	0	80	80	1.0000000
NODE_11746_length_808_cov_7.581100	411	491	0	35	80	0.4375000
NODE_11746_length_808_cov_7.581100	411	491	2	45	80	0.5625000
NODE_11756_length_808_cov_3.283498	471	551	0	6	80	0.0750000
NODE_11756_length_808_cov_3.283498	471	551	2	74	80	0.9250000
NODE_11756_length_808_cov_3.283498	524	604	0	2	80	0.0250000
NODE_11756_length_808_cov_3.283498	524	604	2	78	80	0.9750000
NODE_11783_length_807_cov_67.341808	2	25	23	1	23	0.0434783
NODE_11783_length_807_cov_67.341808	2	25	26	2	23	0.0869565
NODE_11783_length_807_cov_67.341808	2	25	28	1	23	0.0434783
NODE_11783_length_807_cov_67.341808	2	25	31	1	23	0.0434783
NODE_11783_length_807_cov_67.341808	2	25	42	1	23	0.0434783
NODE_11783_length_807_cov_67.341808	2	25	45	1	23	0.0434783
NODE_11783_length_807_cov_67.341808	2	25	49	1	23	0.0434783
NODE_11783_length_807_cov_67.341808	2	25	57	1	23	0.0434783
NODE_11783_length_807_cov_67.341808	2	25	61	3	23	0.1304348
NODE_11783_length_807_cov_67.341808	2	25	68	1	23	0.0434783
NODE_11783_length_807_cov_67.341808	2	25	72	1	23	0.0434783
NODE_11783_length_807_cov_67.341808	2	25	78	2	23	0.0869565
NODE_11783_length_807_cov_67.341808	2	25	80	1	23	0.0434783
NODE_11783_length_807_cov_67.341808	2	25	84	1	23	0.0434783
NODE_11783_length_807_cov_67.341808	2	25	92	1	23	0.0434783
NODE_11783_length_807_cov_67.341808	2	25	99	1	23	0.0434783
NODE_11783_length_807_cov_67.341808	2	25	103	1	23	0.0434783
NODE_11783_length_807_cov_67.341808	2	25	115	1	23	0.0434783
NODE_11783_length_807_cov_67.341808	2	25	116	1	23	0.0434783
NODE_11783_length_807_cov_67.341808	339	370	260	1	31	0.0322581
NODE_11783_length_807_cov_67.341808	339	370	266	1	31	0.0322581
NODE_11783_length_807_cov_67.341808	339	370	270	1	31	0.0322581
NODE_11783_length_807_cov_67.341808	339	370	292	1	31	0.0322581
NODE_11783_length_807_cov_67.341808	339	370	294	2	31	0.0645161
NODE_11783_length_807_cov_67.341808	339	370	301	1	31	0.0322581
NODE_11783_length_807_cov_67.341808	339	370	311	1	31	0.0322581
NODE_11783_length_807_cov_67.341808	339	370	315	1	31	0.0322581
NODE_11783_length_807_cov_67.341808	339	370	331	1	31	0.0322581
NODE_11783_length_807_cov_67.341808	339	370	333	1	31	0.0322581
NODE_11783_length_807_cov_67.341808	339	370	342	1	31	0.0322581
NODE_11783_length_807_cov_67.341808	339	370	346	1	31	0.0322581
NODE_11783_length_807_cov_67.341808	339	370	357	1	31	0.0322581
NODE_11783_length_807_cov_67.341808	339	370	365	1	31	0.0322581
NODE_11783_length_807_cov_67.341808	339	370	375	2	31	0.0645161
NODE_11783_length_807_cov_67.341808	339	370	395	1	31	0.0322581
NODE_11783_length_807_cov_67.341808	339	370	396	1	31	0.0322581
NODE_11783_length_807_cov_67.341808	339	370	411	1	31	0.0322581
NODE_11783_length_807_cov_67.341808	339	370	422	1	31	0.0322581
NODE_11783_length_807_cov_67.341808	339	370	429	1	31	0.0322581
NODE_11783_length_807_cov_67.341808	339	370	439	1	31	0.0322581
NODE_11783_length_807_cov_67.341808	339	370	444	1	31	0.0322581
NODE_11783_length_807_cov_67.341808	339	370	447	3	31	0.0967742
NODE_11783_length_807_cov_67.341808	339	370	453	2	31	0.0645161
NODE_11783_length_807_cov_67.341808	339	370	455	1	31	0.0322581
NODE_11783_length_807_cov_67.341808	339	370	458	1	31	0.0322581
NODE_11783_length_807_cov_67.341808	343	423	292	1	80	0.0125000
NODE_11783_length_807_cov_67.341808	343	423	294	1	80	0.0125000
NODE_11783_length_807_cov_67.341808	343	423	301	1	80	0.0125000
NODE_11783_length_807_cov_67.341808	343	423	311	1	80	0.0125000
NODE_11783_length_807_cov_67.341808	343	423	315	1	80	0.0125000
NODE_11783_length_807_cov_67.341808	343	423	331	1	80	0.0125000
NODE_11783_length_807_cov_67.341808	343	423	333	1	80	0.0125000
NODE_11783_length_807_cov_67.341808	343	423	342	1	80	0.0125000
NODE_11783_length_807_cov_67.341808	343	423	346	1	80	0.0125000
NODE_11783_length_807_cov_67.341808	343	423	357	1	80	0.0125000
NODE_11783_length_807_cov_67.341808	343	423	365	1	80	0.0125000
NODE_11783_length_807_cov_67.341808	343	423	375	2	80	0.0250000
NODE_11783_length_807_cov_67.341808	343	423	395	1	80	0.0125000
NODE_11783_length_807_cov_67.341808	343	423	396	1	80	0.0125000
NODE_11783_length_807_cov_67.341808	343	423	411	1	80	0.0125000
NODE_11783_length_807_cov_67.341808	343	423	422	1	80	0.0125000
NODE_11783_length_807_cov_67.341808	343	423	429	1	80	0.0125000
NODE_11783_length_807_cov_67.341808	343	423	439	1	80	0.0125000
NODE_11783_length_807_cov_67.341808	343	423	444	1	80	0.0125000
NODE_11783_length_807_cov_67.341808	343	423	447	3	80	0.0375000
NODE_11783_length_807_cov_67.341808	343	423	453	2	80	0.0250000
NODE_11783_length_807_cov_67.341808	343	423	454	1	80	0.0125000
NODE_11783_length_807_cov_67.341808	343	423	455	2	80	0.0250000
NODE_11783_length_807_cov_67.341808	343	423	457	1	80	0.0125000
NODE_11783_length_807_cov_67.341808	343	423	458	3	80	0.0375000
NODE_11783_length_807_cov_67.341808	343	423	461	2	80	0.0250000
NODE_11783_length_807_cov_67.341808	343	423	466	1	80	0.0125000
NODE_11783_length_807_cov_67.341808	343	423	469	3	80	0.0375000
NODE_11783_length_807_cov_67.341808	343	423	480	1	80	0.0125000
NODE_11783_length_807_cov_67.341808	343	423	481	2	80	0.0250000
NODE_11783_length_807_cov_67.341808	343	423	487	1	80	0.0125000
NODE_11783_length_807_cov_67.341808	343	423	488	2	80	0.0250000
NODE_11783_length_807_cov_67.341808	343	423	490	4	80	0.0500000
NODE_11783_length_807_cov_67.341808	343	423	492	1	80	0.0125000
NODE_11783_length_807_cov_67.341808	343	423	493	1	80	0.0125000
NODE_11783_length_807_cov_67.341808	343	423	494	1	80	0.0125000
NODE_11783_length_807_cov_67.341808	343	423	495	3	80	0.0375000
NODE_11783_length_807_cov_67.341808	343	423	496	2	80	0.0250000
NODE_11783_length_807_cov_67.341808	343	423	512	1	80	0.0125000
NODE_11783_length_807_cov_67.341808	343	423	515	1	80	0.0125000
NODE_11783_length_807_cov_67.341808	343	423	518	1	80	0.0125000
NODE_11783_length_807_cov_67.341808	343	423	519	1	80	0.0125000
NODE_11783_length_807_cov_67.341808	343	423	520	1	80	0.0125000
NODE_11783_length_807_cov_67.341808	343	423	526	2	80	0.0250000
NODE_11783_length_807_cov_67.341808	343	423	529	1	80	0.0125000
NODE_11783_length_807_cov_67.341808	343	423	531	4	80	0.0500000
NODE_11783_length_807_cov_67.341808	343	423	532	1	80	0.0125000
NODE_11783_length_807_cov_67.341808	343	423	533	2	80	0.0250000
NODE_11783_length_807_cov_67.341808	343	423	536	1	80	0.0125000
NODE_11783_length_807_cov_67.341808	343	423	537	1	80	0.0125000
NODE_11783_length_807_cov_67.341808	343	423	542	1	80	0.0125000
NODE_11783_length_807_cov_67.341808	343	423	543	2	80	0.0250000
NODE_11783_length_807_cov_67.341808	343	423	547	1	80	0.0125000
NODE_11783_length_807_cov_67.341808	343	423	548	1	80	0.0125000
NODE_11783_length_807_cov_67.341808	343	423	554	1	80	0.0125000
NODE_11783_length_807_cov_67.341808	343	423	563	1	80	0.0125000
NODE_11784_length_807_cov_54.980226	683	749	88	1	66	0.0151515
NODE_11784_length_807_cov_54.980226	683	749	90	1	66	0.0151515
NODE_11784_length_807_cov_54.980226	683	749	94	1	66	0.0151515
NODE_11784_length_807_cov_54.980226	683	749	96	2	66	0.0303030
NODE_11784_length_807_cov_54.980226	683	749	98	5	66	0.0757576
NODE_11784_length_807_cov_54.980226	683	749	100	1	66	0.0151515
NODE_11784_length_807_cov_54.980226	683	749	102	7	66	0.1060606
NODE_11784_length_807_cov_54.980226	683	749	104	1	66	0.0151515
NODE_11784_length_807_cov_54.980226	683	749	106	3	66	0.0454545
NODE_11784_length_807_cov_54.980226	683	749	108	5	66	0.0757576
NODE_11784_length_807_cov_54.980226	683	749	110	2	66	0.0303030
NODE_11784_length_807_cov_54.980226	683	749	112	2	66	0.0303030
NODE_11784_length_807_cov_54.980226	683	749	114	3	66	0.0454545
NODE_11784_length_807_cov_54.980226	683	749	116	6	66	0.0909091
NODE_11784_length_807_cov_54.980226	683	749	118	5	66	0.0757576
NODE_11784_length_807_cov_54.980226	683	749	120	2	66	0.0303030
NODE_11784_length_807_cov_54.980226	683	749	122	2	66	0.0303030
NODE_11784_length_807_cov_54.980226	683	749	124	2	66	0.0303030
NODE_11784_length_807_cov_54.980226	683	749	126	15	66	0.2272727
NODE_11784_length_807_cov_54.980226	727	802	7	1	75	0.0133333
NODE_11784_length_807_cov_54.980226	727	802	9	1	75	0.0133333
NODE_11784_length_807_cov_54.980226	727	802	11	2	75	0.0266667
NODE_11784_length_807_cov_54.980226	727	802	13	2	75	0.0266667
NODE_11784_length_807_cov_54.980226	727	802	14	1	75	0.0133333
NODE_11784_length_807_cov_54.980226	727	802	16	1	75	0.0133333
NODE_11784_length_807_cov_54.980226	727	802	18	1	75	0.0133333
NODE_11784_length_807_cov_54.980226	727	802	20	6	75	0.0800000
NODE_11784_length_807_cov_54.980226	727	802	22	2	75	0.0266667
NODE_11784_length_807_cov_54.980226	727	802	28	1	75	0.0133333
NODE_11784_length_807_cov_54.980226	727	802	34	1	75	0.0133333
NODE_11784_length_807_cov_54.980226	727	802	40	1	75	0.0133333
NODE_11784_length_807_cov_54.980226	727	802	50	1	75	0.0133333
NODE_11784_length_807_cov_54.980226	727	802	51	3	75	0.0400000
NODE_11784_length_807_cov_54.980226	727	802	54	1	75	0.0133333
NODE_11784_length_807_cov_54.980226	727	802	59	2	75	0.0266667
NODE_11784_length_807_cov_54.980226	727	802	63	6	75	0.0800000
NODE_11784_length_807_cov_54.980226	727	802	67	5	75	0.0666667
NODE_11784_length_807_cov_54.980226	727	802	71	2	75	0.0266667
NODE_11784_length_807_cov_54.980226	727	802	72	6	75	0.0800000
NODE_11784_length_807_cov_54.980226	727	802	74	1	75	0.0133333
NODE_11784_length_807_cov_54.980226	727	802	76	1	75	0.0133333
NODE_11784_length_807_cov_54.980226	727	802	82	1	75	0.0133333
NODE_11784_length_807_cov_54.980226	727	802	84	3	75	0.0400000
NODE_11784_length_807_cov_54.980226	727	802	86	1	75	0.0133333
NODE_11784_length_807_cov_54.980226	727	802	88	1	75	0.0133333
NODE_11784_length_807_cov_54.980226	727	802	90	1	75	0.0133333
NODE_11784_length_807_cov_54.980226	727	802	94	1	75	0.0133333
NODE_11784_length_807_cov_54.980226	727	802	96	2	75	0.0266667
NODE_11784_length_807_cov_54.980226	727	802	98	4	75	0.0533333
NODE_11784_length_807_cov_54.980226	727	802	100	1	75	0.0133333
NODE_11784_length_807_cov_54.980226	727	802	102	7	75	0.0933333
NODE_11784_length_807_cov_54.980226	727	802	104	1	75	0.0133333
NODE_11784_length_807_cov_54.980226	727	802	108	3	75	0.0400000
NODE_11784_length_807_cov_54.980226	727	802	110	1	75	0.0133333
NODE_11785_length_807_cov_37.306497	435	515	0	52	80	0.6500000
NODE_11785_length_807_cov_37.306497	435	515	4	1	80	0.0125000
NODE_11785_length_807_cov_37.306497	435	515	5	4	80	0.0500000
NODE_11785_length_807_cov_37.306497	435	515	6	23	80	0.2875000
NODE_11785_length_807_cov_37.306497	488	568	5	4	80	0.0500000
NODE_11785_length_807_cov_37.306497	488	568	6	76	80	0.9500000
NODE_11786_length_807_cov_31.177966	287	367	0	59	80	0.7375000
NODE_11786_length_807_cov_31.177966	287	367	4	21	80	0.2625000
NODE_11786_length_807_cov_31.177966	340	420	0	6	80	0.0750000
NODE_11786_length_807_cov_31.177966	340	420	4	74	80	0.9250000
NODE_11787_length_807_cov_30.638418	250	329	0	79	79	1.0000000
NODE_11787_length_807_cov_30.638418	302	382	0	80	80	1.0000000
NODE_11787_length_807_cov_30.638418	378	458	0	68	80	0.8500000
NODE_11787_length_807_cov_30.638418	378	458	2	12	80	0.1500000
NODE_11787_length_807_cov_30.638418	431	511	0	15	80	0.1875000
NODE_11787_length_807_cov_30.638418	431	511	2	65	80	0.8125000
NODE_11788_length_807_cov_29.725989	362	442	0	5	80	0.0625000
NODE_11788_length_807_cov_29.725989	362	442	2	44	80	0.5500000
NODE_11788_length_807_cov_29.725989	362	442	3	16	80	0.2000000
NODE_11788_length_807_cov_29.725989	362	442	4	10	80	0.1250000
NODE_11788_length_807_cov_29.725989	362	442	6	5	80	0.0625000
NODE_11788_length_807_cov_29.725989	415	495	0	5	80	0.0625000
NODE_11788_length_807_cov_29.725989	415	495	2	17	80	0.2125000
NODE_11788_length_807_cov_29.725989	415	495	6	58	80	0.7250000
NODE_11789_length_807_cov_23.200565	441	521	2	80	80	1.0000000
NODE_11789_length_807_cov_23.200565	494	574	0	34	80	0.4250000
NODE_11789_length_807_cov_23.200565	494	574	2	46	80	0.5750000
NODE_11790_length_807_cov_21.888418	319	386	0	67	67	1.0000000
NODE_11790_length_807_cov_21.888418	390	440	0	50	50	1.0000000
NODE_11791_length_807_cov_17.480226	339	419	0	80	80	1.0000000
NODE_11791_length_807_cov_17.480226	392	472	0	80	80	1.0000000
NODE_11792_length_807_cov_14.895480	350	430	0	8	80	0.1000000
NODE_11792_length_807_cov_14.895480	350	430	1	1	80	0.0125000
NODE_11792_length_807_cov_14.895480	350	430	2	71	80	0.8875000
NODE_11792_length_807_cov_14.895480	403	483	0	61	80	0.7625000
NODE_11792_length_807_cov_14.895480	403	483	1	1	80	0.0125000
NODE_11792_length_807_cov_14.895480	403	483	2	18	80	0.2250000
NODE_11794_length_807_cov_12.255650	440	520	0	52	80	0.6500000
NODE_11794_length_807_cov_12.255650	440	520	4	28	80	0.3500000
NODE_11794_length_807_cov_12.255650	493	573	0	80	80	1.0000000
NODE_11795_length_807_cov_11.129944	359	439	2	18	80	0.2250000
NODE_11795_length_807_cov_11.129944	359	439	10	4	80	0.0500000
NODE_11795_length_807_cov_11.129944	359	439	12	58	80	0.7250000
NODE_11795_length_807_cov_11.129944	412	492	0	26	80	0.3250000
NODE_11795_length_807_cov_11.129944	412	492	2	45	80	0.5625000
NODE_11795_length_807_cov_11.129944	412	492	10	4	80	0.0500000
NODE_11795_length_807_cov_11.129944	412	492	12	5	80	0.0625000
NODE_11801_length_807_cov_3.847458	322	385	0	63	63	1.0000000
NODE_11822_length_806_cov_35.650636	397	477	0	71	80	0.8875000
NODE_11822_length_806_cov_35.650636	397	477	2	9	80	0.1125000
NODE_11822_length_806_cov_35.650636	450	530	0	18	80	0.2250000
NODE_11822_length_806_cov_35.650636	450	530	2	62	80	0.7750000
NODE_11822_length_806_cov_35.650636	526	606	0	24	80	0.3000000
NODE_11822_length_806_cov_35.650636	526	606	2	56	80	0.7000000
NODE_11822_length_806_cov_35.650636	579	667	0	85	88	0.9659091
NODE_11822_length_806_cov_35.650636	579	667	2	3	88	0.0340909
NODE_11823_length_806_cov_29.615276	377	457	4	80	80	1.0000000
NODE_11823_length_806_cov_29.615276	430	510	0	45	80	0.5625000
NODE_11823_length_806_cov_29.615276	430	510	4	35	80	0.4375000
NODE_11824_length_806_cov_23.680339	394	474	1	53	80	0.6625000
NODE_11824_length_806_cov_23.680339	394	474	2	27	80	0.3375000
NODE_11824_length_806_cov_23.680339	447	527	1	65	80	0.8125000
NODE_11824_length_806_cov_23.680339	447	527	2	15	80	0.1875000
NODE_11825_length_806_cov_19.107496	239	293	0	54	54	1.0000000
NODE_11825_length_806_cov_19.107496	248	293	0	45	45	1.0000000
NODE_11825_length_806_cov_19.107496	266	345	0	79	79	1.0000000
NODE_11825_length_806_cov_19.107496	266	345	0	79	79	1.0000000
NODE_11825_length_806_cov_19.107496	421	501	0	80	80	1.0000000
NODE_11826_length_806_cov_17.551627	308	388	2	29	80	0.3625000
NODE_11826_length_806_cov_17.551627	308	388	3	51	80	0.6375000
NODE_11826_length_806_cov_17.551627	361	441	0	41	80	0.5125000
NODE_11826_length_806_cov_17.551627	361	441	3	39	80	0.4875000
NODE_11827_length_806_cov_15.608204	408	488	0	80	80	1.0000000
NODE_11827_length_806_cov_15.608204	461	543	0	82	82	1.0000000
NODE_11864_length_805_cov_94.121813	398	478	4	46	80	0.5750000
NODE_11864_length_805_cov_94.121813	398	478	8	34	80	0.4250000
NODE_11864_length_805_cov_94.121813	451	531	2	2	80	0.0250000
NODE_11864_length_805_cov_94.121813	451	531	4	6	80	0.0750000
NODE_11864_length_805_cov_94.121813	451	531	6	49	80	0.6125000
NODE_11864_length_805_cov_94.121813	451	531	8	23	80	0.2875000
NODE_11865_length_805_cov_54.001416	284	364	0	7	80	0.0875000
NODE_11865_length_805_cov_54.001416	284	364	6	73	80	0.9125000
NODE_11865_length_805_cov_54.001416	337	417	0	9	80	0.1125000
NODE_11865_length_805_cov_54.001416	337	417	5	1	80	0.0125000
NODE_11865_length_805_cov_54.001416	337	417	6	70	80	0.8750000
NODE_11865_length_805_cov_54.001416	413	493	0	32	80	0.4000000
NODE_11865_length_805_cov_54.001416	413	493	4	48	80	0.6000000
NODE_11865_length_805_cov_54.001416	466	546	0	9	80	0.1125000
NODE_11865_length_805_cov_54.001416	466	546	4	71	80	0.8875000
NODE_11866_length_805_cov_42.325779	377	457	4	58	80	0.7250000
NODE_11866_length_805_cov_42.325779	377	457	6	14	80	0.1750000
NODE_11866_length_805_cov_42.325779	377	457	8	8	80	0.1000000
NODE_11866_length_805_cov_42.325779	430	510	4	72	80	0.9000000
NODE_11866_length_805_cov_42.325779	430	510	8	8	80	0.1000000
NODE_11867_length_805_cov_36.742210	345	425	17	5	80	0.0625000
NODE_11867_length_805_cov_36.742210	345	425	18	1	80	0.0125000
NODE_11867_length_805_cov_36.742210	345	425	26	38	80	0.4750000
NODE_11867_length_805_cov_36.742210	345	425	28	7	80	0.0875000
NODE_11867_length_805_cov_36.742210	345	425	29	1	80	0.0125000
NODE_11867_length_805_cov_36.742210	345	425	30	28	80	0.3500000
NODE_11867_length_805_cov_36.742210	398	478	12	5	80	0.0625000
NODE_11867_length_805_cov_36.742210	398	478	13	10	80	0.1250000
NODE_11867_length_805_cov_36.742210	398	478	14	1	80	0.0125000
NODE_11867_length_805_cov_36.742210	398	478	26	64	80	0.8000000
NODE_11868_length_805_cov_25.879603	361	441	0	80	80	1.0000000
NODE_11868_length_805_cov_25.879603	414	494	0	80	80	1.0000000
NODE_11869_length_805_cov_25.048159	306	386	0	50	80	0.6250000
NODE_11869_length_805_cov_25.048159	306	386	2	30	80	0.3750000
NODE_11869_length_805_cov_25.048159	359	439	0	80	80	1.0000000
NODE_11870_length_805_cov_15.453258	311	391	4	80	80	1.0000000
NODE_11870_length_805_cov_15.453258	364	444	0	45	80	0.5625000
NODE_11870_length_805_cov_15.453258	364	444	4	35	80	0.4375000
NODE_11871_length_805_cov_14.930595	264	344	0	32	80	0.4000000
NODE_11871_length_805_cov_14.930595	264	344	2	48	80	0.6000000
NODE_11871_length_805_cov_14.930595	317	397	0	80	80	1.0000000
NODE_11872_length_805_cov_10.888102	259	339	0	80	80	1.0000000
NODE_11872_length_805_cov_10.888102	312	392	0	80	80	1.0000000
NODE_11873_length_805_cov_10.716714	348	428	0	80	80	1.0000000
NODE_11873_length_805_cov_10.716714	401	481	0	80	80	1.0000000
NODE_11876_length_805_cov_7.212465	374	454	0	80	80	1.0000000
NODE_11876_length_805_cov_7.212465	427	507	0	80	80	1.0000000
NODE_11877_length_805_cov_5.637394	323	403	0	38	80	0.4750000
NODE_11877_length_805_cov_5.637394	323	403	1	42	80	0.5250000
NODE_11877_length_805_cov_5.637394	376	456	1	80	80	1.0000000
NODE_11878_length_805_cov_4.001416	304	384	0	80	80	1.0000000
NODE_11878_length_805_cov_4.001416	357	437	0	80	80	1.0000000
NODE_11903_length_804_cov_26.204255	319	399	0	75	80	0.9375000
NODE_11903_length_804_cov_26.204255	319	399	2	5	80	0.0625000
NODE_11903_length_804_cov_26.204255	372	452	0	22	80	0.2750000
NODE_11903_length_804_cov_26.204255	372	452	2	58	80	0.7250000
NODE_11904_length_804_cov_25.978723	242	322	0	49	80	0.6125000
NODE_11904_length_804_cov_25.978723	242	322	2	7	80	0.0875000
NODE_11904_length_804_cov_25.978723	242	322	3	4	80	0.0500000
NODE_11904_length_804_cov_25.978723	242	322	5	20	80	0.2500000
NODE_11904_length_804_cov_25.978723	295	375	2	3	80	0.0375000
NODE_11904_length_804_cov_25.978723	295	375	3	4	80	0.0500000
NODE_11904_length_804_cov_25.978723	295	375	5	26	80	0.3250000
NODE_11904_length_804_cov_25.978723	295	375	6	8	80	0.1000000
NODE_11904_length_804_cov_25.978723	295	375	8	22	80	0.2750000
NODE_11904_length_804_cov_25.978723	295	375	10	17	80	0.2125000
NODE_11904_length_804_cov_25.978723	371	451	0	1	80	0.0125000
NODE_11904_length_804_cov_25.978723	371	451	2	16	80	0.2000000
NODE_11904_length_804_cov_25.978723	371	451	4	7	80	0.0875000
NODE_11904_length_804_cov_25.978723	371	451	6	44	80	0.5500000
NODE_11904_length_804_cov_25.978723	371	451	8	2	80	0.0250000
NODE_11904_length_804_cov_25.978723	371	451	10	10	80	0.1250000
NODE_11904_length_804_cov_25.978723	424	504	0	54	80	0.6750000
NODE_11904_length_804_cov_25.978723	424	504	2	16	80	0.2000000
NODE_11904_length_804_cov_25.978723	424	504	4	7	80	0.0875000
NODE_11904_length_804_cov_25.978723	424	504	6	3	80	0.0375000
NODE_11905_length_804_cov_25.628369	444	524	0	80	80	1.0000000
NODE_11905_length_804_cov_25.628369	497	577	0	43	80	0.5375000
NODE_11905_length_804_cov_25.628369	497	577	4	37	80	0.4625000
NODE_11906_length_804_cov_22.438298	269	349	0	19	80	0.2375000
NODE_11906_length_804_cov_22.438298	269	349	5	56	80	0.7000000
NODE_11906_length_804_cov_22.438298	269	349	6	5	80	0.0625000
NODE_11906_length_804_cov_22.438298	322	402	0	13	80	0.1625000
NODE_11906_length_804_cov_22.438298	322	402	5	23	80	0.2875000
NODE_11906_length_804_cov_22.438298	322	402	6	44	80	0.5500000
NODE_11907_length_804_cov_17.425532	273	353	0	7	80	0.0875000
NODE_11907_length_804_cov_17.425532	273	353	3	39	80	0.4875000
NODE_11907_length_804_cov_17.425532	273	353	5	12	80	0.1500000
NODE_11907_length_804_cov_17.425532	273	353	13	3	80	0.0375000
NODE_11907_length_804_cov_17.425532	273	353	15	4	80	0.0500000
NODE_11907_length_804_cov_17.425532	273	353	16	15	80	0.1875000
NODE_11907_length_804_cov_17.425532	326	406	5	5	80	0.0625000
NODE_11907_length_804_cov_17.425532	326	406	13	56	80	0.7000000
NODE_11907_length_804_cov_17.425532	326	406	15	4	80	0.0500000
NODE_11907_length_804_cov_17.425532	326	406	16	15	80	0.1875000
NODE_11908_length_804_cov_16.849645	229	309	0	80	80	1.0000000
NODE_11908_length_804_cov_16.849645	282	362	0	80	80	1.0000000
NODE_11909_length_804_cov_16.024113	499	579	0	80	80	1.0000000
NODE_11909_length_804_cov_16.024113	552	632	0	80	80	1.0000000
NODE_11910_length_804_cov_14.567376	375	455	0	1	80	0.0125000
NODE_11910_length_804_cov_14.567376	375	455	2	51	80	0.6375000
NODE_11910_length_804_cov_14.567376	375	455	6	28	80	0.3500000
NODE_11910_length_804_cov_14.567376	428	508	6	28	80	0.3500000
NODE_11910_length_804_cov_14.567376	428	508	8	40	80	0.5000000
NODE_11910_length_804_cov_14.567376	428	508	10	12	80	0.1500000
NODE_11911_length_804_cov_14.011348	262	342	0	38	80	0.4750000
NODE_11911_length_804_cov_14.011348	262	342	4	31	80	0.3875000
NODE_11911_length_804_cov_14.011348	262	342	10	11	80	0.1375000
NODE_11911_length_804_cov_14.011348	315	395	4	16	80	0.2000000
NODE_11911_length_804_cov_14.011348	315	395	10	64	80	0.8000000
NODE_11912_length_804_cov_13.800000	289	318	0	29	29	1.0000000
NODE_11913_length_804_cov_12.585816	396	476	0	80	80	1.0000000
NODE_11913_length_804_cov_12.585816	449	529	0	80	80	1.0000000
NODE_11914_length_804_cov_12.375887	190	270	4	68	80	0.8500000
NODE_11914_length_804_cov_12.375887	190	270	7	1	80	0.0125000
NODE_11914_length_804_cov_12.375887	190	270	8	11	80	0.1375000
NODE_11914_length_804_cov_12.375887	243	323	4	76	80	0.9500000
NODE_11914_length_804_cov_12.375887	243	323	8	4	80	0.0500000
NODE_11915_length_804_cov_10.947518	363	443	0	32	80	0.4000000
NODE_11915_length_804_cov_10.947518	363	443	2	48	80	0.6000000
NODE_11915_length_804_cov_10.947518	416	496	0	80	80	1.0000000
NODE_11916_length_804_cov_8.164539	427	507	0	9	80	0.1125000
NODE_11916_length_804_cov_8.164539	427	507	2	2	80	0.0250000
NODE_11916_length_804_cov_8.164539	427	507	4	29	80	0.3625000
NODE_11916_length_804_cov_8.164539	427	507	8	40	80	0.5000000
NODE_11916_length_804_cov_8.164539	480	560	4	23	80	0.2875000
NODE_11916_length_804_cov_8.164539	480	560	6	17	80	0.2125000
NODE_11916_length_804_cov_8.164539	480	560	8	40	80	0.5000000
NODE_11917_length_804_cov_7.462411	345	425	0	80	80	1.0000000
NODE_11917_length_804_cov_7.462411	398	478	0	80	80	1.0000000
NODE_11919_length_804_cov_3.663830	736	799	0	63	63	1.0000000
NODE_11933_length_804_cov_1.303546	480	560	0	12	80	0.1500000
NODE_11933_length_804_cov_1.303546	480	560	4	6	80	0.0750000
NODE_11933_length_804_cov_1.303546	480	560	6	10	80	0.1250000
NODE_11933_length_804_cov_1.303546	480	560	12	17	80	0.2125000
NODE_11933_length_804_cov_1.303546	480	560	16	35	80	0.4375000
NODE_11933_length_804_cov_1.303546	533	613	0	4	80	0.0500000
NODE_11933_length_804_cov_1.303546	533	613	4	7	80	0.0875000
NODE_11933_length_804_cov_1.303546	533	613	6	1	80	0.0125000
NODE_11933_length_804_cov_1.303546	533	613	12	8	80	0.1000000
NODE_11933_length_804_cov_1.303546	533	613	16	60	80	0.7500000
NODE_11942_length_803_cov_40.930398	374	454	0	73	80	0.9125000
NODE_11942_length_803_cov_40.930398	374	454	2	7	80	0.0875000
NODE_11942_length_803_cov_40.930398	427	507	0	20	80	0.2500000
NODE_11942_length_803_cov_40.930398	427	507	2	28	80	0.3500000
NODE_11942_length_803_cov_40.930398	427	507	4	3	80	0.0375000
NODE_11942_length_803_cov_40.930398	427	507	6	9	80	0.1125000
NODE_11942_length_803_cov_40.930398	427	507	8	20	80	0.2500000
NODE_11944_length_803_cov_28.346591	242	322	0	80	80	1.0000000
NODE_11944_length_803_cov_28.346591	295	375	0	80	80	1.0000000
NODE_11945_length_803_cov_23.420455	288	368	0	80	80	1.0000000
NODE_11945_length_803_cov_23.420455	341	421	0	59	80	0.7375000
NODE_11945_length_803_cov_23.420455	341	421	4	21	80	0.2625000
NODE_11946_length_803_cov_20.977273	316	396	0	28	80	0.3500000
NODE_11946_length_803_cov_20.977273	316	396	6	7	80	0.0875000
NODE_11946_length_803_cov_20.977273	316	396	8	11	80	0.1375000
NODE_11946_length_803_cov_20.977273	316	396	10	34	80	0.4250000
NODE_11946_length_803_cov_20.977273	369	449	10	57	80	0.7125000
NODE_11946_length_803_cov_20.977273	369	449	12	23	80	0.2875000
NODE_11947_length_803_cov_18.458807	307	387	2	34	80	0.4250000
NODE_11947_length_803_cov_18.458807	307	387	4	10	80	0.1250000
NODE_11947_length_803_cov_18.458807	307	387	5	3	80	0.0375000
NODE_11947_length_803_cov_18.458807	307	387	6	33	80	0.4125000
NODE_11947_length_803_cov_18.458807	360	440	0	11	80	0.1375000
NODE_11947_length_803_cov_18.458807	360	440	4	45	80	0.5625000
NODE_11947_length_803_cov_18.458807	360	440	5	3	80	0.0375000
NODE_11947_length_803_cov_18.458807	360	440	6	21	80	0.2625000
NODE_11948_length_803_cov_14.411932	386	466	0	35	80	0.4375000
NODE_11948_length_803_cov_14.411932	386	466	4	45	80	0.5625000
NODE_11948_length_803_cov_14.411932	439	519	4	80	80	1.0000000
NODE_11949_length_803_cov_10.157670	319	399	0	36	80	0.4500000
NODE_11949_length_803_cov_10.157670	319	399	2	18	80	0.2250000
NODE_11949_length_803_cov_10.157670	319	399	4	26	80	0.3250000
NODE_11949_length_803_cov_10.157670	372	452	2	41	80	0.5125000
NODE_11949_length_803_cov_10.157670	372	452	4	39	80	0.4875000
NODE_11950_length_803_cov_8.977273	362	442	4	36	80	0.4500000
NODE_11950_length_803_cov_8.977273	362	442	6	44	80	0.5500000
NODE_11950_length_803_cov_8.977273	415	485	4	70	70	1.0000000
NODE_11951_length_803_cov_7.735795	195	275	2	4	80	0.0500000
NODE_11951_length_803_cov_7.735795	195	275	8	1	80	0.0125000
NODE_11951_length_803_cov_7.735795	195	275	9	23	80	0.2875000
NODE_11951_length_803_cov_7.735795	195	275	10	20	80	0.2500000
NODE_11951_length_803_cov_7.735795	195	275	12	32	80	0.4000000
NODE_11951_length_803_cov_7.735795	248	328	8	26	80	0.3250000
NODE_11951_length_803_cov_7.735795	248	328	10	27	80	0.3375000
NODE_11951_length_803_cov_7.735795	248	328	12	27	80	0.3375000
NODE_11955_length_803_cov_4.613636	266	346	0	26	80	0.3250000
NODE_11955_length_803_cov_4.613636	266	346	2	54	80	0.6750000
NODE_11955_length_803_cov_4.613636	319	399	0	79	80	0.9875000
NODE_11955_length_803_cov_4.613636	319	399	2	1	80	0.0125000
NODE_11957_length_803_cov_4.220170	72	152	4	4	80	0.0500000
NODE_11957_length_803_cov_4.220170	72	152	6	4	80	0.0500000
NODE_11957_length_803_cov_4.220170	72	152	8	7	80	0.0875000
NODE_11957_length_803_cov_4.220170	72	152	10	6	80	0.0750000
NODE_11957_length_803_cov_4.220170	72	152	14	1	80	0.0125000
NODE_11957_length_803_cov_4.220170	72	152	16	19	80	0.2375000
NODE_11957_length_803_cov_4.220170	72	152	18	39	80	0.4875000
NODE_11957_length_803_cov_4.220170	130	207	0	24	77	0.3116883
NODE_11957_length_803_cov_4.220170	130	207	4	1	77	0.0129870
NODE_11957_length_803_cov_4.220170	130	207	8	1	77	0.0129870
NODE_11957_length_803_cov_4.220170	130	207	10	1	77	0.0129870
NODE_11957_length_803_cov_4.220170	130	207	12	3	77	0.0389610
NODE_11957_length_803_cov_4.220170	130	207	14	2	77	0.0259740
NODE_11957_length_803_cov_4.220170	130	207	16	14	77	0.1818182
NODE_11957_length_803_cov_4.220170	130	207	18	31	77	0.4025974
NODE_11985_length_802_cov_42.294452	289	369	0	12	80	0.1500000
NODE_11985_length_802_cov_42.294452	289	369	4	53	80	0.6625000
NODE_11985_length_802_cov_42.294452	289	369	6	15	80	0.1875000
NODE_11985_length_802_cov_42.294452	342	422	0	65	80	0.8125000
NODE_11985_length_802_cov_42.294452	342	422	4	15	80	0.1875000
NODE_11986_length_802_cov_31.896159	246	326	0	47	80	0.5875000
NODE_11986_length_802_cov_31.896159	246	326	1	5	80	0.0625000
NODE_11986_length_802_cov_31.896159	246	326	2	28	80	0.3500000
NODE_11986_length_802_cov_31.896159	299	379	2	80	80	1.0000000
NODE_11987_length_802_cov_30.786629	419	499	0	80	80	1.0000000
NODE_11987_length_802_cov_30.786629	472	552	0	80	80	1.0000000
NODE_11988_length_802_cov_19.540541	368	448	0	80	80	1.0000000
NODE_11988_length_802_cov_19.540541	421	501	0	80	80	1.0000000
NODE_11989_length_802_cov_17.689900	268	348	2	50	80	0.6250000
NODE_11989_length_802_cov_17.689900	268	348	4	30	80	0.3750000
NODE_11989_length_802_cov_17.689900	321	401	0	15	80	0.1875000
NODE_11989_length_802_cov_17.689900	321	401	2	65	80	0.8125000
NODE_11990_length_802_cov_16.432432	364	444	0	49	80	0.6125000
NODE_11990_length_802_cov_16.432432	364	444	1	8	80	0.1000000
NODE_11990_length_802_cov_16.432432	364	444	2	12	80	0.1500000
NODE_11990_length_802_cov_16.432432	364	444	4	11	80	0.1375000
NODE_11990_length_802_cov_16.432432	417	497	0	80	80	1.0000000
NODE_11991_length_802_cov_15.409673	317	397	2	80	80	1.0000000
NODE_11991_length_802_cov_15.409673	370	450	0	50	80	0.6250000
NODE_11991_length_802_cov_15.409673	370	450	2	30	80	0.3750000
NODE_11992_length_802_cov_12.507824	340	420	0	47	80	0.5875000
NODE_11992_length_802_cov_12.507824	340	420	2	33	80	0.4125000
NODE_11992_length_802_cov_12.507824	393	473	2	80	80	1.0000000
NODE_11993_length_802_cov_9.310100	374	454	0	80	80	1.0000000
NODE_11993_length_802_cov_9.310100	427	507	0	80	80	1.0000000
NODE_11994_length_802_cov_8.421053	272	351	0	39	79	0.4936709
NODE_11994_length_802_cov_8.421053	272	351	2	40	79	0.5063291
NODE_11994_length_802_cov_8.421053	324	404	0	34	80	0.4250000
NODE_11994_length_802_cov_8.421053	324	404	2	46	80	0.5750000
NODE_11997_length_802_cov_5.576102	294	374	0	80	80	1.0000000
NODE_11997_length_802_cov_5.576102	347	427	0	80	80	1.0000000
NODE_12025_length_801_cov_35.199430	334	414	4	33	80	0.4125000
NODE_12025_length_801_cov_35.199430	334	414	6	22	80	0.2750000
NODE_12025_length_801_cov_35.199430	334	414	8	22	80	0.2750000
NODE_12025_length_801_cov_35.199430	334	414	9	3	80	0.0375000
NODE_12025_length_801_cov_35.199430	387	467	4	13	80	0.1625000
NODE_12025_length_801_cov_35.199430	387	467	6	29	80	0.3625000
NODE_12025_length_801_cov_35.199430	387	467	8	35	80	0.4375000
NODE_12025_length_801_cov_35.199430	387	467	9	3	80	0.0375000
NODE_12026_length_801_cov_20.096866	347	427	0	36	80	0.4500000
NODE_12026_length_801_cov_20.096866	347	427	2	44	80	0.5500000
NODE_12026_length_801_cov_20.096866	400	480	0	80	80	1.0000000
NODE_12027_length_801_cov_18.643875	355	435	0	51	80	0.6375000
NODE_12027_length_801_cov_18.643875	355	435	2	29	80	0.3625000
NODE_12027_length_801_cov_18.643875	408	488	0	80	80	1.0000000
NODE_12028_length_801_cov_16.099715	427	507	0	80	80	1.0000000
NODE_12028_length_801_cov_16.099715	480	560	0	80	80	1.0000000
NODE_12029_length_801_cov_12.307692	332	412	0	80	80	1.0000000
NODE_12029_length_801_cov_12.307692	385	465	0	80	80	1.0000000
NODE_12030_length_801_cov_11.464387	293	373	0	58	80	0.7250000
NODE_12030_length_801_cov_11.464387	293	373	4	22	80	0.2750000
NODE_12030_length_801_cov_11.464387	346	426	0	5	80	0.0625000
NODE_12030_length_801_cov_11.464387	346	426	4	75	80	0.9375000
NODE_12031_length_801_cov_8.562678	309	389	0	80	80	1.0000000
NODE_12031_length_801_cov_8.562678	362	442	0	80	80	1.0000000
NODE_12032_length_801_cov_3.927350	339	419	0	80	80	1.0000000
NODE_12032_length_801_cov_3.927350	392	472	0	80	80	1.0000000
NODE_12053_length_800_cov_72.029957	245	325	0	80	80	1.0000000
NODE_12053_length_800_cov_72.029957	298	378	0	80	80	1.0000000
NODE_12054_length_800_cov_22.631954	297	377	0	5	80	0.0625000
NODE_12054_length_800_cov_22.631954	297	377	2	48	80	0.6000000
NODE_12054_length_800_cov_22.631954	297	377	4	27	80	0.3375000
NODE_12054_length_800_cov_22.631954	350	430	0	20	80	0.2500000
NODE_12054_length_800_cov_22.631954	350	430	2	40	80	0.5000000
NODE_12054_length_800_cov_22.631954	350	430	4	20	80	0.2500000
NODE_12055_length_800_cov_9.457917	409	489	0	42	80	0.5250000
NODE_12055_length_800_cov_9.457917	409	489	2	38	80	0.4750000
NODE_12055_length_800_cov_9.457917	462	542	0	80	80	1.0000000
NODE_12084_length_799_cov_101.640000	101	132	44	2	31	0.0645161
NODE_12084_length_799_cov_101.640000	101	132	48	1	31	0.0322581
NODE_12084_length_799_cov_101.640000	101	132	60	5	31	0.1612903
NODE_12084_length_799_cov_101.640000	101	132	64	1	31	0.0322581
NODE_12084_length_799_cov_101.640000	101	132	66	1	31	0.0322581
NODE_12084_length_799_cov_101.640000	101	132	68	1	31	0.0322581
NODE_12084_length_799_cov_101.640000	101	132	72	1	31	0.0322581
NODE_12084_length_799_cov_101.640000	101	132	76	1	31	0.0322581
NODE_12084_length_799_cov_101.640000	101	132	80	1	31	0.0322581
NODE_12084_length_799_cov_101.640000	101	132	84	1	31	0.0322581
NODE_12084_length_799_cov_101.640000	101	132	92	1	31	0.0322581
NODE_12084_length_799_cov_101.640000	101	132	97	1	31	0.0322581
NODE_12084_length_799_cov_101.640000	101	132	99	3	31	0.0967742
NODE_12084_length_799_cov_101.640000	101	132	101	1	31	0.0322581
NODE_12084_length_799_cov_101.640000	101	132	102	1	31	0.0322581
NODE_12084_length_799_cov_101.640000	101	132	111	1	31	0.0322581
NODE_12084_length_799_cov_101.640000	101	132	121	1	31	0.0322581
NODE_12084_length_799_cov_101.640000	101	132	129	2	31	0.0645161
NODE_12084_length_799_cov_101.640000	101	132	131	1	31	0.0322581
NODE_12084_length_799_cov_101.640000	101	132	138	1	31	0.0322581
NODE_12084_length_799_cov_101.640000	101	132	142	1	31	0.0322581
NODE_12084_length_799_cov_101.640000	101	132	149	1	31	0.0322581
NODE_12084_length_799_cov_101.640000	101	132	153	1	31	0.0322581
NODE_12085_length_799_cov_33.630000	367	447	0	80	80	1.0000000
NODE_12085_length_799_cov_33.630000	420	500	0	80	80	1.0000000
NODE_12086_length_799_cov_15.717143	408	488	0	80	80	1.0000000
NODE_12086_length_799_cov_15.717143	461	541	0	80	80	1.0000000
NODE_12087_length_799_cov_15.175714	293	373	0	75	80	0.9375000
NODE_12087_length_799_cov_15.175714	293	373	2	5	80	0.0625000
NODE_12087_length_799_cov_15.175714	346	426	0	26	80	0.3250000
NODE_12087_length_799_cov_15.175714	346	426	2	54	80	0.6750000
NODE_12088_length_799_cov_8.444286	408	488	0	80	80	1.0000000
NODE_12088_length_799_cov_8.444286	461	541	0	80	80	1.0000000
NODE_12120_length_798_cov_42.629471	148	228	0	23	80	0.2875000
NODE_12120_length_798_cov_42.629471	148	228	2	47	80	0.5875000
NODE_12120_length_798_cov_42.629471	148	228	4	10	80	0.1250000
NODE_12120_length_798_cov_42.629471	201	281	2	49	80	0.6125000
NODE_12120_length_798_cov_42.629471	201	281	4	31	80	0.3875000
NODE_12121_length_798_cov_23.658083	368	448	0	48	80	0.6000000
NODE_12121_length_798_cov_23.658083	368	448	4	3	80	0.0375000
NODE_12121_length_798_cov_23.658083	368	448	5	29	80	0.3625000
NODE_12121_length_798_cov_23.658083	421	501	1	7	80	0.0875000
NODE_12121_length_798_cov_23.658083	421	501	5	73	80	0.9125000
NODE_12122_length_798_cov_15.037196	341	421	0	80	80	1.0000000
NODE_12122_length_798_cov_15.037196	394	474	0	80	80	1.0000000
NODE_12123_length_798_cov_6.816881	404	483	0	9	79	0.1139240
NODE_12123_length_798_cov_6.816881	404	483	8	36	79	0.4556962
NODE_12123_length_798_cov_6.816881	404	483	10	34	79	0.4303797
NODE_12123_length_798_cov_6.816881	457	536	0	22	79	0.2784810
NODE_12123_length_798_cov_6.816881	457	536	2	5	79	0.0632911
NODE_12123_length_798_cov_6.816881	457	536	10	52	79	0.6582279
NODE_12129_length_798_cov_2.796853	246	326	0	80	80	1.0000000
NODE_12129_length_798_cov_2.796853	299	379	0	80	80	1.0000000
NODE_12151_length_797_cov_24.340974	207	287	0	8	80	0.1000000
NODE_12151_length_797_cov_24.340974	207	287	2	72	80	0.9000000
NODE_12151_length_797_cov_24.340974	260	340	0	59	80	0.7375000
NODE_12151_length_797_cov_24.340974	260	340	2	21	80	0.2625000
NODE_12152_length_797_cov_21.071633	372	452	0	27	80	0.3375000
NODE_12152_length_797_cov_21.071633	372	452	2	23	80	0.2875000
NODE_12152_length_797_cov_21.071633	372	452	4	11	80	0.1375000
NODE_12152_length_797_cov_21.071633	372	452	6	19	80	0.2375000
NODE_12152_length_797_cov_21.071633	425	505	4	8	80	0.1000000
NODE_12152_length_797_cov_21.071633	425	505	6	65	80	0.8125000
NODE_12152_length_797_cov_21.071633	425	505	8	7	80	0.0875000
NODE_12153_length_797_cov_18.286533	346	426	0	1	80	0.0125000
NODE_12153_length_797_cov_18.286533	346	426	2	79	80	0.9875000
NODE_12153_length_797_cov_18.286533	399	479	0	54	80	0.6750000
NODE_12153_length_797_cov_18.286533	399	479	2	26	80	0.3250000
NODE_12154_length_797_cov_16.628940	322	402	0	57	80	0.7125000
NODE_12154_length_797_cov_16.628940	322	402	2	23	80	0.2875000
NODE_12154_length_797_cov_16.628940	375	455	0	80	80	1.0000000
NODE_12155_length_797_cov_15.266476	299	379	0	20	80	0.2500000
NODE_12155_length_797_cov_15.266476	299	379	2	54	80	0.6750000
NODE_12155_length_797_cov_15.266476	299	379	6	6	80	0.0750000
NODE_12155_length_797_cov_15.266476	352	432	2	21	80	0.2625000
NODE_12155_length_797_cov_15.266476	352	432	4	7	80	0.0875000
NODE_12155_length_797_cov_15.266476	352	432	5	1	80	0.0125000
NODE_12155_length_797_cov_15.266476	352	432	6	51	80	0.6375000
NODE_12156_length_797_cov_15.035817	263	343	0	80	80	1.0000000
NODE_12156_length_797_cov_15.035817	316	396	0	80	80	1.0000000
NODE_12157_length_797_cov_12.934097	403	484	0	81	81	1.0000000
NODE_12157_length_797_cov_12.934097	457	537	0	80	80	1.0000000
NODE_12158_length_797_cov_11.140401	201	281	0	2	80	0.0250000
NODE_12158_length_797_cov_11.140401	201	281	2	78	80	0.9750000
NODE_12158_length_797_cov_11.140401	254	334	0	55	80	0.6875000
NODE_12158_length_797_cov_11.140401	254	334	2	25	80	0.3125000
NODE_12159_length_797_cov_8.681948	284	364	0	80	80	1.0000000
NODE_12159_length_797_cov_8.681948	337	417	0	50	80	0.6250000
NODE_12159_length_797_cov_8.681948	337	417	2	30	80	0.3750000
NODE_12160_length_797_cov_7.616046	314	397	0	83	83	1.0000000
NODE_12160_length_797_cov_7.616046	370	450	0	80	80	1.0000000
NODE_12161_length_797_cov_7.487106	275	347	0	72	72	1.0000000
NODE_12161_length_797_cov_7.487106	320	400	0	80	80	1.0000000
NODE_12163_length_797_cov_6.068768	357	437	0	4	80	0.0500000
NODE_12163_length_797_cov_6.068768	357	437	2	46	80	0.5750000
NODE_12163_length_797_cov_6.068768	357	437	4	30	80	0.3750000
NODE_12163_length_797_cov_6.068768	410	490	2	30	80	0.3750000
NODE_12163_length_797_cov_6.068768	410	490	4	50	80	0.6250000
NODE_12186_length_796_cov_20.862267	262	342	0	80	80	1.0000000
NODE_12186_length_796_cov_20.862267	315	395	0	80	80	1.0000000
NODE_12187_length_796_cov_18.291248	283	363	0	10	80	0.1250000
NODE_12187_length_796_cov_18.291248	283	363	3	1	80	0.0125000
NODE_12187_length_796_cov_18.291248	283	363	4	69	80	0.8625000
NODE_12187_length_796_cov_18.291248	336	416	2	8	80	0.1000000
NODE_12187_length_796_cov_18.291248	336	416	4	57	80	0.7125000
NODE_12187_length_796_cov_18.291248	336	416	5	3	80	0.0375000
NODE_12187_length_796_cov_18.291248	336	416	6	12	80	0.1500000
NODE_12189_length_796_cov_7.880918	388	460	0	72	72	1.0000000
NODE_12189_length_796_cov_7.880918	442	513	0	71	71	1.0000000
NODE_12216_length_795_cov_31.729885	298	378	0	53	80	0.6625000
NODE_12216_length_795_cov_31.729885	298	378	2	27	80	0.3375000
NODE_12216_length_795_cov_31.729885	351	431	2	80	80	1.0000000
NODE_12217_length_795_cov_26.760057	367	447	0	76	80	0.9500000
NODE_12217_length_795_cov_26.760057	367	447	5	2	80	0.0250000
NODE_12217_length_795_cov_26.760057	367	447	7	2	80	0.0250000
NODE_12217_length_795_cov_26.760057	420	500	0	23	80	0.2875000
NODE_12217_length_795_cov_26.760057	420	500	5	2	80	0.0250000
NODE_12217_length_795_cov_26.760057	420	500	7	55	80	0.6875000
NODE_12218_length_795_cov_24.522989	352	432	8	62	80	0.7750000
NODE_12218_length_795_cov_24.522989	352	432	10	18	80	0.2250000
NODE_12218_length_795_cov_24.522989	405	485	0	27	80	0.3375000
NODE_12218_length_795_cov_24.522989	405	485	2	13	80	0.1625000
NODE_12218_length_795_cov_24.522989	405	485	8	40	80	0.5000000
NODE_12219_length_795_cov_22.747126	363	443	0	7	80	0.0875000
NODE_12219_length_795_cov_22.747126	363	443	2	15	80	0.1875000
NODE_12219_length_795_cov_22.747126	363	443	4	58	80	0.7250000
NODE_12219_length_795_cov_22.747126	416	496	0	60	80	0.7500000
NODE_12219_length_795_cov_22.747126	416	496	2	15	80	0.1875000
NODE_12219_length_795_cov_22.747126	416	496	4	5	80	0.0625000
NODE_12220_length_795_cov_9.439655	425	505	0	9	80	0.1125000
NODE_12220_length_795_cov_9.439655	425	505	2	61	80	0.7625000
NODE_12220_length_795_cov_9.439655	425	505	4	10	80	0.1250000
NODE_12220_length_795_cov_9.439655	478	558	2	30	80	0.3750000
NODE_12220_length_795_cov_9.439655	478	558	4	50	80	0.6250000
NODE_12232_length_795_cov_3.359195	349	429	0	80	80	1.0000000
NODE_12232_length_795_cov_3.359195	402	482	0	80	80	1.0000000
NODE_12256_length_794_cov_24.680576	326	406	0	11	80	0.1375000
NODE_12256_length_794_cov_24.680576	326	406	6	39	80	0.4875000
NODE_12256_length_794_cov_24.680576	326	406	8	30	80	0.3750000
NODE_12256_length_794_cov_24.680576	379	459	6	3	80	0.0375000
NODE_12256_length_794_cov_24.680576	379	459	8	77	80	0.9625000
NODE_12257_length_794_cov_20.057554	153	233	0	80	80	1.0000000
NODE_12257_length_794_cov_20.057554	206	286	0	80	80	1.0000000
NODE_12257_length_794_cov_20.057554	282	362	0	80	80	1.0000000
NODE_12257_length_794_cov_20.057554	335	415	0	33	80	0.4125000
NODE_12257_length_794_cov_20.057554	335	415	2	47	80	0.5875000
NODE_12258_length_794_cov_16.602878	361	441	0	80	80	1.0000000
NODE_12258_length_794_cov_16.602878	414	494	0	80	80	1.0000000
NODE_12259_length_794_cov_16.362590	337	417	0	80	80	1.0000000
NODE_12259_length_794_cov_16.362590	390	470	0	80	80	1.0000000
NODE_12260_length_794_cov_14.444604	101	160	0	59	59	1.0000000
NODE_12260_length_794_cov_14.444604	409	489	0	80	80	1.0000000
NODE_12260_length_794_cov_14.444604	462	542	0	80	80	1.0000000
NODE_12261_length_794_cov_12.866187	442	522	0	19	80	0.2375000
NODE_12261_length_794_cov_12.866187	442	522	2	61	80	0.7625000
NODE_12261_length_794_cov_12.866187	495	575	0	34	80	0.4250000
NODE_12261_length_794_cov_12.866187	495	575	2	46	80	0.5750000
NODE_12262_length_794_cov_12.287770	235	315	0	80	80	1.0000000
NODE_12262_length_794_cov_12.287770	288	368	0	80	80	1.0000000
NODE_12263_length_794_cov_11.210072	315	395	0	48	80	0.6000000
NODE_12263_length_794_cov_11.210072	315	395	2	32	80	0.4000000
NODE_12263_length_794_cov_11.210072	368	448	0	80	80	1.0000000
NODE_12264_length_794_cov_10.638849	325	406	0	81	81	1.0000000
NODE_12264_length_794_cov_10.638849	379	459	0	80	80	1.0000000
NODE_12266_length_794_cov_6.274820	412	492	0	61	80	0.7625000
NODE_12266_length_794_cov_6.274820	412	492	1	19	80	0.2375000
NODE_12266_length_794_cov_6.274820	465	545	0	61	80	0.7625000
NODE_12266_length_794_cov_6.274820	465	545	1	19	80	0.2375000
NODE_12271_length_794_cov_3.197122	273	338	0	65	65	1.0000000
NODE_12282_length_794_cov_1.848921	246	326	0	42	80	0.5250000
NODE_12282_length_794_cov_1.848921	246	326	1	1	80	0.0125000
NODE_12282_length_794_cov_1.848921	246	326	2	37	80	0.4625000
NODE_12282_length_794_cov_1.848921	299	379	0	13	80	0.1625000
NODE_12282_length_794_cov_1.848921	299	379	2	67	80	0.8375000
NODE_12295_length_793_cov_29.878963	326	406	2	6	80	0.0750000
NODE_12295_length_793_cov_29.878963	326	406	4	74	80	0.9250000
NODE_12295_length_793_cov_29.878963	379	459	0	30	80	0.3750000
NODE_12295_length_793_cov_29.878963	379	459	2	17	80	0.2125000
NODE_12295_length_793_cov_29.878963	379	459	3	1	80	0.0125000
NODE_12295_length_793_cov_29.878963	379	459	4	32	80	0.4000000
NODE_12296_length_793_cov_25.981268	310	390	0	45	80	0.5625000
NODE_12296_length_793_cov_25.981268	310	390	2	35	80	0.4375000
NODE_12296_length_793_cov_25.981268	363	445	2	82	82	1.0000000
NODE_12297_length_793_cov_24.840058	331	411	0	19	80	0.2375000
NODE_12297_length_793_cov_24.840058	331	411	2	61	80	0.7625000
NODE_12297_length_793_cov_24.840058	384	464	0	72	80	0.9000000
NODE_12297_length_793_cov_24.840058	384	464	2	8	80	0.1000000
NODE_12298_length_793_cov_21.707493	398	478	0	5	80	0.0625000
NODE_12298_length_793_cov_21.707493	398	478	4	75	80	0.9375000
NODE_12298_length_793_cov_21.707493	451	531	0	35	80	0.4375000
NODE_12298_length_793_cov_21.707493	451	531	4	45	80	0.5625000
NODE_12299_length_793_cov_8.358790	257	337	0	6	80	0.0750000
NODE_12299_length_793_cov_8.358790	257	337	2	74	80	0.9250000
NODE_12299_length_793_cov_8.358790	310	390	0	59	80	0.7375000
NODE_12299_length_793_cov_8.358790	310	390	2	21	80	0.2625000
NODE_12300_length_793_cov_8.236311	477	557	0	80	80	1.0000000
NODE_12300_length_793_cov_8.236311	530	610	0	80	80	1.0000000
NODE_12302_length_793_cov_6.763689	461	541	0	80	80	1.0000000
NODE_12302_length_793_cov_6.763689	514	594	0	80	80	1.0000000
NODE_12307_length_793_cov_4.465418	501	549	0	48	48	1.0000000
NODE_12311_length_793_cov_4.138329	174	254	0	80	80	1.0000000
NODE_12311_length_793_cov_4.138329	227	307	0	80	80	1.0000000
NODE_12338_length_792_cov_40.025974	198	278	2	14	80	0.1750000
NODE_12338_length_792_cov_40.025974	198	278	4	66	80	0.8250000
NODE_12338_length_792_cov_40.025974	251	331	2	55	80	0.6875000
NODE_12338_length_792_cov_40.025974	251	331	4	25	80	0.3125000
NODE_12338_length_792_cov_40.025974	327	408	0	7	81	0.0864198
NODE_12338_length_792_cov_40.025974	327	408	2	69	81	0.8518519
NODE_12338_length_792_cov_40.025974	327	408	6	1	81	0.0123457
NODE_12338_length_792_cov_40.025974	327	408	7	4	81	0.0493827
NODE_12338_length_792_cov_40.025974	381	461	0	7	80	0.0875000
NODE_12338_length_792_cov_40.025974	381	461	2	15	80	0.1875000
NODE_12338_length_792_cov_40.025974	381	461	6	1	80	0.0125000
NODE_12338_length_792_cov_40.025974	381	461	7	6	80	0.0750000
NODE_12338_length_792_cov_40.025974	381	461	9	29	80	0.3625000
NODE_12338_length_792_cov_40.025974	381	461	10	1	80	0.0125000
NODE_12338_length_792_cov_40.025974	381	461	15	11	80	0.1375000
NODE_12338_length_792_cov_40.025974	381	461	17	10	80	0.1250000
NODE_12339_length_792_cov_31.176046	331	411	0	80	80	1.0000000
NODE_12339_length_792_cov_31.176046	384	463	0	79	79	1.0000000
NODE_12339_length_792_cov_31.176046	459	539	0	80	80	1.0000000
NODE_12339_length_792_cov_31.176046	512	546	0	34	34	1.0000000
NODE_12340_length_792_cov_21.347763	303	383	0	80	80	1.0000000
NODE_12340_length_792_cov_21.347763	356	436	0	45	80	0.5625000
NODE_12340_length_792_cov_21.347763	356	436	2	35	80	0.4375000
NODE_12341_length_792_cov_20.142857	361	441	0	7	80	0.0875000
NODE_12341_length_792_cov_20.142857	361	441	4	73	80	0.9125000
NODE_12341_length_792_cov_20.142857	414	494	0	20	80	0.2500000
NODE_12341_length_792_cov_20.142857	414	494	2	1	80	0.0125000
NODE_12341_length_792_cov_20.142857	414	494	3	1	80	0.0125000
NODE_12341_length_792_cov_20.142857	414	494	4	58	80	0.7250000
NODE_12342_length_792_cov_18.733045	320	400	1	10	80	0.1250000
NODE_12342_length_792_cov_18.733045	320	400	2	7	80	0.0875000
NODE_12342_length_792_cov_18.733045	320	400	6	16	80	0.2000000
NODE_12342_length_792_cov_18.733045	320	400	8	23	80	0.2875000
NODE_12342_length_792_cov_18.733045	320	400	9	1	80	0.0125000
NODE_12342_length_792_cov_18.733045	320	400	10	23	80	0.2875000
NODE_12342_length_792_cov_18.733045	373	453	5	4	80	0.0500000
NODE_12342_length_792_cov_18.733045	373	453	8	3	80	0.0375000
NODE_12342_length_792_cov_18.733045	373	453	9	10	80	0.1250000
NODE_12342_length_792_cov_18.733045	373	453	10	31	80	0.3875000
NODE_12342_length_792_cov_18.733045	373	453	11	2	80	0.0250000
NODE_12342_length_792_cov_18.733045	373	453	12	30	80	0.3750000
NODE_12343_length_792_cov_12.024531	369	449	0	20	80	0.2500000
NODE_12343_length_792_cov_12.024531	369	449	2	60	80	0.7500000
NODE_12343_length_792_cov_12.024531	422	502	2	80	80	1.0000000
NODE_12372_length_791_cov_53.573699	287	359	14	16	72	0.2222222
NODE_12372_length_791_cov_53.573699	287	359	23	8	72	0.1111111
NODE_12372_length_791_cov_53.573699	287	359	24	35	72	0.4861111
NODE_12372_length_791_cov_53.573699	287	359	28	7	72	0.0972222
NODE_12372_length_791_cov_53.573699	287	359	29	6	72	0.0833333
NODE_12372_length_791_cov_53.573699	332	412	17	36	80	0.4500000
NODE_12372_length_791_cov_53.573699	332	412	23	1	80	0.0125000
NODE_12372_length_791_cov_53.573699	332	412	24	27	80	0.3375000
NODE_12372_length_791_cov_53.573699	332	412	28	7	80	0.0875000
NODE_12372_length_791_cov_53.573699	332	412	29	9	80	0.1125000
NODE_12373_length_791_cov_40.416185	238	318	2	80	80	1.0000000
NODE_12373_length_791_cov_40.416185	291	371	0	36	80	0.4500000
NODE_12373_length_791_cov_40.416185	291	371	2	44	80	0.5500000
NODE_12374_length_791_cov_38.791908	309	389	0	14	80	0.1750000
NODE_12374_length_791_cov_38.791908	309	389	1	19	80	0.2375000
NODE_12374_length_791_cov_38.791908	309	389	3	26	80	0.3250000
NODE_12374_length_791_cov_38.791908	309	389	4	21	80	0.2625000
NODE_12374_length_791_cov_38.791908	362	442	2	27	80	0.3375000
NODE_12374_length_791_cov_38.791908	362	442	3	6	80	0.0750000
NODE_12374_length_791_cov_38.791908	362	442	4	47	80	0.5875000
NODE_12375_length_791_cov_23.468208	328	408	0	6	80	0.0750000
NODE_12375_length_791_cov_23.468208	328	408	4	5	80	0.0625000
NODE_12375_length_791_cov_23.468208	328	408	6	10	80	0.1250000
NODE_12375_length_791_cov_23.468208	328	408	12	24	80	0.3000000
NODE_12375_length_791_cov_23.468208	328	408	18	35	80	0.4375000
NODE_12375_length_791_cov_23.468208	381	461	10	14	80	0.1750000
NODE_12375_length_791_cov_23.468208	381	461	15	1	80	0.0125000
NODE_12375_length_791_cov_23.468208	381	461	16	28	80	0.3500000
NODE_12375_length_791_cov_23.468208	381	461	18	37	80	0.4625000
NODE_12376_length_791_cov_20.897399	299	379	0	33	80	0.4125000
NODE_12376_length_791_cov_20.897399	299	379	4	47	80	0.5875000
NODE_12376_length_791_cov_20.897399	352	432	4	67	80	0.8375000
NODE_12376_length_791_cov_20.897399	352	432	6	10	80	0.1250000
NODE_12376_length_791_cov_20.897399	352	432	8	3	80	0.0375000
NODE_12377_length_791_cov_13.504335	339	419	4	21	80	0.2625000
NODE_12377_length_791_cov_13.504335	339	419	8	24	80	0.3000000
NODE_12377_length_791_cov_13.504335	339	419	10	22	80	0.2750000
NODE_12377_length_791_cov_13.504335	339	419	12	13	80	0.1625000
NODE_12377_length_791_cov_13.504335	392	472	4	8	80	0.1000000
NODE_12377_length_791_cov_13.504335	392	472	8	43	80	0.5375000
NODE_12377_length_791_cov_13.504335	392	472	10	24	80	0.3000000
NODE_12377_length_791_cov_13.504335	392	472	12	5	80	0.0625000
NODE_12379_length_791_cov_12.547688	338	418	0	39	80	0.4875000
NODE_12379_length_791_cov_12.547688	338	418	7	1	80	0.0125000
NODE_12379_length_791_cov_12.547688	338	418	8	10	80	0.1250000
NODE_12379_length_791_cov_12.547688	338	418	10	30	80	0.3750000
NODE_12379_length_791_cov_12.547688	391	471	8	22	80	0.2750000
NODE_12379_length_791_cov_12.547688	391	471	10	58	80	0.7250000
NODE_12380_length_791_cov_11.791908	440	520	0	80	80	1.0000000
NODE_12380_length_791_cov_11.791908	493	573	0	80	80	1.0000000
NODE_12381_length_791_cov_11.011561	337	417	0	80	80	1.0000000
NODE_12381_length_791_cov_11.011561	390	470	0	80	80	1.0000000
NODE_12382_length_791_cov_8.757225	325	405	0	80	80	1.0000000
NODE_12382_length_791_cov_8.757225	378	458	0	80	80	1.0000000
NODE_12384_length_791_cov_8.125723	416	496	1	26	80	0.3250000
NODE_12384_length_791_cov_8.125723	416	496	2	54	80	0.6750000
NODE_12384_length_791_cov_8.125723	469	549	1	18	80	0.2250000
NODE_12384_length_791_cov_8.125723	469	549	2	62	80	0.7750000
NODE_12409_length_790_cov_48.021708	526	606	0	16	80	0.2000000
NODE_12409_length_790_cov_48.021708	526	606	2	64	80	0.8000000
NODE_12409_length_790_cov_48.021708	579	659	0	43	80	0.5375000
NODE_12409_length_790_cov_48.021708	579	659	2	37	80	0.4625000
NODE_12410_length_790_cov_44.151954	343	423	0	80	80	1.0000000
NODE_12410_length_790_cov_44.151954	396	438	0	42	42	1.0000000
NODE_12410_length_790_cov_44.151954	696	776	20	1	80	0.0125000
NODE_12410_length_790_cov_44.151954	696	776	29	1	80	0.0125000
NODE_12410_length_790_cov_44.151954	696	776	34	1	80	0.0125000
NODE_12410_length_790_cov_44.151954	696	776	40	1	80	0.0125000
NODE_12410_length_790_cov_44.151954	696	776	41	1	80	0.0125000
NODE_12410_length_790_cov_44.151954	696	776	47	2	80	0.0250000
NODE_12410_length_790_cov_44.151954	696	776	49	1	80	0.0125000
NODE_12410_length_790_cov_44.151954	696	776	51	3	80	0.0375000
NODE_12410_length_790_cov_44.151954	696	776	55	2	80	0.0250000
NODE_12410_length_790_cov_44.151954	696	776	61	5	80	0.0625000
NODE_12410_length_790_cov_44.151954	696	776	74	1	80	0.0125000
NODE_12410_length_790_cov_44.151954	696	776	76	10	80	0.1250000
NODE_12410_length_790_cov_44.151954	696	776	78	5	80	0.0625000
NODE_12410_length_790_cov_44.151954	696	776	80	2	80	0.0250000
NODE_12410_length_790_cov_44.151954	696	776	81	5	80	0.0625000
NODE_12410_length_790_cov_44.151954	696	776	83	3	80	0.0375000
NODE_12410_length_790_cov_44.151954	696	776	89	1	80	0.0125000
NODE_12410_length_790_cov_44.151954	696	776	91	7	80	0.0875000
NODE_12410_length_790_cov_44.151954	696	776	95	4	80	0.0500000
NODE_12410_length_790_cov_44.151954	696	776	97	2	80	0.0250000
NODE_12410_length_790_cov_44.151954	696	776	101	3	80	0.0375000
NODE_12410_length_790_cov_44.151954	696	776	103	1	80	0.0125000
NODE_12410_length_790_cov_44.151954	696	776	105	1	80	0.0125000
NODE_12410_length_790_cov_44.151954	696	776	106	2	80	0.0250000
NODE_12410_length_790_cov_44.151954	696	776	107	1	80	0.0125000
NODE_12410_length_790_cov_44.151954	696	776	110	1	80	0.0125000
NODE_12410_length_790_cov_44.151954	696	776	112	7	80	0.0875000
NODE_12410_length_790_cov_44.151954	696	776	113	1	80	0.0125000
NODE_12410_length_790_cov_44.151954	696	776	117	2	80	0.0250000
NODE_12410_length_790_cov_44.151954	696	776	119	1	80	0.0125000
NODE_12410_length_790_cov_44.151954	696	776	121	2	80	0.0250000
NODE_12411_length_790_cov_27.144718	291	371	2	69	80	0.8625000
NODE_12411_length_790_cov_27.144718	291	371	4	11	80	0.1375000
NODE_12411_length_790_cov_27.144718	344	424	0	30	80	0.3750000
NODE_12411_length_790_cov_27.144718	344	424	2	50	80	0.6250000
NODE_12412_length_790_cov_16.973951	232	312	2	69	80	0.8625000
NODE_12412_length_790_cov_16.973951	232	312	4	11	80	0.1375000
NODE_12412_length_790_cov_16.973951	285	365	0	24	80	0.3000000
NODE_12412_length_790_cov_16.973951	285	365	2	56	80	0.7000000
NODE_12413_length_790_cov_13.374819	204	284	0	63	80	0.7875000
NODE_12413_length_790_cov_13.374819	204	284	2	17	80	0.2125000
NODE_12413_length_790_cov_13.374819	257	337	0	80	80	1.0000000
NODE_12415_length_790_cov_10.613603	302	382	0	4	80	0.0500000
NODE_12415_length_790_cov_10.613603	302	382	2	76	80	0.9500000
NODE_12415_length_790_cov_10.613603	355	435	0	57	80	0.7125000
NODE_12415_length_790_cov_10.613603	355	435	2	23	80	0.2875000
NODE_12418_length_790_cov_5.493488	271	351	0	55	80	0.6875000
NODE_12418_length_790_cov_5.493488	271	351	2	25	80	0.3125000
NODE_12418_length_790_cov_5.493488	324	404	0	80	80	1.0000000
NODE_12434_length_790_cov_1.463097	313	376	0	63	63	1.0000000
NODE_12452_length_789_cov_39.123188	226	306	0	80	80	1.0000000
NODE_12452_length_789_cov_39.123188	279	359	0	80	80	1.0000000
NODE_12453_length_789_cov_37.205797	423	503	0	80	80	1.0000000
NODE_12453_length_789_cov_37.205797	476	556	0	80	80	1.0000000
NODE_12454_length_789_cov_31.311594	223	303	0	49	80	0.6125000
NODE_12454_length_789_cov_31.311594	223	303	2	31	80	0.3875000
NODE_12454_length_789_cov_31.311594	276	356	2	80	80	1.0000000
NODE_12455_length_789_cov_30.536232	306	386	0	14	80	0.1750000
NODE_12455_length_789_cov_30.536232	306	386	2	66	80	0.8250000
NODE_12455_length_789_cov_30.536232	359	439	0	40	80	0.5000000
NODE_12455_length_789_cov_30.536232	359	439	2	40	80	0.5000000
NODE_12456_length_789_cov_24.886957	343	423	0	75	80	0.9375000
NODE_12456_length_789_cov_24.886957	343	423	2	5	80	0.0625000
NODE_12456_length_789_cov_24.886957	396	476	0	22	80	0.2750000
NODE_12456_length_789_cov_24.886957	396	476	2	58	80	0.7250000
NODE_12457_length_789_cov_23.539130	357	437	0	29	80	0.3625000
NODE_12457_length_789_cov_23.539130	357	437	2	32	80	0.4000000
NODE_12457_length_789_cov_23.539130	357	437	4	11	80	0.1375000
NODE_12457_length_789_cov_23.539130	357	437	5	8	80	0.1000000
NODE_12457_length_789_cov_23.539130	410	490	2	8	80	0.1000000
NODE_12457_length_789_cov_23.539130	410	490	3	19	80	0.2375000
NODE_12457_length_789_cov_23.539130	410	490	4	11	80	0.1375000
NODE_12457_length_789_cov_23.539130	410	490	5	42	80	0.5250000
NODE_12458_length_789_cov_16.169565	392	472	0	80	80	1.0000000
NODE_12458_length_789_cov_16.169565	445	525	0	80	80	1.0000000
NODE_12459_length_789_cov_15.175362	242	322	0	80	80	1.0000000
NODE_12459_length_789_cov_15.175362	295	375	0	80	80	1.0000000
NODE_12459_length_789_cov_15.175362	371	451	0	80	80	1.0000000
NODE_12459_length_789_cov_15.175362	424	504	0	80	80	1.0000000
NODE_12460_length_789_cov_7.276812	306	386	0	80	80	1.0000000
NODE_12460_length_789_cov_7.276812	359	439	0	80	80	1.0000000
NODE_12482_length_788_cov_43.091437	335	415	0	55	80	0.6875000
NODE_12482_length_788_cov_43.091437	335	415	2	23	80	0.2875000
NODE_12482_length_788_cov_43.091437	335	415	4	2	80	0.0250000
NODE_12482_length_788_cov_43.091437	388	460	0	2	72	0.0277778
NODE_12482_length_788_cov_43.091437	388	460	2	23	72	0.3194444
NODE_12482_length_788_cov_43.091437	388	460	4	47	72	0.6527778
NODE_12483_length_788_cov_38.914369	345	425	0	80	80	1.0000000
NODE_12483_length_788_cov_38.914369	398	478	0	80	80	1.0000000
NODE_12484_length_788_cov_36.148041	320	400	0	21	80	0.2625000
NODE_12484_length_788_cov_36.148041	320	400	2	59	80	0.7375000
NODE_12484_length_788_cov_36.148041	373	453	0	31	80	0.3875000
NODE_12484_length_788_cov_36.148041	373	453	2	49	80	0.6125000
NODE_12485_length_788_cov_35.460087	346	426	0	51	80	0.6375000
NODE_12485_length_788_cov_35.460087	346	426	2	29	80	0.3625000
NODE_12485_length_788_cov_35.460087	399	479	2	56	80	0.7000000
NODE_12485_length_788_cov_35.460087	399	479	4	24	80	0.3000000
NODE_12486_length_788_cov_30.785196	278	358	4	80	80	1.0000000
NODE_12486_length_788_cov_30.785196	331	411	4	44	80	0.5500000
NODE_12486_length_788_cov_30.785196	331	411	6	1	80	0.0125000
NODE_12486_length_788_cov_30.785196	331	411	8	35	80	0.4375000
NODE_12488_length_788_cov_20.867925	300	380	7	29	80	0.3625000
NODE_12488_length_788_cov_20.867925	300	380	8	31	80	0.3875000
NODE_12488_length_788_cov_20.867925	300	380	9	20	80	0.2500000
NODE_12488_length_788_cov_20.867925	353	430	2	32	77	0.4155844
NODE_12488_length_788_cov_20.867925	353	430	7	4	77	0.0519481
NODE_12488_length_788_cov_20.867925	353	430	8	41	77	0.5324675
NODE_12489_length_788_cov_20.821480	322	402	0	80	80	1.0000000
NODE_12489_length_788_cov_20.821480	375	455	0	80	80	1.0000000
NODE_12490_length_788_cov_15.570392	342	422	0	45	80	0.5625000
NODE_12490_length_788_cov_15.570392	342	422	2	35	80	0.4375000
NODE_12490_length_788_cov_15.570392	395	475	0	80	80	1.0000000
NODE_12491_length_788_cov_12.235123	241	321	0	80	80	1.0000000
NODE_12491_length_788_cov_12.235123	294	374	0	80	80	1.0000000
NODE_12492_length_788_cov_10.509434	405	480	0	75	75	1.0000000
NODE_12493_length_788_cov_9.737300	310	390	0	57	80	0.7125000
NODE_12493_length_788_cov_9.737300	310	390	3	1	80	0.0125000
NODE_12493_length_788_cov_9.737300	310	390	4	22	80	0.2750000
NODE_12493_length_788_cov_9.737300	363	443	0	4	80	0.0500000
NODE_12493_length_788_cov_9.737300	363	443	3	1	80	0.0125000
NODE_12493_length_788_cov_9.737300	363	443	4	75	80	0.9375000
NODE_12494_length_788_cov_8.872279	280	360	2	80	80	1.0000000
NODE_12494_length_788_cov_8.872279	333	413	0	23	80	0.2875000
NODE_12494_length_788_cov_8.872279	333	413	2	57	80	0.7125000
NODE_12516_length_787_cov_34.683140	274	335	0	61	61	1.0000000
NODE_12516_length_787_cov_34.683140	319	380	0	61	61	1.0000000
NODE_12517_length_787_cov_28.039244	252	329	2	16	77	0.2077922
NODE_12517_length_787_cov_28.039244	252	329	3	14	77	0.1818182
NODE_12517_length_787_cov_28.039244	252	329	6	47	77	0.6103896
NODE_12517_length_787_cov_28.039244	302	370	0	8	68	0.1176471
NODE_12517_length_787_cov_28.039244	302	370	4	13	68	0.1911765
NODE_12517_length_787_cov_28.039244	302	370	6	47	68	0.6911765
NODE_12518_length_787_cov_25.422965	351	431	0	56	80	0.7000000
NODE_12518_length_787_cov_25.422965	351	431	2	24	80	0.3000000
NODE_12518_length_787_cov_25.422965	404	484	0	80	80	1.0000000
NODE_12519_length_787_cov_24.857558	319	399	0	80	80	1.0000000
NODE_12519_length_787_cov_24.857558	372	452	0	80	80	1.0000000
NODE_12520_length_787_cov_21.357558	291	371	0	80	80	1.0000000
NODE_12520_length_787_cov_21.357558	344	424	0	80	80	1.0000000
NODE_12521_length_787_cov_17.360465	396	476	4	36	80	0.4500000
NODE_12521_length_787_cov_17.360465	396	476	5	1	80	0.0125000
NODE_12521_length_787_cov_17.360465	396	476	6	43	80	0.5375000
NODE_12521_length_787_cov_17.360465	449	529	2	53	80	0.6625000
NODE_12521_length_787_cov_17.360465	449	529	5	1	80	0.0125000
NODE_12521_length_787_cov_17.360465	449	529	6	26	80	0.3250000
NODE_12522_length_787_cov_14.677326	178	258	0	15	80	0.1875000
NODE_12522_length_787_cov_14.677326	178	258	4	36	80	0.4500000
NODE_12522_length_787_cov_14.677326	178	258	6	29	80	0.3625000
NODE_12522_length_787_cov_14.677326	231	311	4	19	80	0.2375000
NODE_12522_length_787_cov_14.677326	231	311	6	61	80	0.7625000
NODE_12523_length_787_cov_12.959302	331	411	0	30	80	0.3750000
NODE_12523_length_787_cov_12.959302	331	411	2	50	80	0.6250000
NODE_12523_length_787_cov_12.959302	384	464	0	2	80	0.0250000
NODE_12523_length_787_cov_12.959302	384	464	2	78	80	0.9750000
NODE_12524_length_787_cov_12.748547	426	506	0	80	80	1.0000000
NODE_12524_length_787_cov_12.748547	479	559	0	80	80	1.0000000
NODE_12525_length_787_cov_12.369186	338	418	0	80	80	1.0000000
NODE_12525_length_787_cov_12.369186	391	471	0	80	80	1.0000000
NODE_12526_length_787_cov_9.213663	376	456	0	80	80	1.0000000
NODE_12527_length_787_cov_8.857558	344	424	0	33	80	0.4125000
NODE_12527_length_787_cov_8.857558	344	424	2	47	80	0.5875000
NODE_12527_length_787_cov_8.857558	397	477	2	80	80	1.0000000
NODE_12529_length_787_cov_8.186047	508	552	6	44	44	1.0000000
NODE_12541_length_787_cov_2.188953	505	552	4	47	47	1.0000000
NODE_12562_length_786_cov_36.441048	431	511	0	80	80	1.0000000
NODE_12562_length_786_cov_36.441048	484	564	0	80	80	1.0000000
NODE_12563_length_786_cov_23.771470	235	315	0	80	80	1.0000000
NODE_12563_length_786_cov_23.771470	288	368	0	80	80	1.0000000
NODE_12564_length_786_cov_23.333333	361	436	6	4	75	0.0533333
NODE_12564_length_786_cov_23.333333	361	436	10	18	75	0.2400000
NODE_12564_length_786_cov_23.333333	361	436	12	17	75	0.2266667
NODE_12564_length_786_cov_23.333333	361	436	13	3	75	0.0400000
NODE_12564_length_786_cov_23.333333	361	436	25	5	75	0.0666667
NODE_12564_length_786_cov_23.333333	361	436	27	14	75	0.1866667
NODE_12564_length_786_cov_23.333333	361	436	32	3	75	0.0400000
NODE_12564_length_786_cov_23.333333	361	436	33	3	75	0.0400000
NODE_12564_length_786_cov_23.333333	361	436	43	1	75	0.0133333
NODE_12564_length_786_cov_23.333333	361	436	46	2	75	0.0266667
NODE_12564_length_786_cov_23.333333	361	436	53	1	75	0.0133333
NODE_12564_length_786_cov_23.333333	361	436	54	4	75	0.0533333
NODE_12564_length_786_cov_23.333333	362	436	6	3	74	0.0405405
NODE_12564_length_786_cov_23.333333	362	436	10	18	74	0.2432432
NODE_12564_length_786_cov_23.333333	362	436	12	17	74	0.2297297
NODE_12564_length_786_cov_23.333333	362	436	13	3	74	0.0405405
NODE_12564_length_786_cov_23.333333	362	436	25	5	74	0.0675676
NODE_12564_length_786_cov_23.333333	362	436	27	14	74	0.1891892
NODE_12564_length_786_cov_23.333333	362	436	32	3	74	0.0405405
NODE_12564_length_786_cov_23.333333	362	436	33	3	74	0.0405405
NODE_12564_length_786_cov_23.333333	362	436	43	1	74	0.0135135
NODE_12564_length_786_cov_23.333333	362	436	46	2	74	0.0270270
NODE_12564_length_786_cov_23.333333	362	436	53	1	74	0.0135135
NODE_12564_length_786_cov_23.333333	362	436	54	4	74	0.0540541
NODE_12564_length_786_cov_23.333333	375	436	10	18	61	0.2950820
NODE_12564_length_786_cov_23.333333	375	436	12	7	61	0.1147541
NODE_12564_length_786_cov_23.333333	375	436	13	3	61	0.0491803
NODE_12564_length_786_cov_23.333333	375	436	25	5	61	0.0819672
NODE_12564_length_786_cov_23.333333	375	436	27	14	61	0.2295082
NODE_12564_length_786_cov_23.333333	375	436	32	3	61	0.0491803
NODE_12564_length_786_cov_23.333333	375	436	33	3	61	0.0491803
NODE_12564_length_786_cov_23.333333	375	436	43	1	61	0.0163934
NODE_12564_length_786_cov_23.333333	375	436	46	2	61	0.0327869
NODE_12564_length_786_cov_23.333333	375	436	53	1	61	0.0163934
NODE_12564_length_786_cov_23.333333	375	436	54	4	61	0.0655738
NODE_12564_length_786_cov_23.333333	414	489	25	2	75	0.0266667
NODE_12564_length_786_cov_23.333333	414	489	27	6	75	0.0800000
NODE_12564_length_786_cov_23.333333	414	489	32	3	75	0.0400000
NODE_12564_length_786_cov_23.333333	414	489	33	3	75	0.0400000
NODE_12564_length_786_cov_23.333333	414	489	43	1	75	0.0133333
NODE_12564_length_786_cov_23.333333	414	489	46	2	75	0.0266667
NODE_12564_length_786_cov_23.333333	414	489	53	1	75	0.0133333
NODE_12564_length_786_cov_23.333333	414	489	54	16	75	0.2133333
NODE_12564_length_786_cov_23.333333	414	489	56	20	75	0.2666667
NODE_12564_length_786_cov_23.333333	414	489	58	3	75	0.0400000
NODE_12564_length_786_cov_23.333333	414	489	60	5	75	0.0666667
NODE_12564_length_786_cov_23.333333	414	489	62	13	75	0.1733333
NODE_12564_length_786_cov_23.333333	414	489	25	2	75	0.0266667
NODE_12564_length_786_cov_23.333333	414	489	27	6	75	0.0800000
NODE_12564_length_786_cov_23.333333	414	489	32	3	75	0.0400000
NODE_12564_length_786_cov_23.333333	414	489	33	3	75	0.0400000
NODE_12564_length_786_cov_23.333333	414	489	43	1	75	0.0133333
NODE_12564_length_786_cov_23.333333	414	489	46	2	75	0.0266667
NODE_12564_length_786_cov_23.333333	414	489	53	1	75	0.0133333
NODE_12564_length_786_cov_23.333333	414	489	54	16	75	0.2133333
NODE_12564_length_786_cov_23.333333	414	489	56	20	75	0.2666667
NODE_12564_length_786_cov_23.333333	414	489	58	3	75	0.0400000
NODE_12564_length_786_cov_23.333333	414	489	60	5	75	0.0666667
NODE_12564_length_786_cov_23.333333	414	489	62	13	75	0.1733333
NODE_12564_length_786_cov_23.333333	414	489	25	2	75	0.0266667
NODE_12564_length_786_cov_23.333333	414	489	27	6	75	0.0800000
NODE_12564_length_786_cov_23.333333	414	489	32	3	75	0.0400000
NODE_12564_length_786_cov_23.333333	414	489	33	3	75	0.0400000
NODE_12564_length_786_cov_23.333333	414	489	43	1	75	0.0133333
NODE_12564_length_786_cov_23.333333	414	489	46	2	75	0.0266667
NODE_12564_length_786_cov_23.333333	414	489	53	1	75	0.0133333
NODE_12564_length_786_cov_23.333333	414	489	54	16	75	0.2133333
NODE_12564_length_786_cov_23.333333	414	489	56	20	75	0.2666667
NODE_12564_length_786_cov_23.333333	414	489	58	3	75	0.0400000
NODE_12564_length_786_cov_23.333333	414	489	60	5	75	0.0666667
NODE_12564_length_786_cov_23.333333	414	489	62	13	75	0.1733333
NODE_12564_length_786_cov_23.333333	490	564	26	2	74	0.0270270
NODE_12564_length_786_cov_23.333333	490	564	28	4	74	0.0540541
NODE_12564_length_786_cov_23.333333	490	564	30	6	74	0.0810811
NODE_12564_length_786_cov_23.333333	490	564	31	3	74	0.0405405
NODE_12564_length_786_cov_23.333333	490	564	52	5	74	0.0675676
NODE_12564_length_786_cov_23.333333	490	564	56	3	74	0.0405405
NODE_12564_length_786_cov_23.333333	490	564	57	31	74	0.4189189
NODE_12564_length_786_cov_23.333333	490	564	58	7	74	0.0945946
NODE_12564_length_786_cov_23.333333	490	564	59	13	74	0.1756757
NODE_12565_length_786_cov_19.279476	310	375	0	65	65	1.0000000
NODE_12565_length_786_cov_19.279476	371	441	0	70	70	1.0000000
NODE_12565_length_786_cov_19.279476	371	451	0	80	80	1.0000000
NODE_12565_length_786_cov_19.279476	424	491	0	67	67	1.0000000
NODE_12566_length_786_cov_18.652111	251	331	0	46	80	0.5750000
NODE_12566_length_786_cov_18.652111	251	331	2	34	80	0.4250000
NODE_12566_length_786_cov_18.652111	304	384	0	12	80	0.1500000
NODE_12566_length_786_cov_18.652111	304	384	2	68	80	0.8500000
NODE_12567_length_786_cov_16.704512	319	399	0	9	80	0.1125000
NODE_12567_length_786_cov_16.704512	319	399	2	10	80	0.1250000
NODE_12567_length_786_cov_16.704512	319	399	4	61	80	0.7625000
NODE_12567_length_786_cov_16.704512	372	452	0	62	80	0.7750000
NODE_12567_length_786_cov_16.704512	372	452	2	10	80	0.1250000
NODE_12567_length_786_cov_16.704512	372	452	4	8	80	0.1000000
NODE_12568_length_786_cov_16.254731	378	458	0	72	80	0.9000000
NODE_12568_length_786_cov_16.254731	378	458	1	8	80	0.1000000
NODE_12568_length_786_cov_16.254731	431	511	0	19	80	0.2375000
NODE_12568_length_786_cov_16.254731	431	511	1	37	80	0.4625000
NODE_12568_length_786_cov_16.254731	431	511	2	24	80	0.3000000
NODE_12571_length_786_cov_10.053857	381	461	0	80	80	1.0000000
NODE_12571_length_786_cov_10.053857	434	514	0	80	80	1.0000000
NODE_12572_length_786_cov_7.455604	400	473	0	73	73	1.0000000
NODE_12572_length_786_cov_7.455604	453	533	0	80	80	1.0000000
NODE_12573_length_786_cov_7.119360	276	356	0	80	80	1.0000000
NODE_12573_length_786_cov_7.119360	329	409	0	80	80	1.0000000
NODE_12575_length_786_cov_6.771470	382	462	0	66	80	0.8250000
NODE_12575_length_786_cov_6.771470	382	462	1	6	80	0.0750000
NODE_12575_length_786_cov_6.771470	382	462	2	8	80	0.1000000
NODE_12575_length_786_cov_6.771470	435	515	0	13	80	0.1625000
NODE_12575_length_786_cov_6.771470	435	515	1	6	80	0.0750000
NODE_12575_length_786_cov_6.771470	435	515	2	61	80	0.7625000
NODE_12603_length_785_cov_83.972303	315	395	0	60	80	0.7500000
NODE_12603_length_785_cov_83.972303	315	395	2	20	80	0.2500000
NODE_12603_length_785_cov_83.972303	368	448	0	7	80	0.0875000
NODE_12603_length_785_cov_83.972303	368	448	2	73	80	0.9125000
NODE_12604_length_785_cov_33.911079	477	557	2	80	80	1.0000000
NODE_12604_length_785_cov_33.911079	530	610	0	36	80	0.4500000
NODE_12604_length_785_cov_33.911079	530	610	2	44	80	0.5500000
NODE_12605_length_785_cov_21.174927	265	299	4	34	34	1.0000000
NODE_12605_length_785_cov_21.174927	295	375	4	48	80	0.6000000
NODE_12605_length_785_cov_21.174927	295	375	6	23	80	0.2875000
NODE_12605_length_785_cov_21.174927	295	375	7	1	80	0.0125000
NODE_12605_length_785_cov_21.174927	295	375	8	8	80	0.1000000
NODE_12605_length_785_cov_21.174927	348	428	2	17	80	0.2125000
NODE_12605_length_785_cov_21.174927	348	428	4	63	80	0.7875000
NODE_12606_length_785_cov_18.612245	291	371	0	8	80	0.1000000
NODE_12606_length_785_cov_18.612245	291	371	2	72	80	0.9000000
NODE_12606_length_785_cov_18.612245	344	424	0	27	80	0.3375000
NODE_12606_length_785_cov_18.612245	344	424	2	53	80	0.6625000
NODE_12606_length_785_cov_18.612245	684	705	0	21	21	1.0000000
NODE_12607_length_785_cov_9.893586	153	233	0	80	80	1.0000000
NODE_12607_length_785_cov_9.893586	206	286	0	80	80	1.0000000
NODE_12645_length_784_cov_203.604380	5	85	129	1	80	0.0125000
NODE_12645_length_784_cov_203.604380	5	85	134	1	80	0.0125000
NODE_12645_length_784_cov_203.604380	5	85	155	1	80	0.0125000
NODE_12645_length_784_cov_203.604380	5	85	159	1	80	0.0125000
NODE_12645_length_784_cov_203.604380	5	85	168	1	80	0.0125000
NODE_12645_length_784_cov_203.604380	5	85	181	1	80	0.0125000
NODE_12645_length_784_cov_203.604380	5	85	202	1	80	0.0125000
NODE_12645_length_784_cov_203.604380	5	85	210	1	80	0.0125000
NODE_12645_length_784_cov_203.604380	5	85	255	1	80	0.0125000
NODE_12645_length_784_cov_203.604380	5	85	260	1	80	0.0125000
NODE_12645_length_784_cov_203.604380	5	85	266	1	80	0.0125000
NODE_12645_length_784_cov_203.604380	5	85	279	1	80	0.0125000
NODE_12645_length_784_cov_203.604380	5	85	283	1	80	0.0125000
NODE_12645_length_784_cov_203.604380	5	85	319	1	80	0.0125000
NODE_12645_length_784_cov_203.604380	5	85	326	1	80	0.0125000
NODE_12645_length_784_cov_203.604380	5	85	335	1	80	0.0125000
NODE_12645_length_784_cov_203.604380	5	85	353	1	80	0.0125000
NODE_12645_length_784_cov_203.604380	5	85	359	1	80	0.0125000
NODE_12645_length_784_cov_203.604380	5	85	362	1	80	0.0125000
NODE_12645_length_784_cov_203.604380	5	85	370	1	80	0.0125000
NODE_12645_length_784_cov_203.604380	5	85	380	1	80	0.0125000
NODE_12645_length_784_cov_203.604380	5	85	404	1	80	0.0125000
NODE_12645_length_784_cov_203.604380	5	85	406	1	80	0.0125000
NODE_12645_length_784_cov_203.604380	5	85	413	1	80	0.0125000
NODE_12645_length_784_cov_203.604380	5	85	426	1	80	0.0125000
NODE_12645_length_784_cov_203.604380	5	85	442	1	80	0.0125000
NODE_12645_length_784_cov_203.604380	5	85	445	1	80	0.0125000
NODE_12645_length_784_cov_203.604380	5	85	451	1	80	0.0125000
NODE_12645_length_784_cov_203.604380	5	85	459	1	80	0.0125000
NODE_12645_length_784_cov_203.604380	5	85	461	1	80	0.0125000
NODE_12645_length_784_cov_203.604380	5	85	466	2	80	0.0250000
NODE_12645_length_784_cov_203.604380	5	85	474	1	80	0.0125000
NODE_12645_length_784_cov_203.604380	5	85	484	1	80	0.0125000
NODE_12645_length_784_cov_203.604380	5	85	497	1	80	0.0125000
NODE_12645_length_784_cov_203.604380	5	85	521	1	80	0.0125000
NODE_12645_length_784_cov_203.604380	5	85	533	1	80	0.0125000
NODE_12645_length_784_cov_203.604380	5	85	541	1	80	0.0125000
NODE_12645_length_784_cov_203.604380	5	85	567	1	80	0.0125000
NODE_12645_length_784_cov_203.604380	5	85	576	1	80	0.0125000
NODE_12645_length_784_cov_203.604380	5	85	578	1	80	0.0125000
NODE_12645_length_784_cov_203.604380	5	85	585	1	80	0.0125000
NODE_12645_length_784_cov_203.604380	5	85	593	1	80	0.0125000
NODE_12645_length_784_cov_203.604380	5	85	597	1	80	0.0125000
NODE_12645_length_784_cov_203.604380	5	85	609	1	80	0.0125000
NODE_12645_length_784_cov_203.604380	5	85	614	1	80	0.0125000
NODE_12645_length_784_cov_203.604380	5	85	617	1	80	0.0125000
NODE_12645_length_784_cov_203.604380	5	85	619	1	80	0.0125000
NODE_12645_length_784_cov_203.604380	5	85	622	1	80	0.0125000
NODE_12645_length_784_cov_203.604380	5	85	625	1	80	0.0125000
NODE_12645_length_784_cov_203.604380	5	85	634	1	80	0.0125000
NODE_12645_length_784_cov_203.604380	5	85	636	1	80	0.0125000
NODE_12645_length_784_cov_203.604380	5	85	640	1	80	0.0125000
NODE_12645_length_784_cov_203.604380	5	85	651	1	80	0.0125000
NODE_12645_length_784_cov_203.604380	5	85	654	1	80	0.0125000
NODE_12645_length_784_cov_203.604380	5	85	655	1	80	0.0125000
NODE_12645_length_784_cov_203.604380	5	85	661	3	80	0.0375000
NODE_12645_length_784_cov_203.604380	5	85	662	2	80	0.0250000
NODE_12645_length_784_cov_203.604380	5	85	668	2	80	0.0250000
NODE_12645_length_784_cov_203.604380	5	85	671	1	80	0.0125000
NODE_12645_length_784_cov_203.604380	5	85	673	1	80	0.0125000
NODE_12645_length_784_cov_203.604380	5	85	678	1	80	0.0125000
NODE_12645_length_784_cov_203.604380	5	85	685	1	80	0.0125000
NODE_12645_length_784_cov_203.604380	5	85	687	1	80	0.0125000
NODE_12645_length_784_cov_203.604380	5	85	695	1	80	0.0125000
NODE_12645_length_784_cov_203.604380	5	85	700	1	80	0.0125000
NODE_12645_length_784_cov_203.604380	5	85	701	1	80	0.0125000
NODE_12645_length_784_cov_203.604380	5	85	704	1	80	0.0125000
NODE_12645_length_784_cov_203.604380	5	85	717	3	80	0.0375000
NODE_12645_length_784_cov_203.604380	5	85	718	1	80	0.0125000
NODE_12645_length_784_cov_203.604380	5	85	720	1	80	0.0125000
NODE_12645_length_784_cov_203.604380	5	85	726	1	80	0.0125000
NODE_12645_length_784_cov_203.604380	5	85	735	1	80	0.0125000
NODE_12645_length_784_cov_203.604380	5	85	736	1	80	0.0125000
NODE_12645_length_784_cov_203.604380	58	138	651	2	80	0.0250000
NODE_12645_length_784_cov_203.604380	58	138	652	1	80	0.0125000
NODE_12645_length_784_cov_203.604380	58	138	654	2	80	0.0250000
NODE_12645_length_784_cov_203.604380	58	138	655	1	80	0.0125000
NODE_12645_length_784_cov_203.604380	58	138	661	3	80	0.0375000
NODE_12645_length_784_cov_203.604380	58	138	662	2	80	0.0250000
NODE_12645_length_784_cov_203.604380	58	138	663	1	80	0.0125000
NODE_12645_length_784_cov_203.604380	58	138	668	2	80	0.0250000
NODE_12645_length_784_cov_203.604380	58	138	670	1	80	0.0125000
NODE_12645_length_784_cov_203.604380	58	138	671	1	80	0.0125000
NODE_12645_length_784_cov_203.604380	58	138	673	1	80	0.0125000
NODE_12645_length_784_cov_203.604380	58	138	675	1	80	0.0125000
NODE_12645_length_784_cov_203.604380	58	138	678	1	80	0.0125000
NODE_12645_length_784_cov_203.604380	58	138	685	1	80	0.0125000
NODE_12645_length_784_cov_203.604380	58	138	687	1	80	0.0125000
NODE_12645_length_784_cov_203.604380	58	138	695	1	80	0.0125000
NODE_12645_length_784_cov_203.604380	58	138	700	1	80	0.0125000
NODE_12645_length_784_cov_203.604380	58	138	701	1	80	0.0125000
NODE_12645_length_784_cov_203.604380	58	138	704	1	80	0.0125000
NODE_12645_length_784_cov_203.604380	58	138	712	1	80	0.0125000
NODE_12645_length_784_cov_203.604380	58	138	717	3	80	0.0375000
NODE_12645_length_784_cov_203.604380	58	138	718	1	80	0.0125000
NODE_12645_length_784_cov_203.604380	58	138	720	1	80	0.0125000
NODE_12645_length_784_cov_203.604380	58	138	726	1	80	0.0125000
NODE_12645_length_784_cov_203.604380	58	138	727	1	80	0.0125000
NODE_12645_length_784_cov_203.604380	58	138	730	1	80	0.0125000
NODE_12645_length_784_cov_203.604380	58	138	735	1	80	0.0125000
NODE_12645_length_784_cov_203.604380	58	138	736	1	80	0.0125000
NODE_12645_length_784_cov_203.604380	58	138	742	2	80	0.0250000
NODE_12645_length_784_cov_203.604380	58	138	746	1	80	0.0125000
NODE_12645_length_784_cov_203.604380	58	138	749	2	80	0.0250000
NODE_12645_length_784_cov_203.604380	58	138	754	1	80	0.0125000
NODE_12645_length_784_cov_203.604380	58	138	758	1	80	0.0125000
NODE_12645_length_784_cov_203.604380	58	138	759	2	80	0.0250000
NODE_12645_length_784_cov_203.604380	58	138	762	1	80	0.0125000
NODE_12645_length_784_cov_203.604380	58	138	769	1	80	0.0125000
NODE_12645_length_784_cov_203.604380	58	138	773	1	80	0.0125000
NODE_12645_length_784_cov_203.604380	58	138	783	1	80	0.0125000
NODE_12645_length_784_cov_203.604380	58	138	784	1	80	0.0125000
NODE_12645_length_784_cov_203.604380	58	138	789	1	80	0.0125000
NODE_12645_length_784_cov_203.604380	58	138	795	1	80	0.0125000
NODE_12645_length_784_cov_203.604380	58	138	801	2	80	0.0250000
NODE_12645_length_784_cov_203.604380	58	138	805	2	80	0.0250000
NODE_12645_length_784_cov_203.604380	58	138	806	1	80	0.0125000
NODE_12645_length_784_cov_203.604380	58	138	807	2	80	0.0250000
NODE_12645_length_784_cov_203.604380	58	138	808	1	80	0.0125000
NODE_12645_length_784_cov_203.604380	58	138	809	2	80	0.0250000
NODE_12645_length_784_cov_203.604380	58	138	811	2	80	0.0250000
NODE_12645_length_784_cov_203.604380	58	138	812	2	80	0.0250000
NODE_12645_length_784_cov_203.604380	58	138	815	1	80	0.0125000
NODE_12645_length_784_cov_203.604380	58	138	817	1	80	0.0125000
NODE_12645_length_784_cov_203.604380	58	138	821	1	80	0.0125000
NODE_12645_length_784_cov_203.604380	58	138	822	1	80	0.0125000
NODE_12645_length_784_cov_203.604380	58	138	824	1	80	0.0125000
NODE_12645_length_784_cov_203.604380	58	138	825	1	80	0.0125000
NODE_12645_length_784_cov_203.604380	58	138	826	1	80	0.0125000
NODE_12645_length_784_cov_203.604380	58	138	827	1	80	0.0125000
NODE_12645_length_784_cov_203.604380	58	138	829	1	80	0.0125000
NODE_12645_length_784_cov_203.604380	58	138	830	2	80	0.0250000
NODE_12645_length_784_cov_203.604380	58	138	833	2	80	0.0250000
NODE_12645_length_784_cov_203.604380	58	138	836	1	80	0.0125000
NODE_12646_length_784_cov_45.210219	49	129	0	80	80	1.0000000
NODE_12646_length_784_cov_45.210219	102	182	0	80	80	1.0000000
NODE_12646_length_784_cov_45.210219	218	298	0	80	80	1.0000000
NODE_12646_length_784_cov_45.210219	271	351	0	80	80	1.0000000
NODE_12646_length_784_cov_45.210219	347	427	0	80	80	1.0000000
NODE_12646_length_784_cov_45.210219	347	427	0	80	80	1.0000000
NODE_12646_length_784_cov_45.210219	347	427	0	80	80	1.0000000
NODE_12646_length_784_cov_45.210219	400	447	0	47	47	1.0000000
NODE_12646_length_784_cov_45.210219	400	480	0	80	80	1.0000000
NODE_12646_length_784_cov_45.210219	400	455	0	55	55	1.0000000
NODE_12647_length_784_cov_33.543066	405	485	0	80	80	1.0000000
NODE_12647_length_784_cov_33.543066	458	538	0	80	80	1.0000000
NODE_12648_length_784_cov_21.762044	318	398	0	80	80	1.0000000
NODE_12648_length_784_cov_21.762044	371	451	0	80	80	1.0000000
NODE_12649_length_784_cov_20.583942	286	366	0	80	80	1.0000000
NODE_12649_length_784_cov_20.583942	339	419	0	80	80	1.0000000
NODE_12649_length_784_cov_20.583942	415	495	0	80	80	1.0000000
NODE_12649_length_784_cov_20.583942	468	548	0	80	80	1.0000000
NODE_12650_length_784_cov_19.448175	217	297	0	45	80	0.5625000
NODE_12650_length_784_cov_19.448175	217	297	2	35	80	0.4375000
NODE_12650_length_784_cov_19.448175	270	350	2	41	80	0.5125000
NODE_12650_length_784_cov_19.448175	270	350	4	23	80	0.2875000
NODE_12650_length_784_cov_19.448175	270	350	6	16	80	0.2000000
NODE_12652_length_784_cov_12.480292	297	377	0	27	80	0.3375000
NODE_12652_length_784_cov_12.480292	297	377	2	53	80	0.6625000
NODE_12652_length_784_cov_12.480292	350	430	0	80	80	1.0000000
NODE_12653_length_784_cov_9.296350	250	330	0	80	80	1.0000000
NODE_12653_length_784_cov_9.296350	303	383	0	80	80	1.0000000
NODE_12653_length_784_cov_9.296350	379	459	0	80	80	1.0000000
NODE_12653_length_784_cov_9.296350	432	512	0	80	80	1.0000000
NODE_12654_length_784_cov_6.316788	274	354	0	80	80	1.0000000
NODE_12654_length_784_cov_6.316788	327	407	0	80	80	1.0000000
NODE_12688_length_783_cov_41.849415	459	539	2	6	80	0.0750000
NODE_12688_length_783_cov_41.849415	459	539	8	56	80	0.7000000
NODE_12688_length_783_cov_41.849415	459	539	9	1	80	0.0125000
NODE_12688_length_783_cov_41.849415	459	539	10	17	80	0.2125000
NODE_12688_length_783_cov_41.849415	512	592	0	45	80	0.5625000
NODE_12688_length_783_cov_41.849415	512	592	8	35	80	0.4375000
NODE_12689_length_783_cov_39.881579	230	310	0	80	80	1.0000000
NODE_12689_length_783_cov_39.881579	283	363	0	80	80	1.0000000
NODE_12689_length_783_cov_39.881579	359	439	0	59	80	0.7375000
NODE_12689_length_783_cov_39.881579	359	439	2	21	80	0.2625000
NODE_12689_length_783_cov_39.881579	412	492	0	6	80	0.0750000
NODE_12689_length_783_cov_39.881579	412	492	2	74	80	0.9250000
NODE_12690_length_783_cov_35.967836	229	309	0	80	80	1.0000000
NODE_12690_length_783_cov_35.967836	282	362	0	80	80	1.0000000
NODE_12691_length_783_cov_28.203216	292	372	0	80	80	1.0000000
NODE_12691_length_783_cov_28.203216	345	425	0	80	80	1.0000000
NODE_12692_length_783_cov_16.695906	393	473	0	80	80	1.0000000
NODE_12692_length_783_cov_16.695906	446	526	0	45	80	0.5625000
NODE_12692_length_783_cov_16.695906	446	526	2	35	80	0.4375000
NODE_12693_length_783_cov_15.656433	418	498	0	74	80	0.9250000
NODE_12693_length_783_cov_15.656433	418	498	2	6	80	0.0750000
NODE_12693_length_783_cov_15.656433	471	551	0	80	80	1.0000000
NODE_12694_length_783_cov_14.904971	321	401	2	73	80	0.9125000
NODE_12694_length_783_cov_14.904971	321	401	3	4	80	0.0500000
NODE_12694_length_783_cov_14.904971	321	401	4	3	80	0.0375000
NODE_12694_length_783_cov_14.904971	374	454	2	78	80	0.9750000
NODE_12694_length_783_cov_14.904971	374	454	3	2	80	0.0250000
NODE_12728_length_782_cov_22.461201	347	427	0	80	80	1.0000000
NODE_12728_length_782_cov_22.461201	400	480	0	80	80	1.0000000
NODE_12729_length_782_cov_19.163982	306	386	0	80	80	1.0000000
NODE_12729_length_782_cov_19.163982	382	462	0	56	80	0.7000000
NODE_12729_length_782_cov_19.163982	382	462	2	24	80	0.3000000
NODE_12729_length_782_cov_19.163982	435	515	0	3	80	0.0375000
NODE_12729_length_782_cov_19.163982	435	515	2	38	80	0.4750000
NODE_12729_length_782_cov_19.163982	435	515	4	39	80	0.4875000
NODE_12730_length_782_cov_19.090776	295	375	0	35	80	0.4375000
NODE_12730_length_782_cov_19.090776	295	375	2	45	80	0.5625000
NODE_12730_length_782_cov_19.090776	348	428	0	80	80	1.0000000
NODE_12731_length_782_cov_13.509517	323	403	0	80	80	1.0000000
NODE_12731_length_782_cov_13.509517	376	456	0	80	80	1.0000000
NODE_12732_length_782_cov_11.364568	367	447	0	23	80	0.2875000
NODE_12732_length_782_cov_11.364568	367	447	3	20	80	0.2500000
NODE_12732_length_782_cov_11.364568	367	447	4	37	80	0.4625000
NODE_12732_length_782_cov_11.364568	420	500	0	5	80	0.0625000
NODE_12732_length_782_cov_11.364568	420	500	4	75	80	0.9375000
NODE_12735_length_782_cov_7.976574	245	325	0	80	80	1.0000000
NODE_12735_length_782_cov_7.976574	298	378	0	80	80	1.0000000
NODE_12737_length_782_cov_5.500732	384	464	0	80	80	1.0000000
NODE_12737_length_782_cov_5.500732	437	517	0	80	80	1.0000000
NODE_12739_length_782_cov_4.434846	309	389	0	7	80	0.0875000
NODE_12739_length_782_cov_4.434846	309	389	4	73	80	0.9125000
NODE_12739_length_782_cov_4.434846	362	442	0	16	80	0.2000000
NODE_12739_length_782_cov_4.434846	362	442	4	64	80	0.8000000
NODE_12740_length_782_cov_3.352855	177	196	0	19	19	1.0000000
NODE_12741_length_782_cov_3.231332	160	240	0	80	80	1.0000000
NODE_12741_length_782_cov_3.231332	213	298	0	85	85	1.0000000
NODE_12765_length_781_cov_34.247801	174	254	27	11	80	0.1375000
NODE_12765_length_781_cov_34.247801	174	254	29	36	80	0.4500000
NODE_12765_length_781_cov_34.247801	174	254	30	1	80	0.0125000
NODE_12765_length_781_cov_34.247801	174	254	33	5	80	0.0625000
NODE_12765_length_781_cov_34.247801	174	254	34	27	80	0.3375000
NODE_12765_length_781_cov_34.247801	227	307	0	26	80	0.3250000
NODE_12765_length_781_cov_34.247801	227	307	34	54	80	0.6750000
NODE_12766_length_781_cov_27.530792	490	570	0	48	80	0.6000000
NODE_12766_length_781_cov_27.530792	490	570	2	32	80	0.4000000
NODE_12766_length_781_cov_27.530792	543	623	0	11	80	0.1375000
NODE_12766_length_781_cov_27.530792	543	623	2	69	80	0.8625000
NODE_12766_length_781_cov_27.530792	619	699	0	37	80	0.4625000
NODE_12766_length_781_cov_27.530792	619	699	2	43	80	0.5375000
NODE_12766_length_781_cov_27.530792	672	752	0	3	80	0.0375000
NODE_12766_length_781_cov_27.530792	672	752	2	77	80	0.9625000
NODE_12767_length_781_cov_22.768328	427	507	0	80	80	1.0000000
NODE_12767_length_781_cov_22.768328	480	560	0	80	80	1.0000000
NODE_12768_length_781_cov_17.894428	411	491	0	80	80	1.0000000
NODE_12768_length_781_cov_17.894428	464	544	0	80	80	1.0000000
NODE_12769_length_781_cov_14.922287	486	565	4	79	79	1.0000000
NODE_12769_length_781_cov_14.922287	538	618	0	21	80	0.2625000
NODE_12769_length_781_cov_14.922287	538	618	4	59	80	0.7375000
NODE_12770_length_781_cov_12.529326	318	398	0	66	80	0.8250000
NODE_12770_length_781_cov_12.529326	318	398	2	11	80	0.1375000
NODE_12770_length_781_cov_12.529326	318	398	4	3	80	0.0375000
NODE_12770_length_781_cov_12.529326	371	451	0	13	80	0.1625000
NODE_12770_length_781_cov_12.529326	371	451	2	11	80	0.1375000
NODE_12770_length_781_cov_12.529326	371	451	4	56	80	0.7000000
NODE_12771_length_781_cov_10.303519	444	524	2	1	80	0.0125000
NODE_12771_length_781_cov_10.303519	444	524	8	35	80	0.4375000
NODE_12771_length_781_cov_10.303519	444	524	10	44	80	0.5500000
NODE_12772_length_781_cov_9.851906	374	454	0	80	80	1.0000000
NODE_12772_length_781_cov_9.851906	427	507	0	80	80	1.0000000
NODE_12775_length_781_cov_8.557185	113	194	0	81	81	1.0000000
NODE_12775_length_781_cov_8.557185	166	239	0	73	73	1.0000000
NODE_12778_length_781_cov_4.734604	30	110	1	9	80	0.1125000
NODE_12778_length_781_cov_4.734604	30	110	3	18	80	0.2250000
NODE_12778_length_781_cov_4.734604	30	110	4	24	80	0.3000000
NODE_12778_length_781_cov_4.734604	30	110	6	13	80	0.1625000
NODE_12778_length_781_cov_4.734604	30	110	8	16	80	0.2000000
NODE_12778_length_781_cov_4.734604	83	163	6	11	80	0.1375000
NODE_12778_length_781_cov_4.734604	83	163	8	31	80	0.3875000
NODE_12778_length_781_cov_4.734604	83	163	9	4	80	0.0500000
NODE_12778_length_781_cov_4.734604	83	163	10	34	80	0.4250000
NODE_12780_length_781_cov_4.077713	269	349	0	80	80	1.0000000
NODE_12780_length_781_cov_4.077713	322	402	0	80	80	1.0000000
NODE_12812_length_780_cov_37.693098	165	245	0	80	80	1.0000000
NODE_12812_length_780_cov_37.693098	218	298	0	80	80	1.0000000
NODE_12813_length_780_cov_22.132159	407	487	4	8	80	0.1000000
NODE_12813_length_780_cov_22.132159	407	487	6	4	80	0.0500000
NODE_12813_length_780_cov_22.132159	407	487	8	68	80	0.8500000
NODE_12813_length_780_cov_22.132159	460	540	2	26	80	0.3250000
NODE_12813_length_780_cov_22.132159	460	540	4	17	80	0.2125000
NODE_12813_length_780_cov_22.132159	460	540	8	37	80	0.4625000
NODE_12814_length_780_cov_21.831131	299	379	2	17	80	0.2125000
NODE_12814_length_780_cov_21.831131	299	379	4	12	80	0.1500000
NODE_12814_length_780_cov_21.831131	299	379	5	15	80	0.1875000
NODE_12814_length_780_cov_21.831131	299	379	6	36	80	0.4500000
NODE_12814_length_780_cov_21.831131	352	432	0	49	80	0.6125000
NODE_12814_length_780_cov_21.831131	352	432	2	21	80	0.2625000
NODE_12814_length_780_cov_21.831131	352	432	6	10	80	0.1250000
NODE_12815_length_780_cov_16.722467	165	245	2	50	80	0.6250000
NODE_12815_length_780_cov_16.722467	165	245	4	30	80	0.3750000
NODE_12815_length_780_cov_16.722467	218	298	2	57	80	0.7125000
NODE_12815_length_780_cov_16.722467	218	298	4	23	80	0.2875000
NODE_12816_length_780_cov_13.189427	150	254	0	104	104	1.0000000
NODE_12816_length_780_cov_13.189427	227	307	0	80	80	1.0000000
NODE_12817_length_780_cov_12.910426	276	356	1	80	80	1.0000000
NODE_12817_length_780_cov_12.910426	329	409	0	29	80	0.3625000
NODE_12817_length_780_cov_12.910426	329	409	1	51	80	0.6375000
NODE_12818_length_780_cov_8.455213	141	221	0	80	80	1.0000000
NODE_12818_length_780_cov_8.455213	194	274	0	80	80	1.0000000
NODE_12848_length_779_cov_51.022059	8	43	8	9	35	0.2571429
NODE_12848_length_779_cov_51.022059	8	43	10	1	35	0.0285714
NODE_12848_length_779_cov_51.022059	8	43	12	25	35	0.7142857
NODE_12848_length_779_cov_51.022059	53	96	12	23	43	0.5348837
NODE_12848_length_779_cov_51.022059	53	96	14	20	43	0.4651163
NODE_12848_length_779_cov_51.022059	97	177	4	4	80	0.0500000
NODE_12848_length_779_cov_51.022059	97	177	6	29	80	0.3625000
NODE_12848_length_779_cov_51.022059	97	177	8	31	80	0.3875000
NODE_12848_length_779_cov_51.022059	97	177	10	4	80	0.0500000
NODE_12848_length_779_cov_51.022059	97	177	12	6	80	0.0750000
NODE_12848_length_779_cov_51.022059	97	177	14	6	80	0.0750000
NODE_12848_length_779_cov_51.022059	150	230	0	23	80	0.2875000
NODE_12848_length_779_cov_51.022059	150	230	4	26	80	0.3250000
NODE_12848_length_779_cov_51.022059	150	230	6	28	80	0.3500000
NODE_12848_length_779_cov_51.022059	150	230	8	3	80	0.0375000
NODE_12849_length_779_cov_23.682353	362	442	0	80	80	1.0000000
NODE_12849_length_779_cov_23.682353	415	495	0	80	80	1.0000000
NODE_12850_length_779_cov_15.994118	320	400	0	17	80	0.2125000
NODE_12850_length_779_cov_15.994118	320	400	4	13	80	0.1625000
NODE_12850_length_779_cov_15.994118	320	400	6	50	80	0.6250000
NODE_12850_length_779_cov_15.994118	373	453	0	70	80	0.8750000
NODE_12850_length_779_cov_15.994118	373	453	4	10	80	0.1250000
NODE_12851_length_779_cov_14.386765	258	320	0	33	62	0.5322581
NODE_12851_length_779_cov_14.386765	258	320	2	1	62	0.0161290
NODE_12851_length_779_cov_14.386765	258	320	4	28	62	0.4516129
NODE_12851_length_779_cov_14.386765	293	368	0	11	75	0.1466667
NODE_12851_length_779_cov_14.386765	293	368	4	64	75	0.8533334
NODE_12851_length_779_cov_14.386765	369	443	0	19	74	0.2567568
NODE_12851_length_779_cov_14.386765	369	443	2	21	74	0.2837838
NODE_12851_length_779_cov_14.386765	369	443	4	1	74	0.0135135
NODE_12851_length_779_cov_14.386765	369	443	6	18	74	0.2432432
NODE_12851_length_779_cov_14.386765	369	443	8	15	74	0.2027027
NODE_12852_length_779_cov_11.861765	180	263	1	53	83	0.6385542
NODE_12852_length_779_cov_11.861765	180	263	2	30	83	0.3614458
NODE_12852_length_779_cov_11.861765	236	316	1	35	80	0.4375000
NODE_12852_length_779_cov_11.861765	236	316	2	45	80	0.5625000
NODE_12852_length_779_cov_11.861765	312	392	0	57	80	0.7125000
NODE_12852_length_779_cov_11.861765	312	392	1	23	80	0.2875000
NODE_12852_length_779_cov_11.861765	365	445	0	80	80	1.0000000
NODE_12853_length_779_cov_11.735294	285	365	0	39	80	0.4875000
NODE_12853_length_779_cov_11.735294	285	365	2	41	80	0.5125000
NODE_12853_length_779_cov_11.735294	338	418	0	13	80	0.1625000
NODE_12853_length_779_cov_11.735294	338	418	2	67	80	0.8375000
NODE_12854_length_779_cov_7.211765	333	413	0	24	80	0.3000000
NODE_12854_length_779_cov_7.211765	333	413	2	56	80	0.7000000
NODE_12854_length_779_cov_7.211765	386	466	0	50	80	0.6250000
NODE_12854_length_779_cov_7.211765	386	466	2	4	80	0.0500000
NODE_12854_length_779_cov_7.211765	386	466	4	26	80	0.3250000
NODE_12857_length_779_cov_5.611765	271	351	2	80	80	1.0000000
NODE_12857_length_779_cov_5.611765	324	404	0	33	80	0.4125000
NODE_12857_length_779_cov_5.611765	324	404	1	3	80	0.0375000
NODE_12857_length_779_cov_5.611765	324	404	2	44	80	0.5500000
NODE_12859_length_779_cov_4.695588	216	296	2	29	80	0.3625000
NODE_12859_length_779_cov_4.695588	216	296	4	51	80	0.6375000
NODE_12859_length_779_cov_4.695588	269	349	0	37	80	0.4625000
NODE_12859_length_779_cov_4.695588	269	349	2	43	80	0.5375000
NODE_12863_length_779_cov_2.329412	615	672	4	57	57	1.0000000
NODE_12883_length_778_cov_21.615611	325	405	0	10	80	0.1250000
NODE_12883_length_778_cov_21.615611	325	405	2	33	80	0.4125000
NODE_12883_length_778_cov_21.615611	325	405	4	37	80	0.4625000
NODE_12883_length_778_cov_21.615611	378	458	0	44	80	0.5500000
NODE_12883_length_778_cov_21.615611	378	458	2	12	80	0.1500000
NODE_12883_length_778_cov_21.615611	378	458	4	24	80	0.3000000
NODE_12884_length_778_cov_19.549337	348	428	0	58	80	0.7250000
NODE_12884_length_778_cov_19.549337	348	428	2	22	80	0.2750000
NODE_12884_length_778_cov_19.549337	401	481	0	23	80	0.2875000
NODE_12884_length_778_cov_19.549337	401	481	2	57	80	0.7125000
NODE_12885_length_778_cov_15.403535	312	392	0	80	80	1.0000000
NODE_12885_length_778_cov_15.403535	365	445	0	80	80	1.0000000
NODE_12886_length_778_cov_14.614138	101	181	0	80	80	1.0000000
NODE_12886_length_778_cov_14.614138	154	234	0	80	80	1.0000000
NODE_12887_length_778_cov_13.368189	256	336	2	80	80	1.0000000
NODE_12887_length_778_cov_13.368189	309	389	0	41	80	0.5125000
NODE_12887_length_778_cov_13.368189	309	389	2	39	80	0.4875000
NODE_12891_length_778_cov_6.307806	349	429	0	7	80	0.0875000
NODE_12891_length_778_cov_6.307806	349	429	2	11	80	0.1375000
NODE_12891_length_778_cov_6.307806	349	429	4	62	80	0.7750000
NODE_12891_length_778_cov_6.307806	402	482	0	24	80	0.3000000
NODE_12891_length_778_cov_6.307806	402	482	2	2	80	0.0250000
NODE_12891_length_778_cov_6.307806	402	482	4	54	80	0.6750000
NODE_12893_length_778_cov_5.985272	385	465	0	80	80	1.0000000
NODE_12893_length_778_cov_5.985272	438	518	0	80	80	1.0000000
NODE_12928_length_777_cov_25.504425	323	403	0	5	80	0.0625000
NODE_12928_length_777_cov_25.504425	323	403	13	1	80	0.0125000
NODE_12928_length_777_cov_25.504425	323	403	14	74	80	0.9250000
NODE_12928_length_777_cov_25.504425	376	456	14	80	80	1.0000000
NODE_12929_length_777_cov_25.410029	346	426	0	26	80	0.3250000
NODE_12929_length_777_cov_25.410029	346	426	4	54	80	0.6750000
NODE_12929_length_777_cov_25.410029	399	479	0	12	80	0.1500000
NODE_12929_length_777_cov_25.410029	399	479	4	68	80	0.8500000
NODE_12930_length_777_cov_25.333333	97	177	0	80	80	1.0000000
NODE_12930_length_777_cov_25.333333	150	230	0	80	80	1.0000000
NODE_12931_length_777_cov_21.600295	408	485	0	77	77	1.0000000
NODE_12931_length_777_cov_21.600295	458	538	0	80	80	1.0000000
NODE_12932_length_777_cov_19.561947	343	423	0	80	80	1.0000000
NODE_12932_length_777_cov_19.561947	396	476	0	80	80	1.0000000
NODE_12933_length_777_cov_16.961652	264	344	0	25	80	0.3125000
NODE_12933_length_777_cov_16.961652	264	344	1	16	80	0.2000000
NODE_12933_length_777_cov_16.961652	264	344	7	39	80	0.4875000
NODE_12933_length_777_cov_16.961652	317	397	1	9	80	0.1125000
NODE_12933_length_777_cov_16.961652	317	397	7	71	80	0.8875000
NODE_12934_length_777_cov_16.081121	299	379	0	80	80	1.0000000
NODE_12934_length_777_cov_16.081121	352	432	0	80	80	1.0000000
NODE_12935_length_777_cov_13.827434	380	460	50	1	80	0.0125000
NODE_12935_length_777_cov_13.827434	380	460	56	1	80	0.0125000
NODE_12935_length_777_cov_13.827434	380	460	58	2	80	0.0250000
NODE_12935_length_777_cov_13.827434	380	460	60	4	80	0.0500000
NODE_12935_length_777_cov_13.827434	380	460	62	4	80	0.0500000
NODE_12935_length_777_cov_13.827434	380	460	64	1	80	0.0125000
NODE_12935_length_777_cov_13.827434	380	460	66	1	80	0.0125000
NODE_12935_length_777_cov_13.827434	380	460	70	2	80	0.0250000
NODE_12935_length_777_cov_13.827434	380	460	74	1	80	0.0125000
NODE_12935_length_777_cov_13.827434	380	460	76	10	80	0.1250000
NODE_12935_length_777_cov_13.827434	380	460	77	6	80	0.0750000
NODE_12935_length_777_cov_13.827434	380	460	78	17	80	0.2125000
NODE_12935_length_777_cov_13.827434	380	460	79	15	80	0.1875000
NODE_12935_length_777_cov_13.827434	380	460	80	12	80	0.1500000
NODE_12935_length_777_cov_13.827434	380	460	81	2	80	0.0250000
NODE_12935_length_777_cov_13.827434	380	460	85	1	80	0.0125000
NODE_12935_length_777_cov_13.827434	433	513	12	7	80	0.0875000
NODE_12935_length_777_cov_13.827434	433	513	18	2	80	0.0250000
NODE_12935_length_777_cov_13.827434	433	513	19	1	80	0.0125000
NODE_12935_length_777_cov_13.827434	433	513	20	6	80	0.0750000
NODE_12935_length_777_cov_13.827434	433	513	23	3	80	0.0375000
NODE_12935_length_777_cov_13.827434	433	513	26	5	80	0.0625000
NODE_12935_length_777_cov_13.827434	433	513	29	4	80	0.0500000
NODE_12935_length_777_cov_13.827434	433	513	31	2	80	0.0250000
NODE_12935_length_777_cov_13.827434	433	513	32	4	80	0.0500000
NODE_12935_length_777_cov_13.827434	433	513	34	2	80	0.0250000
NODE_12935_length_777_cov_13.827434	433	513	36	3	80	0.0375000
NODE_12935_length_777_cov_13.827434	433	513	38	2	80	0.0250000
NODE_12935_length_777_cov_13.827434	433	513	40	1	80	0.0125000
NODE_12935_length_777_cov_13.827434	433	513	46	2	80	0.0250000
NODE_12935_length_777_cov_13.827434	433	513	47	4	80	0.0500000
NODE_12935_length_777_cov_13.827434	433	513	50	6	80	0.0750000
NODE_12935_length_777_cov_13.827434	433	513	56	1	80	0.0125000
NODE_12935_length_777_cov_13.827434	433	513	58	2	80	0.0250000
NODE_12935_length_777_cov_13.827434	433	513	60	4	80	0.0500000
NODE_12935_length_777_cov_13.827434	433	513	62	4	80	0.0500000
NODE_12935_length_777_cov_13.827434	433	513	64	1	80	0.0125000
NODE_12935_length_777_cov_13.827434	433	513	66	1	80	0.0125000
NODE_12935_length_777_cov_13.827434	433	513	70	2	80	0.0250000
NODE_12935_length_777_cov_13.827434	433	513	74	1	80	0.0125000
NODE_12935_length_777_cov_13.827434	433	513	76	4	80	0.0500000
NODE_12935_length_777_cov_13.827434	433	513	78	6	80	0.0750000
NODE_12936_length_777_cov_12.497050	413	493	0	27	80	0.3375000
NODE_12936_length_777_cov_12.497050	413	493	2	20	80	0.2500000
NODE_12936_length_777_cov_12.497050	413	493	4	33	80	0.4125000
NODE_12936_length_777_cov_12.497050	466	546	0	80	80	1.0000000
NODE_12937_length_777_cov_10.787611	213	286	0	4	73	0.0547945
NODE_12937_length_777_cov_10.787611	213	286	2	69	73	0.9452055
NODE_12938_length_777_cov_8.530973	362	422	2	60	60	1.0000000
NODE_12939_length_777_cov_7.634218	79	159	0	80	80	1.0000000
NODE_12939_length_777_cov_7.634218	132	212	0	80	80	1.0000000
NODE_12940_length_777_cov_6.963127	256	336	0	80	80	1.0000000
NODE_12940_length_777_cov_6.963127	309	389	0	80	80	1.0000000
NODE_12941_length_777_cov_6.417404	565	638	0	73	73	1.0000000
NODE_12942_length_777_cov_5.868732	443	523	0	80	80	1.0000000
NODE_12942_length_777_cov_5.868732	496	576	0	80	80	1.0000000
NODE_12971_length_776_cov_81.002954	237	317	6	63	80	0.7875000
NODE_12971_length_776_cov_81.002954	237	317	8	3	80	0.0375000
NODE_12971_length_776_cov_81.002954	237	317	14	1	80	0.0125000
NODE_12971_length_776_cov_81.002954	237	317	38	1	80	0.0125000
NODE_12971_length_776_cov_81.002954	237	317	42	1	80	0.0125000
NODE_12971_length_776_cov_81.002954	237	317	47	2	80	0.0250000
NODE_12971_length_776_cov_81.002954	237	317	58	1	80	0.0125000
NODE_12971_length_776_cov_81.002954	237	317	69	1	80	0.0125000
NODE_12971_length_776_cov_81.002954	237	317	78	1	80	0.0125000
NODE_12971_length_776_cov_81.002954	237	317	91	1	80	0.0125000
NODE_12971_length_776_cov_81.002954	237	317	97	1	80	0.0125000
NODE_12971_length_776_cov_81.002954	237	317	103	2	80	0.0250000
NODE_12971_length_776_cov_81.002954	237	317	119	1	80	0.0125000
NODE_12971_length_776_cov_81.002954	237	317	127	1	80	0.0125000
NODE_12971_length_776_cov_81.002954	290	370	0	2	80	0.0250000
NODE_12971_length_776_cov_81.002954	290	370	2	14	80	0.1750000
NODE_12971_length_776_cov_81.002954	290	370	4	1	80	0.0125000
NODE_12971_length_776_cov_81.002954	290	370	6	63	80	0.7875000
NODE_12972_length_776_cov_40.502216	345	425	0	80	80	1.0000000
NODE_12972_length_776_cov_40.502216	398	478	0	80	80	1.0000000
NODE_12973_length_776_cov_34.921713	204	284	0	51	80	0.6375000
NODE_12973_length_776_cov_34.921713	204	284	2	29	80	0.3625000
NODE_12973_length_776_cov_34.921713	257	337	2	80	80	1.0000000
NODE_12974_length_776_cov_29.998523	177	257	0	13	80	0.1625000
NODE_12974_length_776_cov_29.998523	177	257	2	67	80	0.8375000
NODE_12974_length_776_cov_29.998523	230	310	0	27	80	0.3375000
NODE_12974_length_776_cov_29.998523	230	310	1	5	80	0.0625000
NODE_12974_length_776_cov_29.998523	230	310	2	48	80	0.6000000
NODE_12975_length_776_cov_25.683900	417	497	0	80	80	1.0000000
NODE_12975_length_776_cov_25.683900	470	550	0	80	80	1.0000000
NODE_12976_length_776_cov_22.276219	367	447	1	42	80	0.5250000
NODE_12976_length_776_cov_22.276219	367	447	11	7	80	0.0875000
NODE_12976_length_776_cov_22.276219	367	447	12	3	80	0.0375000
NODE_12976_length_776_cov_22.276219	367	447	13	28	80	0.3500000
NODE_12976_length_776_cov_22.276219	420	500	12	30	80	0.3750000
NODE_12976_length_776_cov_22.276219	420	500	13	50	80	0.6250000
NODE_12977_length_776_cov_19.574594	242	322	0	80	80	1.0000000
NODE_12977_length_776_cov_19.574594	295	375	0	80	80	1.0000000
NODE_12978_length_776_cov_18.262925	384	464	0	9	80	0.1125000
NODE_12978_length_776_cov_18.262925	384	464	6	52	80	0.6500000
NODE_12978_length_776_cov_18.262925	384	464	10	19	80	0.2375000
NODE_12978_length_776_cov_18.262925	437	517	0	2	80	0.0250000
NODE_12978_length_776_cov_18.262925	437	517	4	24	80	0.3000000
NODE_12978_length_776_cov_18.262925	437	517	6	8	80	0.1000000
NODE_12978_length_776_cov_18.262925	437	517	10	46	80	0.5750000
NODE_12979_length_776_cov_16.023634	334	414	0	54	80	0.6750000
NODE_12979_length_776_cov_16.023634	334	414	2	26	80	0.3250000
NODE_12979_length_776_cov_16.023634	387	467	0	80	80	1.0000000
NODE_12980_length_776_cov_15.841950	282	362	0	17	80	0.2125000
NODE_12980_length_776_cov_15.841950	282	362	2	63	80	0.7875000
NODE_12980_length_776_cov_15.841950	335	415	0	30	80	0.3750000
NODE_12980_length_776_cov_15.841950	335	415	2	50	80	0.6250000
NODE_12981_length_776_cov_14.131462	240	320	0	80	80	1.0000000
NODE_12981_length_776_cov_14.131462	293	373	0	80	80	1.0000000
NODE_12981_length_776_cov_14.131462	369	449	0	80	80	1.0000000
NODE_12981_length_776_cov_14.131462	422	502	0	80	80	1.0000000
NODE_12983_length_776_cov_13.890694	302	382	0	80	80	1.0000000
NODE_12983_length_776_cov_13.890694	355	435	0	80	80	1.0000000
NODE_12984_length_776_cov_12.097489	488	568	0	21	80	0.2625000
NODE_12984_length_776_cov_12.097489	488	568	2	59	80	0.7375000
NODE_12984_length_776_cov_12.097489	541	621	0	74	80	0.9250000
NODE_12984_length_776_cov_12.097489	541	621	2	6	80	0.0750000
NODE_12985_length_776_cov_11.923191	422	498	0	76	76	1.0000000
NODE_12985_length_776_cov_11.923191	475	551	0	76	76	1.0000000
NODE_12986_length_776_cov_11.163959	312	392	0	60	80	0.7500000
NODE_12986_length_776_cov_11.163959	312	392	3	1	80	0.0125000
NODE_12986_length_776_cov_11.163959	312	392	4	19	80	0.2375000
NODE_12986_length_776_cov_11.163959	365	445	0	7	80	0.0875000
NODE_12986_length_776_cov_11.163959	365	445	3	1	80	0.0125000
NODE_12986_length_776_cov_11.163959	365	445	4	44	80	0.5500000
NODE_12986_length_776_cov_11.163959	365	445	6	28	80	0.3500000
NODE_12987_length_776_cov_9.754801	370	450	0	7	80	0.0875000
NODE_12987_length_776_cov_9.754801	370	450	2	17	80	0.2125000
NODE_12987_length_776_cov_9.754801	370	450	4	56	80	0.7000000
NODE_12987_length_776_cov_9.754801	423	503	0	60	80	0.7500000
NODE_12987_length_776_cov_9.754801	423	503	2	9	80	0.1125000
NODE_12987_length_776_cov_9.754801	423	503	4	11	80	0.1375000
NODE_12989_length_776_cov_8.271787	332	412	0	48	80	0.6000000
NODE_12989_length_776_cov_8.271787	332	412	2	32	80	0.4000000
NODE_12989_length_776_cov_8.271787	385	465	2	80	80	1.0000000
NODE_12990_length_776_cov_4.874446	330	410	0	80	80	1.0000000
NODE_12990_length_776_cov_4.874446	383	463	0	80	80	1.0000000
NODE_13022_length_775_cov_33.612426	372	452	10	80	80	1.0000000
NODE_13022_length_775_cov_33.612426	425	505	0	3	80	0.0375000
NODE_13022_length_775_cov_33.612426	425	505	2	32	80	0.4000000
NODE_13022_length_775_cov_33.612426	425	505	10	45	80	0.5625000
NODE_13023_length_775_cov_25.500000	361	434	0	24	73	0.3287671
NODE_13023_length_775_cov_25.500000	361	434	6	49	73	0.6712329
NODE_13023_length_775_cov_25.500000	413	487	0	30	74	0.4054054
NODE_13023_length_775_cov_25.500000	413	487	6	44	74	0.5945946
NODE_13024_length_775_cov_24.128698	220	300	0	80	80	1.0000000
NODE_13024_length_775_cov_24.128698	273	353	0	80	80	1.0000000
NODE_13026_length_775_cov_16.165680	358	438	0	80	80	1.0000000
NODE_13026_length_775_cov_16.165680	411	491	0	80	80	1.0000000
NODE_13027_length_775_cov_8.522189	440	520	6	6	80	0.0750000
NODE_13027_length_775_cov_8.522189	440	520	8	1	80	0.0125000
NODE_13027_length_775_cov_8.522189	440	520	10	6	80	0.0750000
NODE_13027_length_775_cov_8.522189	440	520	18	4	80	0.0500000
NODE_13027_length_775_cov_8.522189	440	520	20	1	80	0.0125000
NODE_13027_length_775_cov_8.522189	440	520	22	62	80	0.7750000
NODE_13027_length_775_cov_8.522189	493	573	0	28	80	0.3500000
NODE_13027_length_775_cov_8.522189	493	573	10	3	80	0.0375000
NODE_13027_length_775_cov_8.522189	493	573	12	5	80	0.0625000
NODE_13027_length_775_cov_8.522189	493	573	14	3	80	0.0375000
NODE_13027_length_775_cov_8.522189	493	573	16	12	80	0.1500000
NODE_13027_length_775_cov_8.522189	493	573	20	1	80	0.0125000
NODE_13027_length_775_cov_8.522189	493	573	22	28	80	0.3500000
NODE_13028_length_775_cov_8.258876	247	327	0	80	80	1.0000000
NODE_13028_length_775_cov_8.258876	300	380	0	80	80	1.0000000
NODE_13031_length_775_cov_3.786982	299	379	6	20	80	0.2500000
NODE_13031_length_775_cov_3.786982	299	379	10	50	80	0.6250000
NODE_13031_length_775_cov_3.786982	299	379	14	10	80	0.1250000
NODE_13031_length_775_cov_3.786982	352	432	4	5	80	0.0625000
NODE_13031_length_775_cov_3.786982	352	432	8	11	80	0.1375000
NODE_13031_length_775_cov_3.786982	352	432	10	17	80	0.2125000
NODE_13031_length_775_cov_3.786982	352	432	11	2	80	0.0250000
NODE_13031_length_775_cov_3.786982	352	432	14	45	80	0.5625000
NODE_13059_length_774_cov_27.386667	433	514	0	78	81	0.9629630
NODE_13059_length_774_cov_27.386667	433	514	6	3	81	0.0370370
NODE_13059_length_774_cov_27.386667	487	567	0	24	80	0.3000000
NODE_13059_length_774_cov_27.386667	487	567	6	56	80	0.7000000
NODE_13060_length_774_cov_19.721481	239	319	0	80	80	1.0000000
NODE_13060_length_774_cov_19.721481	292	372	0	46	80	0.5750000
NODE_13060_length_774_cov_19.721481	292	372	2	34	80	0.4250000
NODE_13063_length_774_cov_4.594074	216	294	0	41	78	0.5256410
NODE_13063_length_774_cov_4.594074	216	294	6	37	78	0.4743590
NODE_13063_length_774_cov_4.594074	269	347	4	3	78	0.0384615
NODE_13063_length_774_cov_4.594074	269	347	6	62	78	0.7948718
NODE_13063_length_774_cov_4.594074	269	347	10	13	78	0.1666667
NODE_13063_length_774_cov_4.594074	405	485	0	17	80	0.2125000
NODE_13063_length_774_cov_4.594074	405	485	4	63	80	0.7875000
NODE_13103_length_773_cov_60.566766	249	328	2	29	79	0.3670886
NODE_13103_length_773_cov_60.566766	249	328	6	28	79	0.3544304
NODE_13103_length_773_cov_60.566766	249	328	8	5	79	0.0632911
NODE_13103_length_773_cov_60.566766	249	328	10	17	79	0.2151899
NODE_13103_length_773_cov_60.566766	304	381	6	2	77	0.0259740
NODE_13103_length_773_cov_60.566766	304	381	8	58	77	0.7532467
NODE_13103_length_773_cov_60.566766	304	381	10	17	77	0.2207792
NODE_13104_length_773_cov_27.299703	230	310	0	80	80	1.0000000
NODE_13104_length_773_cov_27.299703	283	363	0	80	80	1.0000000
NODE_13105_length_773_cov_24.250742	392	470	0	32	78	0.4102564
NODE_13105_length_773_cov_24.250742	392	470	4	46	78	0.5897436
NODE_13105_length_773_cov_24.250742	443	523	4	80	80	1.0000000
NODE_13106_length_773_cov_20.683976	367	447	0	22	80	0.2750000
NODE_13106_length_773_cov_20.683976	367	447	2	7	80	0.0875000
NODE_13106_length_773_cov_20.683976	367	447	4	32	80	0.4000000
NODE_13106_length_773_cov_20.683976	367	447	6	19	80	0.2375000
NODE_13106_length_773_cov_20.683976	420	500	0	75	80	0.9375000
NODE_13106_length_773_cov_20.683976	420	500	2	5	80	0.0625000
NODE_13107_length_773_cov_18.498516	248	328	0	58	80	0.7250000
NODE_13107_length_773_cov_18.498516	248	328	2	22	80	0.2750000
NODE_13107_length_773_cov_18.498516	301	381	0	7	80	0.0875000
NODE_13107_length_773_cov_18.498516	301	381	2	73	80	0.9125000
NODE_13108_length_773_cov_14.063798	405	485	0	80	80	1.0000000
NODE_13108_length_773_cov_14.063798	458	538	0	80	80	1.0000000
NODE_13109_length_773_cov_12.482196	421	501	0	80	80	1.0000000
NODE_13109_length_773_cov_12.482196	474	554	0	80	80	1.0000000
NODE_13114_length_773_cov_9.136499	214	294	0	7	80	0.0875000
NODE_13114_length_773_cov_9.136499	214	294	2	73	80	0.9125000
NODE_13114_length_773_cov_9.136499	267	347	0	9	80	0.1125000
NODE_13114_length_773_cov_9.136499	267	347	2	71	80	0.8875000
NODE_13115_length_773_cov_8.609792	461	541	0	80	80	1.0000000
NODE_13115_length_773_cov_8.609792	514	594	0	80	80	1.0000000
NODE_13116_length_773_cov_7.224036	200	280	0	80	80	1.0000000
NODE_13116_length_773_cov_7.224036	253	333	0	27	80	0.3375000
NODE_13116_length_773_cov_7.224036	253	333	2	46	80	0.5750000
NODE_13116_length_773_cov_7.224036	253	333	4	7	80	0.0875000
NODE_13117_length_773_cov_6.910979	522	615	0	93	93	1.0000000
NODE_13117_length_773_cov_6.910979	588	668	0	80	80	1.0000000
NODE_13147_length_772_cov_28.044577	231	311	0	80	80	1.0000000
NODE_13147_length_772_cov_28.044577	284	364	0	80	80	1.0000000
NODE_13149_length_772_cov_9.523031	288	368	0	80	80	1.0000000
NODE_13149_length_772_cov_9.523031	341	421	0	80	80	1.0000000
NODE_13150_length_772_cov_8.778603	133	213	0	80	80	1.0000000
NODE_13150_length_772_cov_8.778603	186	266	0	80	80	1.0000000
NODE_13151_length_772_cov_7.921248	351	431	0	14	80	0.1750000
NODE_13151_length_772_cov_7.921248	351	431	2	66	80	0.8250000
NODE_13151_length_772_cov_7.921248	404	480	0	47	76	0.6184211
NODE_13151_length_772_cov_7.921248	404	480	2	29	76	0.3815790
NODE_13152_length_772_cov_7.059435	276	356	0	44	80	0.5500000
NODE_13152_length_772_cov_7.059435	276	356	2	36	80	0.4500000
NODE_13152_length_772_cov_7.059435	329	409	2	80	80	1.0000000
NODE_13153_length_772_cov_5.536404	269	299	0	30	30	1.0000000
NODE_13153_length_772_cov_5.536404	272	341	0	68	69	0.9855072
NODE_13153_length_772_cov_5.536404	272	341	4	1	69	0.0144928
NODE_13156_length_772_cov_4.838039	430	510	0	27	80	0.3375000
NODE_13156_length_772_cov_4.838039	430	510	2	53	80	0.6625000
NODE_13156_length_772_cov_4.838039	483	563	0	80	80	1.0000000
NODE_13162_length_772_cov_3.041605	339	419	0	80	80	1.0000000
NODE_13162_length_772_cov_3.041605	392	472	0	80	80	1.0000000
NODE_13195_length_771_cov_36.729167	223	304	0	81	81	1.0000000
NODE_13195_length_771_cov_36.729167	277	357	0	80	80	1.0000000
NODE_13195_length_771_cov_36.729167	353	434	0	81	81	1.0000000
NODE_13195_length_771_cov_36.729167	407	487	0	80	80	1.0000000
NODE_13196_length_771_cov_28.903274	337	417	0	6	80	0.0750000
NODE_13196_length_771_cov_28.903274	337	417	4	74	80	0.9250000
NODE_13196_length_771_cov_28.903274	390	470	0	59	80	0.7375000
NODE_13196_length_771_cov_28.903274	390	470	4	21	80	0.2625000
NODE_13197_length_771_cov_28.165179	453	533	0	80	80	1.0000000
NODE_13197_length_771_cov_28.165179	506	586	0	80	80	1.0000000
NODE_13198_length_771_cov_14.336310	259	339	8	80	80	1.0000000
NODE_13198_length_771_cov_14.336310	312	392	0	42	80	0.5250000
NODE_13198_length_771_cov_14.336310	312	392	4	7	80	0.0875000
NODE_13198_length_771_cov_14.336310	312	392	8	31	80	0.3875000
NODE_13199_length_771_cov_13.592262	428	508	0	80	80	1.0000000
NODE_13199_length_771_cov_13.592262	481	561	0	80	80	1.0000000
NODE_13200_length_771_cov_12.226190	407	487	0	80	80	1.0000000
NODE_13200_length_771_cov_12.226190	460	540	0	80	80	1.0000000
NODE_13201_length_771_cov_11.188988	348	428	0	80	80	1.0000000
NODE_13201_length_771_cov_11.188988	401	481	0	70	80	0.8750000
NODE_13201_length_771_cov_11.188988	401	481	2	10	80	0.1250000
NODE_13202_length_771_cov_10.525298	171	251	4	9	80	0.1125000
NODE_13202_length_771_cov_10.525298	171	251	8	53	80	0.6625000
NODE_13202_length_771_cov_10.525298	171	251	10	18	80	0.2250000
NODE_13202_length_771_cov_10.525298	224	304	6	8	80	0.1000000
NODE_13202_length_771_cov_10.525298	224	304	8	9	80	0.1125000
NODE_13202_length_771_cov_10.525298	224	304	10	63	80	0.7875000
NODE_13207_length_771_cov_3.357143	238	318	0	10	80	0.1250000
NODE_13207_length_771_cov_3.357143	238	318	2	52	80	0.6500000
NODE_13207_length_771_cov_3.357143	238	318	4	18	80	0.2250000
NODE_13207_length_771_cov_3.357143	291	371	0	8	80	0.1000000
NODE_13207_length_771_cov_3.357143	291	371	2	72	80	0.9000000
NODE_13209_length_771_cov_3.129464	476	518	0	42	42	1.0000000
NODE_13238_length_770_cov_45.312966	212	292	0	80	80	1.0000000
NODE_13238_length_770_cov_45.312966	265	345	0	80	80	1.0000000
NODE_13239_length_770_cov_23.153502	348	428	0	13	80	0.1625000
NODE_13239_length_770_cov_23.153502	348	428	2	67	80	0.8375000
NODE_13239_length_770_cov_23.153502	401	481	0	66	80	0.8250000
NODE_13239_length_770_cov_23.153502	401	481	2	14	80	0.1750000
NODE_13240_length_770_cov_22.463487	340	420	0	4	80	0.0500000
NODE_13240_length_770_cov_22.463487	340	420	1	2	80	0.0250000
NODE_13240_length_770_cov_22.463487	340	420	3	59	80	0.7375000
NODE_13240_length_770_cov_22.463487	340	420	5	15	80	0.1875000
NODE_13240_length_770_cov_22.463487	393	473	3	45	80	0.5625000
NODE_13240_length_770_cov_22.463487	393	473	5	35	80	0.4375000
NODE_13241_length_770_cov_18.594635	335	416	0	35	81	0.4320988
NODE_13241_length_770_cov_18.594635	335	416	2	46	81	0.5679013
NODE_13241_length_770_cov_18.594635	389	469	0	80	80	1.0000000
NODE_13242_length_770_cov_18.092399	292	372	0	62	80	0.7750000
NODE_13242_length_770_cov_18.092399	292	372	4	18	80	0.2250000
NODE_13242_length_770_cov_18.092399	345	425	0	12	80	0.1500000
NODE_13242_length_770_cov_18.092399	345	425	4	68	80	0.8500000
NODE_13243_length_770_cov_7.064083	294	374	0	54	80	0.6750000
NODE_13243_length_770_cov_7.064083	294	374	2	26	80	0.3250000
NODE_13243_length_770_cov_7.064083	347	426	0	6	79	0.0759494
NODE_13243_length_770_cov_7.064083	347	426	2	73	79	0.9240506
NODE_13246_length_770_cov_5.184799	341	421	0	1	80	0.0125000
NODE_13246_length_770_cov_5.184799	341	421	2	79	80	0.9875000
NODE_13246_length_770_cov_5.184799	394	474	0	54	80	0.6750000
NODE_13246_length_770_cov_5.184799	394	474	2	26	80	0.3250000
NODE_13250_length_770_cov_4.120715	325	405	0	80	80	1.0000000
NODE_13250_length_770_cov_4.120715	378	458	0	80	80	1.0000000
NODE_13272_length_769_cov_11.008955	355	435	4	21	80	0.2625000
NODE_13272_length_769_cov_11.008955	355	435	6	10	80	0.1250000
NODE_13272_length_769_cov_11.008955	355	435	10	2	80	0.0250000
NODE_13272_length_769_cov_11.008955	355	435	14	4	80	0.0500000
NODE_13272_length_769_cov_11.008955	355	435	15	2	80	0.0250000
NODE_13272_length_769_cov_11.008955	355	435	18	41	80	0.5125000
NODE_13272_length_769_cov_11.008955	408	488	4	14	80	0.1750000
NODE_13272_length_769_cov_11.008955	408	488	8	11	80	0.1375000
NODE_13272_length_769_cov_11.008955	408	488	11	9	80	0.1125000
NODE_13272_length_769_cov_11.008955	408	488	15	21	80	0.2625000
NODE_13272_length_769_cov_11.008955	408	488	18	25	80	0.3125000
NODE_13274_length_769_cov_9.077612	263	343	0	29	80	0.3625000
NODE_13274_length_769_cov_9.077612	263	343	2	7	80	0.0875000
NODE_13274_length_769_cov_9.077612	263	343	4	21	80	0.2625000
NODE_13274_length_769_cov_9.077612	263	343	6	6	80	0.0750000
NODE_13274_length_769_cov_9.077612	263	343	8	17	80	0.2125000
NODE_13274_length_769_cov_9.077612	316	396	4	4	80	0.0500000
NODE_13274_length_769_cov_9.077612	316	396	6	22	80	0.2750000
NODE_13274_length_769_cov_9.077612	316	396	7	9	80	0.1125000
NODE_13274_length_769_cov_9.077612	316	396	8	40	80	0.5000000
NODE_13274_length_769_cov_9.077612	316	396	9	5	80	0.0625000
NODE_13275_length_769_cov_7.034328	289	367	0	78	78	1.0000000
NODE_13275_length_769_cov_7.034328	340	420	0	80	80	1.0000000
NODE_13307_length_769_cov_1.262687	620	668	0	48	48	1.0000000
NODE_13316_length_768_cov_19.195815	266	346	2	80	80	1.0000000
NODE_13316_length_768_cov_19.195815	319	399	0	50	80	0.6250000
NODE_13316_length_768_cov_19.195815	319	399	2	30	80	0.3750000
NODE_13316_length_768_cov_19.195815	395	475	0	80	80	1.0000000
NODE_13316_length_768_cov_19.195815	448	528	0	80	80	1.0000000
NODE_13317_length_768_cov_16.420030	246	326	0	80	80	1.0000000
NODE_13317_length_768_cov_16.420030	299	379	0	80	80	1.0000000
NODE_13318_length_768_cov_14.508221	309	389	0	80	80	1.0000000
NODE_13318_length_768_cov_14.508221	362	442	0	80	80	1.0000000
NODE_13319_length_768_cov_11.635277	309	389	0	63	80	0.7875000
NODE_13319_length_768_cov_11.635277	309	389	2	7	80	0.0875000
NODE_13319_length_768_cov_11.635277	309	389	4	10	80	0.1250000
NODE_13319_length_768_cov_11.635277	362	442	0	10	80	0.1250000
NODE_13319_length_768_cov_11.635277	362	442	2	13	80	0.1625000
NODE_13319_length_768_cov_11.635277	362	442	4	57	80	0.7125000
NODE_13321_length_768_cov_9.064275	392	472	0	80	80	1.0000000
NODE_13321_length_768_cov_9.064275	445	525	0	80	80	1.0000000
NODE_13324_length_768_cov_3.605381	512	592	0	80	80	1.0000000
NODE_13324_length_768_cov_3.605381	565	645	0	80	80	1.0000000
NODE_13354_length_767_cov_38.161677	28	108	10	3	80	0.0375000
NODE_13354_length_767_cov_38.161677	28	108	16	5	80	0.0625000
NODE_13354_length_767_cov_38.161677	28	108	18	1	80	0.0125000
NODE_13354_length_767_cov_38.161677	28	108	20	1	80	0.0125000
NODE_13354_length_767_cov_38.161677	28	108	24	70	80	0.8750000
NODE_13354_length_767_cov_38.161677	254	334	0	35	80	0.4375000
NODE_13354_length_767_cov_38.161677	254	334	2	45	80	0.5625000
NODE_13354_length_767_cov_38.161677	307	387	0	73	80	0.9125000
NODE_13354_length_767_cov_38.161677	307	387	2	7	80	0.0875000
NODE_13355_length_767_cov_24.107784	279	359	0	80	80	1.0000000
NODE_13355_length_767_cov_24.107784	332	412	0	80	80	1.0000000
NODE_13356_length_767_cov_22.823353	286	366	0	80	80	1.0000000
NODE_13356_length_767_cov_22.823353	339	419	0	80	80	1.0000000
NODE_13357_length_767_cov_20.898204	312	392	3	21	80	0.2625000
NODE_13357_length_767_cov_20.898204	312	392	4	59	80	0.7375000
NODE_13357_length_767_cov_20.898204	365	445	2	48	80	0.6000000
NODE_13357_length_767_cov_20.898204	365	445	3	22	80	0.2750000
NODE_13357_length_767_cov_20.898204	365	445	4	6	80	0.0750000
NODE_13357_length_767_cov_20.898204	365	445	5	4	80	0.0500000
NODE_13358_length_767_cov_20.058383	357	439	0	82	82	1.0000000
NODE_13358_length_767_cov_20.058383	410	490	0	80	80	1.0000000
NODE_13359_length_767_cov_20.020958	191	271	0	25	80	0.3125000
NODE_13359_length_767_cov_20.020958	191	271	2	55	80	0.6875000
NODE_13359_length_767_cov_20.020958	244	324	0	78	80	0.9750000
NODE_13359_length_767_cov_20.020958	244	324	2	2	80	0.0250000
NODE_13360_length_767_cov_18.687126	270	350	0	20	80	0.2500000
NODE_13360_length_767_cov_18.687126	270	350	2	60	80	0.7500000
NODE_13360_length_767_cov_18.687126	323	403	0	34	80	0.4250000
NODE_13360_length_767_cov_18.687126	323	403	2	46	80	0.5750000
NODE_13362_length_767_cov_13.323353	45	125	0	45	80	0.5625000
NODE_13362_length_767_cov_13.323353	45	125	2	35	80	0.4375000
NODE_13362_length_767_cov_13.323353	98	178	2	80	80	1.0000000
NODE_13366_length_767_cov_8.787425	377	447	0	35	70	0.5000000
NODE_13366_length_767_cov_8.787425	377	447	2	35	70	0.5000000
NODE_13366_length_767_cov_8.787425	420	500	2	80	80	1.0000000
NODE_13367_length_767_cov_7.206587	306	386	0	80	80	1.0000000
NODE_13367_length_767_cov_7.206587	359	440	0	81	81	1.0000000
NODE_13403_length_766_cov_59.388306	322	402	0	41	80	0.5125000
NODE_13403_length_766_cov_59.388306	322	402	2	39	80	0.4875000
NODE_13403_length_766_cov_59.388306	375	455	0	80	80	1.0000000
NODE_13403_length_766_cov_59.388306	451	531	0	80	80	1.0000000
NODE_13403_length_766_cov_59.388306	504	584	0	80	80	1.0000000
NODE_13404_length_766_cov_23.361319	308	388	0	80	80	1.0000000
NODE_13404_length_766_cov_23.361319	361	441	0	80	80	1.0000000
NODE_13405_length_766_cov_22.751124	229	309	2	80	80	1.0000000
NODE_13405_length_766_cov_22.751124	282	362	0	5	80	0.0625000
NODE_13405_length_766_cov_22.751124	282	362	2	30	80	0.3750000
NODE_13405_length_766_cov_22.751124	282	362	4	45	80	0.5625000
NODE_13406_length_766_cov_20.011994	285	363	4	50	78	0.6410257
NODE_13406_length_766_cov_20.011994	285	363	5	1	78	0.0128205
NODE_13406_length_766_cov_20.011994	285	363	6	27	78	0.3461539
NODE_13406_length_766_cov_20.011994	336	416	4	80	80	1.0000000
NODE_13407_length_766_cov_18.685157	288	368	2	80	80	1.0000000
NODE_13407_length_766_cov_18.685157	341	421	2	40	80	0.5000000
NODE_13407_length_766_cov_18.685157	341	421	4	40	80	0.5000000
NODE_13408_length_766_cov_13.131934	271	351	0	80	80	1.0000000
NODE_13408_length_766_cov_13.131934	324	404	0	80	80	1.0000000
NODE_13410_length_766_cov_9.479760	274	354	0	1	80	0.0125000
NODE_13410_length_766_cov_9.479760	274	354	1	49	80	0.6125000
NODE_13410_length_766_cov_9.479760	274	354	2	30	80	0.3750000
NODE_13410_length_766_cov_9.479760	327	407	0	54	80	0.6750000
NODE_13410_length_766_cov_9.479760	327	407	1	26	80	0.3250000
NODE_13415_length_766_cov_4.500750	333	413	0	17	80	0.2125000
NODE_13415_length_766_cov_4.500750	333	413	2	63	80	0.7875000
NODE_13415_length_766_cov_4.500750	369	404	2	35	35	1.0000000
NODE_13415_length_766_cov_4.500750	371	413	2	42	42	1.0000000
NODE_13415_length_766_cov_4.500750	397	466	0	10	69	0.1449275
NODE_13415_length_766_cov_4.500750	397	466	2	59	69	0.8550724
NODE_13447_length_765_cov_92.851351	16	96	16	17	80	0.2125000
NODE_13447_length_765_cov_92.851351	16	96	18	8	80	0.1000000
NODE_13447_length_765_cov_92.851351	16	96	22	11	80	0.1375000
NODE_13447_length_765_cov_92.851351	16	96	26	3	80	0.0375000
NODE_13447_length_765_cov_92.851351	16	96	28	4	80	0.0500000
NODE_13447_length_765_cov_92.851351	16	96	30	5	80	0.0625000
NODE_13447_length_765_cov_92.851351	16	96	32	1	80	0.0125000
NODE_13447_length_765_cov_92.851351	16	96	34	3	80	0.0375000
NODE_13447_length_765_cov_92.851351	16	96	38	1	80	0.0125000
NODE_13447_length_765_cov_92.851351	16	96	40	9	80	0.1125000
NODE_13447_length_765_cov_92.851351	16	96	42	2	80	0.0250000
NODE_13447_length_765_cov_92.851351	16	96	44	8	80	0.1000000
NODE_13447_length_765_cov_92.851351	16	96	46	8	80	0.1000000
NODE_13448_length_765_cov_36.345345	504	584	0	80	80	1.0000000
NODE_13448_length_765_cov_36.345345	557	637	0	80	80	1.0000000
NODE_13449_length_765_cov_27.334835	370	450	0	10	80	0.1250000
NODE_13449_length_765_cov_27.334835	370	450	4	11	80	0.1375000
NODE_13449_length_765_cov_27.334835	370	450	10	59	80	0.7375000
NODE_13449_length_765_cov_27.334835	423	503	0	63	80	0.7875000
NODE_13449_length_765_cov_27.334835	423	503	4	11	80	0.1375000
NODE_13449_length_765_cov_27.334835	423	503	10	6	80	0.0750000
NODE_13450_length_765_cov_23.355856	251	331	0	80	80	1.0000000
NODE_13450_length_765_cov_23.355856	304	384	0	80	80	1.0000000
NODE_13450_length_765_cov_23.355856	380	460	0	80	80	1.0000000
NODE_13450_length_765_cov_23.355856	433	506	0	73	73	1.0000000
NODE_13451_length_765_cov_23.322823	256	336	0	7	80	0.0875000
NODE_13451_length_765_cov_23.322823	256	336	2	73	80	0.9125000
NODE_13451_length_765_cov_23.322823	309	389	0	50	80	0.6250000
NODE_13451_length_765_cov_23.322823	309	389	2	30	80	0.3750000
NODE_13452_length_765_cov_21.741742	379	452	0	73	73	1.0000000
NODE_13452_length_765_cov_21.741742	425	505	0	80	80	1.0000000
NODE_13453_length_765_cov_14.253754	450	530	4	35	80	0.4375000
NODE_13453_length_765_cov_14.253754	450	530	6	9	80	0.1125000
NODE_13453_length_765_cov_14.253754	450	530	8	36	80	0.4500000
NODE_13453_length_765_cov_14.253754	503	583	0	15	80	0.1875000
NODE_13453_length_765_cov_14.253754	503	583	2	27	80	0.3375000
NODE_13453_length_765_cov_14.253754	503	583	4	38	80	0.4750000
NODE_13454_length_765_cov_13.627628	313	393	0	80	80	1.0000000
NODE_13454_length_765_cov_13.627628	366	446	0	80	80	1.0000000
NODE_13455_length_765_cov_5.561562	319	349	0	30	30	1.0000000
NODE_13458_length_765_cov_4.367868	433	513	0	80	80	1.0000000
NODE_13458_length_765_cov_4.367868	486	566	0	80	80	1.0000000
NODE_13483_length_764_cov_30.096241	436	516	4	80	80	1.0000000
NODE_13483_length_764_cov_30.096241	489	569	0	47	80	0.5875000
NODE_13483_length_764_cov_30.096241	489	569	4	33	80	0.4125000
NODE_13484_length_764_cov_29.218045	304	384	0	1	80	0.0125000
NODE_13484_length_764_cov_29.218045	304	384	2	79	80	0.9875000
NODE_13484_length_764_cov_29.218045	357	437	0	9	80	0.1125000
NODE_13484_length_764_cov_29.218045	357	437	2	71	80	0.8875000
NODE_13485_length_764_cov_25.951880	421	501	0	80	80	1.0000000
NODE_13485_length_764_cov_25.951880	474	554	0	80	80	1.0000000
NODE_13486_length_764_cov_23.590977	204	284	0	12	80	0.1500000
NODE_13486_length_764_cov_23.590977	204	284	2	68	80	0.8500000
NODE_13486_length_764_cov_23.590977	257	337	0	65	80	0.8125000
NODE_13486_length_764_cov_23.590977	257	337	2	15	80	0.1875000
NODE_13488_length_764_cov_6.804511	281	361	0	80	80	1.0000000
NODE_13488_length_764_cov_6.804511	334	414	0	80	80	1.0000000
NODE_13489_length_764_cov_6.700752	392	458	2	66	66	1.0000000
NODE_13508_length_764_cov_1.171429	475	537	0	62	62	1.0000000
NODE_13520_length_763_cov_28.807229	311	391	0	69	80	0.8625000
NODE_13520_length_763_cov_28.807229	311	391	2	11	80	0.1375000
NODE_13520_length_763_cov_28.807229	364	444	0	80	80	1.0000000
NODE_13521_length_763_cov_25.299699	598	673	0	75	75	1.0000000
NODE_13521_length_763_cov_25.299699	598	678	0	80	80	1.0000000
NODE_13521_length_763_cov_25.299699	605	675	0	70	70	1.0000000
NODE_13521_length_763_cov_25.299699	607	678	0	71	71	1.0000000
NODE_13521_length_763_cov_25.299699	651	731	0	80	80	1.0000000
NODE_13521_length_763_cov_25.299699	651	731	0	80	80	1.0000000
NODE_13521_length_763_cov_25.299699	651	731	0	80	80	1.0000000
NODE_13521_length_763_cov_25.299699	651	731	0	80	80	1.0000000
NODE_13522_length_763_cov_12.887048	336	416	0	80	80	1.0000000
NODE_13522_length_763_cov_12.887048	389	469	0	80	80	1.0000000
NODE_13523_length_763_cov_11.599398	547	627	0	64	80	0.8000000
NODE_13523_length_763_cov_11.599398	547	627	1	16	80	0.2000000
NODE_13523_length_763_cov_11.599398	600	680	0	80	80	1.0000000
NODE_13524_length_763_cov_9.378012	297	377	0	80	80	1.0000000
NODE_13524_length_763_cov_9.378012	350	430	0	80	80	1.0000000
NODE_13526_length_763_cov_7.246988	368	448	0	80	80	1.0000000
NODE_13526_length_763_cov_7.246988	421	501	0	80	80	1.0000000
NODE_13527_length_763_cov_6.414157	371	451	0	80	80	1.0000000
NODE_13527_length_763_cov_6.414157	424	504	0	80	80	1.0000000
NODE_13558_length_762_cov_21.236802	368	448	0	9	80	0.1125000
NODE_13558_length_762_cov_21.236802	368	448	1	47	80	0.5875000
NODE_13558_length_762_cov_21.236802	368	448	2	22	80	0.2750000
NODE_13558_length_762_cov_21.236802	368	448	4	2	80	0.0250000
NODE_13558_length_762_cov_21.236802	421	501	1	24	80	0.3000000
NODE_13558_length_762_cov_21.236802	421	501	2	11	80	0.1375000
NODE_13558_length_762_cov_21.236802	421	501	3	25	80	0.3125000
NODE_13558_length_762_cov_21.236802	421	501	4	20	80	0.2500000
NODE_13559_length_762_cov_19.984917	327	407	6	26	80	0.3250000
NODE_13559_length_762_cov_19.984917	327	407	10	54	80	0.6750000
NODE_13559_length_762_cov_19.984917	380	460	0	8	80	0.1000000
NODE_13559_length_762_cov_19.984917	380	460	4	22	80	0.2750000
NODE_13559_length_762_cov_19.984917	380	460	6	21	80	0.2625000
NODE_13559_length_762_cov_19.984917	380	460	10	29	80	0.3625000
NODE_13560_length_762_cov_15.975867	318	398	0	75	80	0.9375000
NODE_13560_length_762_cov_15.975867	318	398	2	5	80	0.0625000
NODE_13560_length_762_cov_15.975867	371	439	0	22	68	0.3235294
NODE_13560_length_762_cov_15.975867	371	439	2	16	68	0.2352941
NODE_13560_length_762_cov_15.975867	371	439	10	30	68	0.4411765
NODE_13561_length_762_cov_12.728507	381	461	0	80	80	1.0000000
NODE_13561_length_762_cov_12.728507	434	514	0	80	80	1.0000000
NODE_13562_length_762_cov_10.078431	277	357	0	80	80	1.0000000
NODE_13562_length_762_cov_10.078431	330	410	0	80	80	1.0000000
NODE_13563_length_762_cov_9.705882	339	419	0	9	80	0.1125000
NODE_13563_length_762_cov_9.705882	339	419	2	71	80	0.8875000
NODE_13563_length_762_cov_9.705882	392	472	0	62	80	0.7750000
NODE_13563_length_762_cov_9.705882	392	472	2	18	80	0.2250000
NODE_13564_length_762_cov_7.276018	316	395	0	38	79	0.4810127
NODE_13564_length_762_cov_7.276018	316	395	4	13	79	0.1645570
NODE_13564_length_762_cov_7.276018	316	395	6	7	79	0.0886076
NODE_13564_length_762_cov_7.276018	316	395	10	21	79	0.2658228
NODE_13564_length_762_cov_7.276018	368	448	6	6	80	0.0750000
NODE_13564_length_762_cov_7.276018	368	448	10	49	80	0.6125000
NODE_13564_length_762_cov_7.276018	368	448	12	16	80	0.2000000
NODE_13564_length_762_cov_7.276018	368	448	14	5	80	0.0625000
NODE_13564_length_762_cov_7.276018	368	448	15	1	80	0.0125000
NODE_13564_length_762_cov_7.276018	368	448	16	3	80	0.0375000
NODE_13565_length_762_cov_6.168929	222	302	0	29	80	0.3625000
NODE_13565_length_762_cov_6.168929	222	302	2	51	80	0.6375000
NODE_13565_length_762_cov_6.168929	275	355	0	12	80	0.1500000
NODE_13565_length_762_cov_6.168929	275	355	2	68	80	0.8500000
NODE_13613_length_761_cov_44.243202	531	582	0	20	51	0.3921569
NODE_13613_length_761_cov_44.243202	531	582	2	31	51	0.6078432
NODE_13614_length_761_cov_38.809668	342	422	20	7	80	0.0875000
NODE_13614_length_761_cov_38.809668	342	422	21	29	80	0.3625000
NODE_13614_length_761_cov_38.809668	342	422	22	44	80	0.5500000
NODE_13614_length_761_cov_38.809668	395	475	2	22	80	0.2750000
NODE_13614_length_761_cov_38.809668	395	475	20	3	80	0.0375000
NODE_13614_length_761_cov_38.809668	395	475	21	1	80	0.0125000
NODE_13614_length_761_cov_38.809668	395	475	22	54	80	0.6750000
NODE_13615_length_761_cov_38.694864	314	394	2	80	80	1.0000000
NODE_13615_length_761_cov_38.694864	367	447	0	40	80	0.5000000
NODE_13615_length_761_cov_38.694864	367	447	2	40	80	0.5000000
NODE_13616_length_761_cov_32.382175	432	512	0	80	80	1.0000000
NODE_13616_length_761_cov_32.382175	485	565	0	80	80	1.0000000
NODE_13617_length_761_cov_31.444109	323	403	0	13	80	0.1625000
NODE_13617_length_761_cov_31.444109	323	403	2	39	80	0.4875000
NODE_13617_length_761_cov_31.444109	323	403	4	3	80	0.0375000
NODE_13617_length_761_cov_31.444109	323	403	6	25	80	0.3125000
NODE_13617_length_761_cov_31.444109	376	467	4	67	91	0.7362638
NODE_13617_length_761_cov_31.444109	376	467	6	24	91	0.2637363
NODE_13618_length_761_cov_14.004532	366	446	0	80	80	1.0000000
NODE_13618_length_761_cov_14.004532	419	499	0	80	80	1.0000000
NODE_13619_length_761_cov_13.287009	336	415	0	18	79	0.2278481
NODE_13619_length_761_cov_13.287009	336	415	2	2	79	0.0253165
NODE_13619_length_761_cov_13.287009	336	415	5	16	79	0.2025317
NODE_13619_length_761_cov_13.287009	336	415	7	16	79	0.2025317
NODE_13619_length_761_cov_13.287009	336	415	9	10	79	0.1265823
NODE_13619_length_761_cov_13.287009	336	415	10	17	79	0.2151899
NODE_13619_length_761_cov_13.287009	388	468	8	23	80	0.2875000
NODE_13619_length_761_cov_13.287009	388	468	9	10	80	0.1250000
NODE_13619_length_761_cov_13.287009	388	468	10	47	80	0.5875000
NODE_13621_length_761_cov_9.654079	274	354	0	80	80	1.0000000
NODE_13621_length_761_cov_9.654079	327	407	0	39	80	0.4875000
NODE_13621_length_761_cov_9.654079	327	407	2	41	80	0.5125000
NODE_13622_length_761_cov_7.306647	308	388	0	80	80	1.0000000
NODE_13622_length_761_cov_7.306647	361	441	0	80	80	1.0000000
NODE_13625_length_761_cov_4.314199	354	434	0	80	80	1.0000000
NODE_13625_length_761_cov_4.314199	407	487	0	80	80	1.0000000
NODE_13658_length_760_cov_48.290469	215	295	0	23	80	0.2875000
NODE_13658_length_760_cov_48.290469	215	295	2	57	80	0.7125000
NODE_13658_length_760_cov_48.290469	268	348	0	76	80	0.9500000
NODE_13658_length_760_cov_48.290469	268	348	2	4	80	0.0500000
NODE_13658_length_760_cov_48.290469	344	424	0	80	80	1.0000000
NODE_13658_length_760_cov_48.290469	397	477	0	80	80	1.0000000
NODE_13659_length_760_cov_28.314675	384	464	0	80	80	1.0000000
NODE_13659_length_760_cov_28.314675	437	517	0	80	80	1.0000000
NODE_13660_length_760_cov_27.981846	432	512	0	78	80	0.9750000
NODE_13660_length_760_cov_27.981846	432	512	1	2	80	0.0250000
NODE_13660_length_760_cov_27.981846	485	565	0	25	80	0.3125000
NODE_13660_length_760_cov_27.981846	485	565	1	55	80	0.6875000
NODE_13661_length_760_cov_17.500756	372	452	0	80	80	1.0000000
NODE_13661_length_760_cov_17.500756	425	505	0	80	80	1.0000000
NODE_13662_length_760_cov_17.420575	183	263	0	25	80	0.3125000
NODE_13662_length_760_cov_17.420575	183	263	2	55	80	0.6875000
NODE_13662_length_760_cov_17.420575	236	316	0	78	80	0.9750000
NODE_13662_length_760_cov_17.420575	236	316	2	2	80	0.0250000
NODE_13663_length_760_cov_13.444781	357	437	0	35	80	0.4375000
NODE_13663_length_760_cov_13.444781	357	437	2	45	80	0.5625000
NODE_13663_length_760_cov_13.444781	410	490	0	13	80	0.1625000
NODE_13663_length_760_cov_13.444781	410	490	2	67	80	0.8375000
NODE_13664_length_760_cov_13.196672	282	362	0	29	80	0.3625000
NODE_13664_length_760_cov_13.196672	282	362	2	51	80	0.6375000
NODE_13664_length_760_cov_13.196672	335	415	0	21	80	0.2625000
NODE_13664_length_760_cov_13.196672	335	415	2	59	80	0.7375000
NODE_13665_length_760_cov_12.692890	295	375	0	80	80	1.0000000
NODE_13665_length_760_cov_12.692890	348	428	0	73	80	0.9125000
NODE_13665_length_760_cov_12.692890	348	428	4	7	80	0.0875000
NODE_13671_length_760_cov_4.282905	388	468	0	47	80	0.5875000
NODE_13671_length_760_cov_4.282905	388	468	1	33	80	0.4125000
NODE_13671_length_760_cov_4.282905	441	521	0	80	80	1.0000000
NODE_13671_length_760_cov_4.282905	517	597	0	80	80	1.0000000
NODE_13683_length_760_cov_1.990923	490	570	0	70	80	0.8750000
NODE_13683_length_760_cov_1.990923	490	570	2	10	80	0.1250000
NODE_13683_length_760_cov_1.990923	543	623	0	17	80	0.2125000
NODE_13683_length_760_cov_1.990923	543	623	2	12	80	0.1500000
NODE_13683_length_760_cov_1.990923	543	623	4	6	80	0.0750000
NODE_13683_length_760_cov_1.990923	543	623	5	13	80	0.1625000
NODE_13683_length_760_cov_1.990923	543	623	7	6	80	0.0750000
NODE_13683_length_760_cov_1.990923	543	623	11	17	80	0.2125000
NODE_13683_length_760_cov_1.990923	543	623	13	9	80	0.1125000
NODE_13709_length_759_cov_24.757576	376	456	0	6	80	0.0750000
NODE_13709_length_759_cov_24.757576	376	456	2	14	80	0.1750000
NODE_13709_length_759_cov_24.757576	376	456	4	60	80	0.7500000
NODE_13709_length_759_cov_24.757576	429	509	0	6	80	0.0750000
NODE_13709_length_759_cov_24.757576	429	509	2	32	80	0.4000000
NODE_13709_length_759_cov_24.757576	429	509	4	42	80	0.5250000
NODE_13710_length_759_cov_14.356061	210	290	0	80	80	1.0000000
NODE_13710_length_759_cov_14.356061	263	343	0	80	80	1.0000000
NODE_13711_length_759_cov_10.956061	328	408	0	30	80	0.3750000
NODE_13711_length_759_cov_10.956061	328	408	2	10	80	0.1250000
NODE_13711_length_759_cov_10.956061	328	408	4	40	80	0.5000000
NODE_13711_length_759_cov_10.956061	381	461	0	80	80	1.0000000
NODE_13712_length_759_cov_10.639394	330	410	6	1	80	0.0125000
NODE_13712_length_759_cov_10.639394	330	410	8	51	80	0.6375000
NODE_13712_length_759_cov_10.639394	330	410	10	17	80	0.2125000
NODE_13712_length_759_cov_10.639394	330	410	14	11	80	0.1375000
NODE_13712_length_759_cov_10.639394	383	463	6	1	80	0.0125000
NODE_13712_length_759_cov_10.639394	383	463	8	16	80	0.2000000
NODE_13712_length_759_cov_10.639394	383	463	9	1	80	0.0125000
NODE_13712_length_759_cov_10.639394	383	463	10	51	80	0.6375000
NODE_13712_length_759_cov_10.639394	383	463	14	11	80	0.1375000
NODE_13713_length_759_cov_9.192424	209	290	11	5	81	0.0617284
NODE_13713_length_759_cov_9.192424	209	290	15	8	81	0.0987654
NODE_13713_length_759_cov_9.192424	209	290	17	4	81	0.0493827
NODE_13713_length_759_cov_9.192424	209	290	18	3	81	0.0370370
NODE_13713_length_759_cov_9.192424	209	290	22	3	81	0.0370370
NODE_13713_length_759_cov_9.192424	209	290	24	4	81	0.0493827
NODE_13713_length_759_cov_9.192424	209	290	26	5	81	0.0617284
NODE_13713_length_759_cov_9.192424	209	290	30	9	81	0.1111111
NODE_13713_length_759_cov_9.192424	209	290	32	5	81	0.0617284
NODE_13713_length_759_cov_9.192424	209	290	35	2	81	0.0246914
NODE_13713_length_759_cov_9.192424	209	290	38	7	81	0.0864198
NODE_13713_length_759_cov_9.192424	209	290	40	4	81	0.0493827
NODE_13713_length_759_cov_9.192424	209	290	42	2	81	0.0246914
NODE_13713_length_759_cov_9.192424	209	290	44	4	81	0.0493827
NODE_13713_length_759_cov_9.192424	209	290	46	4	81	0.0493827
NODE_13713_length_759_cov_9.192424	209	290	48	5	81	0.0617284
NODE_13713_length_759_cov_9.192424	209	290	50	7	81	0.0864198
NODE_13713_length_759_cov_9.192424	262	310	7	1	48	0.0208333
NODE_13713_length_759_cov_9.192424	262	310	9	3	48	0.0625000
NODE_13713_length_759_cov_9.192424	262	310	11	17	48	0.3541667
NODE_13713_length_759_cov_9.192424	262	310	15	8	48	0.1666667
NODE_13713_length_759_cov_9.192424	262	310	17	4	48	0.0833333
NODE_13713_length_759_cov_9.192424	262	310	18	3	48	0.0625000
NODE_13713_length_759_cov_9.192424	262	310	19	1	48	0.0208333
NODE_13713_length_759_cov_9.192424	262	310	21	3	48	0.0625000
NODE_13713_length_759_cov_9.192424	262	310	22	3	48	0.0625000
NODE_13713_length_759_cov_9.192424	262	310	24	4	48	0.0833333
NODE_13713_length_759_cov_9.192424	262	310	26	1	48	0.0208333
NODE_13714_length_759_cov_8.771212	292	372	0	64	80	0.8000000
NODE_13714_length_759_cov_8.771212	292	372	2	16	80	0.2000000
NODE_13714_length_759_cov_8.771212	345	425	0	11	80	0.1375000
NODE_13714_length_759_cov_8.771212	345	425	2	31	80	0.3875000
NODE_13714_length_759_cov_8.771212	345	425	4	38	80	0.4750000
NODE_13715_length_759_cov_8.650000	324	404	0	80	80	1.0000000
NODE_13715_length_759_cov_8.650000	377	457	0	51	80	0.6375000
NODE_13715_length_759_cov_8.650000	377	457	2	29	80	0.3625000
NODE_13716_length_759_cov_8.268182	604	684	0	80	80	1.0000000
NODE_13716_length_759_cov_8.268182	657	737	0	80	80	1.0000000
NODE_13717_length_759_cov_6.833333	381	461	0	80	80	1.0000000
NODE_13717_length_759_cov_6.833333	434	515	0	81	81	1.0000000
NODE_13718_length_759_cov_6.407576	319	399	0	78	80	0.9750000
NODE_13718_length_759_cov_6.407576	319	399	1	2	80	0.0250000
NODE_13718_length_759_cov_6.407576	372	452	0	25	80	0.3125000
NODE_13718_length_759_cov_6.407576	372	452	1	2	80	0.0250000
NODE_13718_length_759_cov_6.407576	372	452	2	53	80	0.6625000
NODE_13725_length_759_cov_3.400000	355	435	0	80	80	1.0000000
NODE_13725_length_759_cov_3.400000	408	488	0	80	80	1.0000000
NODE_13726_length_759_cov_3.346970	240	322	0	9	82	0.1097561
NODE_13726_length_759_cov_3.346970	240	322	2	73	82	0.8902439
NODE_13760_length_758_cov_38.414264	215	295	0	80	80	1.0000000
NODE_13760_length_758_cov_38.414264	268	348	0	80	80	1.0000000
NODE_13760_length_758_cov_38.414264	344	424	0	80	80	1.0000000
NODE_13760_length_758_cov_38.414264	397	477	0	37	80	0.4625000
NODE_13760_length_758_cov_38.414264	397	477	2	43	80	0.5375000
NODE_13761_length_758_cov_36.722307	331	411	0	3	80	0.0375000
NODE_13761_length_758_cov_36.722307	331	411	6	1	80	0.0125000
NODE_13761_length_758_cov_36.722307	331	411	7	71	80	0.8875000
NODE_13761_length_758_cov_36.722307	331	411	8	5	80	0.0625000
NODE_13761_length_758_cov_36.722307	384	464	0	56	80	0.7000000
NODE_13761_length_758_cov_36.722307	384	464	6	1	80	0.0125000
NODE_13761_length_758_cov_36.722307	384	464	7	23	80	0.2875000
NODE_13762_length_758_cov_29.910470	235	315	0	46	80	0.5750000
NODE_13762_length_758_cov_29.910470	235	315	2	34	80	0.4250000
NODE_13762_length_758_cov_29.910470	288	368	2	41	80	0.5125000
NODE_13762_length_758_cov_29.910470	288	368	4	39	80	0.4875000
NODE_13763_length_758_cov_16.226100	386	466	0	2	80	0.0250000
NODE_13763_length_758_cov_16.226100	386	466	2	78	80	0.9750000
NODE_13763_length_758_cov_16.226100	439	519	0	55	80	0.6875000
NODE_13763_length_758_cov_16.226100	439	519	2	25	80	0.3125000
NODE_13764_length_758_cov_16.097117	311	391	2	28	80	0.3500000
NODE_13764_length_758_cov_16.097117	311	391	4	52	80	0.6500000
NODE_13764_length_758_cov_16.097117	364	444	0	16	80	0.2000000
NODE_13764_length_758_cov_16.097117	364	444	2	63	80	0.7875000
NODE_13764_length_758_cov_16.097117	364	444	4	1	80	0.0125000
NODE_13765_length_758_cov_15.525038	260	340	1	53	80	0.6625000
NODE_13765_length_758_cov_15.525038	260	340	3	12	80	0.1500000
NODE_13765_length_758_cov_15.525038	260	340	4	15	80	0.1875000
NODE_13765_length_758_cov_15.525038	313	393	1	9	80	0.1125000
NODE_13765_length_758_cov_15.525038	313	393	3	44	80	0.5500000
NODE_13765_length_758_cov_15.525038	313	393	4	27	80	0.3375000
NODE_13768_length_758_cov_9.153263	224	299	0	75	75	1.0000000
NODE_13771_length_758_cov_4.241275	508	588	10	17	80	0.2125000
NODE_13771_length_758_cov_4.241275	508	588	12	30	80	0.3750000
NODE_13771_length_758_cov_4.241275	508	588	14	33	80	0.4125000
NODE_13772_length_758_cov_3.902883	346	426	0	80	80	1.0000000
NODE_13772_length_758_cov_3.902883	399	479	0	80	80	1.0000000
NODE_13794_length_757_cov_49.057751	155	235	0	80	80	1.0000000
NODE_13794_length_757_cov_49.057751	208	288	0	80	80	1.0000000
NODE_13795_length_757_cov_29.954407	181	262	0	81	81	1.0000000
NODE_13795_length_757_cov_29.954407	235	315	0	28	80	0.3500000
NODE_13795_length_757_cov_29.954407	235	315	2	52	80	0.6500000
NODE_13795_length_757_cov_29.954407	311	391	0	50	80	0.6250000
NODE_13795_length_757_cov_29.954407	311	391	2	30	80	0.3750000
NODE_13795_length_757_cov_29.954407	364	444	0	80	80	1.0000000
NODE_13796_length_757_cov_25.565350	352	432	0	37	80	0.4625000
NODE_13796_length_757_cov_25.565350	352	432	2	41	80	0.5125000
NODE_13796_length_757_cov_25.565350	352	432	4	2	80	0.0250000
NODE_13796_length_757_cov_25.565350	405	483	2	49	78	0.6282051
NODE_13796_length_757_cov_25.565350	405	483	4	29	78	0.3717949
NODE_13797_length_757_cov_18.338906	264	344	0	80	80	1.0000000
NODE_13797_length_757_cov_18.338906	317	397	0	80	80	1.0000000
NODE_13798_length_757_cov_15.879939	58	138	0	80	80	1.0000000
NODE_13798_length_757_cov_15.879939	111	191	0	80	80	1.0000000
NODE_13800_length_757_cov_15.291793	314	394	0	43	80	0.5375000
NODE_13800_length_757_cov_15.291793	314	394	3	1	80	0.0125000
NODE_13800_length_757_cov_15.291793	314	394	4	36	80	0.4500000
NODE_13800_length_757_cov_15.291793	367	447	0	80	80	1.0000000
NODE_13807_length_757_cov_3.182371	423	503	0	80	80	1.0000000
NODE_13807_length_757_cov_3.182371	476	556	0	80	80	1.0000000
NODE_13832_length_756_cov_26.441400	287	367	0	45	80	0.5625000
NODE_13832_length_756_cov_26.441400	287	367	2	35	80	0.4375000
NODE_13832_length_756_cov_26.441400	340	420	0	9	80	0.1125000
NODE_13832_length_756_cov_26.441400	340	420	2	71	80	0.8875000
NODE_13834_length_756_cov_13.097412	154	234	0	74	80	0.9250000
NODE_13834_length_756_cov_13.097412	154	234	4	6	80	0.0750000
NODE_13834_length_756_cov_13.097412	207	287	0	21	80	0.2625000
NODE_13834_length_756_cov_13.097412	207	287	4	59	80	0.7375000
NODE_13835_length_756_cov_12.732116	377	457	5	19	80	0.2375000
NODE_13835_length_756_cov_12.732116	377	457	7	12	80	0.1500000
NODE_13835_length_756_cov_12.732116	377	457	10	27	80	0.3375000
NODE_13835_length_756_cov_12.732116	377	457	11	6	80	0.0750000
NODE_13835_length_756_cov_12.732116	377	457	12	16	80	0.2000000
NODE_13836_length_756_cov_9.254186	241	321	0	80	80	1.0000000
NODE_13836_length_756_cov_9.254186	294	374	0	80	80	1.0000000
NODE_13837_length_756_cov_8.304414	363	409	0	46	46	1.0000000
NODE_13838_length_756_cov_8.105023	271	351	0	9	80	0.1125000
NODE_13838_length_756_cov_8.105023	271	351	2	61	80	0.7625000
NODE_13838_length_756_cov_8.105023	271	351	4	3	80	0.0375000
NODE_13838_length_756_cov_8.105023	271	351	6	7	80	0.0875000
NODE_13838_length_756_cov_8.105023	324	404	0	9	80	0.1125000
NODE_13838_length_756_cov_8.105023	324	404	2	46	80	0.5750000
NODE_13838_length_756_cov_8.105023	324	404	4	25	80	0.3125000
NODE_13840_length_756_cov_6.622527	431	511	0	80	80	1.0000000
NODE_13840_length_756_cov_6.622527	484	565	0	81	81	1.0000000
NODE_13888_length_755_cov_64.705793	303	383	0	25	80	0.3125000
NODE_13888_length_755_cov_64.705793	303	383	5	1	80	0.0125000
NODE_13888_length_755_cov_64.705793	303	383	6	54	80	0.6750000
NODE_13888_length_755_cov_64.705793	356	436	0	35	80	0.4375000
NODE_13888_length_755_cov_64.705793	356	436	6	45	80	0.5625000
NODE_13889_length_755_cov_58.214939	425	505	0	53	80	0.6625000
NODE_13889_length_755_cov_58.214939	425	505	4	27	80	0.3375000
NODE_13889_length_755_cov_58.214939	425	505	0	53	80	0.6625000
NODE_13889_length_755_cov_58.214939	425	505	4	27	80	0.3375000
NODE_13889_length_755_cov_58.214939	478	556	0	78	78	1.0000000
NODE_13889_length_755_cov_58.214939	478	556	0	78	78	1.0000000
NODE_13890_length_755_cov_25.945122	237	317	0	80	80	1.0000000
NODE_13890_length_755_cov_25.945122	290	370	0	80	80	1.0000000
NODE_13891_length_755_cov_24.263720	334	414	0	80	80	1.0000000
NODE_13891_length_755_cov_24.263720	387	467	0	80	80	1.0000000
NODE_13892_length_755_cov_15.559451	306	386	0	12	80	0.1500000
NODE_13892_length_755_cov_15.559451	306	386	1	38	80	0.4750000
NODE_13892_length_755_cov_15.559451	306	386	5	30	80	0.3750000
NODE_13892_length_755_cov_15.559451	359	439	5	80	80	1.0000000
NODE_13894_length_755_cov_10.196646	332	412	0	80	80	1.0000000
NODE_13894_length_755_cov_10.196646	385	465	0	80	80	1.0000000
NODE_13895_length_755_cov_9.772866	210	290	0	41	80	0.5125000
NODE_13895_length_755_cov_9.772866	210	290	2	39	80	0.4875000
NODE_13895_length_755_cov_9.772866	263	343	2	61	80	0.7625000
NODE_13895_length_755_cov_9.772866	263	343	4	19	80	0.2375000
NODE_13936_length_754_cov_87.432061	208	288	0	28	80	0.3500000
NODE_13936_length_754_cov_87.432061	208	288	1	18	80	0.2250000
NODE_13936_length_754_cov_87.432061	208	288	7	3	80	0.0375000
NODE_13936_length_754_cov_87.432061	208	288	8	31	80	0.3875000
NODE_13936_length_754_cov_87.432061	261	341	2	4	80	0.0500000
NODE_13936_length_754_cov_87.432061	261	341	8	76	80	0.9500000
NODE_13937_length_754_cov_16.549618	156	236	0	80	80	1.0000000
NODE_13937_length_754_cov_16.549618	209	289	0	80	80	1.0000000
NODE_13939_length_754_cov_9.068702	316	396	0	80	80	1.0000000
NODE_13939_length_754_cov_9.068702	369	449	0	80	80	1.0000000
NODE_13940_length_754_cov_5.925191	287	367	0	59	80	0.7375000
NODE_13940_length_754_cov_5.925191	287	367	2	21	80	0.2625000
NODE_13940_length_754_cov_5.925191	340	420	0	6	80	0.0750000
NODE_13940_length_754_cov_5.925191	340	420	2	74	80	0.9250000
NODE_13974_length_753_cov_10.434251	386	466	1	52	80	0.6500000
NODE_13974_length_753_cov_10.434251	386	466	2	28	80	0.3500000
NODE_13974_length_753_cov_10.434251	439	519	1	73	80	0.9125000
NODE_13974_length_753_cov_10.434251	439	519	2	7	80	0.0875000
NODE_13976_length_753_cov_7.056575	344	424	1	25	80	0.3125000
NODE_13976_length_753_cov_7.056575	344	424	3	9	80	0.1125000
NODE_13976_length_753_cov_7.056575	344	424	4	46	80	0.5750000
NODE_13976_length_753_cov_7.056575	397	477	2	46	80	0.5750000
NODE_13976_length_753_cov_7.056575	397	477	4	34	80	0.4250000
NODE_13977_length_753_cov_4.597859	321	401	0	17	80	0.2125000
NODE_13977_length_753_cov_4.597859	321	401	2	63	80	0.7875000
NODE_13977_length_753_cov_4.597859	374	454	0	70	80	0.8750000
NODE_13977_length_753_cov_4.597859	374	454	2	10	80	0.1250000
NODE_14003_length_752_cov_66.281776	617	697	24	1	80	0.0125000
NODE_14003_length_752_cov_66.281776	617	697	26	2	80	0.0250000
NODE_14003_length_752_cov_66.281776	617	697	32	9	80	0.1125000
NODE_14003_length_752_cov_66.281776	617	697	34	2	80	0.0250000
NODE_14003_length_752_cov_66.281776	617	697	36	8	80	0.1000000
NODE_14003_length_752_cov_66.281776	617	697	38	3	80	0.0375000
NODE_14003_length_752_cov_66.281776	617	697	42	5	80	0.0625000
NODE_14003_length_752_cov_66.281776	617	697	44	6	80	0.0750000
NODE_14003_length_752_cov_66.281776	617	697	47	4	80	0.0500000
NODE_14003_length_752_cov_66.281776	617	697	48	2	80	0.0250000
NODE_14003_length_752_cov_66.281776	617	697	49	26	80	0.3250000
NODE_14003_length_752_cov_66.281776	617	697	51	8	80	0.1000000
NODE_14003_length_752_cov_66.281776	617	697	53	4	80	0.0500000
NODE_14003_length_752_cov_66.281776	670	751	0	4	81	0.0493827
NODE_14003_length_752_cov_66.281776	670	751	13	5	81	0.0617284
NODE_14003_length_752_cov_66.281776	670	751	14	24	81	0.2962963
NODE_14003_length_752_cov_66.281776	670	751	16	3	81	0.0370370
NODE_14003_length_752_cov_66.281776	670	751	17	14	81	0.1728395
NODE_14003_length_752_cov_66.281776	670	751	18	3	81	0.0370370
NODE_14003_length_752_cov_66.281776	670	751	24	2	81	0.0246914
NODE_14003_length_752_cov_66.281776	670	751	26	2	81	0.0246914
NODE_14003_length_752_cov_66.281776	670	751	32	9	81	0.1111111
NODE_14003_length_752_cov_66.281776	670	751	34	2	81	0.0246914
NODE_14003_length_752_cov_66.281776	670	751	36	8	81	0.0987654
NODE_14003_length_752_cov_66.281776	670	751	38	3	81	0.0370370
NODE_14003_length_752_cov_66.281776	670	751	42	2	81	0.0246914
NODE_14004_length_752_cov_60.274119	193	273	2	80	80	1.0000000
NODE_14004_length_752_cov_60.274119	246	326	0	47	80	0.5875000
NODE_14004_length_752_cov_60.274119	246	326	2	33	80	0.4125000
NODE_14005_length_752_cov_19.811639	299	379	0	80	80	1.0000000
NODE_14005_length_752_cov_19.811639	352	432	0	80	80	1.0000000
NODE_14006_length_752_cov_17.661562	118	198	0	80	80	1.0000000
NODE_14006_length_752_cov_17.661562	171	251	0	80	80	1.0000000
NODE_14007_length_752_cov_13.275651	241	321	0	64	80	0.8000000
NODE_14007_length_752_cov_13.275651	241	321	9	16	80	0.2000000
NODE_14007_length_752_cov_13.275651	294	374	0	11	80	0.1375000
NODE_14007_length_752_cov_13.275651	294	374	9	24	80	0.3000000
NODE_14007_length_752_cov_13.275651	294	374	17	33	80	0.4125000
NODE_14007_length_752_cov_13.275651	294	374	18	12	80	0.1500000
NODE_14008_length_752_cov_10.928025	313	393	6	18	80	0.2250000
NODE_14008_length_752_cov_10.928025	313	393	12	9	80	0.1125000
NODE_14008_length_752_cov_10.928025	313	393	14	13	80	0.1625000
NODE_14008_length_752_cov_10.928025	313	393	16	40	80	0.5000000
NODE_14011_length_752_cov_9.558959	249	329	0	13	80	0.1625000
NODE_14011_length_752_cov_9.558959	249	329	2	67	80	0.8375000
NODE_14011_length_752_cov_9.558959	302	382	0	66	80	0.8250000
NODE_14011_length_752_cov_9.558959	302	382	2	14	80	0.1750000
NODE_14014_length_752_cov_8.281776	237	317	0	80	80	1.0000000
NODE_14014_length_752_cov_8.281776	290	370	0	80	80	1.0000000
NODE_14015_length_752_cov_8.082695	352	432	0	67	80	0.8375000
NODE_14015_length_752_cov_8.082695	352	432	2	13	80	0.1625000
NODE_14015_length_752_cov_8.082695	405	485	0	14	80	0.1750000
NODE_14015_length_752_cov_8.082695	405	485	2	32	80	0.4000000
NODE_14015_length_752_cov_8.082695	405	485	4	34	80	0.4250000
NODE_14044_length_751_cov_20.730061	238	318	3	67	80	0.8375000
NODE_14044_length_751_cov_20.730061	238	318	4	13	80	0.1625000
NODE_14044_length_751_cov_20.730061	291	371	0	8	80	0.1000000
NODE_14044_length_751_cov_20.730061	291	371	2	43	80	0.5375000
NODE_14044_length_751_cov_20.730061	291	371	3	29	80	0.3625000
NODE_14045_length_751_cov_18.478528	328	409	0	9	81	0.1111111
NODE_14045_length_751_cov_18.478528	328	409	2	72	81	0.8888889
NODE_14045_length_751_cov_18.478528	382	462	0	5	80	0.0625000
NODE_14045_length_751_cov_18.478528	382	462	2	75	80	0.9375000
NODE_14046_length_751_cov_13.016871	172	252	0	80	80	1.0000000
NODE_14046_length_751_cov_13.016871	225	305	0	80	80	1.0000000
NODE_14047_length_751_cov_12.363497	397	477	0	80	80	1.0000000
NODE_14047_length_751_cov_12.363497	450	530	0	39	80	0.4875000
NODE_14047_length_751_cov_12.363497	450	530	2	23	80	0.2875000
NODE_14047_length_751_cov_12.363497	450	530	4	18	80	0.2250000
NODE_14085_length_750_cov_46.371736	396	476	0	16	80	0.2000000
NODE_14085_length_750_cov_46.371736	396	476	6	64	80	0.8000000
NODE_14085_length_750_cov_46.371736	449	529	0	26	80	0.3250000
NODE_14085_length_750_cov_46.371736	449	529	5	1	80	0.0125000
NODE_14085_length_750_cov_46.371736	449	529	6	53	80	0.6625000
NODE_14086_length_750_cov_24.428571	524	604	33	1	80	0.0125000
NODE_14086_length_750_cov_24.428571	524	604	35	1	80	0.0125000
NODE_14086_length_750_cov_24.428571	524	604	39	1	80	0.0125000
NODE_14086_length_750_cov_24.428571	524	604	41	1	80	0.0125000
NODE_14086_length_750_cov_24.428571	524	604	47	2	80	0.0250000
NODE_14086_length_750_cov_24.428571	524	604	49	5	80	0.0625000
NODE_14086_length_750_cov_24.428571	524	604	51	8	80	0.1000000
NODE_14086_length_750_cov_24.428571	524	604	53	3	80	0.0375000
NODE_14086_length_750_cov_24.428571	524	604	55	2	80	0.0250000
NODE_14086_length_750_cov_24.428571	524	604	57	4	80	0.0500000
NODE_14086_length_750_cov_24.428571	524	604	59	1	80	0.0125000
NODE_14086_length_750_cov_24.428571	524	604	61	17	80	0.2125000
NODE_14086_length_750_cov_24.428571	524	604	63	8	80	0.1000000
NODE_14086_length_750_cov_24.428571	524	604	65	13	80	0.1625000
NODE_14086_length_750_cov_24.428571	524	604	67	3	80	0.0375000
NODE_14086_length_750_cov_24.428571	524	604	68	7	80	0.0875000
NODE_14086_length_750_cov_24.428571	524	604	70	3	80	0.0375000
NODE_14086_length_750_cov_24.428571	683	746	0	63	63	1.0000000
NODE_14087_length_750_cov_24.311828	325	405	0	15	80	0.1875000
NODE_14087_length_750_cov_24.311828	325	405	1	3	80	0.0375000
NODE_14087_length_750_cov_24.311828	325	405	2	6	80	0.0750000
NODE_14087_length_750_cov_24.311828	325	405	3	56	80	0.7000000
NODE_14087_length_750_cov_24.311828	378	458	0	68	80	0.8500000
NODE_14087_length_750_cov_24.311828	378	458	2	6	80	0.0750000
NODE_14087_length_750_cov_24.311828	378	458	3	6	80	0.0750000
NODE_14089_length_750_cov_8.529954	336	416	2	67	80	0.8375000
NODE_14089_length_750_cov_8.529954	336	416	4	13	80	0.1625000
NODE_14089_length_750_cov_8.529954	395	469	2	61	74	0.8243243
NODE_14089_length_750_cov_8.529954	395	469	4	13	74	0.1756757
NODE_14137_length_749_cov_18.986154	221	301	0	80	80	1.0000000
NODE_14137_length_749_cov_18.986154	274	354	0	80	80	1.0000000
NODE_14138_length_749_cov_18.836923	273	355	0	41	82	0.5000000
NODE_14138_length_749_cov_18.836923	273	355	2	41	82	0.5000000
NODE_14138_length_749_cov_18.836923	328	408	2	59	80	0.7375000
NODE_14138_length_749_cov_18.836923	328	408	4	21	80	0.2625000
NODE_14138_length_749_cov_18.836923	404	484	2	65	80	0.8125000
NODE_14138_length_749_cov_18.836923	404	484	5	13	80	0.1625000
NODE_14138_length_749_cov_18.836923	404	484	6	2	80	0.0250000
NODE_14138_length_749_cov_18.836923	457	535	2	15	78	0.1923077
NODE_14138_length_749_cov_18.836923	457	535	4	28	78	0.3589744
NODE_14138_length_749_cov_18.836923	457	535	5	13	78	0.1666667
NODE_14138_length_749_cov_18.836923	457	535	6	22	78	0.2820513
NODE_14139_length_749_cov_16.160000	232	253	0	1	21	0.0476190
NODE_14139_length_749_cov_16.160000	232	253	2	20	21	0.9523810
NODE_14139_length_749_cov_16.160000	232	306	0	1	74	0.0135135
NODE_14139_length_749_cov_16.160000	232	306	2	73	74	0.9864865
NODE_14140_length_749_cov_16.115385	307	387	0	17	80	0.2125000
NODE_14140_length_749_cov_16.115385	307	387	4	63	80	0.7875000
NODE_14140_length_749_cov_16.115385	360	440	0	50	80	0.6250000
NODE_14140_length_749_cov_16.115385	360	440	2	20	80	0.2500000
NODE_14140_length_749_cov_16.115385	360	440	4	10	80	0.1250000
NODE_14141_length_749_cov_11.210769	340	420	0	80	80	1.0000000
NODE_14141_length_749_cov_11.210769	393	473	0	80	80	1.0000000
NODE_14142_length_749_cov_8.424615	372	452	0	80	80	1.0000000
NODE_14142_length_749_cov_8.424615	425	505	0	80	80	1.0000000
NODE_14145_length_749_cov_4.521538	550	630	0	80	80	1.0000000
NODE_14145_length_749_cov_4.521538	603	683	0	80	80	1.0000000
NODE_14185_length_748_cov_55.348228	393	473	0	80	80	1.0000000
NODE_14185_length_748_cov_55.348228	446	526	0	80	80	1.0000000
NODE_14186_length_748_cov_51.838213	369	449	0	10	80	0.1250000
NODE_14186_length_748_cov_51.838213	369	449	2	70	80	0.8750000
NODE_14186_length_748_cov_51.838213	422	502	2	34	80	0.4250000
NODE_14186_length_748_cov_51.838213	422	502	4	32	80	0.4000000
NODE_14186_length_748_cov_51.838213	422	502	5	1	80	0.0125000
NODE_14186_length_748_cov_51.838213	422	502	6	13	80	0.1625000
NODE_14187_length_748_cov_46.952234	293	373	0	80	80	1.0000000
NODE_14187_length_748_cov_46.952234	346	426	0	51	80	0.6375000
NODE_14187_length_748_cov_46.952234	346	426	2	29	80	0.3625000
NODE_14188_length_748_cov_45.001541	272	352	0	28	80	0.3500000
NODE_14188_length_748_cov_45.001541	272	352	2	52	80	0.6500000
NODE_14188_length_748_cov_45.001541	325	405	0	80	80	1.0000000
NODE_14189_length_748_cov_34.355932	488	568	0	33	80	0.4125000
NODE_14189_length_748_cov_34.355932	488	568	2	47	80	0.5875000
NODE_14189_length_748_cov_34.355932	541	621	0	80	80	1.0000000
NODE_14190_length_748_cov_25.972265	297	377	2	24	80	0.3000000
NODE_14190_length_748_cov_25.972265	297	377	4	18	80	0.2250000
NODE_14190_length_748_cov_25.972265	297	377	6	38	80	0.4750000
NODE_14190_length_748_cov_25.972265	350	430	2	1	80	0.0125000
NODE_14190_length_748_cov_25.972265	350	430	4	70	80	0.8750000
NODE_14190_length_748_cov_25.972265	350	430	6	9	80	0.1125000
NODE_14191_length_748_cov_21.050847	362	442	4	53	80	0.6625000
NODE_14191_length_748_cov_21.050847	362	442	6	27	80	0.3375000
NODE_14191_length_748_cov_21.050847	415	495	0	2	80	0.0250000
NODE_14191_length_748_cov_21.050847	415	495	4	78	80	0.9750000
NODE_14192_length_748_cov_20.682589	353	433	0	36	80	0.4500000
NODE_14192_length_748_cov_20.682589	353	433	2	44	80	0.5500000
NODE_14192_length_748_cov_20.682589	406	486	0	34	80	0.4250000
NODE_14192_length_748_cov_20.682589	406	486	2	46	80	0.5750000
NODE_14193_length_748_cov_19.081664	261	341	0	15	80	0.1875000
NODE_14193_length_748_cov_19.081664	261	341	4	22	80	0.2750000
NODE_14193_length_748_cov_19.081664	261	341	6	43	80	0.5375000
NODE_14193_length_748_cov_19.081664	314	394	0	68	80	0.8500000
NODE_14193_length_748_cov_19.081664	314	394	4	12	80	0.1500000
NODE_14193_length_748_cov_19.081664	390	470	0	80	80	1.0000000
NODE_14193_length_748_cov_19.081664	443	522	0	79	79	1.0000000
NODE_14194_length_748_cov_16.579353	81	161	0	8	80	0.1000000
NODE_14194_length_748_cov_16.579353	81	161	2	4	80	0.0500000
NODE_14194_length_748_cov_16.579353	81	161	4	68	80	0.8500000
NODE_14194_length_748_cov_16.579353	134	214	4	27	80	0.3375000
NODE_14194_length_748_cov_16.579353	134	214	8	12	80	0.1500000
NODE_14194_length_748_cov_16.579353	134	214	10	17	80	0.2125000
NODE_14194_length_748_cov_16.579353	134	214	12	24	80	0.3000000
NODE_14194_length_748_cov_16.579353	210	290	8	5	80	0.0625000
NODE_14194_length_748_cov_16.579353	210	290	10	5	80	0.0625000
NODE_14194_length_748_cov_16.579353	210	290	12	20	80	0.2500000
NODE_14194_length_748_cov_16.579353	210	290	15	11	80	0.1375000
NODE_14194_length_748_cov_16.579353	210	290	16	2	80	0.0250000
NODE_14194_length_748_cov_16.579353	210	290	17	37	80	0.4625000
NODE_14194_length_748_cov_16.579353	263	343	4	12	80	0.1500000
NODE_14194_length_748_cov_16.579353	263	343	6	17	80	0.2125000
NODE_14194_length_748_cov_16.579353	263	343	8	8	80	0.1000000
NODE_14194_length_748_cov_16.579353	263	343	12	36	80	0.4500000
NODE_14194_length_748_cov_16.579353	263	343	17	7	80	0.0875000
NODE_14196_length_748_cov_11.983051	375	455	0	80	80	1.0000000
NODE_14196_length_748_cov_11.983051	428	508	0	80	80	1.0000000
NODE_14197_length_748_cov_11.474576	257	337	0	13	80	0.1625000
NODE_14197_length_748_cov_11.474576	257	337	1	67	80	0.8375000
NODE_14197_length_748_cov_11.474576	310	390	1	27	80	0.3375000
NODE_14197_length_748_cov_11.474576	310	390	2	53	80	0.6625000
NODE_14200_length_748_cov_7.979969	223	303	0	80	80	1.0000000
NODE_14200_length_748_cov_7.979969	276	356	0	80	80	1.0000000
NODE_14240_length_747_cov_24.279321	205	285	2	1	80	0.0125000
NODE_14240_length_747_cov_24.279321	205	285	5	16	80	0.2000000
NODE_14240_length_747_cov_24.279321	205	285	6	22	80	0.2750000
NODE_14240_length_747_cov_24.279321	205	285	8	41	80	0.5125000
NODE_14240_length_747_cov_24.279321	258	338	0	11	80	0.1375000
NODE_14240_length_747_cov_24.279321	258	338	2	43	80	0.5375000
NODE_14240_length_747_cov_24.279321	258	338	5	16	80	0.2000000
NODE_14240_length_747_cov_24.279321	258	338	8	10	80	0.1250000
NODE_14241_length_747_cov_15.438272	352	432	0	80	80	1.0000000
NODE_14241_length_747_cov_15.438272	405	485	0	80	80	1.0000000
NODE_14244_length_747_cov_7.979938	237	317	0	52	80	0.6500000
NODE_14244_length_747_cov_7.979938	237	317	2	28	80	0.3500000
NODE_14244_length_747_cov_7.979938	290	370	2	80	80	1.0000000
NODE_14248_length_747_cov_4.918210	157	237	0	80	80	1.0000000
NODE_14248_length_747_cov_4.918210	210	290	0	66	80	0.8250000
NODE_14248_length_747_cov_4.918210	210	290	2	1	80	0.0125000
NODE_14248_length_747_cov_4.918210	210	290	3	13	80	0.1625000
NODE_14277_length_746_cov_44.041731	153	233	0	80	80	1.0000000
NODE_14277_length_746_cov_44.041731	206	286	0	80	80	1.0000000
NODE_14278_length_746_cov_24.435858	334	414	2	52	80	0.6500000
NODE_14278_length_746_cov_24.435858	334	414	4	28	80	0.3500000
NODE_14278_length_746_cov_24.435858	387	467	0	10	80	0.1250000
NODE_14278_length_746_cov_24.435858	387	467	2	66	80	0.8250000
NODE_14278_length_746_cov_24.435858	387	467	4	4	80	0.0500000
NODE_14279_length_746_cov_20.225657	114	194	0	7	80	0.0875000
NODE_14279_length_746_cov_20.225657	114	194	4	27	80	0.3375000
NODE_14279_length_746_cov_20.225657	114	194	8	46	80	0.5750000
NODE_14279_length_746_cov_20.225657	167	247	0	8	80	0.1000000
NODE_14279_length_746_cov_20.225657	167	247	4	17	80	0.2125000
NODE_14279_length_746_cov_20.225657	167	247	8	55	80	0.6875000
NODE_14280_length_746_cov_17.919629	330	410	0	80	80	1.0000000
NODE_14280_length_746_cov_17.919629	383	463	0	80	80	1.0000000
NODE_14281_length_746_cov_17.523957	292	372	0	80	80	1.0000000
NODE_14281_length_746_cov_17.523957	345	425	0	80	80	1.0000000
NODE_14282_length_746_cov_17.214838	306	386	0	80	80	1.0000000
NODE_14282_length_746_cov_17.214838	359	439	0	80	80	1.0000000
NODE_14283_length_746_cov_16.765070	344	424	2	5	80	0.0625000
NODE_14283_length_746_cov_16.765070	344	424	4	3	80	0.0375000
NODE_14283_length_746_cov_16.765070	344	424	6	72	80	0.9000000
NODE_14283_length_746_cov_16.765070	397	477	0	30	80	0.3750000
NODE_14283_length_746_cov_16.765070	397	477	4	26	80	0.3250000
NODE_14283_length_746_cov_16.765070	397	477	6	24	80	0.3000000
NODE_14284_length_746_cov_13.153014	126	206	0	80	80	1.0000000
NODE_14284_length_746_cov_13.153014	179	259	0	80	80	1.0000000
NODE_14284_length_746_cov_13.153014	244	263	0	19	19	1.0000000
NODE_14285_length_746_cov_12.316847	364	442	4	78	78	1.0000000
NODE_14286_length_746_cov_11.301391	349	429	0	80	80	1.0000000
NODE_14286_length_746_cov_11.301391	402	482	0	27	80	0.3375000
NODE_14286_length_746_cov_11.301391	402	482	6	53	80	0.6625000
NODE_14302_length_746_cov_2.639876	331	411	0	45	80	0.5625000
NODE_14302_length_746_cov_2.639876	331	411	2	3	80	0.0375000
NODE_14302_length_746_cov_2.639876	331	411	4	12	80	0.1500000
NODE_14302_length_746_cov_2.639876	331	411	6	20	80	0.2500000
NODE_14307_length_746_cov_1.879444	435	502	0	67	67	1.0000000
NODE_14310_length_746_cov_1.727975	65	121	0	56	56	1.0000000
NODE_14310_length_746_cov_1.727975	494	540	2	4	46	0.0869565
NODE_14310_length_746_cov_1.727975	494	540	4	42	46	0.9130435
NODE_14329_length_745_cov_40.360681	257	337	0	33	80	0.4125000
NODE_14329_length_745_cov_40.360681	257	337	2	47	80	0.5875000
NODE_14329_length_745_cov_40.360681	310	390	0	80	80	1.0000000
NODE_14330_length_745_cov_30.817337	339	419	0	58	80	0.7250000
NODE_14330_length_745_cov_30.817337	339	419	7	22	80	0.2750000
NODE_14330_length_745_cov_30.817337	392	459	0	5	67	0.0746269
NODE_14330_length_745_cov_30.817337	392	459	7	62	67	0.9253731
NODE_14335_length_745_cov_8.620743	225	275	0	50	50	1.0000000
NODE_14335_length_745_cov_8.620743	248	328	0	80	80	1.0000000
NODE_14343_length_745_cov_3.922601	249	280	37	3	31	0.0967742
NODE_14343_length_745_cov_3.922601	249	280	41	1	31	0.0322581
NODE_14343_length_745_cov_3.922601	249	280	42	11	31	0.3548387
NODE_14343_length_745_cov_3.922601	249	280	44	6	31	0.1935484
NODE_14343_length_745_cov_3.922601	249	280	46	4	31	0.1290323
NODE_14343_length_745_cov_3.922601	249	280	48	1	31	0.0322581
NODE_14343_length_745_cov_3.922601	249	280	51	5	31	0.1612903
NODE_14343_length_745_cov_3.922601	253	333	42	11	80	0.1375000
NODE_14343_length_745_cov_3.922601	253	333	44	6	80	0.0750000
NODE_14343_length_745_cov_3.922601	253	333	46	4	80	0.0500000
NODE_14343_length_745_cov_3.922601	253	333	48	1	80	0.0125000
NODE_14343_length_745_cov_3.922601	253	333	49	21	80	0.2625000
NODE_14343_length_745_cov_3.922601	253	333	51	31	80	0.3875000
NODE_14343_length_745_cov_3.922601	253	333	55	6	80	0.0750000
NODE_14381_length_744_cov_44.953488	553	633	4	17	80	0.2125000
NODE_14381_length_744_cov_44.953488	553	633	8	63	80	0.7875000
NODE_14381_length_744_cov_44.953488	553	633	4	17	80	0.2125000
NODE_14381_length_744_cov_44.953488	553	633	8	63	80	0.7875000
NODE_14381_length_744_cov_44.953488	553	633	4	17	80	0.2125000
NODE_14381_length_744_cov_44.953488	553	633	8	63	80	0.7875000
NODE_14381_length_744_cov_44.953488	553	633	4	17	80	0.2125000
NODE_14381_length_744_cov_44.953488	553	633	8	63	80	0.7875000
NODE_14382_length_744_cov_35.333333	163	243	0	19	80	0.2375000
NODE_14382_length_744_cov_35.333333	163	243	2	61	80	0.7625000
NODE_14382_length_744_cov_35.333333	216	296	0	19	80	0.2375000
NODE_14382_length_744_cov_35.333333	216	296	2	61	80	0.7625000
NODE_14382_length_744_cov_35.333333	292	372	0	17	80	0.2125000
NODE_14382_length_744_cov_35.333333	292	372	2	44	80	0.5500000
NODE_14382_length_744_cov_35.333333	292	372	5	6	80	0.0750000
NODE_14382_length_744_cov_35.333333	292	372	8	1	80	0.0125000
NODE_14382_length_744_cov_35.333333	292	372	9	10	80	0.1250000
NODE_14382_length_744_cov_35.333333	292	372	11	2	80	0.0250000
NODE_14382_length_744_cov_35.333333	345	425	0	8	80	0.1000000
NODE_14382_length_744_cov_35.333333	345	425	5	6	80	0.0750000
NODE_14382_length_744_cov_35.333333	345	425	8	1	80	0.0125000
NODE_14382_length_744_cov_35.333333	345	425	9	10	80	0.1250000
NODE_14382_length_744_cov_35.333333	345	425	11	8	80	0.1000000
NODE_14382_length_744_cov_35.333333	345	425	13	36	80	0.4500000
NODE_14382_length_744_cov_35.333333	345	425	14	11	80	0.1375000
NODE_14383_length_744_cov_34.503876	294	374	4	51	80	0.6375000
NODE_14383_length_744_cov_34.503876	294	374	6	29	80	0.3625000
NODE_14383_length_744_cov_34.503876	347	427	2	18	80	0.2250000
NODE_14383_length_744_cov_34.503876	347	427	4	3	80	0.0375000
NODE_14383_length_744_cov_34.503876	347	427	5	1	80	0.0125000
NODE_14383_length_744_cov_34.503876	347	427	6	58	80	0.7250000
NODE_14384_length_744_cov_32.282171	333	403	0	70	70	1.0000000
NODE_14384_length_744_cov_32.282171	440	520	0	80	80	1.0000000
NODE_14384_length_744_cov_32.282171	493	573	0	80	80	1.0000000
NODE_14390_length_744_cov_4.537984	260	340	0	80	80	1.0000000
NODE_14390_length_744_cov_4.537984	313	393	0	80	80	1.0000000
NODE_14396_length_744_cov_2.784496	335	387	0	45	52	0.8653846
NODE_14396_length_744_cov_2.784496	335	387	2	3	52	0.0576923
NODE_14396_length_744_cov_2.784496	335	387	3	3	52	0.0576923
NODE_14396_length_744_cov_2.784496	335	387	4	1	52	0.0192308
NODE_14396_length_744_cov_2.784496	360	437	0	20	77	0.2597403
NODE_14396_length_744_cov_2.784496	360	437	2	3	77	0.0389610
NODE_14396_length_744_cov_2.784496	360	437	3	3	77	0.0389610
NODE_14396_length_744_cov_2.784496	360	437	4	13	77	0.1688312
NODE_14396_length_744_cov_2.784496	360	437	5	10	77	0.1298701
NODE_14396_length_744_cov_2.784496	360	437	6	26	77	0.3376623
NODE_14396_length_744_cov_2.784496	360	437	8	2	77	0.0259740
NODE_14427_length_743_cov_26.369565	354	434	0	12	80	0.1500000
NODE_14427_length_743_cov_26.369565	354	434	2	68	80	0.8500000
NODE_14427_length_743_cov_26.369565	407	487	0	61	80	0.7625000
NODE_14427_length_743_cov_26.369565	407	487	2	19	80	0.2375000
NODE_14428_length_743_cov_21.759317	138	218	4	45	80	0.5625000
NODE_14428_length_743_cov_21.759317	138	218	5	16	80	0.2000000
NODE_14428_length_743_cov_21.759317	138	218	6	2	80	0.0250000
NODE_14428_length_743_cov_21.759317	138	218	7	17	80	0.2125000
NODE_14428_length_743_cov_21.759317	191	271	2	1	80	0.0125000
NODE_14428_length_743_cov_21.759317	191	271	5	31	80	0.3875000
NODE_14428_length_743_cov_21.759317	191	271	7	36	80	0.4500000
NODE_14428_length_743_cov_21.759317	191	271	9	12	80	0.1500000
NODE_14429_length_743_cov_18.173913	213	293	0	80	80	1.0000000
NODE_14429_length_743_cov_18.173913	266	346	0	80	80	1.0000000
NODE_14431_length_743_cov_17.066770	400	480	3	4	80	0.0500000
NODE_14431_length_743_cov_17.066770	400	480	4	14	80	0.1750000
NODE_14431_length_743_cov_17.066770	400	480	6	1	80	0.0125000
NODE_14431_length_743_cov_17.066770	400	480	8	26	80	0.3250000
NODE_14431_length_743_cov_17.066770	400	480	10	35	80	0.4375000
NODE_14431_length_743_cov_17.066770	453	532	6	53	79	0.6708861
NODE_14431_length_743_cov_17.066770	453	532	10	26	79	0.3291139
NODE_14432_length_743_cov_16.354037	350	430	0	19	80	0.2375000
NODE_14432_length_743_cov_16.354037	350	430	2	61	80	0.7625000
NODE_14432_length_743_cov_16.354037	403	483	0	41	80	0.5125000
NODE_14432_length_743_cov_16.354037	403	483	2	39	80	0.4875000
NODE_14433_length_743_cov_15.667702	220	300	0	36	80	0.4500000
NODE_14433_length_743_cov_15.667702	220	300	1	6	80	0.0750000
NODE_14433_length_743_cov_15.667702	220	300	3	38	80	0.4750000
NODE_14433_length_743_cov_15.667702	273	353	1	23	80	0.2875000
NODE_14433_length_743_cov_15.667702	273	353	3	57	80	0.7125000
NODE_14433_length_743_cov_15.667702	349	429	0	37	80	0.4625000
NODE_14433_length_743_cov_15.667702	349	429	1	43	80	0.5375000
NODE_14433_length_743_cov_15.667702	402	482	0	80	80	1.0000000
NODE_14434_length_743_cov_14.975155	289	362	0	10	73	0.1369863
NODE_14434_length_743_cov_14.975155	289	362	4	1	73	0.0136986
NODE_14434_length_743_cov_14.975155	289	362	6	15	73	0.2054795
NODE_14434_length_743_cov_14.975155	289	362	8	47	73	0.6438356
NODE_14435_length_743_cov_14.100932	232	312	0	80	80	1.0000000
NODE_14435_length_743_cov_14.100932	285	365	0	80	80	1.0000000
NODE_14435_length_743_cov_14.100932	361	441	0	38	80	0.4750000
NODE_14435_length_743_cov_14.100932	361	441	2	42	80	0.5250000
NODE_14435_length_743_cov_14.100932	414	494	2	80	80	1.0000000
NODE_14436_length_743_cov_12.968944	268	348	0	80	80	1.0000000
NODE_14436_length_743_cov_12.968944	321	401	0	80	80	1.0000000
NODE_14437_length_743_cov_12.847826	485	565	0	24	80	0.3000000
NODE_14437_length_743_cov_12.847826	485	565	2	56	80	0.7000000
NODE_14437_length_743_cov_12.847826	538	618	0	16	80	0.2000000
NODE_14437_length_743_cov_12.847826	538	618	2	64	80	0.8000000
NODE_14438_length_743_cov_11.871118	403	483	0	80	80	1.0000000
NODE_14438_length_743_cov_11.871118	456	536	0	80	80	1.0000000
NODE_14439_length_743_cov_11.760870	337	417	1	2	80	0.0250000
NODE_14439_length_743_cov_11.760870	337	417	2	78	80	0.9750000
NODE_14439_length_743_cov_11.760870	390	470	0	41	80	0.5125000
NODE_14439_length_743_cov_11.760870	390	470	1	14	80	0.1750000
NODE_14439_length_743_cov_11.760870	390	470	2	25	80	0.3125000
NODE_14440_length_743_cov_9.006211	351	431	0	80	80	1.0000000
NODE_14440_length_743_cov_9.006211	404	484	0	62	80	0.7750000
NODE_14440_length_743_cov_9.006211	404	484	2	18	80	0.2250000
NODE_14441_length_743_cov_8.063665	290	370	0	54	80	0.6750000
NODE_14441_length_743_cov_8.063665	290	370	1	26	80	0.3250000
NODE_14441_length_743_cov_8.063665	343	423	0	1	80	0.0125000
NODE_14441_length_743_cov_8.063665	343	423	1	61	80	0.7625000
NODE_14441_length_743_cov_8.063665	343	423	2	18	80	0.2250000
NODE_14456_length_743_cov_2.029503	260	284	0	13	24	0.5416667
NODE_14456_length_743_cov_2.029503	260	284	2	11	24	0.4583333
NODE_14456_length_743_cov_2.029503	301	363	0	14	62	0.2258064
NODE_14456_length_743_cov_2.029503	301	363	2	48	62	0.7741935
NODE_14473_length_743_cov_0.989130	592	670	6	2	78	0.0256410
NODE_14473_length_743_cov_0.989130	592	670	8	2	78	0.0256410
NODE_14473_length_743_cov_0.989130	592	670	10	2	78	0.0256410
NODE_14473_length_743_cov_0.989130	592	670	12	7	78	0.0897436
NODE_14473_length_743_cov_0.989130	592	670	13	2	78	0.0256410
NODE_14473_length_743_cov_0.989130	592	670	52	1	78	0.0128205
NODE_14473_length_743_cov_0.989130	592	670	54	2	78	0.0256410
NODE_14473_length_743_cov_0.989130	592	670	56	7	78	0.0897436
NODE_14473_length_743_cov_0.989130	592	670	58	3	78	0.0384615
NODE_14473_length_743_cov_0.989130	592	670	62	1	78	0.0128205
NODE_14473_length_743_cov_0.989130	592	670	64	2	78	0.0256410
NODE_14473_length_743_cov_0.989130	592	670	68	6	78	0.0769231
NODE_14473_length_743_cov_0.989130	592	670	69	7	78	0.0897436
NODE_14473_length_743_cov_0.989130	592	670	70	10	78	0.1282051
NODE_14473_length_743_cov_0.989130	592	670	71	24	78	0.3076923
NODE_14477_length_742_cov_23.664075	271	351	0	5	80	0.0625000
NODE_14477_length_742_cov_23.664075	271	351	2	75	80	0.9375000
NODE_14477_length_742_cov_23.664075	324	404	0	41	80	0.5125000
NODE_14477_length_742_cov_23.664075	324	404	2	39	80	0.4875000
NODE_14478_length_742_cov_19.488336	288	368	0	80	80	1.0000000
NODE_14478_length_742_cov_19.488336	341	421	0	67	80	0.8375000
NODE_14478_length_742_cov_19.488336	341	421	2	13	80	0.1625000
NODE_14479_length_742_cov_18.528771	319	399	0	15	80	0.1875000
NODE_14479_length_742_cov_18.528771	319	399	2	65	80	0.8125000
NODE_14479_length_742_cov_18.528771	372	452	2	80	80	1.0000000
NODE_14480_length_742_cov_17.401244	126	206	0	47	80	0.5875000
NODE_14480_length_742_cov_17.401244	126	206	2	1	80	0.0125000
NODE_14480_length_742_cov_17.401244	126	206	3	23	80	0.2875000
NODE_14480_length_742_cov_17.401244	126	206	11	3	80	0.0375000
NODE_14480_length_742_cov_17.401244	126	206	13	6	80	0.0750000
NODE_14480_length_742_cov_17.401244	179	259	3	18	80	0.2250000
NODE_14480_length_742_cov_17.401244	179	259	11	3	80	0.0375000
NODE_14480_length_742_cov_17.401244	179	259	12	24	80	0.3000000
NODE_14480_length_742_cov_17.401244	179	259	13	35	80	0.4375000
NODE_14482_length_742_cov_7.679627	274	354	0	80	80	1.0000000
NODE_14482_length_742_cov_7.679627	327	407	0	80	80	1.0000000
NODE_14521_length_741_cov_12.168224	316	392	0	10	76	0.1315790
NODE_14521_length_741_cov_12.168224	316	392	2	66	76	0.8684211
NODE_14521_length_741_cov_12.168224	598	663	0	65	65	1.0000000
NODE_14522_length_741_cov_8.542056	198	278	0	80	80	1.0000000
NODE_14522_length_741_cov_8.542056	251	331	0	80	80	1.0000000
NODE_14525_length_741_cov_5.989097	457	538	12	18	81	0.2222222
NODE_14525_length_741_cov_5.989097	457	538	14	2	81	0.0246914
NODE_14525_length_741_cov_5.989097	457	538	16	1	81	0.0123457
NODE_14525_length_741_cov_5.989097	457	538	18	1	81	0.0123457
NODE_14525_length_741_cov_5.989097	457	538	20	15	81	0.1851852
NODE_14525_length_741_cov_5.989097	457	538	22	44	81	0.5432099
NODE_14536_length_741_cov_2.556075	212	289	0	22	77	0.2857143
NODE_14536_length_741_cov_2.556075	212	289	2	53	77	0.6883117
NODE_14536_length_741_cov_2.556075	212	289	4	1	77	0.0129870
NODE_14536_length_741_cov_2.556075	212	289	13	1	77	0.0129870
NODE_14571_length_740_cov_54.372855	192	272	0	80	80	1.0000000
NODE_14571_length_740_cov_54.372855	245	325	0	80	80	1.0000000
NODE_14571_length_740_cov_54.372855	321	401	0	80	80	1.0000000
NODE_14571_length_740_cov_54.372855	374	454	0	80	80	1.0000000
NODE_14572_length_740_cov_51.758190	194	274	0	80	80	1.0000000
NODE_14572_length_740_cov_51.758190	247	327	0	27	80	0.3375000
NODE_14572_length_740_cov_51.758190	247	327	2	53	80	0.6625000
NODE_14573_length_740_cov_34.185647	359	439	0	80	80	1.0000000
NODE_14573_length_740_cov_34.185647	412	492	0	80	80	1.0000000
NODE_14574_length_740_cov_24.794072	286	366	0	62	80	0.7750000
NODE_14574_length_740_cov_24.794072	286	366	4	18	80	0.2250000
NODE_14574_length_740_cov_24.794072	339	419	0	9	80	0.1125000
NODE_14574_length_740_cov_24.794072	339	419	4	19	80	0.2375000
NODE_14574_length_740_cov_24.794072	339	419	7	1	80	0.0125000
NODE_14574_length_740_cov_24.794072	339	419	8	51	80	0.6375000
NODE_14575_length_740_cov_20.361934	316	396	0	77	80	0.9625000
NODE_14575_length_740_cov_20.361934	316	396	2	3	80	0.0375000
NODE_14575_length_740_cov_20.361934	369	449	0	80	80	1.0000000
NODE_14576_length_740_cov_18.982839	266	348	0	82	82	1.0000000
NODE_14576_length_740_cov_18.982839	321	401	0	80	80	1.0000000
NODE_14577_length_740_cov_16.755070	354	434	0	28	80	0.3500000
NODE_14577_length_740_cov_16.755070	354	434	2	18	80	0.2250000
NODE_14577_length_740_cov_16.755070	354	434	4	3	80	0.0375000
NODE_14577_length_740_cov_16.755070	354	434	6	14	80	0.1750000
NODE_14577_length_740_cov_16.755070	354	434	8	15	80	0.1875000
NODE_14577_length_740_cov_16.755070	354	434	10	2	80	0.0250000
NODE_14577_length_740_cov_16.755070	407	487	0	80	80	1.0000000
NODE_14579_length_740_cov_7.585023	206	286	0	80	80	1.0000000
NODE_14579_length_740_cov_7.585023	259	339	0	80	80	1.0000000
NODE_14580_length_740_cov_7.174727	165	245	0	51	80	0.6375000
NODE_14580_length_740_cov_7.174727	165	245	2	29	80	0.3625000
NODE_14580_length_740_cov_7.174727	218	298	2	80	80	1.0000000
NODE_14614_length_739_cov_52.970312	346	426	0	80	80	1.0000000
NODE_14614_length_739_cov_52.970312	399	479	0	80	80	1.0000000
NODE_14615_length_739_cov_31.175000	204	284	0	80	80	1.0000000
NODE_14615_length_739_cov_31.175000	257	337	0	80	80	1.0000000
NODE_14616_length_739_cov_25.482813	487	567	0	80	80	1.0000000
NODE_14616_length_739_cov_25.482813	540	620	0	80	80	1.0000000
NODE_14617_length_739_cov_24.871875	191	271	2	40	80	0.5000000
NODE_14617_length_739_cov_24.871875	191	271	4	40	80	0.5000000
NODE_14617_length_739_cov_24.871875	244	324	0	25	80	0.3125000
NODE_14617_length_739_cov_24.871875	244	324	2	55	80	0.6875000
NODE_14618_length_739_cov_18.360937	146	226	0	80	80	1.0000000
NODE_14618_length_739_cov_18.360937	199	279	0	80	80	1.0000000
NODE_14619_length_739_cov_13.195312	273	353	2	80	80	1.0000000
NODE_14619_length_739_cov_13.195312	326	406	0	46	80	0.5750000
NODE_14619_length_739_cov_13.195312	326	406	2	34	80	0.4250000
NODE_14620_length_739_cov_10.314063	231	311	0	80	80	1.0000000
NODE_14620_length_739_cov_10.314063	284	364	0	80	80	1.0000000
NODE_14622_length_739_cov_8.523438	468	548	0	80	80	1.0000000
NODE_14622_length_739_cov_8.523438	521	600	0	79	79	1.0000000
NODE_14623_length_739_cov_7.398438	342	422	0	61	80	0.7625000
NODE_14623_length_739_cov_7.398438	342	422	2	19	80	0.2375000
NODE_14623_length_739_cov_7.398438	395	475	0	80	80	1.0000000
NODE_14625_length_739_cov_5.826562	252	332	0	80	80	1.0000000
NODE_14625_length_739_cov_5.826562	305	385	0	80	80	1.0000000
NODE_14634_length_739_cov_3.232813	355	435	0	80	80	1.0000000
NODE_14634_length_739_cov_3.232813	408	488	0	80	80	1.0000000
NODE_14679_length_738_cov_35.278560	274	318	75	2	44	0.0454545
NODE_14679_length_738_cov_35.278560	274	318	79	4	44	0.0909091
NODE_14679_length_738_cov_35.278560	274	318	81	3	44	0.0681818
NODE_14679_length_738_cov_35.278560	274	318	83	1	44	0.0227273
NODE_14679_length_738_cov_35.278560	274	318	85	5	44	0.1136364
NODE_14679_length_738_cov_35.278560	274	318	87	5	44	0.1136364
NODE_14679_length_738_cov_35.278560	274	318	89	3	44	0.0681818
NODE_14679_length_738_cov_35.278560	274	318	90	3	44	0.0681818
NODE_14679_length_738_cov_35.278560	274	318	92	2	44	0.0454545
NODE_14679_length_738_cov_35.278560	274	318	94	2	44	0.0454545
NODE_14679_length_738_cov_35.278560	274	318	96	8	44	0.1818182
NODE_14679_length_738_cov_35.278560	274	318	101	1	44	0.0227273
NODE_14679_length_738_cov_35.278560	274	318	102	3	44	0.0681818
NODE_14679_length_738_cov_35.278560	274	318	103	1	44	0.0227273
NODE_14679_length_738_cov_35.278560	274	318	104	1	44	0.0227273
NODE_14680_length_738_cov_21.672926	208	288	0	9	80	0.1125000
NODE_14680_length_738_cov_21.672926	208	288	2	46	80	0.5750000
NODE_14680_length_738_cov_21.672926	208	288	4	25	80	0.3125000
NODE_14680_length_738_cov_21.672926	261	341	0	10	80	0.1250000
NODE_14680_length_738_cov_21.672926	261	341	2	7	80	0.0875000
NODE_14680_length_738_cov_21.672926	261	341	4	63	80	0.7875000
NODE_14681_length_738_cov_15.665102	302	382	0	80	80	1.0000000
NODE_14681_length_738_cov_15.665102	355	435	0	80	80	1.0000000
NODE_14682_length_738_cov_15.661972	338	418	0	80	80	1.0000000
NODE_14682_length_738_cov_15.661972	391	471	0	48	80	0.6000000
NODE_14682_length_738_cov_15.661972	391	471	2	32	80	0.4000000
NODE_14683_length_738_cov_12.594679	49	129	9	46	80	0.5750000
NODE_14683_length_738_cov_12.594679	49	129	10	34	80	0.4250000
NODE_14683_length_738_cov_12.594679	102	182	0	38	80	0.4750000
NODE_14683_length_738_cov_12.594679	102	182	9	42	80	0.5250000
NODE_14683_length_738_cov_12.594679	178	258	0	80	80	1.0000000
NODE_14683_length_738_cov_12.594679	231	311	0	80	80	1.0000000
NODE_14691_length_738_cov_4.056338	254	326	0	3	72	0.0416667
NODE_14691_length_738_cov_4.056338	254	326	2	69	72	0.9583333
NODE_14691_length_738_cov_4.056338	437	528	0	51	91	0.5604396
NODE_14691_length_738_cov_4.056338	437	528	2	28	91	0.3076923
NODE_14691_length_738_cov_4.056338	437	528	4	11	91	0.1208791
NODE_14691_length_738_cov_4.056338	437	528	6	1	91	0.0109890
NODE_14724_length_737_cov_22.363636	303	383	0	1	80	0.0125000
NODE_14724_length_737_cov_22.363636	303	383	2	79	80	0.9875000
NODE_14724_length_737_cov_22.363636	356	436	0	17	80	0.2125000
NODE_14724_length_737_cov_22.363636	356	436	2	63	80	0.7875000
NODE_14725_length_737_cov_21.318182	208	288	0	80	80	1.0000000
NODE_14725_length_737_cov_21.318182	261	341	0	80	80	1.0000000
NODE_14726_length_737_cov_17.161442	346	426	0	12	80	0.1500000
NODE_14726_length_737_cov_17.161442	346	426	2	68	80	0.8500000
NODE_14726_length_737_cov_17.161442	399	479	0	12	80	0.1500000
NODE_14726_length_737_cov_17.161442	399	479	2	68	80	0.8500000
NODE_14727_length_737_cov_11.835423	211	291	2	5	80	0.0625000
NODE_14727_length_737_cov_11.835423	211	291	6	75	80	0.9375000
NODE_14727_length_737_cov_11.835423	264	344	0	35	80	0.4375000
NODE_14727_length_737_cov_11.835423	264	344	1	17	80	0.2125000
NODE_14727_length_737_cov_11.835423	264	344	2	6	80	0.0750000
NODE_14727_length_737_cov_11.835423	264	344	6	22	80	0.2750000
NODE_14729_length_737_cov_6.782132	488	548	0	60	60	1.0000000
NODE_14732_length_737_cov_6.089342	241	321	8	12	80	0.1500000
NODE_14732_length_737_cov_6.089342	241	321	10	8	80	0.1000000
NODE_14732_length_737_cov_6.089342	241	321	12	12	80	0.1500000
NODE_14732_length_737_cov_6.089342	241	321	16	13	80	0.1625000
NODE_14732_length_737_cov_6.089342	241	321	18	1	80	0.0125000
NODE_14732_length_737_cov_6.089342	241	321	22	34	80	0.4250000
NODE_14732_length_737_cov_6.089342	294	374	0	6	80	0.0750000
NODE_14732_length_737_cov_6.089342	294	374	7	1	80	0.0125000
NODE_14732_length_737_cov_6.089342	294	374	8	58	80	0.7250000
NODE_14732_length_737_cov_6.089342	294	374	10	8	80	0.1000000
NODE_14732_length_737_cov_6.089342	294	374	12	7	80	0.0875000
NODE_14747_length_737_cov_2.548589	386	416	0	30	30	1.0000000
NODE_14781_length_736_cov_46.601256	226	306	0	43	80	0.5375000
NODE_14781_length_736_cov_46.601256	226	306	1	37	80	0.4625000
NODE_14781_length_736_cov_46.601256	279	359	1	80	80	1.0000000
NODE_14782_length_736_cov_32.442700	215	295	0	12	80	0.1500000
NODE_14782_length_736_cov_32.442700	215	295	2	68	80	0.8500000
NODE_14782_length_736_cov_32.442700	268	350	0	41	82	0.5000000
NODE_14782_length_736_cov_32.442700	268	350	2	41	82	0.5000000
NODE_14783_length_736_cov_26.364207	220	300	0	80	80	1.0000000
NODE_14783_length_736_cov_26.364207	273	353	0	80	80	1.0000000
NODE_14785_length_736_cov_10.317111	313	393	0	63	80	0.7875000
NODE_14785_length_736_cov_10.317111	313	393	4	17	80	0.2125000
NODE_14785_length_736_cov_10.317111	366	446	0	10	80	0.1250000
NODE_14785_length_736_cov_10.317111	366	446	4	70	80	0.8750000
NODE_14786_length_736_cov_9.188383	292	372	0	80	80	1.0000000
NODE_14786_length_736_cov_9.188383	345	425	0	80	80	1.0000000
NODE_14787_length_736_cov_8.149137	315	391	0	76	76	1.0000000
NODE_14787_length_736_cov_8.149137	365	445	0	80	80	1.0000000
NODE_14788_length_736_cov_8.103611	295	375	0	80	80	1.0000000
NODE_14788_length_736_cov_8.103611	348	428	0	80	80	1.0000000
NODE_14789_length_736_cov_7.513344	239	319	1	5	80	0.0625000
NODE_14789_length_736_cov_7.513344	239	319	2	75	80	0.9375000
NODE_14789_length_736_cov_7.513344	292	372	0	53	80	0.6625000
NODE_14789_length_736_cov_7.513344	292	372	1	5	80	0.0625000
NODE_14789_length_736_cov_7.513344	292	372	2	22	80	0.2750000
NODE_14792_length_736_cov_5.967033	253	333	0	80	80	1.0000000
NODE_14792_length_736_cov_5.967033	306	386	0	80	80	1.0000000
NODE_14795_length_736_cov_4.908948	258	338	0	43	80	0.5375000
NODE_14795_length_736_cov_4.908948	258	338	2	37	80	0.4625000
NODE_14795_length_736_cov_4.908948	311	391	0	80	80	1.0000000
NODE_14825_length_735_cov_21.099057	265	345	0	56	80	0.7000000
NODE_14825_length_735_cov_21.099057	265	345	2	24	80	0.3000000
NODE_14825_length_735_cov_21.099057	318	398	0	22	80	0.2750000
NODE_14825_length_735_cov_21.099057	318	398	2	58	80	0.7250000
NODE_14826_length_735_cov_16.696541	190	270	0	80	80	1.0000000
NODE_14826_length_735_cov_16.696541	243	323	0	80	80	1.0000000
NODE_14826_length_735_cov_16.696541	479	538	2	59	59	1.0000000
NODE_14827_length_735_cov_13.143082	231	311	0	80	80	1.0000000
NODE_14827_length_735_cov_13.143082	284	364	0	80	80	1.0000000
NODE_14828_length_735_cov_12.415094	434	514	0	22	80	0.2750000
NODE_14828_length_735_cov_12.415094	434	514	2	58	80	0.7250000
NODE_14828_length_735_cov_12.415094	487	567	2	80	80	1.0000000
NODE_14836_length_735_cov_5.603774	326	394	0	68	68	1.0000000
NODE_14836_length_735_cov_5.603774	367	409	0	42	42	1.0000000
NODE_14880_length_734_cov_26.787402	209	289	0	12	80	0.1500000
NODE_14880_length_734_cov_26.787402	209	289	2	68	80	0.8500000
NODE_14880_length_734_cov_26.787402	262	342	0	65	80	0.8125000
NODE_14880_length_734_cov_26.787402	262	342	2	15	80	0.1875000
NODE_14881_length_734_cov_23.214173	200	280	0	80	80	1.0000000
NODE_14881_length_734_cov_23.214173	253	333	0	80	80	1.0000000
NODE_14883_length_734_cov_21.645669	245	325	2	45	80	0.5625000
NODE_14883_length_734_cov_21.645669	245	325	4	35	80	0.4375000
NODE_14883_length_734_cov_21.645669	298	378	0	35	80	0.4375000
NODE_14883_length_734_cov_21.645669	298	378	2	45	80	0.5625000
NODE_14884_length_734_cov_14.393701	249	329	0	80	80	1.0000000
NODE_14884_length_734_cov_14.393701	302	382	0	36	80	0.4500000
NODE_14884_length_734_cov_14.393701	302	382	2	44	80	0.5500000
NODE_14885_length_734_cov_11.324409	133	196	0	63	63	1.0000000
NODE_14885_length_734_cov_11.324409	169	229	0	60	60	1.0000000
NODE_14886_length_734_cov_10.872441	302	331	0	10	29	0.3448276
NODE_14886_length_734_cov_10.872441	302	331	2	2	29	0.0689655
NODE_14886_length_734_cov_10.872441	302	331	4	15	29	0.5172414
NODE_14886_length_734_cov_10.872441	302	331	6	2	29	0.0689655
NODE_14890_length_734_cov_6.352756	371	451	0	80	80	1.0000000
NODE_14890_length_734_cov_6.352756	424	504	0	80	80	1.0000000
NODE_14896_length_734_cov_2.705512	231	302	0	71	71	1.0000000
NODE_14934_length_733_cov_35.041009	268	348	0	80	80	1.0000000
NODE_14934_length_733_cov_35.041009	321	402	0	81	81	1.0000000
NODE_14935_length_733_cov_29.810726	28	108	0	4	80	0.0500000
NODE_14935_length_733_cov_29.810726	28	108	4	63	80	0.7875000
NODE_14935_length_733_cov_29.810726	28	108	6	13	80	0.1625000
NODE_14935_length_733_cov_29.810726	81	161	2	33	80	0.4125000
NODE_14935_length_733_cov_29.810726	81	161	4	14	80	0.1750000
NODE_14935_length_733_cov_29.810726	81	161	6	33	80	0.4125000
NODE_14935_length_733_cov_29.810726	157	237	2	36	80	0.4500000
NODE_14935_length_733_cov_29.810726	157	237	4	44	80	0.5500000
NODE_14935_length_733_cov_29.810726	210	290	0	13	80	0.1625000
NODE_14935_length_733_cov_29.810726	210	290	2	19	80	0.2375000
NODE_14935_length_733_cov_29.810726	210	290	4	48	80	0.6000000
NODE_14936_length_733_cov_13.738170	333	413	0	80	80	1.0000000
NODE_14936_length_733_cov_13.738170	386	466	0	80	80	1.0000000
NODE_14937_length_733_cov_11.471609	314	389	0	75	75	1.0000000
NODE_14938_length_733_cov_11.321767	245	325	0	80	80	1.0000000
NODE_14938_length_733_cov_11.321767	298	378	0	80	80	1.0000000
NODE_14940_length_733_cov_8.481073	318	395	0	40	77	0.5194805
NODE_14940_length_733_cov_8.481073	318	395	2	37	77	0.4805195
NODE_14940_length_733_cov_8.481073	371	451	0	80	80	1.0000000
NODE_14944_length_733_cov_5.485804	659	715	12	19	56	0.3392857
NODE_14944_length_733_cov_5.485804	659	715	14	6	56	0.1071429
NODE_14944_length_733_cov_5.485804	659	715	15	6	56	0.1071429
NODE_14944_length_733_cov_5.485804	659	715	17	9	56	0.1607143
NODE_14944_length_733_cov_5.485804	659	715	22	3	56	0.0535714
NODE_14944_length_733_cov_5.485804	659	715	23	9	56	0.1607143
NODE_14944_length_733_cov_5.485804	659	715	24	4	56	0.0714286
NODE_14944_length_733_cov_5.485804	696	733	6	4	37	0.1081081
NODE_14944_length_733_cov_5.485804	696	733	8	5	37	0.1351351
NODE_14944_length_733_cov_5.485804	696	733	10	6	37	0.1621622
NODE_14944_length_733_cov_5.485804	696	733	12	22	37	0.5945946
NODE_14957_length_733_cov_2.272871	312	392	0	80	80	1.0000000
NODE_14957_length_733_cov_2.272871	365	445	0	80	80	1.0000000
NODE_14975_length_732_cov_19.519747	229	309	0	80	80	1.0000000
NODE_14975_length_732_cov_19.519747	282	362	0	50	80	0.6250000
NODE_14975_length_732_cov_19.519747	282	362	2	30	80	0.3750000
NODE_14976_length_732_cov_10.846761	247	327	6	43	80	0.5375000
NODE_14976_length_732_cov_10.846761	247	327	8	37	80	0.4625000
NODE_14976_length_732_cov_10.846761	300	380	0	33	80	0.4125000
NODE_14976_length_732_cov_10.846761	300	380	4	15	80	0.1875000
NODE_14976_length_732_cov_10.846761	300	380	6	32	80	0.4000000
NODE_14977_length_732_cov_9.807267	276	356	0	80	80	1.0000000
NODE_14977_length_732_cov_9.807267	329	409	0	80	80	1.0000000
NODE_14978_length_732_cov_8.053712	415	495	0	80	80	1.0000000
NODE_14978_length_732_cov_8.053712	468	548	0	80	80	1.0000000
NODE_14980_length_732_cov_5.194313	319	399	0	80	80	1.0000000
NODE_14980_length_732_cov_5.194313	372	452	0	80	80	1.0000000
NODE_14981_length_732_cov_4.998420	293	373	0	80	80	1.0000000
NODE_14981_length_732_cov_4.998420	346	426	0	80	80	1.0000000
NODE_14983_length_732_cov_4.758294	483	524	0	41	41	1.0000000
NODE_15021_length_731_cov_36.123418	464	544	2	4	80	0.0500000
NODE_15021_length_731_cov_36.123418	464	544	4	75	80	0.9375000
NODE_15021_length_731_cov_36.123418	464	544	6	1	80	0.0125000
NODE_15021_length_731_cov_36.123418	517	597	2	57	80	0.7125000
NODE_15021_length_731_cov_36.123418	517	597	4	22	80	0.2750000
NODE_15021_length_731_cov_36.123418	517	597	6	1	80	0.0125000
NODE_15022_length_731_cov_27.721519	294	374	2	28	80	0.3500000
NODE_15022_length_731_cov_27.721519	294	374	4	15	80	0.1875000
NODE_15022_length_731_cov_27.721519	294	374	10	9	80	0.1125000
NODE_15022_length_731_cov_27.721519	294	374	11	6	80	0.0750000
NODE_15022_length_731_cov_27.721519	294	374	12	22	80	0.2750000
NODE_15022_length_731_cov_27.721519	347	427	10	3	80	0.0375000
NODE_15022_length_731_cov_27.721519	347	427	11	21	80	0.2625000
NODE_15022_length_731_cov_27.721519	347	427	12	26	80	0.3250000
NODE_15022_length_731_cov_27.721519	347	427	13	30	80	0.3750000
NODE_15023_length_731_cov_19.655063	394	474	0	80	80	1.0000000
NODE_15023_length_731_cov_19.655063	447	527	0	80	80	1.0000000
NODE_15024_length_731_cov_16.346519	429	509	0	80	80	1.0000000
NODE_15024_length_731_cov_16.346519	482	562	0	80	80	1.0000000
NODE_15025_length_731_cov_13.892405	321	401	0	80	80	1.0000000
NODE_15025_length_731_cov_13.892405	374	454	0	80	80	1.0000000
NODE_15027_length_731_cov_8.800633	218	298	0	80	80	1.0000000
NODE_15027_length_731_cov_8.800633	271	352	0	81	81	1.0000000
NODE_15028_length_731_cov_7.658228	335	406	2	71	71	1.0000000
NODE_15028_length_731_cov_7.658228	387	468	0	58	81	0.7160494
NODE_15028_length_731_cov_7.658228	387	468	2	23	81	0.2839506
NODE_15031_length_731_cov_5.471519	261	341	0	59	80	0.7375000
NODE_15031_length_731_cov_5.471519	261	341	2	21	80	0.2625000
NODE_15031_length_731_cov_5.471519	314	394	0	6	80	0.0750000
NODE_15031_length_731_cov_5.471519	314	394	2	74	80	0.9250000
NODE_15034_length_731_cov_4.083861	361	441	0	22	80	0.2750000
NODE_15034_length_731_cov_4.083861	361	441	4	58	80	0.7250000
NODE_15034_length_731_cov_4.083861	458	482	0	24	24	1.0000000
NODE_15050_length_731_cov_2.226266	466	548	2	12	82	0.1463415
NODE_15050_length_731_cov_2.226266	466	548	3	4	82	0.0487805
NODE_15050_length_731_cov_2.226266	466	548	4	53	82	0.6463414
NODE_15050_length_731_cov_2.226266	466	548	6	13	82	0.1585366
NODE_15077_length_730_cov_51.556260	349	429	2	80	80	1.0000000
NODE_15077_length_730_cov_51.556260	402	482	0	6	80	0.0750000
NODE_15077_length_730_cov_51.556260	402	482	2	74	80	0.9250000
NODE_15078_length_730_cov_39.862124	370	450	0	80	80	1.0000000
NODE_15078_length_730_cov_39.862124	423	503	0	80	80	1.0000000
NODE_15079_length_730_cov_15.801902	261	341	0	44	80	0.5500000
NODE_15079_length_730_cov_15.801902	261	341	2	36	80	0.4500000
NODE_15079_length_730_cov_15.801902	314	394	0	30	80	0.3750000
NODE_15079_length_730_cov_15.801902	314	394	2	50	80	0.6250000
NODE_15080_length_730_cov_11.746434	242	322	0	80	80	1.0000000
NODE_15080_length_730_cov_11.746434	295	375	0	80	80	1.0000000
NODE_15081_length_730_cov_9.209192	358	438	0	80	80	1.0000000
NODE_15081_length_730_cov_9.209192	411	483	0	72	72	1.0000000
NODE_15131_length_729_cov_44.188889	418	498	0	80	80	1.0000000
NODE_15131_length_729_cov_44.188889	471	551	0	80	80	1.0000000
NODE_15132_length_729_cov_40.390476	330	410	0	80	80	1.0000000
NODE_15132_length_729_cov_40.390476	383	463	0	80	80	1.0000000
NODE_15133_length_729_cov_35.973016	231	311	0	80	80	1.0000000
NODE_15133_length_729_cov_35.973016	284	363	0	79	79	1.0000000
NODE_15134_length_729_cov_18.357143	170	250	0	22	80	0.2750000
NODE_15134_length_729_cov_18.357143	170	250	4	22	80	0.2750000
NODE_15134_length_729_cov_18.357143	170	250	8	36	80	0.4500000
NODE_15134_length_729_cov_18.357143	223	303	8	43	80	0.5375000
NODE_15134_length_729_cov_18.357143	223	303	12	9	80	0.1125000
NODE_15134_length_729_cov_18.357143	223	303	16	28	80	0.3500000
NODE_15135_length_729_cov_17.928571	194	274	2	24	80	0.3000000
NODE_15135_length_729_cov_17.928571	194	274	4	12	80	0.1500000
NODE_15135_length_729_cov_17.928571	194	274	6	30	80	0.3750000
NODE_15135_length_729_cov_17.928571	194	274	10	8	80	0.1000000
NODE_15135_length_729_cov_17.928571	194	274	12	6	80	0.0750000
NODE_15135_length_729_cov_17.928571	247	327	6	28	80	0.3500000
NODE_15135_length_729_cov_17.928571	247	327	8	2	80	0.0250000
NODE_15135_length_729_cov_17.928571	247	327	10	44	80	0.5500000
NODE_15135_length_729_cov_17.928571	247	327	12	6	80	0.0750000
NODE_15136_length_729_cov_17.373016	369	449	0	80	80	1.0000000
NODE_15136_length_729_cov_17.373016	422	502	0	80	80	1.0000000
NODE_15137_length_729_cov_12.452381	347	427	0	80	80	1.0000000
NODE_15137_length_729_cov_12.452381	400	480	0	80	80	1.0000000
NODE_15138_length_729_cov_10.388889	296	376	0	80	80	1.0000000
NODE_15138_length_729_cov_10.388889	349	429	0	80	80	1.0000000
NODE_15185_length_728_cov_23.503975	338	418	2	80	80	1.0000000
NODE_15185_length_728_cov_23.503975	391	471	0	53	80	0.6625000
NODE_15185_length_728_cov_23.503975	391	471	2	27	80	0.3375000
NODE_15186_length_728_cov_22.496025	310	390	0	80	80	1.0000000
NODE_15186_length_728_cov_22.496025	363	443	0	80	80	1.0000000
NODE_15187_length_728_cov_16.596184	257	337	0	80	80	1.0000000
NODE_15187_length_728_cov_16.596184	310	387	0	37	77	0.4805195
NODE_15187_length_728_cov_16.596184	310	387	2	40	77	0.5194805
NODE_15188_length_728_cov_16.114467	192	272	0	80	80	1.0000000
NODE_15188_length_728_cov_16.114467	245	325	0	80	80	1.0000000
NODE_15189_length_728_cov_15.128776	298	377	0	41	79	0.5189874
NODE_15189_length_728_cov_15.128776	298	377	2	38	79	0.4810127
NODE_15189_length_728_cov_15.128776	350	430	0	80	80	1.0000000
NODE_15190_length_728_cov_10.613672	269	349	0	80	80	1.0000000
NODE_15190_length_728_cov_10.613672	322	402	0	80	80	1.0000000
NODE_15191_length_728_cov_7.613672	408	488	0	80	80	1.0000000
NODE_15191_length_728_cov_7.613672	461	541	0	80	80	1.0000000
NODE_15196_length_728_cov_3.405405	335	415	0	16	80	0.2000000
NODE_15196_length_728_cov_3.405405	335	415	2	64	80	0.8000000
NODE_15244_length_727_cov_34.883758	57	137	0	71	80	0.8875000
NODE_15244_length_727_cov_34.883758	57	137	2	9	80	0.1125000
NODE_15244_length_727_cov_34.883758	57	137	0	71	80	0.8875000
NODE_15244_length_727_cov_34.883758	57	137	2	9	80	0.1125000
NODE_15244_length_727_cov_34.883758	57	137	0	71	80	0.8875000
NODE_15244_length_727_cov_34.883758	57	137	2	9	80	0.1125000
NODE_15244_length_727_cov_34.883758	110	190	0	18	80	0.2250000
NODE_15244_length_727_cov_34.883758	110	190	2	62	80	0.7750000
NODE_15244_length_727_cov_34.883758	110	190	0	18	80	0.2250000
NODE_15244_length_727_cov_34.883758	110	190	2	62	80	0.7750000
NODE_15245_length_727_cov_32.025478	275	355	0	19	80	0.2375000
NODE_15245_length_727_cov_32.025478	275	355	2	61	80	0.7625000
NODE_15245_length_727_cov_32.025478	328	408	0	47	80	0.5875000
NODE_15245_length_727_cov_32.025478	328	408	2	33	80	0.4125000
NODE_15246_length_727_cov_28.523885	307	381	0	74	74	1.0000000
NODE_15246_length_727_cov_28.523885	360	381	0	21	21	1.0000000
NODE_15246_length_727_cov_28.523885	378	415	0	37	37	1.0000000
NODE_15247_length_727_cov_25.826433	325	405	0	4	80	0.0500000
NODE_15247_length_727_cov_25.826433	325	405	2	68	80	0.8500000
NODE_15247_length_727_cov_25.826433	325	405	4	8	80	0.1000000
NODE_15247_length_727_cov_25.826433	378	458	0	57	80	0.7125000
NODE_15247_length_727_cov_25.826433	378	458	2	23	80	0.2875000
NODE_15248_length_727_cov_22.253185	150	230	0	60	80	0.7500000
NODE_15248_length_727_cov_22.253185	150	230	4	20	80	0.2500000
NODE_15248_length_727_cov_22.253185	203	283	0	7	80	0.0875000
NODE_15248_length_727_cov_22.253185	203	283	4	24	80	0.3000000
NODE_15248_length_727_cov_22.253185	203	283	6	49	80	0.6125000
NODE_15249_length_727_cov_18.972930	263	343	0	22	80	0.2750000
NODE_15249_length_727_cov_18.972930	263	343	2	58	80	0.7250000
NODE_15249_length_727_cov_18.972930	316	396	0	6	80	0.0750000
NODE_15249_length_727_cov_18.972930	316	396	2	74	80	0.9250000
NODE_15250_length_727_cov_15.531847	269	349	0	44	80	0.5500000
NODE_15250_length_727_cov_15.531847	269	349	4	36	80	0.4500000
NODE_15250_length_727_cov_15.531847	322	402	4	80	80	1.0000000
NODE_15252_length_727_cov_10.178344	280	360	0	58	80	0.7250000
NODE_15252_length_727_cov_10.178344	280	360	2	22	80	0.2750000
NODE_15252_length_727_cov_10.178344	333	413	0	13	80	0.1625000
NODE_15252_length_727_cov_10.178344	333	413	2	67	80	0.8375000
NODE_15258_length_727_cov_4.955414	360	440	0	69	80	0.8625000
NODE_15258_length_727_cov_4.955414	360	440	2	11	80	0.1375000
NODE_15258_length_727_cov_4.955414	413	493	0	80	80	1.0000000
NODE_15287_length_726_cov_52.923445	415	495	0	60	80	0.7500000
NODE_15287_length_726_cov_52.923445	415	495	3	2	80	0.0250000
NODE_15287_length_726_cov_52.923445	415	495	4	18	80	0.2250000
NODE_15287_length_726_cov_52.923445	468	548	0	7	80	0.0875000
NODE_15287_length_726_cov_52.923445	468	548	3	2	80	0.0250000
NODE_15287_length_726_cov_52.923445	468	548	4	71	80	0.8875000
NODE_15288_length_726_cov_35.896332	108	188	0	79	80	0.9875000
NODE_15288_length_726_cov_35.896332	108	188	2	1	80	0.0125000
NODE_15288_length_726_cov_35.896332	161	241	0	80	80	1.0000000
NODE_15288_length_726_cov_35.896332	237	317	0	80	80	1.0000000
NODE_15288_length_726_cov_35.896332	290	370	0	80	80	1.0000000
NODE_15291_length_726_cov_8.534290	355	435	0	80	80	1.0000000
NODE_15291_length_726_cov_8.534290	408	488	0	80	80	1.0000000
NODE_15330_length_725_cov_40.856230	203	283	0	80	80	1.0000000
NODE_15330_length_725_cov_40.856230	256	336	0	80	80	1.0000000
NODE_15330_length_725_cov_40.856230	332	412	0	24	80	0.3000000
NODE_15330_length_725_cov_40.856230	332	412	2	27	80	0.3375000
NODE_15330_length_725_cov_40.856230	332	412	4	19	80	0.2375000
NODE_15330_length_725_cov_40.856230	332	412	6	10	80	0.1250000
NODE_15330_length_725_cov_40.856230	385	465	2	5	80	0.0625000
NODE_15330_length_725_cov_40.856230	385	465	4	31	80	0.3875000
NODE_15330_length_725_cov_40.856230	385	465	6	44	80	0.5500000
NODE_15331_length_725_cov_25.036741	366	446	2	80	80	1.0000000
NODE_15331_length_725_cov_25.036741	419	499	0	29	80	0.3625000
NODE_15331_length_725_cov_25.036741	419	499	2	51	80	0.6375000
NODE_15332_length_725_cov_23.009585	455	536	2	34	81	0.4197531
NODE_15332_length_725_cov_23.009585	455	536	4	47	81	0.5802469
NODE_15333_length_725_cov_20.474441	112	192	0	80	80	1.0000000
NODE_15333_length_725_cov_20.474441	165	245	0	80	80	1.0000000
NODE_15334_length_725_cov_15.455272	106	186	0	61	80	0.7625000
NODE_15334_length_725_cov_15.455272	106	186	2	19	80	0.2375000
NODE_15334_length_725_cov_15.455272	159	239	0	80	80	1.0000000
NODE_15334_length_725_cov_15.455272	235	315	0	80	80	1.0000000
NODE_15334_length_725_cov_15.455272	288	368	0	80	80	1.0000000
NODE_15335_length_725_cov_10.426518	289	369	0	30	80	0.3750000
NODE_15335_length_725_cov_10.426518	289	369	4	18	80	0.2250000
NODE_15335_length_725_cov_10.426518	289	369	6	32	80	0.4000000
NODE_15335_length_725_cov_10.426518	342	422	6	33	80	0.4125000
NODE_15335_length_725_cov_10.426518	342	422	8	47	80	0.5875000
NODE_15337_length_725_cov_7.781150	189	269	0	27	80	0.3375000
NODE_15337_length_725_cov_7.781150	189	269	2	53	80	0.6625000
NODE_15337_length_725_cov_7.781150	242	322	0	44	80	0.5500000
NODE_15337_length_725_cov_7.781150	242	322	2	36	80	0.4500000
NODE_15388_length_724_cov_28.132800	354	434	4	80	80	1.0000000
NODE_15388_length_724_cov_28.132800	407	473	0	35	66	0.5303030
NODE_15388_length_724_cov_28.132800	407	473	4	31	66	0.4696970
NODE_15389_length_724_cov_24.710400	376	461	2	74	85	0.8705882
NODE_15389_length_724_cov_24.710400	376	461	4	11	85	0.1294118
NODE_15389_length_724_cov_24.710400	434	514	0	16	80	0.2000000
NODE_15389_length_724_cov_24.710400	434	514	2	57	80	0.7125000
NODE_15389_length_724_cov_24.710400	434	514	4	7	80	0.0875000
NODE_15390_length_724_cov_13.960000	152	232	0	80	80	1.0000000
NODE_15390_length_724_cov_13.960000	205	248	0	43	43	1.0000000
NODE_15390_length_724_cov_13.960000	237	286	0	49	49	1.0000000
NODE_15390_length_724_cov_13.960000	259	302	0	43	43	1.0000000
NODE_15390_length_724_cov_13.960000	288	340	0	52	52	1.0000000
NODE_15390_length_724_cov_13.960000	313	393	0	80	80	1.0000000
NODE_15391_length_724_cov_13.065600	215	295	0	80	80	1.0000000
NODE_15391_length_724_cov_13.065600	268	347	0	79	79	1.0000000
NODE_15393_length_724_cov_10.358400	257	337	0	80	80	1.0000000
NODE_15393_length_724_cov_10.358400	310	385	0	75	75	1.0000000
NODE_15396_length_724_cov_6.451200	151	231	0	80	80	1.0000000
NODE_15396_length_724_cov_6.451200	202	282	0	80	80	1.0000000
NODE_15397_length_724_cov_5.921600	165	213	4	48	48	1.0000000
NODE_15399_length_724_cov_5.028800	416	469	2	53	53	1.0000000
NODE_15399_length_724_cov_5.028800	488	526	0	27	38	0.7105263
NODE_15399_length_724_cov_5.028800	488	526	2	11	38	0.2894737
NODE_15403_length_724_cov_3.315200	166	246	0	80	80	1.0000000
NODE_15403_length_724_cov_3.315200	219	299	0	80	80	1.0000000
NODE_15442_length_723_cov_81.453526	205	285	2	56	80	0.7000000
NODE_15442_length_723_cov_81.453526	205	285	8	24	80	0.3000000
NODE_15442_length_723_cov_81.453526	258	338	2	10	80	0.1250000
NODE_15442_length_723_cov_81.453526	258	338	8	70	80	0.8750000
NODE_15443_length_723_cov_33.075321	254	329	0	75	75	1.0000000
NODE_15443_length_723_cov_33.075321	307	387	0	80	80	1.0000000
NODE_15444_length_723_cov_25.410256	291	371	0	80	80	1.0000000
NODE_15444_length_723_cov_25.410256	344	424	0	80	80	1.0000000
NODE_15445_length_723_cov_18.097756	233	313	0	80	80	1.0000000
NODE_15445_length_723_cov_18.097756	286	351	0	65	65	1.0000000
NODE_15446_length_723_cov_14.113782	311	391	0	80	80	1.0000000
NODE_15446_length_723_cov_14.113782	364	444	0	80	80	1.0000000
NODE_15447_length_723_cov_11.634615	299	379	0	80	80	1.0000000
NODE_15447_length_723_cov_11.634615	352	432	0	47	80	0.5875000
NODE_15447_length_723_cov_11.634615	352	432	2	33	80	0.4125000
NODE_15448_length_723_cov_8.342949	357	437	0	80	80	1.0000000
NODE_15448_length_723_cov_8.342949	410	490	0	33	80	0.4125000
NODE_15448_length_723_cov_8.342949	410	490	2	47	80	0.5875000
NODE_15455_length_723_cov_2.711538	379	422	0	43	43	1.0000000
NODE_15459_length_723_cov_2.573718	383	413	14	22	30	0.7333333
NODE_15459_length_723_cov_2.573718	383	413	15	8	30	0.2666667
NODE_15495_length_722_cov_19.182986	180	260	0	73	80	0.9125000
NODE_15495_length_722_cov_19.182986	180	260	2	7	80	0.0875000
NODE_15495_length_722_cov_19.182986	233	313	0	25	80	0.3125000
NODE_15495_length_722_cov_19.182986	233	313	2	55	80	0.6875000
NODE_15496_length_722_cov_13.582665	192	272	0	80	80	1.0000000
NODE_15496_length_722_cov_13.582665	245	326	0	81	81	1.0000000
NODE_15497_length_722_cov_9.202247	347	427	0	80	80	1.0000000
NODE_15497_length_722_cov_9.202247	400	480	0	80	80	1.0000000
NODE_15500_length_722_cov_6.707865	343	423	0	37	80	0.4625000
NODE_15500_length_722_cov_6.707865	343	423	2	43	80	0.5375000
NODE_15500_length_722_cov_6.707865	396	476	0	80	80	1.0000000
NODE_15504_length_722_cov_4.985554	332	393	0	61	61	1.0000000
NODE_15508_length_722_cov_3.977528	217	297	0	32	80	0.4000000
NODE_15508_length_722_cov_3.977528	217	297	2	48	80	0.6000000
NODE_15508_length_722_cov_3.977528	270	350	0	19	80	0.2375000
NODE_15508_length_722_cov_3.977528	270	350	2	61	80	0.7625000
NODE_15553_length_721_cov_105.927653	425	505	0	80	80	1.0000000
NODE_15553_length_721_cov_105.927653	478	558	0	80	80	1.0000000
NODE_15554_length_721_cov_49.660772	304	384	0	80	80	1.0000000
NODE_15554_length_721_cov_49.660772	357	437	0	38	80	0.4750000
NODE_15554_length_721_cov_49.660772	357	437	2	42	80	0.5250000
NODE_15555_length_721_cov_46.991961	341	421	7	2	80	0.0250000
NODE_15555_length_721_cov_46.991961	341	421	8	44	80	0.5500000
NODE_15555_length_721_cov_46.991961	341	421	10	34	80	0.4250000
NODE_15555_length_721_cov_46.991961	394	474	0	1	80	0.0125000
NODE_15555_length_721_cov_46.991961	394	474	2	51	80	0.6375000
NODE_15555_length_721_cov_46.991961	394	474	10	28	80	0.3500000
NODE_15556_length_721_cov_38.864952	208	288	0	36	80	0.4500000
NODE_15556_length_721_cov_38.864952	208	288	2	14	80	0.1750000
NODE_15556_length_721_cov_38.864952	208	288	4	30	80	0.3750000
NODE_15556_length_721_cov_38.864952	269	341	0	15	72	0.2083333
NODE_15556_length_721_cov_38.864952	269	341	2	55	72	0.7638889
NODE_15556_length_721_cov_38.864952	269	341	4	2	72	0.0277778
NODE_15556_length_721_cov_38.864952	337	417	2	36	80	0.4500000
NODE_15556_length_721_cov_38.864952	337	417	4	44	80	0.5500000
NODE_15556_length_721_cov_38.864952	390	467	0	2	77	0.0259740
NODE_15556_length_721_cov_38.864952	390	467	1	1	77	0.0129870
NODE_15556_length_721_cov_38.864952	390	467	2	50	77	0.6493506
NODE_15556_length_721_cov_38.864952	390	467	4	24	77	0.3116883
NODE_15557_length_721_cov_29.016077	192	272	0	35	80	0.4375000
NODE_15557_length_721_cov_29.016077	192	272	8	45	80	0.5625000
NODE_15557_length_721_cov_29.016077	251	325	8	74	74	1.0000000
NODE_15558_length_721_cov_26.196141	398	478	2	21	80	0.2625000
NODE_15558_length_721_cov_26.196141	398	478	4	8	80	0.1000000
NODE_15558_length_721_cov_26.196141	398	478	8	51	80	0.6375000
NODE_15558_length_721_cov_26.196141	451	531	0	7	80	0.0875000
NODE_15558_length_721_cov_26.196141	451	531	4	35	80	0.4375000
NODE_15558_length_721_cov_26.196141	451	531	6	2	80	0.0250000
NODE_15558_length_721_cov_26.196141	451	531	8	36	80	0.4500000
NODE_15560_length_721_cov_20.054662	178	258	0	66	80	0.8250000
NODE_15560_length_721_cov_20.054662	178	258	2	14	80	0.1750000
NODE_15560_length_721_cov_20.054662	231	311	0	13	80	0.1625000
NODE_15560_length_721_cov_20.054662	231	311	2	67	80	0.8375000
NODE_15561_length_721_cov_13.670418	263	343	0	80	80	1.0000000
NODE_15561_length_721_cov_13.670418	316	396	0	80	80	1.0000000
NODE_15562_length_721_cov_13.652733	268	350	0	82	82	1.0000000
NODE_15562_length_721_cov_13.652733	321	403	0	82	82	1.0000000
NODE_15563_length_721_cov_13.120579	312	392	0	49	80	0.6125000
NODE_15563_length_721_cov_13.120579	312	392	8	21	80	0.2625000
NODE_15563_length_721_cov_13.120579	312	392	10	10	80	0.1250000
NODE_15563_length_721_cov_13.120579	365	445	8	17	80	0.2125000
NODE_15563_length_721_cov_13.120579	365	445	10	63	80	0.7875000
NODE_15572_length_721_cov_4.491961	210	280	0	8	70	0.1142857
NODE_15572_length_721_cov_4.491961	210	280	4	32	70	0.4571429
NODE_15572_length_721_cov_4.491961	210	280	6	30	70	0.4285714
NODE_15572_length_721_cov_4.491961	253	333	2	9	80	0.1125000
NODE_15572_length_721_cov_4.491961	253	333	4	16	80	0.2000000
NODE_15572_length_721_cov_4.491961	253	333	6	32	80	0.4000000
NODE_15572_length_721_cov_4.491961	253	333	8	23	80	0.2875000
NODE_15572_length_721_cov_4.491961	470	521	0	51	51	1.0000000
NODE_15608_length_720_cov_17.449275	267	347	2	4	80	0.0500000
NODE_15608_length_720_cov_17.449275	267	347	4	15	80	0.1875000
NODE_15608_length_720_cov_17.449275	267	347	6	61	80	0.7625000
NODE_15608_length_720_cov_17.449275	320	400	2	22	80	0.2750000
NODE_15608_length_720_cov_17.449275	320	400	4	15	80	0.1875000
NODE_15608_length_720_cov_17.449275	320	400	6	43	80	0.5375000
NODE_15609_length_720_cov_14.814815	261	341	0	23	80	0.2875000
NODE_15609_length_720_cov_14.814815	261	341	2	57	80	0.7125000
NODE_15609_length_720_cov_14.814815	314	394	0	43	80	0.5375000
NODE_15609_length_720_cov_14.814815	314	394	2	37	80	0.4625000
NODE_15610_length_720_cov_14.107890	290	370	0	80	80	1.0000000
NODE_15610_length_720_cov_14.107890	343	423	0	80	80	1.0000000
NODE_15612_length_720_cov_12.924316	314	394	0	35	80	0.4375000
NODE_15612_length_720_cov_12.924316	314	394	4	45	80	0.5625000
NODE_15612_length_720_cov_12.924316	367	447	0	13	80	0.1625000
NODE_15612_length_720_cov_12.924316	367	447	4	67	80	0.8375000
NODE_15614_length_720_cov_10.389694	435	515	0	17	80	0.2125000
NODE_15614_length_720_cov_10.389694	435	515	2	7	80	0.0875000
NODE_15614_length_720_cov_10.389694	435	515	4	56	80	0.7000000
NODE_15614_length_720_cov_10.389694	488	568	2	34	80	0.4250000
NODE_15614_length_720_cov_10.389694	488	568	4	46	80	0.5750000
NODE_15620_length_720_cov_5.278583	309	389	0	80	80	1.0000000
NODE_15620_length_720_cov_5.278583	362	442	0	80	80	1.0000000
NODE_15624_length_720_cov_3.792271	157	235	0	4	78	0.0512821
NODE_15624_length_720_cov_3.792271	157	235	2	26	78	0.3333333
NODE_15624_length_720_cov_3.792271	157	235	4	48	78	0.6153846
NODE_15624_length_720_cov_3.792271	215	265	0	34	50	0.6800000
NODE_15624_length_720_cov_3.792271	215	265	2	16	50	0.3200000
NODE_15658_length_719_cov_30.256452	279	359	0	66	80	0.8250000
NODE_15658_length_719_cov_30.256452	279	359	2	14	80	0.1750000
NODE_15658_length_719_cov_30.256452	332	412	0	13	80	0.1625000
NODE_15658_length_719_cov_30.256452	332	412	2	67	80	0.8375000
NODE_15659_length_719_cov_29.093548	310	390	2	62	80	0.7750000
NODE_15659_length_719_cov_29.093548	310	390	3	9	80	0.1125000
NODE_15659_length_719_cov_29.093548	310	390	4	9	80	0.1125000
NODE_15659_length_719_cov_29.093548	363	443	2	78	80	0.9750000
NODE_15659_length_719_cov_29.093548	363	443	4	2	80	0.0250000
NODE_15660_length_719_cov_10.988710	195	275	0	80	80	1.0000000
NODE_15660_length_719_cov_10.988710	248	328	0	80	80	1.0000000
NODE_15661_length_719_cov_10.837097	259	339	0	80	80	1.0000000
NODE_15661_length_719_cov_10.837097	312	392	0	80	80	1.0000000
NODE_15662_length_719_cov_7.622581	288	368	0	69	80	0.8625000
NODE_15662_length_719_cov_7.622581	288	368	2	11	80	0.1375000
NODE_15662_length_719_cov_7.622581	341	421	0	16	80	0.2000000
NODE_15662_length_719_cov_7.622581	341	421	2	64	80	0.8000000
NODE_15663_length_719_cov_7.570968	351	431	0	80	80	1.0000000
NODE_15663_length_719_cov_7.570968	404	484	0	80	80	1.0000000
NODE_15672_length_719_cov_4.264516	251	281	2	13	30	0.4333333
NODE_15672_length_719_cov_4.264516	251	281	4	17	30	0.5666667
NODE_15684_length_719_cov_1.629032	88	163	10	38	75	0.5066667
NODE_15684_length_719_cov_1.629032	88	163	12	18	75	0.2400000
NODE_15684_length_719_cov_1.629032	88	163	14	19	75	0.2533333
NODE_15706_length_718_cov_35.382876	296	376	0	80	80	1.0000000
NODE_15706_length_718_cov_35.382876	296	376	0	80	80	1.0000000
NODE_15706_length_718_cov_35.382876	349	429	0	80	80	1.0000000
NODE_15706_length_718_cov_35.382876	349	429	0	80	80	1.0000000
NODE_15707_length_718_cov_24.211632	313	393	0	80	80	1.0000000
NODE_15707_length_718_cov_24.211632	366	446	0	80	80	1.0000000
NODE_15708_length_718_cov_18.300485	217	297	0	71	80	0.8875000
NODE_15708_length_718_cov_18.300485	217	297	2	9	80	0.1125000
NODE_15708_length_718_cov_18.300485	270	350	0	18	80	0.2250000
NODE_15708_length_718_cov_18.300485	270	350	2	62	80	0.7750000
NODE_15709_length_718_cov_14.757674	383	463	0	80	80	1.0000000
NODE_15709_length_718_cov_14.757674	436	516	0	80	80	1.0000000
NODE_15710_length_718_cov_14.355412	254	334	0	80	80	1.0000000
NODE_15710_length_718_cov_14.355412	307	387	0	80	80	1.0000000
NODE_15715_length_718_cov_4.804523	263	343	0	80	80	1.0000000
NODE_15715_length_718_cov_4.804523	316	396	0	80	80	1.0000000
NODE_15750_length_717_cov_28.377023	335	415	2	50	80	0.6250000
NODE_15750_length_717_cov_28.377023	335	415	4	30	80	0.3750000
NODE_15750_length_717_cov_28.377023	388	468	0	36	80	0.4500000
NODE_15750_length_717_cov_28.377023	388	468	2	31	80	0.3875000
NODE_15750_length_717_cov_28.377023	388	468	4	13	80	0.1625000
NODE_15751_length_717_cov_23.275081	162	242	0	80	80	1.0000000
NODE_15751_length_717_cov_23.275081	215	295	0	80	80	1.0000000
NODE_15752_length_717_cov_18.564725	319	399	0	80	80	1.0000000
NODE_15752_length_717_cov_18.564725	372	452	0	80	80	1.0000000
NODE_15753_length_717_cov_18.389968	358	438	0	80	80	1.0000000
NODE_15753_length_717_cov_18.389968	411	491	0	80	80	1.0000000
NODE_15754_length_717_cov_17.932039	241	321	0	3	80	0.0375000
NODE_15754_length_717_cov_17.932039	241	321	2	49	80	0.6125000
NODE_15754_length_717_cov_17.932039	241	321	4	14	80	0.1750000
NODE_15754_length_717_cov_17.932039	241	321	6	14	80	0.1750000
NODE_15754_length_717_cov_17.932039	294	374	0	56	80	0.7000000
NODE_15754_length_717_cov_17.932039	294	374	2	24	80	0.3000000
NODE_15755_length_717_cov_14.637540	298	378	0	80	80	1.0000000
NODE_15755_length_717_cov_14.637540	351	431	0	68	80	0.8500000
NODE_15755_length_717_cov_14.637540	351	431	2	12	80	0.1500000
NODE_15756_length_717_cov_12.279935	113	196	0	83	83	1.0000000
NODE_15756_length_717_cov_12.279935	169	249	0	80	80	1.0000000
NODE_15757_length_717_cov_10.711974	353	431	0	12	78	0.1538462
NODE_15757_length_717_cov_10.711974	353	431	2	54	78	0.6923077
NODE_15757_length_717_cov_10.711974	353	431	4	12	78	0.1538462
NODE_15758_length_717_cov_9.399676	331	411	0	80	80	1.0000000
NODE_15758_length_717_cov_9.399676	384	464	0	80	80	1.0000000
NODE_15762_length_717_cov_5.341424	475	555	0	24	80	0.3000000
NODE_15762_length_717_cov_5.341424	475	555	2	56	80	0.7000000
NODE_15762_length_717_cov_5.341424	528	608	2	80	80	1.0000000
NODE_15770_length_717_cov_3.187702	285	322	2	37	37	1.0000000
NODE_15805_length_716_cov_16.800648	430	510	0	32	80	0.4000000
NODE_15805_length_716_cov_16.800648	430	510	6	48	80	0.6000000
NODE_15805_length_716_cov_16.800648	483	563	6	80	80	1.0000000
NODE_15806_length_716_cov_12.565640	356	436	0	80	80	1.0000000
NODE_15806_length_716_cov_12.565640	409	489	0	80	80	1.0000000
NODE_15807_length_716_cov_9.277147	385	465	0	80	80	1.0000000
NODE_15807_length_716_cov_9.277147	438	518	0	80	80	1.0000000
NODE_15808_length_716_cov_9.257699	302	382	2	80	80	1.0000000
NODE_15808_length_716_cov_9.257699	355	435	0	40	80	0.5000000
NODE_15808_length_716_cov_9.257699	355	435	2	40	80	0.5000000
NODE_15809_length_716_cov_6.761750	263	343	0	80	80	1.0000000
NODE_15809_length_716_cov_6.761750	316	396	0	80	80	1.0000000
NODE_15812_length_716_cov_4.909238	236	316	0	80	80	1.0000000
NODE_15812_length_716_cov_4.909238	289	369	0	80	80	1.0000000
NODE_15824_length_716_cov_2.068071	453	481	0	28	28	1.0000000
NODE_15853_length_715_cov_38.795455	260	340	0	48	80	0.6000000
NODE_15853_length_715_cov_38.795455	260	340	2	32	80	0.4000000
NODE_15853_length_715_cov_38.795455	313	393	0	5	80	0.0625000
NODE_15853_length_715_cov_38.795455	313	393	2	75	80	0.9375000
NODE_15854_length_715_cov_30.344156	316	396	0	64	80	0.8000000
NODE_15854_length_715_cov_30.344156	316	396	1	16	80	0.2000000
NODE_15854_length_715_cov_30.344156	369	449	0	11	80	0.1375000
NODE_15854_length_715_cov_30.344156	369	449	1	24	80	0.3000000
NODE_15854_length_715_cov_30.344156	369	449	2	45	80	0.5625000
NODE_15857_length_715_cov_11.209416	484	564	0	80	80	1.0000000
NODE_15857_length_715_cov_11.209416	537	617	0	80	80	1.0000000
NODE_15858_length_715_cov_10.894481	189	242	6	3	53	0.0566038
NODE_15858_length_715_cov_10.894481	189	242	7	50	53	0.9433962
NODE_15859_length_715_cov_10.628247	502	582	0	80	80	1.0000000
NODE_15859_length_715_cov_10.628247	555	635	0	80	80	1.0000000
NODE_15860_length_715_cov_8.647727	138	218	0	40	80	0.5000000
NODE_15860_length_715_cov_8.647727	138	218	2	40	80	0.5000000
NODE_15860_length_715_cov_8.647727	191	271	0	59	80	0.7375000
NODE_15860_length_715_cov_8.647727	191	271	6	21	80	0.2625000
NODE_15861_length_715_cov_8.412338	364	444	0	80	80	1.0000000
NODE_15861_length_715_cov_8.412338	417	497	0	80	80	1.0000000
NODE_15864_length_715_cov_5.373377	318	398	0	20	80	0.2500000
NODE_15864_length_715_cov_5.373377	318	398	4	60	80	0.7500000
NODE_15864_length_715_cov_5.373377	371	451	0	73	80	0.9125000
NODE_15864_length_715_cov_5.373377	371	451	4	7	80	0.0875000
NODE_15898_length_715_cov_1.271104	331	397	0	66	66	1.0000000
NODE_15910_length_714_cov_18.621138	297	377	0	80	80	1.0000000
NODE_15910_length_714_cov_18.621138	350	430	0	80	80	1.0000000
NODE_15911_length_714_cov_15.468293	268	348	0	80	80	1.0000000
NODE_15911_length_714_cov_15.468293	321	401	0	80	80	1.0000000
NODE_15913_length_714_cov_10.530081	218	298	0	80	80	1.0000000
NODE_15913_length_714_cov_10.530081	271	351	0	51	80	0.6375000
NODE_15913_length_714_cov_10.530081	271	351	1	11	80	0.1375000
NODE_15913_length_714_cov_10.530081	271	351	2	18	80	0.2250000
NODE_15913_length_714_cov_10.530081	354	434	2	80	80	1.0000000
NODE_15913_length_714_cov_10.530081	407	487	0	4	80	0.0500000
NODE_15913_length_714_cov_10.530081	407	487	1	11	80	0.1375000
NODE_15913_length_714_cov_10.530081	407	487	2	65	80	0.8125000
NODE_15914_length_714_cov_8.365854	285	365	0	80	80	1.0000000
NODE_15914_length_714_cov_8.365854	338	418	0	80	80	1.0000000
NODE_15919_length_714_cov_6.993496	263	343	0	41	80	0.5125000
NODE_15919_length_714_cov_6.993496	263	343	2	8	80	0.1000000
NODE_15919_length_714_cov_6.993496	263	343	3	3	80	0.0375000
NODE_15919_length_714_cov_6.993496	263	343	4	10	80	0.1250000
NODE_15919_length_714_cov_6.993496	263	343	6	7	80	0.0875000
NODE_15919_length_714_cov_6.993496	263	343	8	11	80	0.1375000
NODE_15919_length_714_cov_6.993496	316	384	0	68	68	1.0000000
NODE_15921_length_714_cov_4.224390	218	288	0	62	70	0.8857143
NODE_15921_length_714_cov_4.224390	218	288	2	8	70	0.1142857
NODE_15921_length_714_cov_4.224390	271	351	0	9	80	0.1125000
NODE_15921_length_714_cov_4.224390	271	351	2	71	80	0.8875000
NODE_15969_length_713_cov_19.304560	271	351	2	3	80	0.0375000
NODE_15969_length_713_cov_19.304560	271	351	4	10	80	0.1250000
NODE_15969_length_713_cov_19.304560	271	351	6	67	80	0.8375000
NODE_15969_length_713_cov_19.304560	324	404	0	31	80	0.3875000
NODE_15969_length_713_cov_19.304560	324	404	4	32	80	0.4000000
NODE_15969_length_713_cov_19.304560	324	404	6	17	80	0.2125000
NODE_15970_length_713_cov_16.926710	262	342	0	34	80	0.4250000
NODE_15970_length_713_cov_16.926710	262	342	4	46	80	0.5750000
NODE_15970_length_713_cov_16.926710	315	395	2	12	80	0.1500000
NODE_15970_length_713_cov_16.926710	315	395	4	29	80	0.3625000
NODE_15970_length_713_cov_16.926710	315	395	6	39	80	0.4875000
NODE_15973_length_713_cov_7.159609	351	431	0	80	80	1.0000000
NODE_15973_length_713_cov_7.159609	404	484	0	80	80	1.0000000
NODE_15974_length_713_cov_6.723127	379	427	4	2	48	0.0416667
NODE_15974_length_713_cov_6.723127	379	427	6	10	48	0.2083333
NODE_15974_length_713_cov_6.723127	379	427	8	15	48	0.3125000
NODE_15974_length_713_cov_6.723127	379	427	9	14	48	0.2916667
NODE_15974_length_713_cov_6.723127	379	427	13	7	48	0.1458333
NODE_15975_length_713_cov_4.954397	90	171	0	50	81	0.6172839
NODE_15975_length_713_cov_4.954397	90	171	2	31	81	0.3827161
NODE_15975_length_713_cov_4.954397	144	224	0	80	80	1.0000000
NODE_15980_length_713_cov_4.302932	402	482	0	80	80	1.0000000
NODE_15980_length_713_cov_4.302932	455	535	0	80	80	1.0000000
NODE_16004_length_713_cov_1.939739	15	75	0	60	60	1.0000000
NODE_16010_length_713_cov_1.605863	81	161	0	80	80	1.0000000
NODE_16010_length_713_cov_1.605863	134	214	0	80	80	1.0000000
NODE_16052_length_712_cov_32.931485	289	369	0	80	80	1.0000000
NODE_16052_length_712_cov_32.931485	342	422	0	80	80	1.0000000
NODE_16053_length_712_cov_31.752039	185	251	0	24	66	0.3636364
NODE_16053_length_712_cov_31.752039	185	251	2	42	66	0.6363636
NODE_16053_length_712_cov_31.752039	228	307	2	79	79	1.0000000
NODE_16054_length_712_cov_22.567700	228	308	0	80	80	1.0000000
NODE_16054_length_712_cov_22.567700	281	361	0	80	80	1.0000000
NODE_16055_length_712_cov_19.306688	238	318	0	11	80	0.1375000
NODE_16055_length_712_cov_19.306688	238	318	4	69	80	0.8625000
NODE_16055_length_712_cov_19.306688	291	371	0	23	80	0.2875000
NODE_16055_length_712_cov_19.306688	291	371	4	57	80	0.7125000
NODE_16056_length_712_cov_14.929853	332	412	0	80	80	1.0000000
NODE_16056_length_712_cov_14.929853	385	465	0	80	80	1.0000000
NODE_16057_length_712_cov_14.228385	250	330	0	14	80	0.1750000
NODE_16057_length_712_cov_14.228385	250	330	2	17	80	0.2125000
NODE_16057_length_712_cov_14.228385	250	330	4	8	80	0.1000000
NODE_16057_length_712_cov_14.228385	250	330	6	41	80	0.5125000
NODE_16057_length_712_cov_14.228385	303	383	2	2	80	0.0250000
NODE_16057_length_712_cov_14.228385	303	383	4	8	80	0.1000000
NODE_16057_length_712_cov_14.228385	303	383	6	70	80	0.8750000
NODE_16059_length_712_cov_9.221860	326	406	0	80	80	1.0000000
NODE_16059_length_712_cov_9.221860	379	463	0	84	84	1.0000000
NODE_16060_length_712_cov_8.368679	331	411	0	63	80	0.7875000
NODE_16060_length_712_cov_8.368679	331	411	2	17	80	0.2125000
NODE_16060_length_712_cov_8.368679	384	464	0	80	80	1.0000000
NODE_16079_length_712_cov_2.350734	466	510	0	44	44	1.0000000
NODE_16118_length_711_cov_36.459150	146	223	0	58	77	0.7532467
NODE_16118_length_711_cov_36.459150	146	223	2	19	77	0.2467532
NODE_16118_length_711_cov_36.459150	199	280	0	81	81	1.0000000
NODE_16119_length_711_cov_26.702614	460	540	0	80	80	1.0000000
NODE_16119_length_711_cov_26.702614	513	593	0	80	80	1.0000000
NODE_16120_length_711_cov_19.632353	329	409	0	24	80	0.3000000
NODE_16120_length_711_cov_19.632353	329	409	4	56	80	0.7000000
NODE_16120_length_711_cov_19.632353	382	462	0	2	80	0.0250000
NODE_16120_length_711_cov_19.632353	382	462	4	78	80	0.9750000
NODE_16121_length_711_cov_19.267974	283	363	0	80	80	1.0000000
NODE_16121_length_711_cov_19.267974	336	416	0	80	80	1.0000000
NODE_16122_length_711_cov_12.813725	255	334	0	79	79	1.0000000
NODE_16123_length_711_cov_12.147059	314	394	0	80	80	1.0000000
NODE_16123_length_711_cov_12.147059	367	447	0	34	80	0.4250000
NODE_16123_length_711_cov_12.147059	367	447	2	32	80	0.4000000
NODE_16123_length_711_cov_12.147059	367	447	4	14	80	0.1750000
NODE_16124_length_711_cov_10.009804	336	415	0	79	79	1.0000000
NODE_16127_length_711_cov_5.619281	276	356	0	80	80	1.0000000
NODE_16127_length_711_cov_5.619281	329	409	0	80	80	1.0000000
NODE_16130_length_711_cov_4.040850	165	245	0	80	80	1.0000000
NODE_16130_length_711_cov_4.040850	218	298	0	80	80	1.0000000
NODE_16167_length_710_cov_73.721768	626	706	0	80	80	1.0000000
NODE_16168_length_710_cov_21.772504	292	372	0	15	80	0.1875000
NODE_16168_length_710_cov_21.772504	292	372	1	20	80	0.2500000
NODE_16168_length_710_cov_21.772504	292	372	2	21	80	0.2625000
NODE_16168_length_710_cov_21.772504	292	372	4	24	80	0.3000000
NODE_16168_length_710_cov_21.772504	345	425	0	68	80	0.8500000
NODE_16168_length_710_cov_21.772504	345	425	1	12	80	0.1500000
NODE_16169_length_710_cov_21.597381	18	54	0	36	36	1.0000000
NODE_16170_length_710_cov_13.155483	306	386	2	18	80	0.2250000
NODE_16170_length_710_cov_13.155483	306	386	4	19	80	0.2375000
NODE_16170_length_710_cov_13.155483	306	386	6	43	80	0.5375000
NODE_16170_length_710_cov_13.155483	359	439	0	4	80	0.0500000
NODE_16170_length_710_cov_13.155483	359	439	2	15	80	0.1875000
NODE_16170_length_710_cov_13.155483	359	439	4	43	80	0.5375000
NODE_16170_length_710_cov_13.155483	359	439	6	18	80	0.2250000
NODE_16173_length_710_cov_8.031097	316	396	0	80	80	1.0000000
NODE_16173_length_710_cov_8.031097	369	449	0	80	80	1.0000000
NODE_16175_length_710_cov_6.664484	264	344	2	39	80	0.4875000
NODE_16175_length_710_cov_6.664484	264	344	4	41	80	0.5125000
NODE_16178_length_710_cov_5.590835	352	421	0	42	69	0.6086956
NODE_16178_length_710_cov_5.590835	352	421	2	27	69	0.3913043
NODE_16178_length_710_cov_5.590835	394	474	2	80	80	1.0000000
NODE_16180_length_710_cov_5.356792	248	328	2	42	80	0.5250000
NODE_16180_length_710_cov_5.356792	248	328	4	36	80	0.4500000
NODE_16180_length_710_cov_5.356792	248	328	6	2	80	0.0250000
NODE_16180_length_710_cov_5.356792	301	381	4	71	80	0.8875000
NODE_16180_length_710_cov_5.356792	301	381	6	9	80	0.1125000
NODE_16233_length_709_cov_12.227869	347	427	0	80	80	1.0000000
NODE_16233_length_709_cov_12.227869	400	480	0	80	80	1.0000000
NODE_16234_length_709_cov_10.531148	279	359	0	22	80	0.2750000
NODE_16234_length_709_cov_10.531148	279	359	1	20	80	0.2500000
NODE_16234_length_709_cov_10.531148	279	359	3	38	80	0.4750000
NODE_16234_length_709_cov_10.531148	332	412	0	75	80	0.9375000
NODE_16234_length_709_cov_10.531148	332	412	1	5	80	0.0625000
NODE_16238_length_709_cov_7.181967	225	305	0	26	80	0.3250000
NODE_16238_length_709_cov_7.181967	225	305	4	45	80	0.5625000
NODE_16238_length_709_cov_7.181967	225	305	6	9	80	0.1125000
NODE_16238_length_709_cov_7.181967	279	312	0	33	33	1.0000000
NODE_16241_length_709_cov_5.888525	239	319	0	80	80	1.0000000
NODE_16241_length_709_cov_5.888525	292	372	0	80	80	1.0000000
NODE_16294_length_708_cov_42.435140	307	387	2	10	80	0.1250000
NODE_16294_length_708_cov_42.435140	307	387	4	31	80	0.3875000
NODE_16294_length_708_cov_42.435140	307	387	6	39	80	0.4875000
NODE_16294_length_708_cov_42.435140	360	440	0	23	80	0.2875000
NODE_16294_length_708_cov_42.435140	360	440	4	57	80	0.7125000
NODE_16296_length_708_cov_33.412151	235	315	0	80	80	1.0000000
NODE_16296_length_708_cov_33.412151	288	368	0	80	80	1.0000000
NODE_16297_length_708_cov_23.034483	316	396	0	80	80	1.0000000
NODE_16297_length_708_cov_23.034483	369	449	0	72	80	0.9000000
NODE_16297_length_708_cov_23.034483	369	449	2	8	80	0.1000000
NODE_16298_length_708_cov_20.449918	254	334	0	80	80	1.0000000
NODE_16298_length_708_cov_20.449918	307	387	0	80	80	1.0000000
NODE_16299_length_708_cov_19.998358	238	318	0	80	80	1.0000000
NODE_16299_length_708_cov_19.998358	291	371	0	80	80	1.0000000
NODE_16300_length_708_cov_19.021346	366	446	2	26	80	0.3250000
NODE_16300_length_708_cov_19.021346	366	446	4	15	80	0.1875000
NODE_16300_length_708_cov_19.021346	366	446	8	39	80	0.4875000
NODE_16300_length_708_cov_19.021346	419	499	6	25	80	0.3125000
NODE_16300_length_708_cov_19.021346	419	499	8	55	80	0.6875000
NODE_16302_length_708_cov_12.228243	181	263	0	8	82	0.0975610
NODE_16302_length_708_cov_12.228243	181	263	2	74	82	0.9024390
NODE_16302_length_708_cov_12.228243	188	268	0	13	80	0.1625000
NODE_16302_length_708_cov_12.228243	188	268	2	67	80	0.8375000
NODE_16302_length_708_cov_12.228243	236	316	0	61	80	0.7625000
NODE_16302_length_708_cov_12.228243	236	316	2	19	80	0.2375000
NODE_16302_length_708_cov_12.228243	312	392	0	30	80	0.3750000
NODE_16302_length_708_cov_12.228243	312	392	2	50	80	0.6250000
NODE_16302_length_708_cov_12.228243	312	392	0	30	80	0.3750000
NODE_16302_length_708_cov_12.228243	312	392	2	50	80	0.6250000
NODE_16302_length_708_cov_12.228243	365	445	0	19	80	0.2375000
NODE_16302_length_708_cov_12.228243	365	445	2	61	80	0.7625000
NODE_16303_length_708_cov_11.338259	255	335	0	80	80	1.0000000
NODE_16303_length_708_cov_11.338259	308	388	0	80	80	1.0000000
NODE_16305_length_708_cov_9.676519	219	299	2	31	80	0.3875000
NODE_16305_length_708_cov_9.676519	219	299	6	49	80	0.6125000
NODE_16305_length_708_cov_9.676519	272	352	0	11	80	0.1375000
NODE_16305_length_708_cov_9.676519	272	352	4	41	80	0.5125000
NODE_16305_length_708_cov_9.676519	272	352	6	28	80	0.3500000
NODE_16306_length_708_cov_8.638752	324	399	0	75	75	1.0000000
NODE_16330_length_708_cov_2.699507	358	398	0	40	40	1.0000000
NODE_16370_length_707_cov_30.067434	325	405	0	80	80	1.0000000
NODE_16370_length_707_cov_30.067434	378	458	0	80	80	1.0000000
NODE_16371_length_707_cov_26.555921	241	321	0	59	80	0.7375000
NODE_16371_length_707_cov_26.555921	241	321	2	21	80	0.2625000
NODE_16371_length_707_cov_26.555921	294	374	0	6	80	0.0750000
NODE_16371_length_707_cov_26.555921	294	374	2	74	80	0.9250000
NODE_16372_length_707_cov_23.972039	322	402	0	20	80	0.2500000
NODE_16372_length_707_cov_23.972039	322	402	2	60	80	0.7500000
NODE_16372_length_707_cov_23.972039	375	455	0	73	80	0.9125000
NODE_16372_length_707_cov_23.972039	375	455	2	7	80	0.0875000
NODE_16373_length_707_cov_20.348684	157	237	0	80	80	1.0000000
NODE_16373_length_707_cov_20.348684	210	281	0	34	71	0.4788733
NODE_16373_length_707_cov_20.348684	210	281	2	37	71	0.5211267
NODE_16374_length_707_cov_18.970395	253	333	0	80	80	1.0000000
NODE_16374_length_707_cov_18.970395	306	386	0	80	80	1.0000000
NODE_16375_length_707_cov_14.324013	302	382	0	80	80	1.0000000
NODE_16375_length_707_cov_14.324013	355	435	0	80	80	1.0000000
NODE_16378_length_707_cov_5.062500	313	393	0	80	80	1.0000000
NODE_16441_length_706_cov_34.116969	272	352	0	80	80	1.0000000
NODE_16441_length_706_cov_34.116969	325	405	0	80	80	1.0000000
NODE_16442_length_706_cov_27.220758	229	309	0	80	80	1.0000000
NODE_16442_length_706_cov_27.220758	282	362	0	80	80	1.0000000
NODE_16443_length_706_cov_20.380560	264	344	0	11	80	0.1375000
NODE_16443_length_706_cov_20.380560	264	344	4	69	80	0.8625000
NODE_16443_length_706_cov_20.380560	317	397	0	64	80	0.8000000
NODE_16443_length_706_cov_20.380560	317	397	4	16	80	0.2000000
NODE_16444_length_706_cov_19.525535	289	369	0	80	80	1.0000000
NODE_16444_length_706_cov_19.525535	342	422	0	30	80	0.3750000
NODE_16444_length_706_cov_19.525535	342	422	2	50	80	0.6250000
NODE_16454_length_706_cov_3.344316	465	545	2	38	80	0.4750000
NODE_16454_length_706_cov_3.344316	465	545	6	10	80	0.1250000
NODE_16454_length_706_cov_3.344316	465	545	8	32	80	0.4000000
NODE_16454_length_706_cov_3.344316	518	598	0	13	80	0.1625000
NODE_16454_length_706_cov_3.344316	518	598	6	50	80	0.6250000
NODE_16454_length_706_cov_3.344316	518	598	8	17	80	0.2125000
NODE_16494_length_705_cov_19.211221	118	198	2	3	80	0.0375000
NODE_16494_length_705_cov_19.211221	118	198	4	36	80	0.4500000
NODE_16494_length_705_cov_19.211221	118	198	5	37	80	0.4625000
NODE_16494_length_705_cov_19.211221	118	198	6	4	80	0.0500000
NODE_16494_length_705_cov_19.211221	171	250	4	21	79	0.2658228
NODE_16494_length_705_cov_19.211221	171	250	5	58	79	0.7341772
NODE_16495_length_705_cov_16.338284	291	339	0	45	48	0.9375000
NODE_16495_length_705_cov_16.338284	291	339	8	3	48	0.0625000
NODE_16495_length_705_cov_16.338284	336	406	8	17	70	0.2428571
NODE_16495_length_705_cov_16.338284	336	406	10	53	70	0.7571428
NODE_16496_length_705_cov_14.354785	209	289	2	80	80	1.0000000
NODE_16496_length_705_cov_14.354785	262	342	0	50	80	0.6250000
NODE_16496_length_705_cov_14.354785	262	342	2	30	80	0.3750000
NODE_16497_length_705_cov_12.231023	293	373	0	80	80	1.0000000
NODE_16497_length_705_cov_12.231023	346	426	0	80	80	1.0000000
NODE_16498_length_705_cov_11.836634	390	470	2	5	80	0.0625000
NODE_16498_length_705_cov_11.836634	390	470	6	38	80	0.4750000
NODE_16498_length_705_cov_11.836634	390	470	8	37	80	0.4625000
NODE_16498_length_705_cov_11.836634	443	523	2	58	80	0.7250000
NODE_16498_length_705_cov_11.836634	443	523	8	22	80	0.2750000
NODE_16499_length_705_cov_10.049505	382	479	0	97	97	1.0000000
NODE_16499_length_705_cov_10.049505	452	532	0	80	80	1.0000000
NODE_16507_length_705_cov_4.275578	358	438	0	80	80	1.0000000
NODE_16507_length_705_cov_4.275578	411	491	0	80	80	1.0000000
NODE_16509_length_705_cov_4.018152	306	364	8	58	58	1.0000000
NODE_16509_length_705_cov_4.018152	337	410	0	24	73	0.3287671
NODE_16509_length_705_cov_4.018152	337	410	2	7	73	0.0958904
NODE_16509_length_705_cov_4.018152	337	410	4	8	73	0.1095890
NODE_16509_length_705_cov_4.018152	337	410	6	2	73	0.0273973
NODE_16509_length_705_cov_4.018152	337	410	8	32	73	0.4383562
NODE_16511_length_705_cov_3.620462	253	315	8	40	62	0.6451613
NODE_16511_length_705_cov_3.620462	253	315	10	19	62	0.3064516
NODE_16511_length_705_cov_3.620462	253	315	12	3	62	0.0483871
NODE_16511_length_705_cov_3.620462	308	368	4	34	60	0.5666667
NODE_16511_length_705_cov_3.620462	308	368	6	13	60	0.2166667
NODE_16511_length_705_cov_3.620462	308	368	7	1	60	0.0166667
NODE_16511_length_705_cov_3.620462	308	368	8	12	60	0.2000000
NODE_16527_length_705_cov_1.607261	462	531	1	69	69	1.0000000
NODE_16549_length_705_cov_0.529703	33	97	2	26	64	0.4062500
NODE_16549_length_705_cov_0.529703	33	97	4	6	64	0.0937500
NODE_16549_length_705_cov_0.529703	33	97	6	32	64	0.5000000
NODE_16549_length_705_cov_0.529703	86	150	0	13	64	0.2031250
NODE_16549_length_705_cov_0.529703	86	150	2	4	64	0.0625000
NODE_16549_length_705_cov_0.529703	86	150	4	32	64	0.5000000
NODE_16549_length_705_cov_0.529703	86	150	6	15	64	0.2343750
NODE_16550_length_704_cov_18.256198	295	375	0	80	80	1.0000000
NODE_16550_length_704_cov_18.256198	348	428	0	80	80	1.0000000
NODE_16552_length_704_cov_16.662810	264	344	0	16	80	0.2000000
NODE_16552_length_704_cov_16.662810	264	344	2	9	80	0.1125000
NODE_16552_length_704_cov_16.662810	264	344	4	27	80	0.3375000
NODE_16552_length_704_cov_16.662810	264	344	6	2	80	0.0250000
NODE_16552_length_704_cov_16.662810	264	344	17	10	80	0.1250000
NODE_16552_length_704_cov_16.662810	264	344	18	9	80	0.1125000
NODE_16552_length_704_cov_16.662810	264	344	20	7	80	0.0875000
NODE_16552_length_704_cov_16.662810	317	397	6	1	80	0.0125000
NODE_16552_length_704_cov_16.662810	317	397	15	16	80	0.2000000
NODE_16552_length_704_cov_16.662810	317	397	16	5	80	0.0625000
NODE_16552_length_704_cov_16.662810	317	397	17	10	80	0.1250000
NODE_16552_length_704_cov_16.662810	317	397	18	21	80	0.2625000
NODE_16552_length_704_cov_16.662810	317	397	20	27	80	0.3375000
NODE_16553_length_704_cov_12.641322	294	374	0	80	80	1.0000000
NODE_16553_length_704_cov_12.641322	347	427	0	80	80	1.0000000
NODE_16557_length_704_cov_5.603306	440	498	0	27	58	0.4655173
NODE_16557_length_704_cov_5.603306	440	498	2	31	58	0.5344828
NODE_16564_length_704_cov_3.535537	303	383	0	2	80	0.0250000
NODE_16564_length_704_cov_3.535537	303	383	2	78	80	0.9750000
NODE_16564_length_704_cov_3.535537	369	436	0	15	67	0.2238806
NODE_16564_length_704_cov_3.535537	369	436	2	52	67	0.7761194
NODE_16578_length_704_cov_1.963636	345	425	0	19	80	0.2375000
NODE_16578_length_704_cov_1.963636	345	425	2	2	80	0.0250000
NODE_16578_length_704_cov_1.963636	345	425	4	4	80	0.0500000
NODE_16578_length_704_cov_1.963636	345	425	6	55	80	0.6875000
NODE_16578_length_704_cov_1.963636	398	478	2	4	80	0.0500000
NODE_16578_length_704_cov_1.963636	398	478	4	7	80	0.0875000
NODE_16578_length_704_cov_1.963636	398	478	6	69	80	0.8625000
NODE_16598_length_703_cov_44.102649	514	594	4	80	80	1.0000000
NODE_16598_length_703_cov_44.102649	567	647	0	45	80	0.5625000
NODE_16598_length_703_cov_44.102649	567	647	4	35	80	0.4375000
NODE_16599_length_703_cov_33.067881	521	594	64	10	73	0.1369863
NODE_16599_length_703_cov_33.067881	521	594	65	4	73	0.0547945
NODE_16599_length_703_cov_33.067881	521	594	69	2	73	0.0273973
NODE_16599_length_703_cov_33.067881	521	594	71	3	73	0.0410959
NODE_16599_length_703_cov_33.067881	521	594	73	4	73	0.0547945
NODE_16599_length_703_cov_33.067881	521	594	74	2	73	0.0273973
NODE_16599_length_703_cov_33.067881	521	594	75	3	73	0.0410959
NODE_16599_length_703_cov_33.067881	521	594	78	3	73	0.0410959
NODE_16599_length_703_cov_33.067881	521	594	80	2	73	0.0273973
NODE_16599_length_703_cov_33.067881	521	594	84	2	73	0.0273973
NODE_16599_length_703_cov_33.067881	521	594	85	1	73	0.0136986
NODE_16599_length_703_cov_33.067881	521	594	86	1	73	0.0136986
NODE_16599_length_703_cov_33.067881	521	594	88	8	73	0.1095890
NODE_16599_length_703_cov_33.067881	521	594	90	4	73	0.0547945
NODE_16599_length_703_cov_33.067881	521	594	92	2	73	0.0273973
NODE_16599_length_703_cov_33.067881	521	594	94	6	73	0.0821918
NODE_16599_length_703_cov_33.067881	521	594	95	1	73	0.0136986
NODE_16599_length_703_cov_33.067881	521	594	96	7	73	0.0958904
NODE_16599_length_703_cov_33.067881	521	594	98	1	73	0.0136986
NODE_16599_length_703_cov_33.067881	521	594	100	1	73	0.0136986
NODE_16599_length_703_cov_33.067881	521	594	102	6	73	0.0821918
NODE_16599_length_703_cov_33.067881	561	602	62	2	41	0.0487805
NODE_16599_length_703_cov_33.067881	561	602	64	16	41	0.3902439
NODE_16599_length_703_cov_33.067881	561	602	65	4	41	0.0975610
NODE_16599_length_703_cov_33.067881	561	602	69	2	41	0.0487805
NODE_16599_length_703_cov_33.067881	561	602	71	3	41	0.0731707
NODE_16599_length_703_cov_33.067881	561	602	73	4	41	0.0975610
NODE_16599_length_703_cov_33.067881	561	602	74	2	41	0.0487805
NODE_16599_length_703_cov_33.067881	561	602	75	3	41	0.0731707
NODE_16599_length_703_cov_33.067881	561	602	78	3	41	0.0731707
NODE_16599_length_703_cov_33.067881	561	602	80	2	41	0.0487805
NODE_16600_length_703_cov_30.266556	312	392	0	80	80	1.0000000
NODE_16600_length_703_cov_30.266556	365	445	0	80	80	1.0000000
NODE_16601_length_703_cov_17.006623	449	529	0	29	80	0.3625000
NODE_16601_length_703_cov_17.006623	449	529	2	51	80	0.6375000
NODE_16601_length_703_cov_17.006623	502	582	0	80	80	1.0000000
NODE_16602_length_703_cov_14.801325	383	463	2	80	80	1.0000000
NODE_16602_length_703_cov_14.801325	436	516	1	40	80	0.5000000
NODE_16602_length_703_cov_14.801325	436	516	2	40	80	0.5000000
NODE_16603_length_703_cov_11.766556	308	388	0	38	80	0.4750000
NODE_16603_length_703_cov_11.766556	308	388	2	17	80	0.2125000
NODE_16603_length_703_cov_11.766556	308	388	4	25	80	0.3125000
NODE_16603_length_703_cov_11.766556	361	441	2	2	80	0.0250000
NODE_16603_length_703_cov_11.766556	361	441	4	41	80	0.5125000
NODE_16603_length_703_cov_11.766556	361	441	6	37	80	0.4625000
NODE_16604_length_703_cov_10.405629	213	293	3	4	80	0.0500000
NODE_16604_length_703_cov_10.405629	213	293	4	1	80	0.0125000
NODE_16604_length_703_cov_10.405629	213	293	6	15	80	0.1875000
NODE_16604_length_703_cov_10.405629	213	293	10	23	80	0.2875000
NODE_16604_length_703_cov_10.405629	213	293	12	1	80	0.0125000
NODE_16604_length_703_cov_10.405629	213	293	16	36	80	0.4500000
NODE_16604_length_703_cov_10.405629	266	301	3	12	35	0.3428572
NODE_16604_length_703_cov_10.405629	266	301	4	1	35	0.0285714
NODE_16604_length_703_cov_10.405629	266	301	6	15	35	0.4285714
NODE_16604_length_703_cov_10.405629	266	301	10	7	35	0.2000000
NODE_16605_length_703_cov_6.966887	381	440	0	59	59	1.0000000
NODE_16616_length_703_cov_3.491722	256	309	2	53	53	1.0000000
NODE_16616_length_703_cov_3.491722	257	337	2	80	80	1.0000000
NODE_16616_length_703_cov_3.491722	305	362	2	57	57	1.0000000
NODE_16624_length_703_cov_2.687086	216	296	0	80	80	1.0000000
NODE_16624_length_703_cov_2.687086	269	349	0	80	80	1.0000000
NODE_16663_length_702_cov_49.784411	221	299	0	50	78	0.6410257
NODE_16663_length_702_cov_49.784411	221	299	8	28	78	0.3589744
NODE_16663_length_702_cov_49.784411	277	352	8	75	75	1.0000000
NODE_16664_length_702_cov_26.570481	201	281	0	80	80	1.0000000
NODE_16664_length_702_cov_26.570481	254	334	0	77	80	0.9625000
NODE_16664_length_702_cov_26.570481	254	334	2	3	80	0.0375000
NODE_16665_length_702_cov_23.971808	139	219	0	37	80	0.4625000
NODE_16665_length_702_cov_23.971808	139	219	4	43	80	0.5375000
NODE_16665_length_702_cov_23.971808	192	272	0	80	80	1.0000000
NODE_16665_length_702_cov_23.971808	268	348	0	80	80	1.0000000
NODE_16665_length_702_cov_23.971808	321	401	0	79	80	0.9875000
NODE_16665_length_702_cov_23.971808	321	401	2	1	80	0.0125000
NODE_16666_length_702_cov_23.827529	448	528	0	12	80	0.1500000
NODE_16666_length_702_cov_23.827529	448	528	4	68	80	0.8500000
NODE_16666_length_702_cov_23.827529	501	581	0	65	80	0.8125000
NODE_16666_length_702_cov_23.827529	501	581	4	15	80	0.1875000
NODE_16667_length_702_cov_14.661692	424	504	0	44	80	0.5500000
NODE_16667_length_702_cov_14.661692	424	504	2	36	80	0.4500000
NODE_16667_length_702_cov_14.661692	477	557	0	25	80	0.3125000
NODE_16667_length_702_cov_14.661692	477	557	2	55	80	0.6875000
NODE_16668_length_702_cov_13.908789	259	304	2	22	45	0.4888889
NODE_16668_length_702_cov_13.908789	259	304	6	7	45	0.1555556
NODE_16668_length_702_cov_13.908789	259	304	8	16	45	0.3555556
NODE_16668_length_702_cov_13.908789	277	357	2	4	80	0.0500000
NODE_16668_length_702_cov_13.908789	277	357	6	27	80	0.3375000
NODE_16668_length_702_cov_13.908789	277	357	8	49	80	0.6125000
NODE_16668_length_702_cov_13.908789	289	357	6	20	68	0.2941177
NODE_16668_length_702_cov_13.908789	289	357	8	48	68	0.7058824
NODE_16669_length_702_cov_8.502488	337	417	0	80	80	1.0000000
NODE_16669_length_702_cov_8.502488	390	470	0	80	80	1.0000000
NODE_16671_length_702_cov_6.470978	209	289	0	80	80	1.0000000
NODE_16671_length_702_cov_6.470978	262	342	0	80	80	1.0000000
NODE_16729_length_701_cov_38.715947	178	258	0	80	80	1.0000000
NODE_16729_length_701_cov_38.715947	231	311	0	80	80	1.0000000
NODE_16729_length_701_cov_38.715947	307	387	0	12	80	0.1500000
NODE_16729_length_701_cov_38.715947	307	387	2	35	80	0.4375000
NODE_16729_length_701_cov_38.715947	307	387	4	4	80	0.0500000
NODE_16729_length_701_cov_38.715947	307	387	6	29	80	0.3625000
NODE_16729_length_701_cov_38.715947	360	440	2	6	80	0.0750000
NODE_16729_length_701_cov_38.715947	360	440	4	42	80	0.5250000
NODE_16729_length_701_cov_38.715947	360	440	6	32	80	0.4000000
NODE_16730_length_701_cov_28.059801	432	513	0	81	81	1.0000000
NODE_16730_length_701_cov_28.059801	486	566	0	80	80	1.0000000
NODE_16731_length_701_cov_18.387043	258	338	0	80	80	1.0000000
NODE_16731_length_701_cov_18.387043	311	391	0	80	80	1.0000000
NODE_16732_length_701_cov_17.122924	295	367	6	5	72	0.0694444
NODE_16732_length_701_cov_17.122924	295	367	10	67	72	0.9305556
NODE_16733_length_701_cov_16.114618	242	322	4	80	80	1.0000000
NODE_16733_length_701_cov_16.114618	295	375	0	52	80	0.6500000
NODE_16733_length_701_cov_16.114618	295	375	4	28	80	0.3500000
NODE_16734_length_701_cov_15.588040	399	479	0	42	80	0.5250000
NODE_16734_length_701_cov_15.588040	399	479	2	38	80	0.4750000
NODE_16734_length_701_cov_15.588040	452	532	2	80	80	1.0000000
NODE_16736_length_701_cov_11.420266	229	309	0	15	80	0.1875000
NODE_16736_length_701_cov_11.420266	229	309	2	65	80	0.8125000
NODE_16736_length_701_cov_11.420266	282	362	0	2	80	0.0250000
NODE_16736_length_701_cov_11.420266	282	362	2	78	80	0.9750000
NODE_16737_length_701_cov_10.411960	202	283	0	81	81	1.0000000
NODE_16737_length_701_cov_10.411960	256	336	0	80	80	1.0000000
NODE_16738_length_701_cov_9.107973	400	480	0	80	80	1.0000000
NODE_16738_length_701_cov_9.107973	453	533	0	80	80	1.0000000
NODE_16739_length_701_cov_8.877076	283	363	0	13	80	0.1625000
NODE_16739_length_701_cov_8.877076	283	363	4	67	80	0.8375000
NODE_16739_length_701_cov_8.877076	336	416	0	45	80	0.5625000
NODE_16739_length_701_cov_8.877076	336	416	3	1	80	0.0125000
NODE_16739_length_701_cov_8.877076	336	416	4	34	80	0.4250000
NODE_16740_length_701_cov_8.543189	341	421	0	80	80	1.0000000
NODE_16740_length_701_cov_8.543189	394	474	0	80	80	1.0000000
NODE_16742_length_701_cov_6.317276	273	353	0	29	80	0.3625000
NODE_16742_length_701_cov_6.317276	273	353	2	51	80	0.6375000
NODE_16742_length_701_cov_6.317276	326	382	0	56	56	1.0000000
NODE_16747_length_701_cov_5.081395	318	374	13	1	56	0.0178571
NODE_16747_length_701_cov_5.081395	318	374	15	2	56	0.0357143
NODE_16747_length_701_cov_5.081395	318	374	21	4	56	0.0714286
NODE_16747_length_701_cov_5.081395	318	374	25	6	56	0.1071429
NODE_16747_length_701_cov_5.081395	318	374	26	4	56	0.0714286
NODE_16747_length_701_cov_5.081395	318	374	28	25	56	0.4464286
NODE_16747_length_701_cov_5.081395	318	374	30	14	56	0.2500000
NODE_16752_length_701_cov_3.320598	207	287	0	80	80	1.0000000
NODE_16752_length_701_cov_3.320598	260	340	0	80	80	1.0000000
NODE_16794_length_700_cov_22.241265	326	406	49	5	80	0.0625000
NODE_16794_length_700_cov_22.241265	326	406	53	9	80	0.1125000
NODE_16794_length_700_cov_22.241265	326	406	55	6	80	0.0750000
NODE_16794_length_700_cov_22.241265	326	406	59	5	80	0.0625000
NODE_16794_length_700_cov_22.241265	326	406	61	11	80	0.1375000
NODE_16794_length_700_cov_22.241265	326	406	62	9	80	0.1125000
NODE_16794_length_700_cov_22.241265	326	406	63	5	80	0.0625000
NODE_16794_length_700_cov_22.241265	326	406	64	14	80	0.1750000
NODE_16794_length_700_cov_22.241265	326	406	65	4	80	0.0500000
NODE_16794_length_700_cov_22.241265	326	406	66	9	80	0.1125000
NODE_16794_length_700_cov_22.241265	326	406	68	3	80	0.0375000
NODE_16796_length_700_cov_11.730449	294	374	0	80	80	1.0000000
NODE_16796_length_700_cov_11.730449	347	427	0	80	80	1.0000000
NODE_16800_length_700_cov_7.291181	317	397	0	80	80	1.0000000
NODE_16800_length_700_cov_7.291181	370	450	0	80	80	1.0000000
NODE_16801_length_700_cov_6.557404	353	404	0	43	51	0.8431373
NODE_16801_length_700_cov_6.557404	353	404	2	8	51	0.1568628
NODE_16802_length_700_cov_5.475874	301	381	2	80	80	1.0000000
NODE_16802_length_700_cov_5.475874	354	434	0	14	80	0.1750000
NODE_16802_length_700_cov_5.475874	354	434	2	66	80	0.8250000
NODE_16803_length_700_cov_3.960067	158	234	0	10	76	0.1315790
NODE_16803_length_700_cov_3.960067	158	234	4	66	76	0.8684211
NODE_16803_length_700_cov_3.960067	209	291	0	11	82	0.1341463
NODE_16803_length_700_cov_3.960067	209	291	4	71	82	0.8658537
NODE_16822_length_700_cov_1.517471	324	404	2	80	80	1.0000000
NODE_16822_length_700_cov_1.517471	377	457	0	48	80	0.6000000
NODE_16822_length_700_cov_1.517471	377	457	2	32	80	0.4000000
NODE_16844_length_699_cov_18.446667	185	265	0	80	80	1.0000000
NODE_16844_length_699_cov_18.446667	238	318	0	80	80	1.0000000
NODE_16845_length_699_cov_18.383333	258	338	0	27	80	0.3375000
NODE_16845_length_699_cov_18.383333	258	338	4	53	80	0.6625000
NODE_16845_length_699_cov_18.383333	311	391	0	22	80	0.2750000
NODE_16845_length_699_cov_18.383333	311	391	4	58	80	0.7250000
NODE_16846_length_699_cov_18.103333	218	298	0	67	80	0.8375000
NODE_16846_length_699_cov_18.103333	218	298	2	13	80	0.1625000
NODE_16846_length_699_cov_18.103333	271	351	0	80	80	1.0000000
NODE_16847_length_699_cov_15.636667	279	359	0	80	80	1.0000000
NODE_16847_length_699_cov_15.636667	332	412	0	80	80	1.0000000
NODE_16848_length_699_cov_15.113333	313	393	2	8	80	0.1000000
NODE_16848_length_699_cov_15.113333	313	393	4	14	80	0.1750000
NODE_16848_length_699_cov_15.113333	313	393	6	58	80	0.7250000
NODE_16848_length_699_cov_15.113333	366	446	0	15	80	0.1875000
NODE_16848_length_699_cov_15.113333	366	446	4	52	80	0.6500000
NODE_16848_length_699_cov_15.113333	366	446	6	13	80	0.1625000
NODE_16849_length_699_cov_10.070000	233	313	0	80	80	1.0000000
NODE_16849_length_699_cov_10.070000	286	366	0	80	80	1.0000000
NODE_16849_length_699_cov_10.070000	362	442	0	80	80	1.0000000
NODE_16849_length_699_cov_10.070000	415	495	0	80	80	1.0000000
NODE_16850_length_699_cov_8.083333	347	427	0	80	80	1.0000000
NODE_16850_length_699_cov_8.083333	400	480	0	80	80	1.0000000
NODE_16851_length_699_cov_7.758333	307	387	2	80	80	1.0000000
NODE_16851_length_699_cov_7.758333	360	440	0	47	80	0.5875000
NODE_16851_length_699_cov_7.758333	360	440	2	33	80	0.4125000
NODE_16852_length_699_cov_7.713333	252	332	0	46	80	0.5750000
NODE_16852_length_699_cov_7.713333	252	332	2	34	80	0.4250000
NODE_16852_length_699_cov_7.713333	305	385	0	11	80	0.1375000
NODE_16852_length_699_cov_7.713333	305	385	2	69	80	0.8625000
NODE_16853_length_699_cov_7.186667	271	332	0	61	61	1.0000000
NODE_16853_length_699_cov_7.186667	348	428	0	2	80	0.0250000
NODE_16853_length_699_cov_7.186667	348	428	2	27	80	0.3375000
NODE_16853_length_699_cov_7.186667	348	428	10	7	80	0.0875000
NODE_16853_length_699_cov_7.186667	348	428	12	4	80	0.0500000
NODE_16853_length_699_cov_7.186667	348	428	14	40	80	0.5000000
NODE_16857_length_699_cov_5.815000	243	316	5	10	73	0.1369863
NODE_16857_length_699_cov_5.815000	243	316	6	1	73	0.0136986
NODE_16857_length_699_cov_5.815000	243	316	10	8	73	0.1095890
NODE_16857_length_699_cov_5.815000	243	316	12	24	73	0.3287671
NODE_16857_length_699_cov_5.815000	243	316	14	20	73	0.2739726
NODE_16857_length_699_cov_5.815000	243	316	16	10	73	0.1369863
NODE_16857_length_699_cov_5.815000	293	374	0	1	81	0.0123457
NODE_16857_length_699_cov_5.815000	293	374	2	7	81	0.0864198
NODE_16857_length_699_cov_5.815000	293	374	6	15	81	0.1851852
NODE_16857_length_699_cov_5.815000	293	374	12	58	81	0.7160494
NODE_16858_length_699_cov_5.520000	302	382	0	80	80	1.0000000
NODE_16858_length_699_cov_5.520000	355	435	0	80	80	1.0000000
NODE_16860_length_699_cov_4.051667	289	369	0	80	80	1.0000000
NODE_16860_length_699_cov_4.051667	342	422	0	80	80	1.0000000
NODE_16868_length_699_cov_2.498333	204	284	0	80	80	1.0000000
NODE_16868_length_699_cov_2.498333	257	337	0	80	80	1.0000000
NODE_16908_length_698_cov_47.350584	321	401	2	14	80	0.1750000
NODE_16908_length_698_cov_47.350584	321	401	6	19	80	0.2375000
NODE_16908_length_698_cov_47.350584	321	401	8	17	80	0.2125000
NODE_16908_length_698_cov_47.350584	321	401	10	30	80	0.3750000
NODE_16908_length_698_cov_47.350584	374	454	0	10	80	0.1250000
NODE_16908_length_698_cov_47.350584	374	454	4	21	80	0.2625000
NODE_16908_length_698_cov_47.350584	374	454	8	39	80	0.4875000
NODE_16908_length_698_cov_47.350584	374	454	10	10	80	0.1250000
NODE_16909_length_698_cov_42.848080	255	335	0	37	80	0.4625000
NODE_16909_length_698_cov_42.848080	255	335	2	43	80	0.5375000
NODE_16909_length_698_cov_42.848080	308	388	0	80	80	1.0000000
NODE_16910_length_698_cov_36.697830	366	446	0	80	80	1.0000000
NODE_16910_length_698_cov_36.697830	419	484	0	65	65	1.0000000
NODE_16911_length_698_cov_23.874791	222	302	0	62	80	0.7750000
NODE_16911_length_698_cov_23.874791	222	302	1	18	80	0.2250000
NODE_16911_length_698_cov_23.874791	275	355	0	9	80	0.1125000
NODE_16911_length_698_cov_23.874791	275	355	1	71	80	0.8875000
NODE_16912_length_698_cov_7.133556	360	440	0	80	80	1.0000000
NODE_16912_length_698_cov_7.133556	413	493	0	77	80	0.9625000
NODE_16912_length_698_cov_7.133556	413	493	1	3	80	0.0375000
NODE_16913_length_698_cov_6.520868	267	347	0	29	80	0.3625000
NODE_16913_length_698_cov_6.520868	267	347	2	51	80	0.6375000
NODE_16913_length_698_cov_6.520868	320	400	2	80	80	1.0000000
NODE_16917_length_698_cov_4.762938	329	359	0	30	30	1.0000000
NODE_16926_length_698_cov_2.577629	309	389	0	63	80	0.7875000
NODE_16926_length_698_cov_2.577629	309	389	2	17	80	0.2125000
NODE_16926_length_698_cov_2.577629	362	442	0	80	80	1.0000000
NODE_16962_length_697_cov_16.013378	305	385	0	80	80	1.0000000
NODE_16962_length_697_cov_16.013378	358	438	0	80	80	1.0000000
NODE_16963_length_697_cov_14.411371	440	520	0	21	80	0.2625000
NODE_16963_length_697_cov_14.411371	440	520	2	59	80	0.7375000
NODE_16963_length_697_cov_14.411371	493	573	0	24	80	0.3000000
NODE_16963_length_697_cov_14.411371	493	573	2	56	80	0.7000000
NODE_16964_length_697_cov_14.282609	257	354	0	32	97	0.3298969
NODE_16964_length_697_cov_14.282609	257	354	2	8	97	0.0824742
NODE_16964_length_697_cov_14.282609	257	354	4	57	97	0.5876288
NODE_16964_length_697_cov_14.282609	327	385	0	58	58	1.0000000
NODE_16965_length_697_cov_9.969900	360	440	0	52	80	0.6500000
NODE_16965_length_697_cov_9.969900	360	440	2	28	80	0.3500000
NODE_16965_length_697_cov_9.969900	413	493	2	80	80	1.0000000
NODE_16968_length_697_cov_6.117057	236	316	0	28	80	0.3500000
NODE_16968_length_697_cov_6.117057	236	316	2	52	80	0.6500000
NODE_16968_length_697_cov_6.117057	289	369	0	7	80	0.0875000
NODE_16968_length_697_cov_6.117057	289	369	2	73	80	0.9125000
NODE_17025_length_696_cov_28.360134	319	399	6	80	80	1.0000000
NODE_17025_length_696_cov_28.360134	372	452	3	22	80	0.2750000
NODE_17025_length_696_cov_28.360134	372	452	6	58	80	0.7250000
NODE_17026_length_696_cov_18.708543	367	447	0	80	80	1.0000000
NODE_17026_length_696_cov_18.708543	420	500	0	80	80	1.0000000
NODE_17027_length_696_cov_18.170854	390	470	0	1	80	0.0125000
NODE_17027_length_696_cov_18.170854	390	470	2	79	80	0.9875000
NODE_17027_length_696_cov_18.170854	443	523	0	2	80	0.0250000
NODE_17027_length_696_cov_18.170854	443	523	2	78	80	0.9750000
NODE_17028_length_696_cov_13.738693	266	346	0	1	80	0.0125000
NODE_17028_length_696_cov_13.738693	266	346	2	79	80	0.9875000
NODE_17028_length_696_cov_13.738693	319	399	0	16	80	0.2000000
NODE_17028_length_696_cov_13.738693	319	399	2	64	80	0.8000000
NODE_17030_length_696_cov_10.693467	239	266	2	27	27	1.0000000
NODE_17031_length_696_cov_9.949749	248	328	0	39	80	0.4875000
NODE_17031_length_696_cov_9.949749	248	328	2	41	80	0.5125000
NODE_17031_length_696_cov_9.949749	301	381	2	80	80	1.0000000
NODE_17032_length_696_cov_8.658291	247	327	0	80	80	1.0000000
NODE_17032_length_696_cov_8.658291	300	380	0	80	80	1.0000000
NODE_17032_length_696_cov_8.658291	376	456	0	80	80	1.0000000
NODE_17032_length_696_cov_8.658291	429	509	0	80	80	1.0000000
NODE_17068_length_696_cov_1.675042	498	543	0	14	45	0.3111111
NODE_17068_length_696_cov_1.675042	498	543	2	25	45	0.5555556
NODE_17068_length_696_cov_1.675042	498	543	4	6	45	0.1333333
NODE_17100_length_695_cov_24.112416	388	468	0	80	80	1.0000000
NODE_17100_length_695_cov_24.112416	441	521	0	80	80	1.0000000
NODE_17101_length_695_cov_12.152685	349	429	0	80	80	1.0000000
NODE_17101_length_695_cov_12.152685	402	482	0	80	80	1.0000000
NODE_17103_length_695_cov_8.466443	345	425	0	80	80	1.0000000
NODE_17103_length_695_cov_8.466443	398	478	0	80	80	1.0000000
NODE_17106_length_695_cov_5.661074	283	363	0	80	80	1.0000000
NODE_17106_length_695_cov_5.661074	346	416	0	31	70	0.4428571
NODE_17106_length_695_cov_5.661074	346	416	2	39	70	0.5571429
NODE_17124_length_695_cov_2.050336	36	112	0	76	76	1.0000000
NODE_17161_length_694_cov_46.675630	30	110	0	80	80	1.0000000
NODE_17161_length_694_cov_46.675630	83	163	0	80	80	1.0000000
NODE_17161_length_694_cov_46.675630	159	239	0	80	80	1.0000000
NODE_17161_length_694_cov_46.675630	212	292	0	80	80	1.0000000
NODE_17162_length_694_cov_12.850420	326	406	0	10	80	0.1250000
NODE_17162_length_694_cov_12.850420	326	406	4	46	80	0.5750000
NODE_17162_length_694_cov_12.850420	326	406	6	24	80	0.3000000
NODE_17162_length_694_cov_12.850420	379	459	2	6	80	0.0750000
NODE_17162_length_694_cov_12.850420	379	459	4	3	80	0.0375000
NODE_17162_length_694_cov_12.850420	379	459	6	71	80	0.8875000
NODE_17163_length_694_cov_7.236975	318	396	0	78	78	1.0000000
NODE_17163_length_694_cov_7.236975	371	450	0	79	79	1.0000000
NODE_17166_length_694_cov_5.554622	404	484	0	12	80	0.1500000
NODE_17166_length_694_cov_5.554622	404	484	2	6	80	0.0750000
NODE_17166_length_694_cov_5.554622	404	484	4	62	80	0.7750000
NODE_17166_length_694_cov_5.554622	457	537	0	16	80	0.2000000
NODE_17166_length_694_cov_5.554622	457	537	2	33	80	0.4125000
NODE_17166_length_694_cov_5.554622	457	537	4	31	80	0.3875000
NODE_17168_length_694_cov_5.373109	152	232	0	35	80	0.4375000
NODE_17168_length_694_cov_5.373109	152	232	2	45	80	0.5625000
NODE_17168_length_694_cov_5.373109	205	285	2	80	80	1.0000000
NODE_17227_length_693_cov_26.616162	435	515	0	10	80	0.1250000
NODE_17227_length_693_cov_26.616162	435	515	4	70	80	0.8750000
NODE_17227_length_693_cov_26.616162	488	568	0	63	80	0.7875000
NODE_17227_length_693_cov_26.616162	488	568	4	17	80	0.2125000
NODE_17228_length_693_cov_23.552189	193	273	0	80	80	1.0000000
NODE_17228_length_693_cov_23.552189	246	326	0	80	80	1.0000000
NODE_17229_length_693_cov_22.848485	231	311	0	80	80	1.0000000
NODE_17229_length_693_cov_22.848485	284	364	0	80	80	1.0000000
NODE_17230_length_693_cov_13.616162	219	299	0	80	80	1.0000000
NODE_17230_length_693_cov_13.616162	272	352	0	75	80	0.9375000
NODE_17230_length_693_cov_13.616162	272	352	2	5	80	0.0625000
NODE_17231_length_693_cov_12.382155	305	385	0	80	80	1.0000000
NODE_17231_length_693_cov_12.382155	358	424	0	66	66	1.0000000
NODE_17232_length_693_cov_10.053872	279	359	8	28	80	0.3500000
NODE_17232_length_693_cov_10.053872	279	359	14	52	80	0.6500000
NODE_17232_length_693_cov_10.053872	332	412	8	32	80	0.4000000
NODE_17232_length_693_cov_10.053872	332	412	14	48	80	0.6000000
NODE_17233_length_693_cov_9.659933	247	327	1	19	80	0.2375000
NODE_17233_length_693_cov_9.659933	247	327	3	61	80	0.7625000
NODE_17233_length_693_cov_9.659933	300	380	0	26	80	0.3250000
NODE_17233_length_693_cov_9.659933	300	380	1	46	80	0.5750000
NODE_17233_length_693_cov_9.659933	300	380	3	8	80	0.1000000
NODE_17235_length_693_cov_8.077441	343	423	0	59	80	0.7375000
NODE_17235_length_693_cov_8.077441	343	423	2	21	80	0.2625000
NODE_17235_length_693_cov_8.077441	396	476	0	80	80	1.0000000
NODE_17243_length_693_cov_3.680135	250	321	0	4	71	0.0563380
NODE_17243_length_693_cov_3.680135	250	321	8	67	71	0.9436620
NODE_17280_length_692_cov_33.416526	462	542	2	15	80	0.1875000
NODE_17280_length_692_cov_33.416526	462	542	3	28	80	0.3500000
NODE_17280_length_692_cov_33.416526	462	542	4	1	80	0.0125000
NODE_17280_length_692_cov_33.416526	462	542	6	36	80	0.4500000
NODE_17280_length_692_cov_33.416526	515	595	0	13	80	0.1625000
NODE_17280_length_692_cov_33.416526	515	595	3	67	80	0.8375000
NODE_17281_length_692_cov_17.559865	291	371	1	80	80	1.0000000
NODE_17282_length_692_cov_15.070826	304	375	0	36	71	0.5070422
NODE_17282_length_692_cov_15.070826	304	375	2	35	71	0.4929577
NODE_17283_length_692_cov_13.279933	308	388	0	67	80	0.8375000
NODE_17283_length_692_cov_13.279933	308	388	2	13	80	0.1625000
NODE_17283_length_692_cov_13.279933	361	441	0	80	80	1.0000000
NODE_17285_length_692_cov_10.750422	317	397	0	80	80	1.0000000
NODE_17287_length_692_cov_7.497470	175	255	0	80	80	1.0000000
NODE_17287_length_692_cov_7.497470	228	312	0	84	84	1.0000000
NODE_17289_length_692_cov_7.370995	235	315	1	23	80	0.2875000
NODE_17289_length_692_cov_7.370995	235	315	2	27	80	0.3375000
NODE_17289_length_692_cov_7.370995	235	315	4	2	80	0.0250000
NODE_17289_length_692_cov_7.370995	235	315	6	28	80	0.3500000
NODE_17289_length_692_cov_7.370995	288	369	3	1	81	0.0123457
NODE_17289_length_692_cov_7.370995	288	369	4	2	81	0.0246914
NODE_17289_length_692_cov_7.370995	288	369	6	78	81	0.9629630
NODE_17328_length_692_cov_1.514334	404	484	0	22	80	0.2750000
NODE_17328_length_692_cov_1.514334	404	484	2	20	80	0.2500000
NODE_17328_length_692_cov_1.514334	404	484	4	3	80	0.0375000
NODE_17328_length_692_cov_1.514334	404	484	6	1	80	0.0125000
NODE_17328_length_692_cov_1.514334	404	484	8	9	80	0.1125000
NODE_17328_length_692_cov_1.514334	404	484	10	25	80	0.3125000
NODE_17350_length_691_cov_115.233108	276	356	18	14	80	0.1750000
NODE_17350_length_691_cov_115.233108	276	356	21	8	80	0.1000000
NODE_17350_length_691_cov_115.233108	276	356	22	22	80	0.2750000
NODE_17350_length_691_cov_115.233108	276	356	24	6	80	0.0750000
NODE_17350_length_691_cov_115.233108	276	356	25	18	80	0.2250000
NODE_17350_length_691_cov_115.233108	276	356	27	12	80	0.1500000
NODE_17350_length_691_cov_115.233108	329	409	7	7	80	0.0875000
NODE_17350_length_691_cov_115.233108	329	409	8	11	80	0.1375000
NODE_17350_length_691_cov_115.233108	329	409	9	2	80	0.0250000
NODE_17350_length_691_cov_115.233108	329	409	18	6	80	0.0750000
NODE_17350_length_691_cov_115.233108	329	409	19	2	80	0.0250000
NODE_17350_length_691_cov_115.233108	329	409	20	4	80	0.0500000
NODE_17350_length_691_cov_115.233108	329	409	22	11	80	0.1375000
NODE_17350_length_691_cov_115.233108	329	409	25	25	80	0.3125000
NODE_17350_length_691_cov_115.233108	329	409	27	12	80	0.1500000
NODE_17350_length_691_cov_115.233108	405	485	8	2	80	0.0250000
NODE_17350_length_691_cov_115.233108	405	485	9	5	80	0.0625000
NODE_17350_length_691_cov_115.233108	405	485	15	2	80	0.0250000
NODE_17350_length_691_cov_115.233108	405	485	19	6	80	0.0750000
NODE_17350_length_691_cov_115.233108	405	485	27	2	80	0.0250000
NODE_17350_length_691_cov_115.233108	405	485	31	7	80	0.0875000
NODE_17350_length_691_cov_115.233108	405	485	33	2	80	0.0250000
NODE_17350_length_691_cov_115.233108	405	485	35	1	80	0.0125000
NODE_17350_length_691_cov_115.233108	405	485	37	2	80	0.0250000
NODE_17350_length_691_cov_115.233108	405	485	41	4	80	0.0500000
NODE_17350_length_691_cov_115.233108	405	485	45	7	80	0.0875000
NODE_17350_length_691_cov_115.233108	405	485	47	3	80	0.0375000
NODE_17350_length_691_cov_115.233108	405	485	51	3	80	0.0375000
NODE_17350_length_691_cov_115.233108	405	485	53	13	80	0.1625000
NODE_17350_length_691_cov_115.233108	405	485	54	4	80	0.0500000
NODE_17350_length_691_cov_115.233108	405	485	58	4	80	0.0500000
NODE_17350_length_691_cov_115.233108	405	485	60	6	80	0.0750000
NODE_17350_length_691_cov_115.233108	405	485	64	2	80	0.0250000
NODE_17350_length_691_cov_115.233108	405	485	68	5	80	0.0625000
NODE_17350_length_691_cov_115.233108	458	538	53	6	80	0.0750000
NODE_17350_length_691_cov_115.233108	458	538	54	4	80	0.0500000
NODE_17350_length_691_cov_115.233108	458	538	58	4	80	0.0500000
NODE_17350_length_691_cov_115.233108	458	538	60	6	80	0.0750000
NODE_17350_length_691_cov_115.233108	458	538	64	2	80	0.0250000
NODE_17350_length_691_cov_115.233108	458	538	68	18	80	0.2250000
NODE_17350_length_691_cov_115.233108	458	538	69	3	80	0.0375000
NODE_17350_length_691_cov_115.233108	458	538	71	2	80	0.0250000
NODE_17350_length_691_cov_115.233108	458	538	75	4	80	0.0500000
NODE_17350_length_691_cov_115.233108	458	538	77	4	80	0.0500000
NODE_17350_length_691_cov_115.233108	458	538	79	10	80	0.1250000
NODE_17350_length_691_cov_115.233108	458	538	80	3	80	0.0375000
NODE_17350_length_691_cov_115.233108	458	538	81	10	80	0.1250000
NODE_17350_length_691_cov_115.233108	458	538	82	3	80	0.0375000
NODE_17350_length_691_cov_115.233108	458	538	83	1	80	0.0125000
NODE_17351_length_691_cov_26.076014	188	268	0	80	80	1.0000000
NODE_17351_length_691_cov_26.076014	241	321	0	50	80	0.6250000
NODE_17351_length_691_cov_26.076014	241	321	2	30	80	0.3750000
NODE_17352_length_691_cov_21.991554	288	368	0	80	80	1.0000000
NODE_17352_length_691_cov_21.991554	341	419	0	78	78	1.0000000
NODE_17353_length_691_cov_14.908784	226	306	0	80	80	1.0000000
NODE_17353_length_691_cov_14.908784	279	359	0	80	80	1.0000000
NODE_17358_length_691_cov_5.670608	325	402	0	74	77	0.9610389
NODE_17358_length_691_cov_5.670608	325	402	2	3	77	0.0389610
NODE_17358_length_691_cov_5.670608	375	455	0	80	80	1.0000000
NODE_17361_length_691_cov_4.866554	103	183	0	54	80	0.6750000
NODE_17361_length_691_cov_4.866554	103	183	2	26	80	0.3250000
NODE_17361_length_691_cov_4.866554	156	236	0	1	80	0.0125000
NODE_17361_length_691_cov_4.866554	156	236	2	72	80	0.9000000
NODE_17361_length_691_cov_4.866554	156	236	4	7	80	0.0875000
NODE_17367_length_691_cov_3.388514	304	384	0	80	80	1.0000000
NODE_17367_length_691_cov_3.388514	357	437	0	80	80	1.0000000
NODE_17415_length_690_cov_39.538071	563	612	0	49	49	1.0000000
NODE_17415_length_690_cov_39.538071	598	678	0	80	80	1.0000000
NODE_17415_length_690_cov_39.538071	651	690	0	39	39	1.0000000
NODE_17417_length_690_cov_30.336717	319	394	0	49	75	0.6533333
NODE_17417_length_690_cov_30.336717	319	394	2	26	75	0.3466667
NODE_17417_length_690_cov_30.336717	372	453	0	18	81	0.2222222
NODE_17417_length_690_cov_30.336717	372	453	2	63	81	0.7777778
NODE_17417_length_690_cov_30.336717	449	529	0	80	80	1.0000000
NODE_17417_length_690_cov_30.336717	502	582	0	80	80	1.0000000
NODE_17418_length_690_cov_26.888325	270	350	0	80	80	1.0000000
NODE_17418_length_690_cov_26.888325	323	403	0	80	80	1.0000000
NODE_17419_length_690_cov_23.360406	131	211	0	53	80	0.6625000
NODE_17419_length_690_cov_23.360406	131	211	2	4	80	0.0500000
NODE_17419_length_690_cov_23.360406	131	211	4	5	80	0.0625000
NODE_17419_length_690_cov_23.360406	131	211	8	18	80	0.2250000
NODE_17419_length_690_cov_23.360406	188	264	4	5	76	0.0657895
NODE_17419_length_690_cov_23.360406	188	264	6	7	76	0.0921053
NODE_17419_length_690_cov_23.360406	188	264	8	64	76	0.8421053
NODE_17420_length_690_cov_18.737733	316	396	0	32	80	0.4000000
NODE_17420_length_690_cov_18.737733	316	396	2	10	80	0.1250000
NODE_17420_length_690_cov_18.737733	316	396	4	38	80	0.4750000
NODE_17420_length_690_cov_18.737733	369	449	4	31	80	0.3875000
NODE_17420_length_690_cov_18.737733	369	449	6	21	80	0.2625000
NODE_17420_length_690_cov_18.737733	369	449	8	28	80	0.3500000
NODE_17421_length_690_cov_16.593909	364	444	0	80	80	1.0000000
NODE_17421_length_690_cov_16.593909	417	497	0	80	80	1.0000000
NODE_17422_length_690_cov_12.896785	320	400	0	9	80	0.1125000
NODE_17422_length_690_cov_12.896785	320	400	2	71	80	0.8875000
NODE_17422_length_690_cov_12.896785	373	453	0	25	80	0.3125000
NODE_17422_length_690_cov_12.896785	373	453	2	55	80	0.6875000
NODE_17423_length_690_cov_10.818951	349	429	2	14	80	0.1750000
NODE_17423_length_690_cov_10.818951	349	429	4	39	80	0.4875000
NODE_17423_length_690_cov_10.818951	349	429	6	27	80	0.3375000
NODE_17424_length_690_cov_7.015228	273	353	0	80	80	1.0000000
NODE_17424_length_690_cov_7.015228	326	406	0	80	80	1.0000000
NODE_17429_length_690_cov_4.793570	316	365	212	1	49	0.0204082
NODE_17429_length_690_cov_4.793570	316	365	213	2	49	0.0408163
NODE_17429_length_690_cov_4.793570	316	365	214	1	49	0.0204082
NODE_17429_length_690_cov_4.793570	316	365	219	1	49	0.0204082
NODE_17429_length_690_cov_4.793570	316	365	220	1	49	0.0204082
NODE_17429_length_690_cov_4.793570	316	365	222	3	49	0.0612245
NODE_17429_length_690_cov_4.793570	316	365	226	1	49	0.0204082
NODE_17429_length_690_cov_4.793570	316	365	232	1	49	0.0204082
NODE_17429_length_690_cov_4.793570	316	365	234	1	49	0.0204082
NODE_17429_length_690_cov_4.793570	316	365	235	1	49	0.0204082
NODE_17429_length_690_cov_4.793570	316	365	236	1	49	0.0204082
NODE_17429_length_690_cov_4.793570	316	365	241	1	49	0.0204082
NODE_17429_length_690_cov_4.793570	316	365	242	2	49	0.0408163
NODE_17429_length_690_cov_4.793570	316	365	246	3	49	0.0612245
NODE_17429_length_690_cov_4.793570	316	365	247	1	49	0.0204082
NODE_17429_length_690_cov_4.793570	316	365	248	1	49	0.0204082
NODE_17429_length_690_cov_4.793570	316	365	250	1	49	0.0204082
NODE_17429_length_690_cov_4.793570	316	365	253	1	49	0.0204082
NODE_17429_length_690_cov_4.793570	316	365	255	2	49	0.0408163
NODE_17429_length_690_cov_4.793570	316	365	256	3	49	0.0612245
NODE_17429_length_690_cov_4.793570	316	365	259	1	49	0.0204082
NODE_17429_length_690_cov_4.793570	316	365	261	4	49	0.0816327
NODE_17429_length_690_cov_4.793570	316	365	267	1	49	0.0204082
NODE_17429_length_690_cov_4.793570	316	365	268	3	49	0.0612245
NODE_17429_length_690_cov_4.793570	316	365	269	5	49	0.1020408
NODE_17429_length_690_cov_4.793570	316	365	271	2	49	0.0408163
NODE_17429_length_690_cov_4.793570	316	365	273	1	49	0.0204082
NODE_17429_length_690_cov_4.793570	316	365	274	2	49	0.0408163
NODE_17429_length_690_cov_4.793570	316	365	277	1	49	0.0204082
NODE_17430_length_690_cov_4.717428	316	396	0	80	80	1.0000000
NODE_17430_length_690_cov_4.717428	369	449	0	80	80	1.0000000
NODE_17484_length_689_cov_45.984746	244	322	0	78	78	1.0000000
NODE_17484_length_689_cov_45.984746	297	377	0	80	80	1.0000000
NODE_17485_length_689_cov_35.705085	436	516	0	80	80	1.0000000
NODE_17485_length_689_cov_35.705085	489	569	0	80	80	1.0000000
NODE_17486_length_689_cov_25.372881	211	291	0	12	80	0.1500000
NODE_17486_length_689_cov_25.372881	211	291	2	19	80	0.2375000
NODE_17486_length_689_cov_25.372881	211	291	3	49	80	0.6125000
NODE_17486_length_689_cov_25.372881	264	344	0	4	80	0.0500000
NODE_17486_length_689_cov_25.372881	264	344	2	24	80	0.3000000
NODE_17486_length_689_cov_25.372881	264	344	3	52	80	0.6500000
NODE_17487_length_689_cov_20.138983	319	399	2	31	80	0.3875000
NODE_17487_length_689_cov_20.138983	319	399	6	49	80	0.6125000
NODE_17487_length_689_cov_20.138983	372	452	0	40	80	0.5000000
NODE_17487_length_689_cov_20.138983	372	452	2	40	80	0.5000000
NODE_17488_length_689_cov_14.377966	351	431	0	43	80	0.5375000
NODE_17488_length_689_cov_14.377966	351	431	2	37	80	0.4625000
NODE_17488_length_689_cov_14.377966	404	484	2	80	80	1.0000000
NODE_17489_length_689_cov_9.477966	201	281	0	73	80	0.9125000
NODE_17489_length_689_cov_9.477966	201	281	2	7	80	0.0875000
NODE_17489_length_689_cov_9.477966	254	334	0	20	80	0.2500000
NODE_17489_length_689_cov_9.477966	254	334	2	54	80	0.6750000
NODE_17489_length_689_cov_9.477966	254	334	4	6	80	0.0750000
NODE_17491_length_689_cov_7.367797	122	207	14	12	85	0.1411765
NODE_17491_length_689_cov_7.367797	122	207	15	6	85	0.0705882
NODE_17491_length_689_cov_7.367797	122	207	16	18	85	0.2117647
NODE_17491_length_689_cov_7.367797	122	207	18	49	85	0.5764706
NODE_17492_length_689_cov_6.649153	242	322	0	80	80	1.0000000
NODE_17492_length_689_cov_6.649153	295	375	0	80	80	1.0000000
NODE_17504_length_689_cov_2.788136	128	208	0	4	80	0.0500000
NODE_17504_length_689_cov_2.788136	128	208	2	73	80	0.9125000
NODE_17504_length_689_cov_2.788136	128	208	4	3	80	0.0375000
NODE_17504_length_689_cov_2.788136	181	261	0	3	80	0.0375000
NODE_17504_length_689_cov_2.788136	181	261	2	74	80	0.9250000
NODE_17504_length_689_cov_2.788136	181	261	4	3	80	0.0375000
NODE_17548_length_688_cov_52.256367	198	278	0	80	80	1.0000000
NODE_17548_length_688_cov_52.256367	251	331	0	80	80	1.0000000
NODE_17549_length_688_cov_37.563667	373	453	0	80	80	1.0000000
NODE_17549_length_688_cov_37.563667	426	506	0	80	80	1.0000000
NODE_17549_length_688_cov_37.563667	514	594	0	34	80	0.4250000
NODE_17549_length_688_cov_37.563667	514	594	4	4	80	0.0500000
NODE_17549_length_688_cov_37.563667	514	594	6	26	80	0.3250000
NODE_17549_length_688_cov_37.563667	514	594	8	16	80	0.2000000
NODE_17549_length_688_cov_37.563667	514	594	0	34	80	0.4250000
NODE_17549_length_688_cov_37.563667	514	594	4	4	80	0.0500000
NODE_17549_length_688_cov_37.563667	514	594	6	26	80	0.3250000
NODE_17549_length_688_cov_37.563667	514	594	8	16	80	0.2000000
NODE_17549_length_688_cov_37.563667	514	584	0	34	70	0.4857143
NODE_17549_length_688_cov_37.563667	514	584	4	4	70	0.0571429
NODE_17549_length_688_cov_37.563667	514	584	6	26	70	0.3714286
NODE_17549_length_688_cov_37.563667	514	584	8	6	70	0.0857143
NODE_17549_length_688_cov_37.563667	567	647	6	23	80	0.2875000
NODE_17549_length_688_cov_37.563667	567	647	8	57	80	0.7125000
NODE_17549_length_688_cov_37.563667	567	646	6	22	79	0.2784810
NODE_17549_length_688_cov_37.563667	567	646	8	57	79	0.7215190
NODE_17550_length_688_cov_33.898132	373	453	2	49	80	0.6125000
NODE_17550_length_688_cov_33.898132	373	453	4	31	80	0.3875000
NODE_17550_length_688_cov_33.898132	426	506	0	3	80	0.0375000
NODE_17550_length_688_cov_33.898132	426	506	2	8	80	0.1000000
NODE_17550_length_688_cov_33.898132	426	506	4	69	80	0.8625000
NODE_17551_length_688_cov_26.769100	457	537	4	27	80	0.3375000
NODE_17551_length_688_cov_26.769100	457	537	8	53	80	0.6625000
NODE_17551_length_688_cov_26.769100	510	590	4	80	80	1.0000000
NODE_17552_length_688_cov_22.517827	332	412	0	59	80	0.7375000
NODE_17552_length_688_cov_22.517827	332	412	2	14	80	0.1750000
NODE_17552_length_688_cov_22.517827	332	412	3	1	80	0.0125000
NODE_17552_length_688_cov_22.517827	332	412	4	6	80	0.0750000
NODE_17552_length_688_cov_22.517827	385	465	0	15	80	0.1875000
NODE_17552_length_688_cov_22.517827	385	465	2	5	80	0.0625000
NODE_17552_length_688_cov_22.517827	385	465	3	1	80	0.0125000
NODE_17552_length_688_cov_22.517827	385	465	4	59	80	0.7375000
NODE_17553_length_688_cov_16.796265	225	305	0	43	80	0.5375000
NODE_17553_length_688_cov_16.796265	225	305	2	37	80	0.4625000
NODE_17553_length_688_cov_16.796265	278	358	0	80	80	1.0000000
NODE_17555_length_688_cov_13.758913	378	458	0	79	80	0.9875000
NODE_17555_length_688_cov_13.758913	378	458	2	1	80	0.0125000
NODE_17555_length_688_cov_13.758913	431	511	0	80	80	1.0000000
NODE_17556_length_688_cov_12.511036	330	410	0	80	80	1.0000000
NODE_17556_length_688_cov_12.511036	383	463	0	80	80	1.0000000
NODE_17561_length_688_cov_5.446520	366	414	0	44	48	0.9166667
NODE_17561_length_688_cov_5.446520	366	414	4	4	48	0.0833333
NODE_17567_length_688_cov_3.692699	265	345	2	80	80	1.0000000
NODE_17567_length_688_cov_3.692699	322	380	0	29	58	0.5000000
NODE_17567_length_688_cov_3.692699	322	380	2	29	58	0.5000000
NODE_17621_length_687_cov_50.214286	430	510	4	56	80	0.7000000
NODE_17621_length_687_cov_50.214286	430	510	6	24	80	0.3000000
NODE_17621_length_687_cov_50.214286	483	563	0	25	80	0.3125000
NODE_17621_length_687_cov_50.214286	483	563	2	28	80	0.3500000
NODE_17621_length_687_cov_50.214286	483	563	4	27	80	0.3375000
NODE_17622_length_687_cov_32.564626	204	284	0	80	80	1.0000000
NODE_17622_length_687_cov_32.564626	257	337	0	28	80	0.3500000
NODE_17622_length_687_cov_32.564626	257	337	2	52	80	0.6500000
NODE_17623_length_687_cov_22.365646	231	311	0	8	80	0.1000000
NODE_17623_length_687_cov_22.365646	231	311	2	49	80	0.6125000
NODE_17623_length_687_cov_22.365646	231	311	4	23	80	0.2875000
NODE_17623_length_687_cov_22.365646	284	364	0	24	80	0.3000000
NODE_17623_length_687_cov_22.365646	284	364	2	44	80	0.5500000
NODE_17623_length_687_cov_22.365646	284	364	4	12	80	0.1500000
NODE_17626_length_687_cov_11.943878	233	313	0	80	80	1.0000000
NODE_17626_length_687_cov_11.943878	286	366	0	80	80	1.0000000
NODE_17627_length_687_cov_7.865646	311	391	0	9	80	0.1125000
NODE_17627_length_687_cov_7.865646	311	391	2	71	80	0.8875000
NODE_17627_length_687_cov_7.865646	364	444	0	58	80	0.7250000
NODE_17627_length_687_cov_7.865646	364	444	2	22	80	0.2750000
NODE_17628_length_687_cov_7.353741	286	366	0	80	80	1.0000000
NODE_17628_length_687_cov_7.353741	339	419	0	80	80	1.0000000
NODE_17631_length_687_cov_5.903061	369	449	0	79	80	0.9875000
NODE_17631_length_687_cov_5.903061	369	449	2	1	80	0.0125000
NODE_17631_length_687_cov_5.903061	422	502	0	80	80	1.0000000
NODE_17695_length_686_cov_34.642249	355	440	0	15	85	0.1764706
NODE_17695_length_686_cov_34.642249	355	440	2	70	85	0.8235294
NODE_17695_length_686_cov_34.642249	413	493	0	68	80	0.8500000
NODE_17695_length_686_cov_34.642249	413	493	2	12	80	0.1500000
NODE_17697_length_686_cov_26.357751	413	493	0	18	80	0.2250000
NODE_17697_length_686_cov_26.357751	413	493	2	16	80	0.2000000
NODE_17697_length_686_cov_26.357751	413	493	4	46	80	0.5750000
NODE_17697_length_686_cov_26.357751	466	546	2	4	80	0.0500000
NODE_17697_length_686_cov_26.357751	466	546	4	76	80	0.9500000
NODE_17698_length_686_cov_16.715503	400	480	0	80	80	1.0000000
NODE_17698_length_686_cov_16.715503	453	533	0	80	80	1.0000000
NODE_17757_length_685_cov_8.769625	178	258	0	59	80	0.7375000
NODE_17757_length_685_cov_8.769625	178	258	2	21	80	0.2625000
NODE_17757_length_685_cov_8.769625	222	250	0	28	28	1.0000000
NODE_17757_length_685_cov_8.769625	231	311	0	80	80	1.0000000
NODE_17764_length_685_cov_4.447099	249	329	0	13	80	0.1625000
NODE_17764_length_685_cov_4.447099	249	329	2	67	80	0.8375000
NODE_17764_length_685_cov_4.447099	302	382	0	32	80	0.4000000
NODE_17764_length_685_cov_4.447099	302	382	2	48	80	0.6000000
NODE_17768_length_685_cov_3.556314	338	418	0	34	80	0.4250000
NODE_17768_length_685_cov_3.556314	338	418	4	46	80	0.5750000
NODE_17768_length_685_cov_3.556314	391	471	0	32	80	0.4000000
NODE_17768_length_685_cov_3.556314	391	471	4	48	80	0.6000000
NODE_17821_length_684_cov_7.521368	189	269	0	80	80	1.0000000
NODE_17821_length_684_cov_7.521368	242	322	0	80	80	1.0000000
NODE_17832_length_684_cov_3.639316	306	386	0	80	80	1.0000000
NODE_17832_length_684_cov_3.639316	359	439	0	80	80	1.0000000
NODE_17866_length_683_cov_27.493151	346	426	2	31	80	0.3875000
NODE_17866_length_683_cov_27.493151	346	426	3	10	80	0.1250000
NODE_17866_length_683_cov_27.493151	346	426	4	39	80	0.4875000
NODE_17866_length_683_cov_27.493151	399	479	0	11	80	0.1375000
NODE_17866_length_683_cov_27.493151	399	479	2	39	80	0.4875000
NODE_17866_length_683_cov_27.493151	399	479	3	4	80	0.0500000
NODE_17866_length_683_cov_27.493151	399	479	4	26	80	0.3250000
NODE_17867_length_683_cov_12.880137	242	321	0	17	79	0.2151899
NODE_17867_length_683_cov_12.880137	242	321	2	4	79	0.0506329
NODE_17867_length_683_cov_12.880137	242	321	3	35	79	0.4430380
NODE_17867_length_683_cov_12.880137	242	321	4	23	79	0.2911392
NODE_17868_length_683_cov_11.772260	218	274	0	56	56	1.0000000
NODE_17868_length_683_cov_11.772260	247	333	0	86	86	1.0000000
NODE_17869_length_683_cov_9.936644	435	515	0	80	80	1.0000000
NODE_17869_length_683_cov_9.936644	488	568	0	80	80	1.0000000
NODE_17871_length_683_cov_9.017123	296	364	0	68	68	1.0000000
NODE_17871_length_683_cov_9.017123	337	417	0	80	80	1.0000000
NODE_17873_length_683_cov_6.797945	359	415	0	56	56	1.0000000
NODE_17884_length_683_cov_3.176370	113	186	0	73	73	1.0000000
NODE_17947_length_682_cov_33.516295	423	503	0	80	80	1.0000000
NODE_17947_length_682_cov_33.516295	476	556	0	80	80	1.0000000
NODE_17948_length_682_cov_27.022298	479	559	4	12	80	0.1500000
NODE_17948_length_682_cov_27.022298	479	559	10	13	80	0.1625000
NODE_17948_length_682_cov_27.022298	479	559	16	15	80	0.1875000
NODE_17948_length_682_cov_27.022298	479	559	18	6	80	0.0750000
NODE_17948_length_682_cov_27.022298	479	559	26	5	80	0.0625000
NODE_17948_length_682_cov_27.022298	479	559	28	1	80	0.0125000
NODE_17948_length_682_cov_27.022298	479	559	30	10	80	0.1250000
NODE_17948_length_682_cov_27.022298	479	559	32	1	80	0.0125000
NODE_17948_length_682_cov_27.022298	479	559	42	1	80	0.0125000
NODE_17948_length_682_cov_27.022298	479	559	50	2	80	0.0250000
NODE_17948_length_682_cov_27.022298	479	559	54	2	80	0.0250000
NODE_17948_length_682_cov_27.022298	479	559	56	1	80	0.0125000
NODE_17948_length_682_cov_27.022298	479	559	59	1	80	0.0125000
NODE_17948_length_682_cov_27.022298	479	559	61	4	80	0.0500000
NODE_17948_length_682_cov_27.022298	479	559	62	6	80	0.0750000
NODE_17948_length_682_cov_27.022298	532	612	30	9	80	0.1125000
NODE_17948_length_682_cov_27.022298	532	612	32	1	80	0.0125000
NODE_17948_length_682_cov_27.022298	532	612	42	1	80	0.0125000
NODE_17948_length_682_cov_27.022298	532	612	50	2	80	0.0250000
NODE_17948_length_682_cov_27.022298	532	612	54	13	80	0.1625000
NODE_17948_length_682_cov_27.022298	532	612	56	2	80	0.0250000
NODE_17948_length_682_cov_27.022298	532	612	58	12	80	0.1500000
NODE_17948_length_682_cov_27.022298	532	612	59	1	80	0.0125000
NODE_17948_length_682_cov_27.022298	532	612	61	4	80	0.0500000
NODE_17948_length_682_cov_27.022298	532	612	62	15	80	0.1875000
NODE_17948_length_682_cov_27.022298	532	612	64	20	80	0.2500000
NODE_17949_length_682_cov_19.612350	434	514	4	7	80	0.0875000
NODE_17949_length_682_cov_19.612350	434	514	6	6	80	0.0750000
NODE_17949_length_682_cov_19.612350	434	514	8	67	80	0.8375000
NODE_17949_length_682_cov_19.612350	487	567	0	47	80	0.5875000
NODE_17949_length_682_cov_19.612350	487	567	4	13	80	0.1625000
NODE_17949_length_682_cov_19.612350	487	567	6	6	80	0.0750000
NODE_17949_length_682_cov_19.612350	487	567	8	14	80	0.1750000
NODE_17950_length_682_cov_16.620926	261	341	0	80	80	1.0000000
NODE_17950_length_682_cov_16.620926	314	394	0	80	80	1.0000000
NODE_17951_length_682_cov_13.735849	251	331	0	80	80	1.0000000
NODE_17951_length_682_cov_13.735849	304	384	0	80	80	1.0000000
NODE_17952_length_682_cov_12.835334	228	308	0	80	80	1.0000000
NODE_17952_length_682_cov_12.835334	281	361	0	80	80	1.0000000
NODE_17956_length_682_cov_7.504288	224	304	0	80	80	1.0000000
NODE_17956_length_682_cov_7.504288	277	357	0	80	80	1.0000000
NODE_17960_length_682_cov_5.102916	314	351	0	37	37	1.0000000
NODE_17963_length_682_cov_4.579760	152	232	0	40	80	0.5000000
NODE_17963_length_682_cov_4.579760	152	232	2	40	80	0.5000000
NODE_17963_length_682_cov_4.579760	205	285	0	6	80	0.0750000
NODE_17963_length_682_cov_4.579760	205	285	2	74	80	0.9250000
NODE_17967_length_682_cov_4.006861	317	397	0	80	80	1.0000000
NODE_17967_length_682_cov_4.006861	370	450	0	80	80	1.0000000
NODE_17968_length_682_cov_3.859348	160	240	6	3	80	0.0375000
NODE_17968_length_682_cov_3.859348	160	240	9	1	80	0.0125000
NODE_17968_length_682_cov_3.859348	160	240	10	76	80	0.9500000
NODE_17968_length_682_cov_3.859348	213	293	0	21	80	0.2625000
NODE_17968_length_682_cov_3.859348	213	293	3	1	80	0.0125000
NODE_17968_length_682_cov_3.859348	213	293	4	18	80	0.2250000
NODE_17968_length_682_cov_3.859348	213	293	6	16	80	0.2000000
NODE_17968_length_682_cov_3.859348	213	293	9	1	80	0.0125000
NODE_17968_length_682_cov_3.859348	213	293	10	23	80	0.2875000
NODE_18010_length_681_cov_51.810997	181	261	0	80	80	1.0000000
NODE_18010_length_681_cov_51.810997	234	316	0	82	82	1.0000000
NODE_18011_length_681_cov_32.128866	347	427	0	10	80	0.1250000
NODE_18011_length_681_cov_32.128866	347	427	2	70	80	0.8750000
NODE_18011_length_681_cov_32.128866	400	475	0	58	75	0.7733333
NODE_18011_length_681_cov_32.128866	400	475	2	17	75	0.2266667
NODE_18012_length_681_cov_19.079038	282	362	0	80	80	1.0000000
NODE_18012_length_681_cov_19.079038	335	415	0	80	80	1.0000000
NODE_18013_length_681_cov_17.053265	294	374	0	80	80	1.0000000
NODE_18013_length_681_cov_17.053265	347	427	0	80	80	1.0000000
NODE_18014_length_681_cov_11.183849	306	386	0	40	80	0.5000000
NODE_18014_length_681_cov_11.183849	306	386	2	40	80	0.5000000
NODE_18014_length_681_cov_11.183849	359	439	0	80	80	1.0000000
NODE_18015_length_681_cov_8.065292	236	316	0	75	80	0.9375000
NODE_18015_length_681_cov_8.065292	236	316	2	5	80	0.0625000
NODE_18015_length_681_cov_8.065292	289	369	0	22	80	0.2750000
NODE_18015_length_681_cov_8.065292	289	369	2	58	80	0.7250000
NODE_18017_length_681_cov_6.888316	344	424	0	80	80	1.0000000
NODE_18017_length_681_cov_6.888316	397	477	0	80	80	1.0000000
NODE_18080_length_680_cov_35.695353	348	428	0	80	80	1.0000000
NODE_18080_length_680_cov_35.695353	401	481	0	80	80	1.0000000
NODE_18081_length_680_cov_17.500861	296	376	0	80	80	1.0000000
NODE_18081_length_680_cov_17.500861	349	429	0	80	80	1.0000000
NODE_18082_length_680_cov_16.685026	260	340	0	80	80	1.0000000
NODE_18082_length_680_cov_16.685026	313	393	0	80	80	1.0000000
NODE_18083_length_680_cov_15.345955	332	412	0	64	80	0.8000000
NODE_18083_length_680_cov_15.345955	332	412	2	16	80	0.2000000
NODE_18083_length_680_cov_15.345955	385	465	0	11	80	0.1375000
NODE_18083_length_680_cov_15.345955	385	465	2	69	80	0.8625000
NODE_18089_length_680_cov_3.858864	458	538	0	80	80	1.0000000
NODE_18107_length_680_cov_1.879518	236	256	0	20	20	1.0000000
NODE_18146_length_679_cov_52.046552	367	447	1	24	80	0.3000000
NODE_18146_length_679_cov_52.046552	367	447	11	15	80	0.1875000
NODE_18146_length_679_cov_52.046552	367	447	12	41	80	0.5125000
NODE_18146_length_679_cov_52.046552	420	500	10	12	80	0.1500000
NODE_18146_length_679_cov_52.046552	420	500	11	12	80	0.1500000
NODE_18146_length_679_cov_52.046552	420	500	12	56	80	0.7000000
NODE_18147_length_679_cov_40.353448	179	259	0	80	80	1.0000000
NODE_18147_length_679_cov_40.353448	232	312	0	34	80	0.4250000
NODE_18147_length_679_cov_40.353448	232	312	2	46	80	0.5750000
NODE_18148_length_679_cov_38.144828	364	428	0	14	64	0.2187500
NODE_18148_length_679_cov_38.144828	364	428	8	50	64	0.7812500
NODE_18148_length_679_cov_38.144828	401	481	0	14	80	0.1750000
NODE_18148_length_679_cov_38.144828	401	481	8	66	80	0.8250000
NODE_18149_length_679_cov_17.134483	277	357	0	80	80	1.0000000
NODE_18149_length_679_cov_17.134483	330	410	0	80	80	1.0000000
NODE_18150_length_679_cov_15.046552	310	375	0	65	65	1.0000000
NODE_18151_length_679_cov_12.586207	247	327	0	80	80	1.0000000
NODE_18151_length_679_cov_12.586207	303	381	0	78	78	1.0000000
NODE_18152_length_679_cov_12.282759	337	417	0	57	80	0.7125000
NODE_18152_length_679_cov_12.282759	337	417	2	23	80	0.2875000
NODE_18152_length_679_cov_12.282759	390	470	0	17	80	0.2125000
NODE_18152_length_679_cov_12.282759	390	470	2	63	80	0.7875000
NODE_18153_length_679_cov_11.532759	205	285	0	58	80	0.7250000
NODE_18153_length_679_cov_11.532759	205	285	1	8	80	0.1000000
NODE_18153_length_679_cov_11.532759	205	285	2	14	80	0.1750000
NODE_18153_length_679_cov_11.532759	258	338	0	5	80	0.0625000
NODE_18153_length_679_cov_11.532759	258	338	1	8	80	0.1000000
NODE_18153_length_679_cov_11.532759	258	338	2	67	80	0.8375000
NODE_18155_length_679_cov_8.043103	269	341	0	72	72	1.0000000
NODE_18155_length_679_cov_8.043103	314	394	0	79	80	0.9875000
NODE_18155_length_679_cov_8.043103	314	394	2	1	80	0.0125000
NODE_18156_length_679_cov_7.267241	191	271	0	80	80	1.0000000
NODE_18156_length_679_cov_7.267241	244	324	0	80	80	1.0000000
NODE_18162_length_679_cov_5.391379	279	331	4	15	52	0.2884615
NODE_18162_length_679_cov_5.391379	279	331	9	1	52	0.0192308
NODE_18162_length_679_cov_5.391379	279	331	10	7	52	0.1346154
NODE_18162_length_679_cov_5.391379	279	331	14	29	52	0.5576923
NODE_18164_length_679_cov_3.813793	10	69	1	3	59	0.0508475
NODE_18164_length_679_cov_3.813793	10	69	3	7	59	0.1186441
NODE_18164_length_679_cov_3.813793	10	69	4	4	59	0.0677966
NODE_18164_length_679_cov_3.813793	10	69	5	24	59	0.4067796
NODE_18164_length_679_cov_3.813793	10	69	7	21	59	0.3559322
NODE_18164_length_679_cov_3.813793	48	122	4	3	74	0.0405405
NODE_18164_length_679_cov_3.813793	48	122	5	22	74	0.2972973
NODE_18164_length_679_cov_3.813793	48	122	6	5	74	0.0675676
NODE_18164_length_679_cov_3.813793	48	122	7	44	74	0.5945946
NODE_18217_length_678_cov_38.910190	252	332	0	80	80	1.0000000
NODE_18217_length_678_cov_38.910190	305	385	0	80	80	1.0000000
NODE_18217_length_678_cov_38.910190	381	461	0	29	80	0.3625000
NODE_18217_length_678_cov_38.910190	381	461	2	51	80	0.6375000
NODE_18217_length_678_cov_38.910190	434	514	2	80	80	1.0000000
NODE_18218_length_678_cov_20.663212	243	323	0	80	80	1.0000000
NODE_18218_length_678_cov_20.663212	296	376	0	80	80	1.0000000
NODE_18219_length_678_cov_12.081174	243	323	0	3	80	0.0375000
NODE_18219_length_678_cov_12.081174	243	323	2	2	80	0.0250000
NODE_18219_length_678_cov_12.081174	243	323	6	75	80	0.9375000
NODE_18219_length_678_cov_12.081174	296	376	0	19	80	0.2375000
NODE_18219_length_678_cov_12.081174	296	376	2	22	80	0.2750000
NODE_18219_length_678_cov_12.081174	296	376	6	39	80	0.4875000
NODE_18224_length_678_cov_6.559585	195	264	0	69	69	1.0000000
NODE_18224_length_678_cov_6.559585	237	317	0	80	80	1.0000000
NODE_18228_length_678_cov_4.462867	133	213	0	9	80	0.1125000
NODE_18228_length_678_cov_4.462867	133	213	2	71	80	0.8875000
NODE_18228_length_678_cov_4.462867	186	266	0	62	80	0.7750000
NODE_18228_length_678_cov_4.462867	186	266	2	18	80	0.2250000
NODE_18239_length_678_cov_2.716753	351	431	0	52	80	0.6500000
NODE_18239_length_678_cov_2.716753	351	431	5	1	80	0.0125000
NODE_18239_length_678_cov_2.716753	351	431	6	27	80	0.3375000
NODE_18239_length_678_cov_2.716753	404	484	6	80	80	1.0000000
NODE_18289_length_677_cov_22.235294	274	354	0	80	80	1.0000000
NODE_18289_length_677_cov_22.235294	327	407	0	80	80	1.0000000
NODE_18290_length_677_cov_16.410035	124	206	8	82	82	1.0000000
NODE_18290_length_677_cov_16.410035	177	261	0	10	84	0.1190476
NODE_18290_length_677_cov_16.410035	177	261	7	1	84	0.0119048
NODE_18290_length_677_cov_16.410035	177	261	8	73	84	0.8690476
NODE_18291_length_677_cov_11.031142	393	473	0	31	80	0.3875000
NODE_18291_length_677_cov_11.031142	393	473	2	42	80	0.5250000
NODE_18291_length_677_cov_11.031142	393	473	4	7	80	0.0875000
NODE_18291_length_677_cov_11.031142	446	526	0	80	80	1.0000000
NODE_18292_length_677_cov_10.129758	258	338	0	80	80	1.0000000
NODE_18292_length_677_cov_10.129758	311	391	0	80	80	1.0000000
NODE_18295_length_677_cov_6.660900	217	297	26	2	80	0.0250000
NODE_18295_length_677_cov_6.660900	217	297	27	3	80	0.0375000
NODE_18295_length_677_cov_6.660900	217	297	31	1	80	0.0125000
NODE_18295_length_677_cov_6.660900	217	297	33	3	80	0.0375000
NODE_18295_length_677_cov_6.660900	217	297	37	2	80	0.0250000
NODE_18295_length_677_cov_6.660900	217	297	41	11	80	0.1375000
NODE_18295_length_677_cov_6.660900	217	297	43	4	80	0.0500000
NODE_18295_length_677_cov_6.660900	217	297	47	9	80	0.1125000
NODE_18295_length_677_cov_6.660900	217	297	48	12	80	0.1500000
NODE_18295_length_677_cov_6.660900	217	297	49	16	80	0.2000000
NODE_18295_length_677_cov_6.660900	217	297	50	17	80	0.2125000
NODE_18297_length_677_cov_5.228374	366	446	0	57	80	0.7125000
NODE_18297_length_677_cov_5.228374	366	446	2	23	80	0.2875000
NODE_18312_length_677_cov_2.306228	230	278	0	48	48	1.0000000
NODE_18329_length_677_cov_1.709343	369	449	0	25	80	0.3125000
NODE_18329_length_677_cov_1.709343	369	449	2	6	80	0.0750000
NODE_18329_length_677_cov_1.709343	369	449	4	49	80	0.6125000
NODE_18329_length_677_cov_1.709343	422	502	2	36	80	0.4500000
NODE_18329_length_677_cov_1.709343	422	502	4	44	80	0.5500000
NODE_18368_length_676_cov_66.473137	286	366	0	80	80	1.0000000
NODE_18368_length_676_cov_66.473137	339	419	0	44	80	0.5500000
NODE_18368_length_676_cov_66.473137	339	419	12	1	80	0.0125000
NODE_18368_length_676_cov_66.473137	339	419	16	1	80	0.0125000
NODE_18368_length_676_cov_66.473137	339	419	18	1	80	0.0125000
NODE_18368_length_676_cov_66.473137	339	419	24	1	80	0.0125000
NODE_18368_length_676_cov_66.473137	339	419	26	1	80	0.0125000
NODE_18368_length_676_cov_66.473137	339	419	33	1	80	0.0125000
NODE_18368_length_676_cov_66.473137	339	419	37	2	80	0.0250000
NODE_18368_length_676_cov_66.473137	339	419	38	1	80	0.0125000
NODE_18368_length_676_cov_66.473137	339	419	41	4	80	0.0500000
NODE_18368_length_676_cov_66.473137	339	419	49	2	80	0.0250000
NODE_18368_length_676_cov_66.473137	339	419	53	1	80	0.0125000
NODE_18368_length_676_cov_66.473137	339	419	54	1	80	0.0125000
NODE_18368_length_676_cov_66.473137	339	419	55	6	80	0.0750000
NODE_18368_length_676_cov_66.473137	339	419	57	4	80	0.0500000
NODE_18368_length_676_cov_66.473137	339	419	58	2	80	0.0250000
NODE_18368_length_676_cov_66.473137	339	419	59	1	80	0.0125000
NODE_18368_length_676_cov_66.473137	339	419	61	6	80	0.0750000
NODE_18368_length_676_cov_66.473137	383	419	12	1	36	0.0277778
NODE_18368_length_676_cov_66.473137	383	419	16	1	36	0.0277778
NODE_18368_length_676_cov_66.473137	383	419	18	1	36	0.0277778
NODE_18368_length_676_cov_66.473137	383	419	24	1	36	0.0277778
NODE_18368_length_676_cov_66.473137	383	419	26	1	36	0.0277778
NODE_18368_length_676_cov_66.473137	383	419	33	1	36	0.0277778
NODE_18368_length_676_cov_66.473137	383	419	37	2	36	0.0555556
NODE_18368_length_676_cov_66.473137	383	419	38	1	36	0.0277778
NODE_18368_length_676_cov_66.473137	383	419	41	4	36	0.1111111
NODE_18368_length_676_cov_66.473137	383	419	49	2	36	0.0555556
NODE_18368_length_676_cov_66.473137	383	419	53	1	36	0.0277778
NODE_18368_length_676_cov_66.473137	383	419	54	1	36	0.0277778
NODE_18368_length_676_cov_66.473137	383	419	55	6	36	0.1666667
NODE_18368_length_676_cov_66.473137	383	419	57	4	36	0.1111111
NODE_18368_length_676_cov_66.473137	383	419	58	2	36	0.0555556
NODE_18368_length_676_cov_66.473137	383	419	59	1	36	0.0277778
NODE_18368_length_676_cov_66.473137	383	419	61	6	36	0.1666667
NODE_18368_length_676_cov_66.473137	383	419	12	1	36	0.0277778
NODE_18368_length_676_cov_66.473137	383	419	16	1	36	0.0277778
NODE_18368_length_676_cov_66.473137	383	419	18	1	36	0.0277778
NODE_18368_length_676_cov_66.473137	383	419	24	1	36	0.0277778
NODE_18368_length_676_cov_66.473137	383	419	26	1	36	0.0277778
NODE_18368_length_676_cov_66.473137	383	419	33	1	36	0.0277778
NODE_18368_length_676_cov_66.473137	383	419	37	2	36	0.0555556
NODE_18368_length_676_cov_66.473137	383	419	38	1	36	0.0277778
NODE_18368_length_676_cov_66.473137	383	419	41	4	36	0.1111111
NODE_18368_length_676_cov_66.473137	383	419	49	2	36	0.0555556
NODE_18368_length_676_cov_66.473137	383	419	53	1	36	0.0277778
NODE_18368_length_676_cov_66.473137	383	419	54	1	36	0.0277778
NODE_18368_length_676_cov_66.473137	383	419	55	6	36	0.1666667
NODE_18368_length_676_cov_66.473137	383	419	57	4	36	0.1111111
NODE_18368_length_676_cov_66.473137	383	419	58	2	36	0.0555556
NODE_18368_length_676_cov_66.473137	383	419	59	1	36	0.0277778
NODE_18368_length_676_cov_66.473137	383	419	61	6	36	0.1666667
NODE_18368_length_676_cov_66.473137	398	419	53	1	21	0.0476190
NODE_18368_length_676_cov_66.473137	398	419	54	1	21	0.0476190
NODE_18368_length_676_cov_66.473137	398	419	55	6	21	0.2857143
NODE_18368_length_676_cov_66.473137	398	419	57	4	21	0.1904762
NODE_18368_length_676_cov_66.473137	398	419	58	2	21	0.0952381
NODE_18368_length_676_cov_66.473137	398	419	59	1	21	0.0476190
NODE_18368_length_676_cov_66.473137	398	419	61	6	21	0.2857143
NODE_18369_length_676_cov_14.429809	259	330	2	71	71	1.0000000
NODE_18370_length_676_cov_13.882149	292	372	2	43	80	0.5375000
NODE_18370_length_676_cov_13.882149	292	372	4	37	80	0.4625000
NODE_18370_length_676_cov_13.882149	345	425	0	34	80	0.4250000
NODE_18370_length_676_cov_13.882149	345	425	2	46	80	0.5750000
NODE_18374_length_676_cov_7.225303	363	443	0	31	80	0.3875000
NODE_18374_length_676_cov_7.225303	363	443	2	49	80	0.6125000
NODE_18374_length_676_cov_7.225303	416	496	0	15	80	0.1875000
NODE_18374_length_676_cov_7.225303	416	496	2	65	80	0.8125000
NODE_18375_length_676_cov_6.740035	373	433	0	60	60	1.0000000
NODE_18375_length_676_cov_6.740035	406	486	0	80	80	1.0000000
NODE_18378_length_676_cov_4.658579	167	240	0	73	73	1.0000000
NODE_18397_length_676_cov_2.292894	146	226	0	10	80	0.1250000
NODE_18397_length_676_cov_2.292894	146	226	2	14	80	0.1750000
NODE_18397_length_676_cov_2.292894	146	226	4	4	80	0.0500000
NODE_18397_length_676_cov_2.292894	146	226	5	22	80	0.2750000
NODE_18397_length_676_cov_2.292894	146	226	6	30	80	0.3750000
NODE_18401_length_676_cov_2.157712	175	226	1	51	51	1.0000000
NODE_18417_length_676_cov_1.547660	133	164	0	31	31	1.0000000
NODE_18447_length_675_cov_27.574653	190	270	0	80	80	1.0000000
NODE_18447_length_675_cov_27.574653	243	323	0	80	80	1.0000000
NODE_18448_length_675_cov_11.895833	336	416	2	50	80	0.6250000
NODE_18448_length_675_cov_11.895833	336	416	4	30	80	0.3750000
NODE_18448_length_675_cov_11.895833	389	469	0	9	80	0.1125000
NODE_18448_length_675_cov_11.895833	389	469	2	46	80	0.5750000
NODE_18448_length_675_cov_11.895833	389	469	4	25	80	0.3125000
NODE_18449_length_675_cov_8.157986	414	494	0	18	80	0.2250000
NODE_18449_length_675_cov_8.157986	414	494	2	62	80	0.7750000
NODE_18449_length_675_cov_8.157986	467	547	0	22	80	0.2750000
NODE_18449_length_675_cov_8.157986	467	547	2	58	80	0.7250000
NODE_18450_length_675_cov_8.026042	320	400	0	48	80	0.6000000
NODE_18450_length_675_cov_8.026042	320	400	2	32	80	0.4000000
NODE_18450_length_675_cov_8.026042	373	453	0	80	80	1.0000000
NODE_18451_length_675_cov_7.277778	317	397	0	80	80	1.0000000
NODE_18455_length_675_cov_5.666667	142	222	0	80	80	1.0000000
NODE_18455_length_675_cov_5.666667	195	275	0	80	80	1.0000000
NODE_18464_length_675_cov_2.751736	67	122	0	15	55	0.2727273
NODE_18464_length_675_cov_2.751736	67	122	2	40	55	0.7272727
NODE_18467_length_675_cov_2.623264	251	289	0	4	38	0.1052632
NODE_18467_length_675_cov_2.623264	251	289	2	34	38	0.8947368
NODE_18467_length_675_cov_2.623264	279	343	0	6	64	0.0937500
NODE_18467_length_675_cov_2.623264	279	343	2	58	64	0.9062500
NODE_18467_length_675_cov_2.623264	432	494	0	62	62	1.0000000
NODE_18515_length_674_cov_38.401739	225	305	0	80	80	1.0000000
NODE_18515_length_674_cov_38.401739	278	358	0	80	80	1.0000000
NODE_18516_length_674_cov_30.215652	519	599	8	13	80	0.1625000
NODE_18516_length_674_cov_30.215652	519	599	9	1	80	0.0125000
NODE_18516_length_674_cov_30.215652	519	599	10	6	80	0.0750000
NODE_18516_length_674_cov_30.215652	519	599	12	24	80	0.3000000
NODE_18516_length_674_cov_30.215652	519	599	16	13	80	0.1625000
NODE_18516_length_674_cov_30.215652	519	599	18	23	80	0.2875000
NODE_18516_length_674_cov_30.215652	572	602	8	16	30	0.5333334
NODE_18516_length_674_cov_30.215652	572	602	10	2	30	0.0666667
NODE_18516_length_674_cov_30.215652	572	602	12	11	30	0.3666667
NODE_18516_length_674_cov_30.215652	572	602	16	1	30	0.0333333
NODE_18517_length_674_cov_19.636522	283	363	2	2	80	0.0250000
NODE_18517_length_674_cov_19.636522	283	363	4	7	80	0.0875000
NODE_18517_length_674_cov_19.636522	283	363	5	23	80	0.2875000
NODE_18517_length_674_cov_19.636522	283	363	6	32	80	0.4000000
NODE_18517_length_674_cov_19.636522	283	363	7	16	80	0.2000000
NODE_18517_length_674_cov_19.636522	336	416	2	2	80	0.0250000
NODE_18517_length_674_cov_19.636522	336	416	3	4	80	0.0500000
NODE_18517_length_674_cov_19.636522	336	416	4	16	80	0.2000000
NODE_18517_length_674_cov_19.636522	336	416	5	58	80	0.7250000
NODE_18518_length_674_cov_19.436522	81	161	0	80	80	1.0000000
NODE_18518_length_674_cov_19.436522	134	214	0	80	80	1.0000000
NODE_18519_length_674_cov_16.819130	185	265	0	80	80	1.0000000
NODE_18519_length_674_cov_16.819130	238	318	0	36	80	0.4500000
NODE_18519_length_674_cov_16.819130	238	318	4	1	80	0.0125000
NODE_18519_length_674_cov_16.819130	238	318	6	35	80	0.4375000
NODE_18519_length_674_cov_16.819130	238	318	10	8	80	0.1000000
NODE_18520_length_674_cov_14.733913	169	249	0	21	80	0.2625000
NODE_18520_length_674_cov_14.733913	169	249	4	48	80	0.6000000
NODE_18520_length_674_cov_14.733913	169	249	6	7	80	0.0875000
NODE_18520_length_674_cov_14.733913	169	249	8	4	80	0.0500000
NODE_18520_length_674_cov_14.733913	222	302	4	16	80	0.2000000
NODE_18520_length_674_cov_14.733913	222	302	6	7	80	0.0875000
NODE_18520_length_674_cov_14.733913	222	302	8	57	80	0.7125000
NODE_18524_length_674_cov_7.086957	357	437	0	80	80	1.0000000
NODE_18524_length_674_cov_7.086957	410	490	0	80	80	1.0000000
NODE_18528_length_674_cov_4.808696	262	342	0	80	80	1.0000000
NODE_18528_length_674_cov_4.808696	315	395	0	80	80	1.0000000
NODE_18592_length_673_cov_47.109756	405	485	0	44	80	0.5500000
NODE_18592_length_673_cov_47.109756	405	485	2	36	80	0.4500000
NODE_18592_length_673_cov_47.109756	458	538	0	80	80	1.0000000
NODE_18593_length_673_cov_20.548780	214	294	0	72	80	0.9000000
NODE_18593_length_673_cov_20.548780	214	294	2	8	80	0.1000000
NODE_18593_length_673_cov_20.548780	267	347	0	80	80	1.0000000
NODE_18596_length_673_cov_8.306620	337	426	0	89	89	1.0000000
NODE_18607_length_673_cov_3.041812	196	276	0	43	80	0.5375000
NODE_18607_length_673_cov_3.041812	196	276	2	37	80	0.4625000
NODE_18607_length_673_cov_3.041812	249	329	0	80	80	1.0000000
NODE_18660_length_672_cov_15.380454	282	362	0	27	80	0.3375000
NODE_18660_length_672_cov_15.380454	282	362	2	53	80	0.6625000
NODE_18660_length_672_cov_15.380454	335	415	0	10	80	0.1250000
NODE_18660_length_672_cov_15.380454	335	415	2	70	80	0.8750000
NODE_18661_length_672_cov_9.902269	328	408	0	80	80	1.0000000
NODE_18661_length_672_cov_9.902269	381	461	0	80	80	1.0000000
NODE_18662_length_672_cov_9.462478	309	389	0	68	80	0.8500000
NODE_18662_length_672_cov_9.462478	309	389	4	12	80	0.1500000
NODE_18662_length_672_cov_9.462478	362	442	0	80	80	1.0000000
NODE_18666_length_672_cov_6.516579	354	434	0	80	80	1.0000000
NODE_18666_length_672_cov_6.516579	407	487	0	80	80	1.0000000
NODE_18668_length_672_cov_6.108202	135	215	0	80	80	1.0000000
NODE_18668_length_672_cov_6.108202	188	268	0	80	80	1.0000000
NODE_18670_length_672_cov_4.949389	115	152	0	37	37	1.0000000
NODE_18670_length_672_cov_4.949389	125	205	0	80	80	1.0000000
NODE_18670_length_672_cov_4.949389	278	326	0	48	48	1.0000000
NODE_18672_length_672_cov_4.753927	378	450	0	72	72	1.0000000
NODE_18704_length_672_cov_1.713787	340	401	4	1	61	0.0163934
NODE_18704_length_672_cov_1.713787	340	401	8	60	61	0.9836066
NODE_18742_length_671_cov_28.874126	306	387	0	81	81	1.0000000
NODE_18742_length_671_cov_28.874126	360	440	0	80	80	1.0000000
NODE_18744_length_671_cov_18.526224	294	333	0	39	39	1.0000000
NODE_18744_length_671_cov_18.526224	331	404	0	73	73	1.0000000
NODE_18744_length_671_cov_18.526224	331	351	0	20	20	1.0000000
NODE_18745_length_671_cov_16.094406	417	497	2	24	80	0.3000000
NODE_18745_length_671_cov_16.094406	417	497	4	3	80	0.0375000
NODE_18745_length_671_cov_16.094406	417	497	6	53	80	0.6625000
NODE_18745_length_671_cov_16.094406	470	550	0	10	80	0.1250000
NODE_18745_length_671_cov_16.094406	470	550	4	46	80	0.5750000
NODE_18745_length_671_cov_16.094406	470	550	6	24	80	0.3000000
NODE_18746_length_671_cov_11.756993	337	417	0	48	80	0.6000000
NODE_18746_length_671_cov_11.756993	337	417	2	32	80	0.4000000
NODE_18746_length_671_cov_11.756993	390	470	2	80	80	1.0000000
NODE_18747_length_671_cov_9.237762	305	382	4	77	77	1.0000000
NODE_18748_length_671_cov_8.491259	298	379	0	81	81	1.0000000
NODE_18748_length_671_cov_8.491259	352	430	0	78	78	1.0000000
NODE_18749_length_671_cov_8.241259	97	128	2	31	31	1.0000000
NODE_18752_length_671_cov_7.201049	368	448	0	80	80	1.0000000
NODE_18752_length_671_cov_7.201049	421	501	0	80	80	1.0000000
NODE_18753_length_671_cov_5.680070	370	450	0	45	80	0.5625000
NODE_18753_length_671_cov_5.680070	370	450	4	35	80	0.4375000
NODE_18753_length_671_cov_5.680070	423	503	2	1	80	0.0125000
NODE_18753_length_671_cov_5.680070	423	503	4	62	80	0.7750000
NODE_18753_length_671_cov_5.680070	423	503	6	17	80	0.2125000
NODE_18754_length_671_cov_4.769231	362	414	0	51	52	0.9807692
NODE_18754_length_671_cov_4.769231	362	414	2	1	52	0.0192308
NODE_18760_length_671_cov_3.804196	360	440	0	31	80	0.3875000
NODE_18760_length_671_cov_3.804196	360	440	4	49	80	0.6125000
NODE_18812_length_670_cov_21.017513	443	523	0	21	80	0.2625000
NODE_18812_length_670_cov_21.017513	443	523	2	59	80	0.7375000
NODE_18812_length_670_cov_21.017513	496	576	0	74	80	0.9250000
NODE_18812_length_670_cov_21.017513	496	576	2	6	80	0.0750000
NODE_18813_length_670_cov_20.346760	372	452	0	32	80	0.4000000
NODE_18813_length_670_cov_20.346760	372	452	4	48	80	0.6000000
NODE_18813_length_670_cov_20.346760	425	505	4	80	80	1.0000000
NODE_18814_length_670_cov_15.728546	157	237	0	80	80	1.0000000
NODE_18814_length_670_cov_15.728546	210	290	0	80	80	1.0000000
NODE_18814_length_670_cov_15.728546	286	366	0	80	80	1.0000000
NODE_18814_length_670_cov_15.728546	339	419	0	80	80	1.0000000
NODE_18818_length_670_cov_6.499124	390	470	2	80	80	1.0000000
NODE_18834_length_670_cov_3.099825	159	217	0	58	58	1.0000000
NODE_18838_length_670_cov_2.700525	252	332	2	16	80	0.2000000
NODE_18838_length_670_cov_2.700525	252	332	6	64	80	0.8000000
NODE_18838_length_670_cov_2.700525	305	385	0	2	80	0.0250000
NODE_18838_length_670_cov_2.700525	305	385	4	37	80	0.4625000
NODE_18838_length_670_cov_2.700525	305	385	6	41	80	0.5125000
NODE_18883_length_669_cov_13.307018	432	512	0	21	80	0.2625000
NODE_18883_length_669_cov_13.307018	432	512	2	59	80	0.7375000
NODE_18883_length_669_cov_13.307018	485	565	0	12	80	0.1500000
NODE_18883_length_669_cov_13.307018	485	565	2	68	80	0.8500000
NODE_18886_length_669_cov_6.921053	245	325	0	4	80	0.0500000
NODE_18886_length_669_cov_6.921053	245	325	2	20	80	0.2500000
NODE_18886_length_669_cov_6.921053	245	325	6	13	80	0.1625000
NODE_18886_length_669_cov_6.921053	245	325	8	43	80	0.5375000
NODE_18886_length_669_cov_6.921053	298	370	0	30	72	0.4166667
NODE_18886_length_669_cov_6.921053	298	370	6	28	72	0.3888889
NODE_18886_length_669_cov_6.921053	298	370	8	14	72	0.1944444
NODE_18901_length_669_cov_3.633333	277	347	0	3	70	0.0428571
NODE_18901_length_669_cov_3.633333	277	347	2	67	70	0.9571428
NODE_18909_length_669_cov_2.361404	434	490	0	56	56	1.0000000
NODE_18958_length_668_cov_23.131810	275	355	0	33	80	0.4125000
NODE_18958_length_668_cov_23.131810	275	355	2	47	80	0.5875000
NODE_18958_length_668_cov_23.131810	328	408	0	17	80	0.2125000
NODE_18958_length_668_cov_23.131810	328	408	2	63	80	0.7875000
NODE_18959_length_668_cov_14.978910	324	404	0	60	80	0.7500000
NODE_18959_length_668_cov_14.978910	324	404	2	20	80	0.2500000
NODE_18959_length_668_cov_14.978910	377	457	0	7	80	0.0875000
NODE_18959_length_668_cov_14.978910	377	457	2	73	80	0.9125000
NODE_18962_length_668_cov_11.184534	187	267	0	80	80	1.0000000
NODE_18962_length_668_cov_11.184534	240	320	0	80	80	1.0000000
NODE_18963_length_668_cov_10.548330	211	291	0	80	80	1.0000000
NODE_18963_length_668_cov_10.548330	264	344	0	80	80	1.0000000
NODE_18964_length_668_cov_10.370826	226	308	0	39	82	0.4756097
NODE_18964_length_668_cov_10.370826	226	308	4	1	82	0.0121951
NODE_18964_length_668_cov_10.370826	226	308	11	42	82	0.5121951
NODE_18964_length_668_cov_10.370826	279	361	7	3	82	0.0365854
NODE_18964_length_668_cov_10.370826	279	361	11	32	82	0.3902439
NODE_18964_length_668_cov_10.370826	279	361	12	7	82	0.0853659
NODE_18964_length_668_cov_10.370826	279	361	13	14	82	0.1707317
NODE_18964_length_668_cov_10.370826	279	361	14	26	82	0.3170732
NODE_18965_length_668_cov_10.223199	238	318	0	80	80	1.0000000
NODE_18965_length_668_cov_10.223199	291	371	0	80	80	1.0000000
NODE_18967_length_668_cov_9.340949	310	390	0	80	80	1.0000000
NODE_18967_length_668_cov_9.340949	363	443	0	80	80	1.0000000
NODE_18975_length_668_cov_4.077329	304	384	10	80	80	1.0000000
NODE_18975_length_668_cov_4.077329	338	367	10	29	29	1.0000000
NODE_18975_length_668_cov_4.077329	358	427	0	33	69	0.4782609
NODE_18975_length_668_cov_4.077329	358	427	2	3	69	0.0434783
NODE_18975_length_668_cov_4.077329	358	427	4	2	69	0.0289855
NODE_18975_length_668_cov_4.077329	358	427	10	31	69	0.4492754
NODE_19032_length_667_cov_33.848592	168	248	0	80	80	1.0000000
NODE_19032_length_667_cov_33.848592	221	301	0	80	80	1.0000000
NODE_19033_length_667_cov_21.218310	270	350	0	19	80	0.2375000
NODE_19033_length_667_cov_21.218310	270	350	2	61	80	0.7625000
NODE_19033_length_667_cov_21.218310	323	403	0	16	80	0.2000000
NODE_19033_length_667_cov_21.218310	323	403	2	64	80	0.8000000
NODE_19034_length_667_cov_19.204225	258	338	0	6	80	0.0750000
NODE_19034_length_667_cov_19.204225	258	338	2	14	80	0.1750000
NODE_19034_length_667_cov_19.204225	258	338	4	60	80	0.7500000
NODE_19034_length_667_cov_19.204225	311	391	0	59	80	0.7375000
NODE_19034_length_667_cov_19.204225	311	391	2	14	80	0.1750000
NODE_19034_length_667_cov_19.204225	311	391	4	7	80	0.0875000
NODE_19036_length_667_cov_8.264085	299	379	2	80	80	1.0000000
NODE_19036_length_667_cov_8.264085	352	432	0	41	80	0.5125000
NODE_19036_length_667_cov_8.264085	352	432	2	39	80	0.4875000
NODE_19037_length_667_cov_8.248239	76	156	0	80	80	1.0000000
NODE_19037_length_667_cov_8.248239	129	209	0	80	80	1.0000000
NODE_19038_length_667_cov_8.207746	257	323	0	66	66	1.0000000
NODE_19038_length_667_cov_8.207746	296	376	0	80	80	1.0000000
NODE_19039_length_667_cov_7.232394	357	437	0	42	80	0.5250000
NODE_19039_length_667_cov_7.232394	357	437	2	38	80	0.4750000
NODE_19039_length_667_cov_7.232394	410	490	0	80	80	1.0000000
NODE_19042_length_667_cov_4.941901	199	279	0	80	80	1.0000000
NODE_19042_length_667_cov_4.941901	252	332	0	80	80	1.0000000
NODE_19053_length_667_cov_3.404930	501	536	5	4	35	0.1142857
NODE_19053_length_667_cov_3.404930	501	536	7	31	35	0.8857143
NODE_19053_length_667_cov_3.404930	503	533	5	1	30	0.0333333
NODE_19053_length_667_cov_3.404930	503	533	7	29	30	0.9666666
NODE_19100_length_666_cov_24.811287	179	254	6	4	75	0.0533333
NODE_19100_length_666_cov_24.811287	179	254	10	6	75	0.0800000
NODE_19100_length_666_cov_24.811287	179	254	12	1	75	0.0133333
NODE_19100_length_666_cov_24.811287	179	254	14	1	75	0.0133333
NODE_19100_length_666_cov_24.811287	179	254	18	21	75	0.2800000
NODE_19100_length_666_cov_24.811287	179	254	20	42	75	0.5600000
NODE_19100_length_666_cov_24.811287	182	254	6	4	72	0.0555556
NODE_19100_length_666_cov_24.811287	182	254	10	6	72	0.0833333
NODE_19100_length_666_cov_24.811287	182	254	12	1	72	0.0138889
NODE_19100_length_666_cov_24.811287	182	254	14	1	72	0.0138889
NODE_19100_length_666_cov_24.811287	182	254	18	21	72	0.2916667
NODE_19100_length_666_cov_24.811287	182	254	20	39	72	0.5416667
NODE_19100_length_666_cov_24.811287	227	307	0	19	80	0.2375000
NODE_19100_length_666_cov_24.811287	227	307	2	19	80	0.2375000
NODE_19100_length_666_cov_24.811287	227	307	4	3	80	0.0375000
NODE_19100_length_666_cov_24.811287	227	307	6	16	80	0.2000000
NODE_19100_length_666_cov_24.811287	227	307	10	6	80	0.0750000
NODE_19100_length_666_cov_24.811287	227	307	12	1	80	0.0125000
NODE_19100_length_666_cov_24.811287	227	307	14	1	80	0.0125000
NODE_19100_length_666_cov_24.811287	227	307	18	15	80	0.1875000
NODE_19100_length_666_cov_24.811287	227	307	0	19	80	0.2375000
NODE_19100_length_666_cov_24.811287	227	307	2	19	80	0.2375000
NODE_19100_length_666_cov_24.811287	227	307	4	3	80	0.0375000
NODE_19100_length_666_cov_24.811287	227	307	6	16	80	0.2000000
NODE_19100_length_666_cov_24.811287	227	307	10	6	80	0.0750000
NODE_19100_length_666_cov_24.811287	227	307	12	1	80	0.0125000
NODE_19100_length_666_cov_24.811287	227	307	14	1	80	0.0125000
NODE_19100_length_666_cov_24.811287	227	307	18	15	80	0.1875000
NODE_19100_length_666_cov_24.811287	303	383	0	36	80	0.4500000
NODE_19100_length_666_cov_24.811287	303	383	7	1	80	0.0125000
NODE_19100_length_666_cov_24.811287	303	383	9	3	80	0.0375000
NODE_19100_length_666_cov_24.811287	303	383	13	4	80	0.0500000
NODE_19100_length_666_cov_24.811287	303	383	15	1	80	0.0125000
NODE_19100_length_666_cov_24.811287	303	383	21	4	80	0.0500000
NODE_19100_length_666_cov_24.811287	303	383	25	1	80	0.0125000
NODE_19100_length_666_cov_24.811287	303	383	27	1	80	0.0125000
NODE_19100_length_666_cov_24.811287	303	383	43	1	80	0.0125000
NODE_19100_length_666_cov_24.811287	303	383	46	4	80	0.0500000
NODE_19100_length_666_cov_24.811287	303	383	47	2	80	0.0250000
NODE_19100_length_666_cov_24.811287	303	383	48	22	80	0.2750000
NODE_19100_length_666_cov_24.811287	356	436	38	1	80	0.0125000
NODE_19100_length_666_cov_24.811287	356	436	40	6	80	0.0750000
NODE_19100_length_666_cov_24.811287	356	436	46	16	80	0.2000000
NODE_19100_length_666_cov_24.811287	356	436	47	2	80	0.0250000
NODE_19100_length_666_cov_24.811287	356	436	48	55	80	0.6875000
NODE_19102_length_666_cov_20.114638	172	252	0	65	80	0.8125000
NODE_19102_length_666_cov_20.114638	172	252	2	15	80	0.1875000
NODE_19102_length_666_cov_20.114638	225	305	0	12	80	0.1500000
NODE_19102_length_666_cov_20.114638	225	305	2	68	80	0.8500000
NODE_19103_length_666_cov_16.813051	220	286	0	12	66	0.1818182
NODE_19103_length_666_cov_16.813051	220	286	2	54	66	0.8181818
NODE_19103_length_666_cov_16.813051	259	344	0	42	85	0.4941176
NODE_19103_length_666_cov_16.813051	259	344	2	43	85	0.5058824
NODE_19104_length_666_cov_15.384480	306	386	0	78	80	0.9750000
NODE_19104_length_666_cov_15.384480	306	386	2	2	80	0.0250000
NODE_19104_length_666_cov_15.384480	359	439	0	80	80	1.0000000
NODE_19105_length_666_cov_14.195767	485	565	0	2	80	0.0250000
NODE_19105_length_666_cov_14.195767	485	565	2	4	80	0.0500000
NODE_19105_length_666_cov_14.195767	485	565	6	74	80	0.9250000
NODE_19105_length_666_cov_14.195767	538	618	0	14	80	0.1750000
NODE_19105_length_666_cov_14.195767	538	618	4	10	80	0.1250000
NODE_19105_length_666_cov_14.195767	538	618	6	56	80	0.7000000
NODE_19108_length_666_cov_7.770723	226	306	0	80	80	1.0000000
NODE_19108_length_666_cov_7.770723	279	359	0	80	80	1.0000000
NODE_19163_length_665_cov_28.786219	391	471	0	62	80	0.7750000
NODE_19163_length_665_cov_28.786219	391	471	2	18	80	0.2250000
NODE_19163_length_665_cov_28.786219	444	524	0	9	80	0.1125000
NODE_19163_length_665_cov_28.786219	444	524	2	71	80	0.8875000
NODE_19164_length_665_cov_21.740283	311	391	0	80	80	1.0000000
NODE_19164_length_665_cov_21.740283	364	444	0	80	80	1.0000000
NODE_19165_length_665_cov_15.904594	390	470	0	80	80	1.0000000
NODE_19165_length_665_cov_15.904594	443	523	0	80	80	1.0000000
NODE_19224_length_664_cov_27.208850	259	339	0	28	80	0.3500000
NODE_19224_length_664_cov_27.208850	259	339	2	52	80	0.6500000
NODE_19224_length_664_cov_27.208850	345	404	0	59	59	1.0000000
NODE_19225_length_664_cov_16.116814	241	321	0	54	80	0.6750000
NODE_19225_length_664_cov_16.116814	241	321	2	26	80	0.3250000
NODE_19225_length_664_cov_16.116814	294	374	0	1	80	0.0125000
NODE_19225_length_664_cov_16.116814	294	374	2	79	80	0.9875000
NODE_19227_length_664_cov_14.185841	332	412	2	30	80	0.3750000
NODE_19227_length_664_cov_14.185841	332	412	4	50	80	0.6250000
NODE_19227_length_664_cov_14.185841	385	465	0	10	80	0.1250000
NODE_19227_length_664_cov_14.185841	385	465	2	21	80	0.2625000
NODE_19227_length_664_cov_14.185841	385	465	3	9	80	0.1125000
NODE_19227_length_664_cov_14.185841	385	465	4	40	80	0.5000000
NODE_19228_length_664_cov_12.256637	325	405	0	5	80	0.0625000
NODE_19228_length_664_cov_12.256637	325	405	2	75	80	0.9375000
NODE_19228_length_664_cov_12.256637	378	454	0	54	76	0.7105263
NODE_19228_length_664_cov_12.256637	378	454	2	22	76	0.2894737
NODE_19229_length_664_cov_8.378761	252	332	0	33	80	0.4125000
NODE_19229_length_664_cov_8.378761	252	332	2	31	80	0.3875000
NODE_19229_length_664_cov_8.378761	252	332	4	16	80	0.2000000
NODE_19229_length_664_cov_8.378761	305	385	2	11	80	0.1375000
NODE_19229_length_664_cov_8.378761	305	385	4	69	80	0.8625000
NODE_19229_length_664_cov_8.378761	381	461	0	26	80	0.3250000
NODE_19229_length_664_cov_8.378761	381	461	2	2	80	0.0250000
NODE_19229_length_664_cov_8.378761	381	461	4	52	80	0.6500000
NODE_19229_length_664_cov_8.378761	434	514	2	46	80	0.5750000
NODE_19229_length_664_cov_8.378761	434	514	4	34	80	0.4250000
NODE_19254_length_664_cov_1.922124	393	434	0	41	41	1.0000000
NODE_19298_length_663_cov_26.601064	398	478	0	80	80	1.0000000
NODE_19298_length_663_cov_26.601064	451	531	0	34	80	0.4250000
NODE_19298_length_663_cov_26.601064	451	531	2	46	80	0.5750000
NODE_19299_length_663_cov_16.948582	368	448	0	80	80	1.0000000
NODE_19299_length_663_cov_16.948582	421	501	0	80	80	1.0000000
NODE_19300_length_663_cov_16.225177	118	198	0	80	80	1.0000000
NODE_19300_length_663_cov_16.225177	171	251	0	80	80	1.0000000
NODE_19302_length_663_cov_13.748227	277	357	0	2	80	0.0250000
NODE_19302_length_663_cov_13.748227	277	357	2	78	80	0.9750000
NODE_19302_length_663_cov_13.748227	330	410	2	80	80	1.0000000
NODE_19303_length_663_cov_10.377660	300	380	18	3	80	0.0375000
NODE_19303_length_663_cov_10.377660	300	380	20	8	80	0.1000000
NODE_19303_length_663_cov_10.377660	300	380	22	1	80	0.0125000
NODE_19303_length_663_cov_10.377660	300	380	26	3	80	0.0375000
NODE_19303_length_663_cov_10.377660	300	380	28	1	80	0.0125000
NODE_19303_length_663_cov_10.377660	300	380	30	64	80	0.8000000
NODE_19304_length_663_cov_9.549645	199	279	4	80	80	1.0000000
NODE_19304_length_663_cov_9.549645	252	332	0	40	80	0.5000000
NODE_19304_length_663_cov_9.549645	252	332	4	40	80	0.5000000
NODE_19305_length_663_cov_7.397163	151	231	0	16	80	0.2000000
NODE_19305_length_663_cov_7.397163	151	231	2	26	80	0.3250000
NODE_19305_length_663_cov_7.397163	151	231	4	38	80	0.4750000
NODE_19305_length_663_cov_7.397163	204	284	0	6	80	0.0750000
NODE_19305_length_663_cov_7.397163	204	284	2	45	80	0.5625000
NODE_19305_length_663_cov_7.397163	204	284	4	29	80	0.3625000
NODE_19307_length_663_cov_5.081560	317	397	0	80	80	1.0000000
NODE_19368_length_662_cov_29.218472	233	313	0	25	80	0.3125000
NODE_19368_length_662_cov_29.218472	233	313	4	4	80	0.0500000
NODE_19368_length_662_cov_29.218472	233	313	7	2	80	0.0250000
NODE_19368_length_662_cov_29.218472	233	313	8	49	80	0.6125000
NODE_19368_length_662_cov_29.218472	286	366	0	3	80	0.0375000
NODE_19368_length_662_cov_29.218472	286	366	2	8	80	0.1000000
NODE_19368_length_662_cov_29.218472	286	366	4	9	80	0.1125000
NODE_19368_length_662_cov_29.218472	286	366	7	1	80	0.0125000
NODE_19368_length_662_cov_29.218472	286	366	8	59	80	0.7375000
NODE_19369_length_662_cov_18.717584	193	273	0	22	80	0.2750000
NODE_19369_length_662_cov_18.717584	193	273	2	58	80	0.7250000
NODE_19369_length_662_cov_18.717584	246	326	0	4	80	0.0500000
NODE_19369_length_662_cov_18.717584	246	326	2	76	80	0.9500000
NODE_19370_length_662_cov_16.358792	258	338	0	80	80	1.0000000
NODE_19370_length_662_cov_16.358792	311	391	0	80	80	1.0000000
NODE_19371_length_662_cov_12.845471	259	339	0	5	80	0.0625000
NODE_19371_length_662_cov_12.845471	259	339	2	75	80	0.9375000
NODE_19371_length_662_cov_12.845471	312	392	0	58	80	0.7250000
NODE_19371_length_662_cov_12.845471	312	392	2	22	80	0.2750000
NODE_19372_length_662_cov_12.476021	299	379	8	9	80	0.1125000
NODE_19372_length_662_cov_12.476021	299	379	9	2	80	0.0250000
NODE_19372_length_662_cov_12.476021	299	379	10	69	80	0.8625000
NODE_19372_length_662_cov_12.476021	352	432	0	28	80	0.3500000
NODE_19372_length_662_cov_12.476021	352	432	8	34	80	0.4250000
NODE_19372_length_662_cov_12.476021	352	432	9	2	80	0.0250000
NODE_19372_length_662_cov_12.476021	352	432	10	16	80	0.2000000
NODE_19373_length_662_cov_10.252220	239	319	0	80	80	1.0000000
NODE_19373_length_662_cov_10.252220	292	372	0	80	80	1.0000000
NODE_19376_length_662_cov_6.335702	267	347	0	36	80	0.4500000
NODE_19376_length_662_cov_6.335702	267	347	2	44	80	0.5500000
NODE_19376_length_662_cov_6.335702	320	400	0	17	80	0.2125000
NODE_19376_length_662_cov_6.335702	320	400	2	63	80	0.7875000
NODE_19378_length_662_cov_5.738899	295	331	0	36	36	1.0000000
NODE_19378_length_662_cov_5.738899	301	322	0	21	21	1.0000000
NODE_19402_length_662_cov_1.905861	150	230	1	31	80	0.3875000
NODE_19402_length_662_cov_1.905861	150	230	3	49	80	0.6125000
NODE_19402_length_662_cov_1.905861	203	277	1	74	74	1.0000000
NODE_19441_length_661_cov_55.176157	236	316	0	5	80	0.0625000
NODE_19441_length_661_cov_55.176157	236	316	1	75	80	0.9375000
NODE_19441_length_661_cov_55.176157	289	369	0	58	80	0.7250000
NODE_19441_length_661_cov_55.176157	289	369	1	22	80	0.2750000
NODE_19442_length_661_cov_38.501779	231	311	0	8	80	0.1000000
NODE_19442_length_661_cov_38.501779	231	311	2	72	80	0.9000000
NODE_19442_length_661_cov_38.501779	284	364	0	61	80	0.7625000
NODE_19442_length_661_cov_38.501779	284	364	2	19	80	0.2375000
NODE_19442_length_661_cov_38.501779	360	440	0	64	80	0.8000000
NODE_19442_length_661_cov_38.501779	360	440	2	16	80	0.2000000
NODE_19442_length_661_cov_38.501779	413	493	0	11	80	0.1375000
NODE_19442_length_661_cov_38.501779	413	493	2	61	80	0.7625000
NODE_19442_length_661_cov_38.501779	413	493	4	3	80	0.0375000
NODE_19442_length_661_cov_38.501779	413	493	6	5	80	0.0625000
NODE_19443_length_661_cov_31.460854	128	208	0	38	80	0.4750000
NODE_19443_length_661_cov_31.460854	128	208	4	42	80	0.5250000
NODE_19443_length_661_cov_31.460854	181	261	4	80	80	1.0000000
NODE_19444_length_661_cov_18.960854	216	296	0	80	80	1.0000000
NODE_19444_length_661_cov_18.960854	269	349	0	80	80	1.0000000
NODE_19445_length_661_cov_16.035587	201	281	0	80	80	1.0000000
NODE_19445_length_661_cov_16.035587	254	334	0	80	80	1.0000000
NODE_19447_length_661_cov_13.005338	281	343	0	62	62	1.0000000
NODE_19447_length_661_cov_13.005338	353	433	0	80	80	1.0000000
NODE_19447_length_661_cov_13.005338	406	486	0	74	80	0.9250000
NODE_19447_length_661_cov_13.005338	406	486	2	6	80	0.0750000
NODE_19452_length_661_cov_5.670819	374	454	0	35	80	0.4375000
NODE_19452_length_661_cov_5.670819	374	454	2	45	80	0.5625000
NODE_19452_length_661_cov_5.670819	427	507	2	80	80	1.0000000
NODE_19457_length_661_cov_4.601423	319	395	0	16	76	0.2105263
NODE_19457_length_661_cov_4.601423	319	395	2	60	76	0.7894737
NODE_19459_length_661_cov_3.532028	282	362	0	80	80	1.0000000
NODE_19459_length_661_cov_3.532028	335	415	0	80	80	1.0000000
NODE_19515_length_660_cov_20.741533	343	423	4	22	80	0.2750000
NODE_19515_length_660_cov_20.741533	343	423	6	5	80	0.0625000
NODE_19515_length_660_cov_20.741533	343	423	10	53	80	0.6625000
NODE_19515_length_660_cov_20.741533	396	476	0	8	80	0.1000000
NODE_19515_length_660_cov_20.741533	396	476	1	12	80	0.1500000
NODE_19515_length_660_cov_20.741533	396	476	2	22	80	0.2750000
NODE_19515_length_660_cov_20.741533	396	476	4	33	80	0.4125000
NODE_19515_length_660_cov_20.741533	396	476	6	5	80	0.0625000
NODE_19516_length_660_cov_15.089127	148	228	0	80	80	1.0000000
NODE_19516_length_660_cov_15.089127	201	281	0	80	80	1.0000000
NODE_19518_length_660_cov_13.301248	276	356	0	37	80	0.4625000
NODE_19518_length_660_cov_13.301248	276	356	2	43	80	0.5375000
NODE_19518_length_660_cov_13.301248	329	409	0	80	80	1.0000000
NODE_19519_length_660_cov_12.393939	234	314	0	80	80	1.0000000
NODE_19519_length_660_cov_12.393939	287	367	0	80	80	1.0000000
NODE_19521_length_660_cov_11.495544	399	479	4	80	80	1.0000000
NODE_19521_length_660_cov_11.495544	452	532	2	23	80	0.2875000
NODE_19521_length_660_cov_11.495544	452	532	4	57	80	0.7125000
NODE_19522_length_660_cov_10.522282	177	257	0	80	80	1.0000000
NODE_19522_length_660_cov_10.522282	230	311	0	81	81	1.0000000
NODE_19524_length_660_cov_8.887701	254	325	8	63	71	0.8873239
NODE_19524_length_660_cov_8.887701	254	325	10	8	71	0.1126761
NODE_19527_length_660_cov_7.278075	225	305	2	80	80	1.0000000
NODE_19527_length_660_cov_7.278075	278	358	0	34	80	0.4250000
NODE_19527_length_660_cov_7.278075	278	358	2	46	80	0.5750000
NODE_19529_length_660_cov_6.577540	350	430	0	16	80	0.2000000
NODE_19529_length_660_cov_6.577540	350	430	2	9	80	0.1125000
NODE_19529_length_660_cov_6.577540	350	430	4	21	80	0.2625000
NODE_19529_length_660_cov_6.577540	350	430	6	34	80	0.4250000
NODE_19529_length_660_cov_6.577540	403	483	4	14	80	0.1750000
NODE_19529_length_660_cov_6.577540	403	483	6	35	80	0.4375000
NODE_19529_length_660_cov_6.577540	403	483	8	31	80	0.3875000
NODE_19549_length_660_cov_2.354724	421	470	2	17	49	0.3469388
NODE_19549_length_660_cov_2.354724	421	470	4	32	49	0.6530612
NODE_19594_length_659_cov_43.587500	2	82	0	80	80	1.0000000
NODE_19594_length_659_cov_43.587500	55	135	0	80	80	1.0000000
NODE_19594_length_659_cov_43.587500	131	211	0	9	80	0.1125000
NODE_19594_length_659_cov_43.587500	131	211	4	27	80	0.3375000
NODE_19594_length_659_cov_43.587500	131	211	6	44	80	0.5500000
NODE_19594_length_659_cov_43.587500	184	264	2	37	80	0.4625000
NODE_19594_length_659_cov_43.587500	184	264	6	43	80	0.5375000
NODE_19595_length_659_cov_23.330357	236	316	0	80	80	1.0000000
NODE_19595_length_659_cov_23.330357	289	369	0	80	80	1.0000000
NODE_19596_length_659_cov_12.775000	255	335	0	80	80	1.0000000
NODE_19596_length_659_cov_12.775000	308	388	0	80	80	1.0000000
NODE_19598_length_659_cov_9.683929	220	298	0	69	78	0.8846154
NODE_19598_length_659_cov_9.683929	220	298	2	9	78	0.1153846
NODE_19598_length_659_cov_9.683929	271	351	0	18	80	0.2250000
NODE_19598_length_659_cov_9.683929	271	351	2	62	80	0.7750000
NODE_19613_length_659_cov_3.658929	305	385	0	80	80	1.0000000
NODE_19613_length_659_cov_3.658929	358	438	0	80	80	1.0000000
NODE_19678_length_658_cov_38.479428	289	369	0	17	80	0.2125000
NODE_19678_length_658_cov_38.479428	289	369	11	63	80	0.7875000
NODE_19678_length_658_cov_38.479428	342	422	11	80	80	1.0000000
NODE_19679_length_658_cov_35.409660	242	322	12	80	80	1.0000000
NODE_19679_length_658_cov_35.409660	295	375	0	33	80	0.4125000
NODE_19679_length_658_cov_35.409660	295	375	4	3	80	0.0375000
NODE_19679_length_658_cov_35.409660	295	375	12	44	80	0.5500000
NODE_19680_length_658_cov_20.322004	191	271	0	80	80	1.0000000
NODE_19680_length_658_cov_20.322004	244	321	0	77	77	1.0000000
NODE_19680_length_658_cov_20.322004	317	397	0	80	80	1.0000000
NODE_19680_length_658_cov_20.322004	370	449	0	79	79	1.0000000
NODE_19681_length_658_cov_11.352415	324	404	0	80	80	1.0000000
NODE_19681_length_658_cov_11.352415	377	457	0	80	80	1.0000000
NODE_19685_length_658_cov_8.241503	227	307	0	80	80	1.0000000
NODE_19685_length_658_cov_8.241503	280	360	0	80	80	1.0000000
NODE_19689_length_658_cov_5.477639	450	530	0	80	80	1.0000000
NODE_19705_length_658_cov_2.277281	286	366	0	28	80	0.3500000
NODE_19705_length_658_cov_2.277281	286	366	4	52	80	0.6500000
NODE_19705_length_658_cov_2.277281	339	419	0	43	80	0.5375000
NODE_19705_length_658_cov_2.277281	339	419	2	19	80	0.2375000
NODE_19705_length_658_cov_2.277281	339	419	4	6	80	0.0750000
NODE_19705_length_658_cov_2.277281	339	419	6	3	80	0.0375000
NODE_19705_length_658_cov_2.277281	339	419	8	1	80	0.0125000
NODE_19705_length_658_cov_2.277281	339	419	9	8	80	0.1000000
NODE_19750_length_657_cov_71.087814	306	372	0	14	66	0.2121212
NODE_19750_length_657_cov_71.087814	306	372	6	52	66	0.7878788
NODE_19750_length_657_cov_71.087814	382	462	6	2	80	0.0250000
NODE_19750_length_657_cov_71.087814	382	462	12	9	80	0.1125000
NODE_19750_length_657_cov_71.087814	382	462	14	1	80	0.0125000
NODE_19750_length_657_cov_71.087814	382	462	16	1	80	0.0125000
NODE_19750_length_657_cov_71.087814	382	462	24	1	80	0.0125000
NODE_19750_length_657_cov_71.087814	382	462	26	6	80	0.0750000
NODE_19750_length_657_cov_71.087814	382	462	28	16	80	0.2000000
NODE_19750_length_657_cov_71.087814	382	462	30	31	80	0.3875000
NODE_19750_length_657_cov_71.087814	382	462	32	7	80	0.0875000
NODE_19750_length_657_cov_71.087814	382	462	39	6	80	0.0750000
NODE_19750_length_657_cov_71.087814	382	462	6	2	80	0.0250000
NODE_19750_length_657_cov_71.087814	382	462	12	9	80	0.1125000
NODE_19750_length_657_cov_71.087814	382	462	14	1	80	0.0125000
NODE_19750_length_657_cov_71.087814	382	462	16	1	80	0.0125000
NODE_19750_length_657_cov_71.087814	382	462	24	1	80	0.0125000
NODE_19750_length_657_cov_71.087814	382	462	26	6	80	0.0750000
NODE_19750_length_657_cov_71.087814	382	462	28	16	80	0.2000000
NODE_19750_length_657_cov_71.087814	382	462	30	31	80	0.3875000
NODE_19750_length_657_cov_71.087814	382	462	32	7	80	0.0875000
NODE_19750_length_657_cov_71.087814	382	462	39	6	80	0.0750000
NODE_19750_length_657_cov_71.087814	435	515	20	10	80	0.1250000
NODE_19750_length_657_cov_71.087814	435	515	26	6	80	0.0750000
NODE_19750_length_657_cov_71.087814	435	515	28	17	80	0.2125000
NODE_19750_length_657_cov_71.087814	435	515	29	3	80	0.0375000
NODE_19750_length_657_cov_71.087814	435	515	31	18	80	0.2250000
NODE_19750_length_657_cov_71.087814	435	515	32	7	80	0.0875000
NODE_19750_length_657_cov_71.087814	435	515	37	2	80	0.0250000
NODE_19750_length_657_cov_71.087814	435	515	39	17	80	0.2125000
NODE_19750_length_657_cov_71.087814	440	515	20	10	75	0.1333333
NODE_19750_length_657_cov_71.087814	440	515	26	6	75	0.0800000
NODE_19750_length_657_cov_71.087814	440	515	28	17	75	0.2266667
NODE_19750_length_657_cov_71.087814	440	515	29	3	75	0.0400000
NODE_19750_length_657_cov_71.087814	440	515	31	18	75	0.2400000
NODE_19750_length_657_cov_71.087814	440	515	32	2	75	0.0266667
NODE_19750_length_657_cov_71.087814	440	515	37	2	75	0.0266667
NODE_19750_length_657_cov_71.087814	440	515	39	17	75	0.2266667
NODE_19751_length_657_cov_67.408602	98	178	1	52	80	0.6500000
NODE_19751_length_657_cov_67.408602	98	178	2	24	80	0.3000000
NODE_19751_length_657_cov_67.408602	98	178	7	4	80	0.0500000
NODE_19751_length_657_cov_67.408602	151	231	1	23	80	0.2875000
NODE_19751_length_657_cov_67.408602	151	231	6	2	80	0.0250000
NODE_19751_length_657_cov_67.408602	151	231	7	55	80	0.6875000
NODE_19752_length_657_cov_15.568100	265	345	0	80	80	1.0000000
NODE_19752_length_657_cov_15.568100	341	421	0	80	80	1.0000000
NODE_19759_length_657_cov_5.161290	185	256	0	16	71	0.2253521
NODE_19759_length_657_cov_5.161290	185	256	2	55	71	0.7746479
NODE_19759_length_657_cov_5.161290	229	309	0	10	80	0.1250000
NODE_19759_length_657_cov_5.161290	229	309	2	70	80	0.8750000
NODE_19824_length_656_cov_37.023339	470	550	2	2	80	0.0250000
NODE_19824_length_656_cov_37.023339	470	550	4	13	80	0.1625000
NODE_19824_length_656_cov_37.023339	470	550	6	65	80	0.8125000
NODE_19824_length_656_cov_37.023339	523	603	0	41	80	0.5125000
NODE_19824_length_656_cov_37.023339	523	603	2	14	80	0.1750000
NODE_19824_length_656_cov_37.023339	523	603	6	25	80	0.3125000
NODE_19825_length_656_cov_22.804309	173	253	2	80	80	1.0000000
NODE_19825_length_656_cov_22.804309	226	306	0	10	80	0.1250000
NODE_19825_length_656_cov_22.804309	226	306	2	70	80	0.8750000
NODE_19826_length_656_cov_19.280072	345	425	0	46	80	0.5750000
NODE_19826_length_656_cov_19.280072	345	425	2	34	80	0.4250000
NODE_19826_length_656_cov_19.280072	398	478	0	15	80	0.1875000
NODE_19826_length_656_cov_19.280072	398	478	2	65	80	0.8125000
NODE_19827_length_656_cov_18.267504	272	352	0	80	80	1.0000000
NODE_19827_length_656_cov_18.267504	325	405	0	80	80	1.0000000
NODE_19828_length_656_cov_15.928187	223	303	0	80	80	1.0000000
NODE_19829_length_656_cov_15.091562	297	377	0	80	80	1.0000000
NODE_19829_length_656_cov_15.091562	350	430	0	80	80	1.0000000
NODE_19830_length_656_cov_12.773788	269	349	0	80	80	1.0000000
NODE_19830_length_656_cov_12.773788	322	399	0	77	77	1.0000000
NODE_19831_length_656_cov_12.493716	212	292	0	80	80	1.0000000
NODE_19831_length_656_cov_12.493716	265	345	0	80	80	1.0000000
NODE_19832_length_656_cov_10.946140	197	277	0	80	80	1.0000000
NODE_19832_length_656_cov_10.946140	250	330	0	80	80	1.0000000
NODE_19833_length_656_cov_9.412926	295	375	0	80	80	1.0000000
NODE_19833_length_656_cov_9.412926	348	428	0	80	80	1.0000000
NODE_19904_length_655_cov_31.019784	212	292	0	80	80	1.0000000
NODE_19904_length_655_cov_31.019784	265	345	0	28	80	0.3500000
NODE_19904_length_655_cov_31.019784	265	345	2	52	80	0.6500000
NODE_19907_length_655_cov_8.672662	216	296	0	80	80	1.0000000
NODE_19907_length_655_cov_8.672662	269	349	0	80	80	1.0000000
NODE_19908_length_655_cov_8.250000	204	234	0	30	30	1.0000000
NODE_19909_length_655_cov_7.910072	366	446	0	17	80	0.2125000
NODE_19909_length_655_cov_7.910072	366	446	2	63	80	0.7875000
NODE_19909_length_655_cov_7.910072	419	499	0	25	80	0.3125000
NODE_19909_length_655_cov_7.910072	419	499	2	55	80	0.6875000
NODE_19916_length_655_cov_5.478417	178	255	0	65	77	0.8441558
NODE_19916_length_655_cov_5.478417	178	255	2	12	77	0.1558442
NODE_19916_length_655_cov_5.478417	178	221	0	43	43	1.0000000
NODE_19919_length_655_cov_5.174460	347	428	0	14	81	0.1728395
NODE_19919_length_655_cov_5.174460	347	428	4	11	81	0.1358025
NODE_19919_length_655_cov_5.174460	347	428	6	40	81	0.4938272
NODE_19919_length_655_cov_5.174460	347	428	10	16	81	0.1975309
NODE_19919_length_655_cov_5.174460	401	481	4	33	80	0.4125000
NODE_19919_length_655_cov_5.174460	401	481	6	25	80	0.3125000
NODE_19919_length_655_cov_5.174460	401	481	8	1	80	0.0125000
NODE_19919_length_655_cov_5.174460	401	481	10	21	80	0.2625000
NODE_19979_length_654_cov_17.086486	323	403	7	68	80	0.8500000
NODE_19979_length_654_cov_17.086486	323	403	8	12	80	0.1500000
NODE_19979_length_654_cov_17.086486	376	456	0	49	80	0.6125000
NODE_19979_length_654_cov_17.086486	376	456	7	25	80	0.3125000
NODE_19979_length_654_cov_17.086486	376	456	8	6	80	0.0750000
NODE_19980_length_654_cov_16.194595	318	398	0	19	80	0.2375000
NODE_19980_length_654_cov_16.194595	318	398	2	61	80	0.7625000
NODE_19980_length_654_cov_16.194595	371	451	0	72	80	0.9000000
NODE_19980_length_654_cov_16.194595	371	451	2	8	80	0.1000000
NODE_19983_length_654_cov_5.556757	341	412	0	71	71	1.0000000
NODE_19990_length_654_cov_3.236036	105	181	0	76	76	1.0000000
NODE_19990_length_654_cov_3.236036	158	236	0	78	78	1.0000000
NODE_19998_length_654_cov_2.549550	279	366	0	87	87	1.0000000
NODE_20013_length_654_cov_1.790991	480	560	8	80	80	1.0000000
NODE_20044_length_653_cov_70.296029	277	357	0	38	80	0.4750000
NODE_20044_length_653_cov_70.296029	277	357	8	42	80	0.5250000
NODE_20044_length_653_cov_70.296029	330	410	2	1	80	0.0125000
NODE_20044_length_653_cov_70.296029	330	410	8	39	80	0.4875000
NODE_20044_length_653_cov_70.296029	330	410	10	40	80	0.5000000
NODE_20045_length_653_cov_28.072202	302	382	0	80	80	1.0000000
NODE_20045_length_653_cov_28.072202	355	435	0	80	80	1.0000000
NODE_20046_length_653_cov_18.382671	214	294	2	28	80	0.3500000
NODE_20046_length_653_cov_18.382671	214	294	12	46	80	0.5750000
NODE_20046_length_653_cov_18.382671	214	294	14	6	80	0.0750000
NODE_20046_length_653_cov_18.382671	267	347	4	24	80	0.3000000
NODE_20046_length_653_cov_18.382671	267	347	12	21	80	0.2625000
NODE_20046_length_653_cov_18.382671	267	347	14	35	80	0.4375000
NODE_20047_length_653_cov_8.821300	292	372	0	80	80	1.0000000
NODE_20047_length_653_cov_8.821300	345	425	0	80	80	1.0000000
NODE_20048_length_653_cov_8.660650	200	280	0	80	80	1.0000000
NODE_20048_length_653_cov_8.660650	253	333	0	80	80	1.0000000
NODE_20052_length_653_cov_5.777978	308	383	2	14	75	0.1866667
NODE_20052_length_653_cov_5.777978	308	383	6	28	75	0.3733333
NODE_20052_length_653_cov_5.777978	308	383	10	12	75	0.1600000
NODE_20052_length_653_cov_5.777978	308	383	18	19	75	0.2533333
NODE_20052_length_653_cov_5.777978	308	383	20	2	75	0.0266667
NODE_20052_length_653_cov_5.777978	361	435	10	1	74	0.0135135
NODE_20052_length_653_cov_5.777978	361	435	16	39	74	0.5270270
NODE_20052_length_653_cov_5.777978	361	435	18	31	74	0.4189189
NODE_20052_length_653_cov_5.777978	361	435	20	3	74	0.0405405
NODE_20054_length_653_cov_5.193141	304	356	1	6	52	0.1153846
NODE_20054_length_653_cov_5.193141	304	356	3	6	52	0.1153846
NODE_20054_length_653_cov_5.193141	304	356	4	13	52	0.2500000
NODE_20054_length_653_cov_5.193141	304	356	5	27	52	0.5192308
NODE_20058_length_653_cov_4.823105	178	251	2	9	73	0.1232877
NODE_20058_length_653_cov_4.823105	178	251	4	14	73	0.1917808
NODE_20058_length_653_cov_4.823105	178	251	5	1	73	0.0136986
NODE_20058_length_653_cov_4.823105	178	251	6	49	73	0.6712329
NODE_20058_length_653_cov_4.823105	178	256	2	14	78	0.1794872
NODE_20058_length_653_cov_4.823105	178	256	4	14	78	0.1794872
NODE_20058_length_653_cov_4.823105	178	256	5	1	78	0.0128205
NODE_20058_length_653_cov_4.823105	178	256	6	49	78	0.6282051
NODE_20058_length_653_cov_4.823105	229	309	0	46	80	0.5750000
NODE_20058_length_653_cov_4.823105	229	309	2	21	80	0.2625000
NODE_20058_length_653_cov_4.823105	229	309	4	3	80	0.0375000
NODE_20058_length_653_cov_4.823105	229	309	6	10	80	0.1250000
NODE_20058_length_653_cov_4.823105	229	309	0	46	80	0.5750000
NODE_20058_length_653_cov_4.823105	229	309	2	21	80	0.2625000
NODE_20058_length_653_cov_4.823105	229	309	4	3	80	0.0375000
NODE_20058_length_653_cov_4.823105	229	309	6	10	80	0.1250000
NODE_20058_length_653_cov_4.823105	239	309	0	46	70	0.6571429
NODE_20058_length_653_cov_4.823105	239	309	2	21	70	0.3000000
NODE_20058_length_653_cov_4.823105	239	309	4	3	70	0.0428571
NODE_20127_length_652_cov_215.211573	185	248	0	9	63	0.1428571
NODE_20127_length_652_cov_215.211573	185	248	2	4	63	0.0634921
NODE_20127_length_652_cov_215.211573	185	248	10	7	63	0.1111111
NODE_20127_length_652_cov_215.211573	185	248	16	4	63	0.0634921
NODE_20127_length_652_cov_215.211573	185	248	18	11	63	0.1746032
NODE_20127_length_652_cov_215.211573	185	248	20	11	63	0.1746032
NODE_20127_length_652_cov_215.211573	185	248	24	7	63	0.1111111
NODE_20127_length_652_cov_215.211573	185	248	26	4	63	0.0634921
NODE_20127_length_652_cov_215.211573	185	248	28	6	63	0.0952381
NODE_20127_length_652_cov_215.211573	221	301	20	10	80	0.1250000
NODE_20127_length_652_cov_215.211573	221	301	24	7	80	0.0875000
NODE_20127_length_652_cov_215.211573	221	301	26	13	80	0.1625000
NODE_20127_length_652_cov_215.211573	221	301	28	47	80	0.5875000
NODE_20127_length_652_cov_215.211573	221	301	30	3	80	0.0375000
NODE_20128_length_652_cov_21.267631	299	379	0	80	80	1.0000000
NODE_20128_length_652_cov_21.267631	352	432	0	80	80	1.0000000
NODE_20138_length_652_cov_4.622061	266	315	4	22	49	0.4489796
NODE_20138_length_652_cov_4.622061	266	315	6	27	49	0.5510204
NODE_20138_length_652_cov_4.622061	288	368	4	32	80	0.4000000
NODE_20138_length_652_cov_4.622061	288	368	6	48	80	0.6000000
NODE_20210_length_651_cov_49.981884	425	505	6	22	80	0.2750000
NODE_20210_length_651_cov_49.981884	425	505	8	14	80	0.1750000
NODE_20210_length_651_cov_49.981884	425	505	9	2	80	0.0250000
NODE_20210_length_651_cov_49.981884	425	505	10	26	80	0.3250000
NODE_20210_length_651_cov_49.981884	425	505	12	7	80	0.0875000
NODE_20210_length_651_cov_49.981884	425	505	14	9	80	0.1125000
NODE_20210_length_651_cov_49.981884	425	505	6	22	80	0.2750000
NODE_20210_length_651_cov_49.981884	425	505	8	14	80	0.1750000
NODE_20210_length_651_cov_49.981884	425	505	9	2	80	0.0250000
NODE_20210_length_651_cov_49.981884	425	505	10	26	80	0.3250000
NODE_20210_length_651_cov_49.981884	425	505	12	7	80	0.0875000
NODE_20210_length_651_cov_49.981884	425	505	14	9	80	0.1125000
NODE_20210_length_651_cov_49.981884	425	505	6	22	80	0.2750000
NODE_20210_length_651_cov_49.981884	425	505	8	14	80	0.1750000
NODE_20210_length_651_cov_49.981884	425	505	9	2	80	0.0250000
NODE_20210_length_651_cov_49.981884	425	505	10	26	80	0.3250000
NODE_20210_length_651_cov_49.981884	425	505	12	7	80	0.0875000
NODE_20210_length_651_cov_49.981884	425	505	14	9	80	0.1125000
NODE_20210_length_651_cov_49.981884	425	505	6	22	80	0.2750000
NODE_20210_length_651_cov_49.981884	425	505	8	14	80	0.1750000
NODE_20210_length_651_cov_49.981884	425	505	9	2	80	0.0250000
NODE_20210_length_651_cov_49.981884	425	505	10	26	80	0.3250000
NODE_20210_length_651_cov_49.981884	425	505	12	7	80	0.0875000
NODE_20210_length_651_cov_49.981884	425	505	14	9	80	0.1125000
NODE_20210_length_651_cov_49.981884	478	540	4	33	62	0.5322581
NODE_20210_length_651_cov_49.981884	478	540	6	24	62	0.3870968
NODE_20210_length_651_cov_49.981884	478	540	8	3	62	0.0483871
NODE_20210_length_651_cov_49.981884	478	540	12	2	62	0.0322581
NODE_20210_length_651_cov_49.981884	478	540	4	33	62	0.5322581
NODE_20210_length_651_cov_49.981884	478	540	6	24	62	0.3870968
NODE_20210_length_651_cov_49.981884	478	540	8	3	62	0.0483871
NODE_20210_length_651_cov_49.981884	478	540	12	2	62	0.0322581
NODE_20210_length_651_cov_49.981884	478	540	4	33	62	0.5322581
NODE_20210_length_651_cov_49.981884	478	540	6	24	62	0.3870968
NODE_20210_length_651_cov_49.981884	478	540	8	3	62	0.0483871
NODE_20210_length_651_cov_49.981884	478	540	12	2	62	0.0322581
NODE_20210_length_651_cov_49.981884	478	542	4	35	64	0.5468750
NODE_20210_length_651_cov_49.981884	478	542	6	24	64	0.3750000
NODE_20210_length_651_cov_49.981884	478	542	8	3	64	0.0468750
NODE_20210_length_651_cov_49.981884	478	542	12	2	64	0.0312500
NODE_20211_length_651_cov_36.121377	422	502	0	80	80	1.0000000
NODE_20211_length_651_cov_36.121377	475	555	0	80	80	1.0000000
NODE_20212_length_651_cov_20.045290	252	332	0	80	80	1.0000000
NODE_20212_length_651_cov_20.045290	305	385	0	39	80	0.4875000
NODE_20212_length_651_cov_20.045290	305	385	2	41	80	0.5125000
NODE_20213_length_651_cov_12.704710	264	344	0	80	80	1.0000000
NODE_20213_length_651_cov_12.704710	317	397	0	80	80	1.0000000
NODE_20214_length_651_cov_11.632246	205	285	0	80	80	1.0000000
NODE_20214_length_651_cov_11.632246	258	338	0	80	80	1.0000000
NODE_20215_length_651_cov_10.074275	369	449	0	4	80	0.0500000
NODE_20215_length_651_cov_10.074275	369	449	4	76	80	0.9500000
NODE_20215_length_651_cov_10.074275	422	502	0	57	80	0.7125000
NODE_20215_length_651_cov_10.074275	422	502	4	23	80	0.2875000
NODE_20216_length_651_cov_9.699275	199	279	0	33	80	0.4125000
NODE_20216_length_651_cov_9.699275	199	279	4	47	80	0.5875000
NODE_20216_length_651_cov_9.699275	252	332	4	27	80	0.3375000
NODE_20216_length_651_cov_9.699275	252	332	5	53	80	0.6625000
NODE_20219_length_651_cov_8.309783	217	296	0	37	79	0.4683544
NODE_20219_length_651_cov_8.309783	217	296	2	42	79	0.5316456
NODE_20219_length_651_cov_8.309783	269	349	0	14	80	0.1750000
NODE_20219_length_651_cov_8.309783	269	349	2	66	80	0.8250000
NODE_20220_length_651_cov_5.621377	148	228	0	80	80	1.0000000
NODE_20220_length_651_cov_5.621377	201	281	0	80	80	1.0000000
NODE_20221_length_651_cov_5.610507	342	422	0	80	80	1.0000000
NODE_20221_length_651_cov_5.610507	395	475	0	80	80	1.0000000
NODE_20225_length_651_cov_4.246377	299	359	0	60	60	1.0000000
NODE_20238_length_651_cov_2.744565	340	421	0	37	81	0.4567901
NODE_20238_length_651_cov_2.744565	340	421	4	44	81	0.5432099
NODE_20252_length_651_cov_2.016304	280	311	0	31	31	1.0000000
NODE_20292_length_650_cov_22.644283	233	313	0	80	80	1.0000000
NODE_20292_length_650_cov_22.644283	286	366	0	80	80	1.0000000
NODE_20293_length_650_cov_22.156080	269	349	0	80	80	1.0000000
NODE_20293_length_650_cov_22.156080	322	402	0	80	80	1.0000000
NODE_20294_length_650_cov_20.012704	186	266	0	80	80	1.0000000
NODE_20294_length_650_cov_20.012704	239	319	0	80	80	1.0000000
NODE_20295_length_650_cov_17.626134	52	132	0	80	80	1.0000000
NODE_20295_length_650_cov_17.626134	105	185	0	80	80	1.0000000
NODE_20297_length_650_cov_10.687840	289	369	0	80	80	1.0000000
NODE_20297_length_650_cov_10.687840	342	422	0	80	80	1.0000000
NODE_20301_length_650_cov_6.519056	312	365	2	7	53	0.1320755
NODE_20301_length_650_cov_6.519056	312	365	4	32	53	0.6037736
NODE_20301_length_650_cov_6.519056	312	365	6	2	53	0.0377358
NODE_20301_length_650_cov_6.519056	312	365	8	2	53	0.0377358
NODE_20301_length_650_cov_6.519056	312	365	12	10	53	0.1886792
NODE_20301_length_650_cov_6.519056	338	417	4	13	79	0.1645570
NODE_20301_length_650_cov_6.519056	338	417	6	2	79	0.0253165
NODE_20301_length_650_cov_6.519056	338	417	8	2	79	0.0253165
NODE_20301_length_650_cov_6.519056	338	417	12	34	79	0.4303797
NODE_20301_length_650_cov_6.519056	338	417	14	28	79	0.3544304
NODE_20302_length_650_cov_6.159710	243	323	0	5	80	0.0625000
NODE_20302_length_650_cov_6.159710	243	323	2	75	80	0.9375000
NODE_20302_length_650_cov_6.159710	296	376	0	58	80	0.7250000
NODE_20302_length_650_cov_6.159710	296	376	2	22	80	0.2750000
NODE_20318_length_650_cov_2.488203	213	266	0	53	53	1.0000000
NODE_20370_length_649_cov_20.780000	111	140	0	29	29	1.0000000
NODE_20370_length_649_cov_20.780000	111	191	0	80	80	1.0000000
NODE_20370_length_649_cov_20.780000	138	161	0	23	23	1.0000000
NODE_20370_length_649_cov_20.780000	138	214	0	76	76	1.0000000
NODE_20370_length_649_cov_20.780000	164	244	0	80	80	1.0000000
NODE_20371_length_649_cov_17.938182	162	242	0	51	80	0.6375000
NODE_20371_length_649_cov_17.938182	162	242	1	2	80	0.0250000
NODE_20371_length_649_cov_17.938182	162	242	2	27	80	0.3375000
NODE_20371_length_649_cov_17.938182	215	295	0	26	80	0.3250000
NODE_20371_length_649_cov_17.938182	215	295	2	54	80	0.6750000
NODE_20372_length_649_cov_16.761818	395	475	2	80	80	1.0000000
NODE_20372_length_649_cov_16.761818	448	528	0	44	80	0.5500000
NODE_20372_length_649_cov_16.761818	448	528	2	36	80	0.4500000
NODE_20373_length_649_cov_15.632727	226	306	0	17	80	0.2125000
NODE_20373_length_649_cov_15.632727	226	306	2	41	80	0.5125000
NODE_20373_length_649_cov_15.632727	226	306	9	22	80	0.2750000
NODE_20373_length_649_cov_15.632727	279	359	2	80	80	1.0000000
NODE_20374_length_649_cov_15.516364	329	409	0	41	80	0.5125000
NODE_20374_length_649_cov_15.516364	329	409	4	39	80	0.4875000
NODE_20374_length_649_cov_15.516364	382	462	2	7	80	0.0875000
NODE_20374_length_649_cov_15.516364	382	462	4	57	80	0.7125000
NODE_20374_length_649_cov_15.516364	382	462	6	16	80	0.2000000
NODE_20375_length_649_cov_10.374545	453	533	0	42	80	0.5250000
NODE_20375_length_649_cov_10.374545	453	533	2	38	80	0.4750000
NODE_20375_length_649_cov_10.374545	506	586	0	80	80	1.0000000
NODE_20382_length_649_cov_4.403636	213	293	0	80	80	1.0000000
NODE_20382_length_649_cov_4.403636	266	346	0	80	80	1.0000000
NODE_20454_length_648_cov_34.287796	343	423	0	80	80	1.0000000
NODE_20454_length_648_cov_34.287796	396	476	0	80	80	1.0000000
NODE_20454_length_648_cov_34.287796	472	552	0	80	80	1.0000000
NODE_20454_length_648_cov_34.287796	525	605	0	80	80	1.0000000
NODE_20455_length_648_cov_19.433515	259	339	0	69	80	0.8625000
NODE_20455_length_648_cov_19.433515	259	339	2	11	80	0.1375000
NODE_20455_length_648_cov_19.433515	312	392	0	16	80	0.2000000
NODE_20455_length_648_cov_19.433515	312	392	2	64	80	0.8000000
NODE_20457_length_648_cov_8.391621	206	286	0	80	80	1.0000000
NODE_20457_length_648_cov_8.391621	259	339	0	80	80	1.0000000
NODE_20459_length_648_cov_6.573770	293	373	0	56	80	0.7000000
NODE_20459_length_648_cov_6.573770	293	373	2	24	80	0.3000000
NODE_20459_length_648_cov_6.573770	346	426	0	3	80	0.0375000
NODE_20459_length_648_cov_6.573770	346	426	2	77	80	0.9625000
NODE_20460_length_648_cov_6.431694	285	328	0	43	43	1.0000000
NODE_20463_length_648_cov_6.085610	257	337	0	80	80	1.0000000
NODE_20463_length_648_cov_6.085610	310	390	0	80	80	1.0000000
NODE_20483_length_648_cov_2.333333	19	86	2	66	67	0.9850746
NODE_20483_length_648_cov_2.333333	19	86	4	1	67	0.0149254
NODE_20531_length_647_cov_18.489051	295	375	0	80	80	1.0000000
NODE_20531_length_647_cov_18.489051	348	428	0	80	80	1.0000000
NODE_20532_length_647_cov_14.677007	286	366	0	60	80	0.7500000
NODE_20532_length_647_cov_14.677007	286	366	1	5	80	0.0625000
NODE_20532_length_647_cov_14.677007	286	366	2	15	80	0.1875000
NODE_20532_length_647_cov_14.677007	339	419	0	80	80	1.0000000
NODE_20533_length_647_cov_10.895985	231	311	0	80	80	1.0000000
NODE_20533_length_647_cov_10.895985	284	364	0	80	80	1.0000000
NODE_20534_length_647_cov_9.116788	372	452	2	20	80	0.2500000
NODE_20534_length_647_cov_9.116788	372	452	6	60	80	0.7500000
NODE_20534_length_647_cov_9.116788	425	505	0	38	80	0.4750000
NODE_20534_length_647_cov_9.116788	425	505	2	2	80	0.0250000
NODE_20534_length_647_cov_9.116788	425	505	6	40	80	0.5000000
NODE_20536_length_647_cov_6.410584	150	221	0	59	71	0.8309859
NODE_20536_length_647_cov_6.410584	150	221	2	12	71	0.1690141
NODE_20536_length_647_cov_6.410584	194	274	0	15	80	0.1875000
NODE_20536_length_647_cov_6.410584	194	274	2	65	80	0.8125000
NODE_20539_length_647_cov_5.567518	239	319	2	25	80	0.3125000
NODE_20539_length_647_cov_5.567518	239	319	6	13	80	0.1625000
NODE_20539_length_647_cov_5.567518	239	319	8	27	80	0.3375000
NODE_20539_length_647_cov_5.567518	239	319	10	15	80	0.1875000
NODE_20539_length_647_cov_5.567518	292	355	8	28	63	0.4444444
NODE_20539_length_647_cov_5.567518	292	355	9	3	63	0.0476190
NODE_20539_length_647_cov_5.567518	292	355	10	10	63	0.1587302
NODE_20539_length_647_cov_5.567518	292	355	11	15	63	0.2380952
NODE_20539_length_647_cov_5.567518	292	355	14	1	63	0.0158730
NODE_20539_length_647_cov_5.567518	292	355	15	1	63	0.0158730
NODE_20539_length_647_cov_5.567518	292	355	18	5	63	0.0793651
NODE_20539_length_647_cov_5.567518	348	416	14	6	68	0.0882353
NODE_20539_length_647_cov_5.567518	348	416	15	1	68	0.0147059
NODE_20539_length_647_cov_5.567518	348	416	16	38	68	0.5588235
NODE_20539_length_647_cov_5.567518	348	416	17	3	68	0.0441176
NODE_20539_length_647_cov_5.567518	348	416	18	11	68	0.1617647
NODE_20539_length_647_cov_5.567518	348	416	20	9	68	0.1323529
NODE_20539_length_647_cov_5.567518	401	469	14	43	68	0.6323529
NODE_20539_length_647_cov_5.567518	401	469	16	25	68	0.3676471
NODE_20544_length_647_cov_3.775547	356	399	4	43	43	1.0000000
NODE_20550_length_647_cov_2.678832	239	319	0	80	80	1.0000000
NODE_20550_length_647_cov_2.678832	292	372	0	80	80	1.0000000
NODE_20561_length_647_cov_1.937956	254	304	0	1	50	0.0200000
NODE_20561_length_647_cov_1.937956	254	304	2	49	50	0.9800000
NODE_20607_length_646_cov_56.226691	267	347	0	80	80	1.0000000
NODE_20607_length_646_cov_56.226691	320	400	0	80	80	1.0000000
NODE_20608_length_646_cov_23.747715	76	153	0	77	77	1.0000000
NODE_20608_length_646_cov_23.747715	129	209	0	80	80	1.0000000
NODE_20609_length_646_cov_22.740402	326	406	0	80	80	1.0000000
NODE_20609_length_646_cov_22.740402	379	459	0	34	80	0.4250000
NODE_20609_length_646_cov_22.740402	379	459	2	46	80	0.5750000
NODE_20610_length_646_cov_15.160878	363	443	0	80	80	1.0000000
NODE_20610_length_646_cov_15.160878	416	496	0	80	80	1.0000000
NODE_20611_length_646_cov_9.429616	309	389	0	58	80	0.7250000
NODE_20611_length_646_cov_9.429616	309	389	2	22	80	0.2750000
NODE_20611_length_646_cov_9.429616	362	442	0	80	80	1.0000000
NODE_20612_length_646_cov_9.246801	149	221	0	72	72	1.0000000
NODE_20613_length_646_cov_7.539305	227	307	0	80	80	1.0000000
NODE_20613_length_646_cov_7.539305	280	360	0	80	80	1.0000000
NODE_20614_length_646_cov_6.756856	236	316	0	80	80	1.0000000
NODE_20614_length_646_cov_6.756856	289	369	0	80	80	1.0000000
NODE_20615_length_646_cov_6.480804	373	437	0	33	64	0.5156250
NODE_20615_length_646_cov_6.480804	373	437	2	31	64	0.4843750
NODE_20615_length_646_cov_6.480804	410	490	2	80	80	1.0000000
NODE_20616_length_646_cov_6.396709	194	274	0	80	80	1.0000000
NODE_20616_length_646_cov_6.396709	254	327	0	73	73	1.0000000
NODE_20619_length_646_cov_4.652651	265	345	0	80	80	1.0000000
NODE_20623_length_646_cov_4.122486	401	452	0	51	51	1.0000000
NODE_20688_length_645_cov_95.882784	179	259	0	29	80	0.3625000
NODE_20688_length_645_cov_95.882784	179	259	2	51	80	0.6375000
NODE_20688_length_645_cov_95.882784	232	312	0	40	80	0.5000000
NODE_20688_length_645_cov_95.882784	232	312	2	40	80	0.5000000
NODE_20689_length_645_cov_12.985348	343	423	0	80	80	1.0000000
NODE_20689_length_645_cov_12.985348	396	476	0	80	80	1.0000000
NODE_20691_length_645_cov_9.228938	254	334	0	53	80	0.6625000
NODE_20691_length_645_cov_9.228938	254	334	2	27	80	0.3375000
NODE_20691_length_645_cov_9.228938	307	387	2	41	80	0.5125000
NODE_20691_length_645_cov_9.228938	307	387	4	39	80	0.4875000
NODE_20692_length_645_cov_9.172161	293	373	0	80	80	1.0000000
NODE_20692_length_645_cov_9.172161	346	426	0	80	80	1.0000000
NODE_20697_length_645_cov_5.609890	461	541	0	23	80	0.2875000
NODE_20697_length_645_cov_5.609890	461	541	2	57	80	0.7125000
NODE_20697_length_645_cov_5.609890	514	594	2	80	80	1.0000000
NODE_20698_length_645_cov_4.743590	237	317	0	80	80	1.0000000
NODE_20698_length_645_cov_4.743590	290	370	0	80	80	1.0000000
NODE_20716_length_645_cov_2.177656	373	416	2	43	43	1.0000000
NODE_20762_length_644_cov_59.286239	323	401	212	1	78	0.0128205
NODE_20762_length_644_cov_59.286239	323	401	213	1	78	0.0128205
NODE_20762_length_644_cov_59.286239	323	401	215	1	78	0.0128205
NODE_20762_length_644_cov_59.286239	323	401	217	2	78	0.0256410
NODE_20762_length_644_cov_59.286239	323	401	221	4	78	0.0512821
NODE_20762_length_644_cov_59.286239	323	401	223	1	78	0.0128205
NODE_20762_length_644_cov_59.286239	323	401	235	1	78	0.0128205
NODE_20762_length_644_cov_59.286239	323	401	239	1	78	0.0128205
NODE_20762_length_644_cov_59.286239	323	401	241	3	78	0.0384615
NODE_20762_length_644_cov_59.286239	323	401	247	1	78	0.0128205
NODE_20762_length_644_cov_59.286239	323	401	255	1	78	0.0128205
NODE_20762_length_644_cov_59.286239	323	401	257	1	78	0.0128205
NODE_20762_length_644_cov_59.286239	323	401	261	1	78	0.0128205
NODE_20762_length_644_cov_59.286239	323	401	268	1	78	0.0128205
NODE_20762_length_644_cov_59.286239	323	401	272	2	78	0.0256410
NODE_20762_length_644_cov_59.286239	323	401	274	1	78	0.0128205
NODE_20762_length_644_cov_59.286239	323	401	280	1	78	0.0128205
NODE_20762_length_644_cov_59.286239	323	401	282	3	78	0.0384615
NODE_20762_length_644_cov_59.286239	323	401	284	1	78	0.0128205
NODE_20762_length_644_cov_59.286239	323	401	288	1	78	0.0128205
NODE_20762_length_644_cov_59.286239	323	401	298	3	78	0.0384615
NODE_20762_length_644_cov_59.286239	323	401	306	1	78	0.0128205
NODE_20762_length_644_cov_59.286239	323	401	320	1	78	0.0128205
NODE_20762_length_644_cov_59.286239	323	401	324	1	78	0.0128205
NODE_20762_length_644_cov_59.286239	323	401	332	1	78	0.0128205
NODE_20762_length_644_cov_59.286239	323	401	342	1	78	0.0128205
NODE_20762_length_644_cov_59.286239	323	401	346	1	78	0.0128205
NODE_20762_length_644_cov_59.286239	323	401	349	2	78	0.0256410
NODE_20762_length_644_cov_59.286239	323	401	353	1	78	0.0128205
NODE_20762_length_644_cov_59.286239	323	401	359	1	78	0.0128205
NODE_20762_length_644_cov_59.286239	323	401	361	1	78	0.0128205
NODE_20762_length_644_cov_59.286239	323	401	375	1	78	0.0128205
NODE_20762_length_644_cov_59.286239	323	401	382	1	78	0.0128205
NODE_20762_length_644_cov_59.286239	323	401	398	2	78	0.0256410
NODE_20762_length_644_cov_59.286239	323	401	399	1	78	0.0128205
NODE_20762_length_644_cov_59.286239	323	401	402	1	78	0.0128205
NODE_20762_length_644_cov_59.286239	323	401	406	1	78	0.0128205
NODE_20762_length_644_cov_59.286239	323	401	419	1	78	0.0128205
NODE_20762_length_644_cov_59.286239	323	401	422	1	78	0.0128205
NODE_20762_length_644_cov_59.286239	323	401	424	1	78	0.0128205
NODE_20762_length_644_cov_59.286239	323	401	430	1	78	0.0128205
NODE_20762_length_644_cov_59.286239	323	401	438	1	78	0.0128205
NODE_20762_length_644_cov_59.286239	323	401	448	1	78	0.0128205
NODE_20762_length_644_cov_59.286239	323	401	449	2	78	0.0256410
NODE_20762_length_644_cov_59.286239	323	401	451	1	78	0.0128205
NODE_20762_length_644_cov_59.286239	323	401	453	1	78	0.0128205
NODE_20762_length_644_cov_59.286239	323	401	454	2	78	0.0256410
NODE_20762_length_644_cov_59.286239	323	401	455	6	78	0.0769231
NODE_20762_length_644_cov_59.286239	323	401	456	1	78	0.0128205
NODE_20762_length_644_cov_59.286239	323	401	457	2	78	0.0256410
NODE_20762_length_644_cov_59.286239	323	401	458	4	78	0.0512821
NODE_20762_length_644_cov_59.286239	323	401	459	1	78	0.0128205
NODE_20762_length_644_cov_59.286239	323	401	460	1	78	0.0128205
NODE_20762_length_644_cov_59.286239	323	401	462	1	78	0.0128205
NODE_20763_length_644_cov_27.577982	63	143	1	80	80	1.0000000
NODE_20763_length_644_cov_27.577982	116	196	0	37	80	0.4625000
NODE_20763_length_644_cov_27.577982	116	196	1	43	80	0.5375000
NODE_20765_length_644_cov_10.073394	284	364	2	80	80	1.0000000
NODE_20765_length_644_cov_10.073394	337	417	0	20	80	0.2500000
NODE_20765_length_644_cov_10.073394	337	417	2	60	80	0.7500000
NODE_20845_length_643_cov_27.562500	201	281	0	80	80	1.0000000
NODE_20845_length_643_cov_27.562500	254	334	0	80	80	1.0000000
NODE_20845_length_643_cov_27.562500	330	410	0	80	80	1.0000000
NODE_20845_length_643_cov_27.562500	383	463	0	80	80	1.0000000
NODE_20846_length_643_cov_12.895221	203	283	2	80	80	1.0000000
NODE_20846_length_643_cov_12.895221	256	336	0	48	80	0.6000000
NODE_20846_length_643_cov_12.895221	256	336	2	32	80	0.4000000
NODE_20847_length_643_cov_10.501838	280	360	2	80	80	1.0000000
NODE_20847_length_643_cov_10.501838	333	413	0	6	80	0.0750000
NODE_20847_length_643_cov_10.501838	333	413	1	1	80	0.0125000
NODE_20847_length_643_cov_10.501838	333	413	2	73	80	0.9125000
NODE_20848_length_643_cov_9.136029	307	385	0	65	78	0.8333333
NODE_20848_length_643_cov_9.136029	307	385	2	5	78	0.0641026
NODE_20848_length_643_cov_9.136029	307	385	6	2	78	0.0256410
NODE_20848_length_643_cov_9.136029	307	385	11	5	78	0.0641026
NODE_20848_length_643_cov_9.136029	307	385	12	1	78	0.0128205
NODE_20848_length_643_cov_9.136029	358	438	0	14	80	0.1750000
NODE_20848_length_643_cov_9.136029	358	438	2	5	80	0.0625000
NODE_20848_length_643_cov_9.136029	358	438	6	2	80	0.0250000
NODE_20848_length_643_cov_9.136029	358	438	10	23	80	0.2875000
NODE_20848_length_643_cov_9.136029	358	438	11	5	80	0.0625000
NODE_20848_length_643_cov_9.136029	358	438	12	31	80	0.3875000
NODE_20849_length_643_cov_8.264706	202	282	0	46	80	0.5750000
NODE_20849_length_643_cov_8.264706	202	282	2	34	80	0.4250000
NODE_20849_length_643_cov_8.264706	255	335	0	18	80	0.2250000
NODE_20849_length_643_cov_8.264706	255	335	2	62	80	0.7750000
NODE_20851_length_643_cov_7.137868	173	253	0	80	80	1.0000000
NODE_20851_length_643_cov_7.137868	226	306	0	80	80	1.0000000
NODE_20855_length_643_cov_5.851103	255	335	32	3	80	0.0375000
NODE_20855_length_643_cov_5.851103	255	335	34	14	80	0.1750000
NODE_20855_length_643_cov_5.851103	255	335	36	3	80	0.0375000
NODE_20855_length_643_cov_5.851103	255	335	38	11	80	0.1375000
NODE_20855_length_643_cov_5.851103	255	335	40	4	80	0.0500000
NODE_20855_length_643_cov_5.851103	255	335	42	2	80	0.0250000
NODE_20855_length_643_cov_5.851103	255	335	44	2	80	0.0250000
NODE_20855_length_643_cov_5.851103	255	335	46	21	80	0.2625000
NODE_20855_length_643_cov_5.851103	255	335	48	1	80	0.0125000
NODE_20855_length_643_cov_5.851103	255	335	50	3	80	0.0375000
NODE_20855_length_643_cov_5.851103	255	335	52	16	80	0.2000000
NODE_20855_length_643_cov_5.851103	308	388	7	7	80	0.0875000
NODE_20855_length_643_cov_5.851103	308	388	9	5	80	0.0625000
NODE_20855_length_643_cov_5.851103	308	388	12	15	80	0.1875000
NODE_20855_length_643_cov_5.851103	308	388	14	2	80	0.0250000
NODE_20855_length_643_cov_5.851103	308	388	15	1	80	0.0125000
NODE_20855_length_643_cov_5.851103	308	388	18	7	80	0.0875000
NODE_20855_length_643_cov_5.851103	308	388	22	1	80	0.0125000
NODE_20855_length_643_cov_5.851103	308	388	26	2	80	0.0250000
NODE_20855_length_643_cov_5.851103	308	388	27	5	80	0.0625000
NODE_20855_length_643_cov_5.851103	308	388	28	1	80	0.0125000
NODE_20855_length_643_cov_5.851103	308	388	30	1	80	0.0125000
NODE_20855_length_643_cov_5.851103	308	388	32	3	80	0.0375000
NODE_20855_length_643_cov_5.851103	308	388	34	20	80	0.2500000
NODE_20855_length_643_cov_5.851103	308	388	36	3	80	0.0375000
NODE_20855_length_643_cov_5.851103	308	388	38	7	80	0.0875000
NODE_20869_length_643_cov_3.121324	283	348	0	22	65	0.3384615
NODE_20869_length_643_cov_3.121324	283	348	2	43	65	0.6615385
NODE_20872_length_643_cov_2.806985	387	451	0	64	64	1.0000000
NODE_20942_length_642_cov_36.309392	156	236	0	15	80	0.1875000
NODE_20942_length_642_cov_36.309392	156	236	2	65	80	0.8125000
NODE_20942_length_642_cov_36.309392	209	289	0	68	80	0.8500000
NODE_20942_length_642_cov_36.309392	209	289	2	12	80	0.1500000
NODE_20943_length_642_cov_27.046041	154	234	0	80	80	1.0000000
NODE_20943_length_642_cov_27.046041	207	287	0	80	80	1.0000000
NODE_20944_length_642_cov_26.290976	209	289	4	14	80	0.1750000
NODE_20944_length_642_cov_26.290976	209	289	5	14	80	0.1750000
NODE_20944_length_642_cov_26.290976	209	289	9	52	80	0.6500000
NODE_20944_length_642_cov_26.290976	262	342	3	12	80	0.1500000
NODE_20944_length_642_cov_26.290976	262	342	5	15	80	0.1875000
NODE_20944_length_642_cov_26.290976	262	342	7	9	80	0.1125000
NODE_20944_length_642_cov_26.290976	262	342	9	44	80	0.5500000
NODE_20945_length_642_cov_11.651934	309	389	0	80	80	1.0000000
NODE_20945_length_642_cov_11.651934	362	442	0	80	80	1.0000000
NODE_20947_length_642_cov_6.692449	453	533	2	6	80	0.0750000
NODE_20947_length_642_cov_6.692449	453	533	3	1	80	0.0125000
NODE_20947_length_642_cov_6.692449	453	533	4	6	80	0.0750000
NODE_20947_length_642_cov_6.692449	453	533	6	45	80	0.5625000
NODE_20947_length_642_cov_6.692449	453	533	8	22	80	0.2750000
NODE_20947_length_642_cov_6.692449	506	586	2	6	80	0.0750000
NODE_20947_length_642_cov_6.692449	506	586	3	1	80	0.0125000
NODE_20947_length_642_cov_6.692449	506	586	4	59	80	0.7375000
NODE_20947_length_642_cov_6.692449	506	586	8	14	80	0.1750000
NODE_20951_length_642_cov_5.933702	260	340	0	80	80	1.0000000
NODE_20951_length_642_cov_5.933702	313	391	0	78	78	1.0000000
NODE_20967_length_642_cov_2.823204	115	158	10	8	43	0.1860465
NODE_20967_length_642_cov_2.823204	115	158	11	2	43	0.0465116
NODE_20967_length_642_cov_2.823204	115	158	15	3	43	0.0697674
NODE_20967_length_642_cov_2.823204	115	158	17	2	43	0.0465116
NODE_20967_length_642_cov_2.823204	115	158	19	1	43	0.0232558
NODE_20967_length_642_cov_2.823204	115	158	21	1	43	0.0232558
NODE_20967_length_642_cov_2.823204	115	158	22	4	43	0.0930233
NODE_20967_length_642_cov_2.823204	115	158	23	8	43	0.1860465
NODE_20967_length_642_cov_2.823204	115	158	24	9	43	0.2093023
NODE_20967_length_642_cov_2.823204	115	158	25	5	43	0.1162791
NODE_20967_length_642_cov_2.823204	245	300	22	1	55	0.0181818
NODE_20967_length_642_cov_2.823204	245	300	24	4	55	0.0727273
NODE_20967_length_642_cov_2.823204	245	300	27	6	55	0.1090909
NODE_20967_length_642_cov_2.823204	245	300	29	16	55	0.2909091
NODE_20967_length_642_cov_2.823204	245	300	30	1	55	0.0181818
NODE_20967_length_642_cov_2.823204	245	300	36	1	55	0.0181818
NODE_20967_length_642_cov_2.823204	245	300	38	13	55	0.2363636
NODE_20967_length_642_cov_2.823204	245	300	40	1	55	0.0181818
NODE_20967_length_642_cov_2.823204	245	300	42	11	55	0.2000000
NODE_20967_length_642_cov_2.823204	245	300	44	1	55	0.0181818
NODE_20967_length_642_cov_2.823204	329	410	8	31	81	0.3827161
NODE_20967_length_642_cov_2.823204	329	410	10	13	81	0.1604938
NODE_20967_length_642_cov_2.823204	329	410	12	10	81	0.1234568
NODE_20967_length_642_cov_2.823204	329	410	14	9	81	0.1111111
NODE_20967_length_642_cov_2.823204	329	410	22	18	81	0.2222222
NODE_20991_length_642_cov_1.357274	0	75	0	75	75	1.0000000
NODE_21018_length_641_cov_38.675277	284	345	2	4	61	0.0655738
NODE_21018_length_641_cov_38.675277	284	345	11	11	61	0.1803279
NODE_21018_length_641_cov_38.675277	284	345	13	3	61	0.0491803
NODE_21018_length_641_cov_38.675277	284	345	15	1	61	0.0163934
NODE_21018_length_641_cov_38.675277	284	345	17	1	61	0.0163934
NODE_21018_length_641_cov_38.675277	284	345	18	3	61	0.0491803
NODE_21018_length_641_cov_38.675277	284	345	20	1	61	0.0163934
NODE_21018_length_641_cov_38.675277	284	345	21	3	61	0.0491803
NODE_21018_length_641_cov_38.675277	284	345	24	2	61	0.0327869
NODE_21018_length_641_cov_38.675277	284	345	30	9	61	0.1475410
NODE_21018_length_641_cov_38.675277	284	345	34	1	61	0.0163934
NODE_21018_length_641_cov_38.675277	284	345	36	5	61	0.0819672
NODE_21018_length_641_cov_38.675277	284	345	39	2	61	0.0327869
NODE_21018_length_641_cov_38.675277	284	345	41	1	61	0.0163934
NODE_21018_length_641_cov_38.675277	284	345	42	1	61	0.0163934
NODE_21018_length_641_cov_38.675277	284	345	45	2	61	0.0327869
NODE_21018_length_641_cov_38.675277	284	345	47	1	61	0.0163934
NODE_21018_length_641_cov_38.675277	284	345	48	1	61	0.0163934
NODE_21018_length_641_cov_38.675277	284	345	52	2	61	0.0327869
NODE_21018_length_641_cov_38.675277	284	345	54	7	61	0.1147541
NODE_21018_length_641_cov_38.675277	318	369	30	4	51	0.0784314
NODE_21018_length_641_cov_38.675277	318	369	34	1	51	0.0196078
NODE_21018_length_641_cov_38.675277	318	369	36	5	51	0.0980392
NODE_21018_length_641_cov_38.675277	318	369	39	2	51	0.0392157
NODE_21018_length_641_cov_38.675277	318	369	41	1	51	0.0196078
NODE_21018_length_641_cov_38.675277	318	369	42	1	51	0.0196078
NODE_21018_length_641_cov_38.675277	318	369	45	2	51	0.0392157
NODE_21018_length_641_cov_38.675277	318	369	46	1	51	0.0196078
NODE_21018_length_641_cov_38.675277	318	369	47	1	51	0.0196078
NODE_21018_length_641_cov_38.675277	318	369	48	9	51	0.1764706
NODE_21018_length_641_cov_38.675277	318	369	50	1	51	0.0196078
NODE_21018_length_641_cov_38.675277	318	369	52	6	51	0.1176471
NODE_21018_length_641_cov_38.675277	318	369	54	17	51	0.3333333
NODE_21019_length_641_cov_15.271218	260	340	0	80	80	1.0000000
NODE_21019_length_641_cov_15.271218	313	393	0	80	80	1.0000000
NODE_21021_length_641_cov_12.584871	363	443	2	80	80	1.0000000
NODE_21021_length_641_cov_12.584871	416	496	0	41	80	0.5125000
NODE_21021_length_641_cov_12.584871	416	496	2	39	80	0.4875000
NODE_21022_length_641_cov_11.125461	38	118	0	80	80	1.0000000
NODE_21022_length_641_cov_11.125461	91	171	0	80	80	1.0000000
NODE_21025_length_641_cov_7.719557	84	138	4	54	54	1.0000000
NODE_21025_length_641_cov_7.719557	113	193	4	49	80	0.6125000
NODE_21025_length_641_cov_7.719557	113	193	8	31	80	0.3875000
NODE_21026_length_641_cov_7.675277	232	312	0	80	80	1.0000000
NODE_21026_length_641_cov_7.675277	285	365	0	80	80	1.0000000
NODE_21027_length_641_cov_7.675277	255	335	4	2	80	0.0250000
NODE_21027_length_641_cov_7.675277	255	335	8	41	80	0.5125000
NODE_21027_length_641_cov_7.675277	255	335	10	2	80	0.0250000
NODE_21027_length_641_cov_7.675277	255	335	12	6	80	0.0750000
NODE_21027_length_641_cov_7.675277	255	335	14	29	80	0.3625000
NODE_21027_length_641_cov_7.675277	308	388	2	17	80	0.2125000
NODE_21027_length_641_cov_7.675277	308	388	4	2	80	0.0250000
NODE_21027_length_641_cov_7.675277	308	388	6	7	80	0.0875000
NODE_21027_length_641_cov_7.675277	308	388	10	15	80	0.1875000
NODE_21027_length_641_cov_7.675277	308	388	12	11	80	0.1375000
NODE_21027_length_641_cov_7.675277	308	388	14	28	80	0.3500000
NODE_21028_length_641_cov_7.627306	262	342	0	54	80	0.6750000
NODE_21028_length_641_cov_7.627306	262	342	1	26	80	0.3250000
NODE_21028_length_641_cov_7.627306	315	395	0	14	80	0.1750000
NODE_21028_length_641_cov_7.627306	315	395	1	66	80	0.8250000
NODE_21029_length_641_cov_7.282288	247	300	0	53	53	1.0000000
NODE_21031_length_641_cov_5.029520	138	218	0	80	80	1.0000000
NODE_21031_length_641_cov_5.029520	191	271	0	80	80	1.0000000
NODE_21034_length_641_cov_4.701107	238	282	0	9	44	0.2045455
NODE_21034_length_641_cov_4.701107	238	282	2	35	44	0.7954546
NODE_21109_length_640_cov_39.676525	524	597	31	1	73	0.0136986
NODE_21109_length_640_cov_39.676525	524	597	33	1	73	0.0136986
NODE_21109_length_640_cov_39.676525	524	597	37	3	73	0.0410959
NODE_21109_length_640_cov_39.676525	524	597	39	1	73	0.0136986
NODE_21109_length_640_cov_39.676525	524	597	41	2	73	0.0273973
NODE_21109_length_640_cov_39.676525	524	597	45	5	73	0.0684932
NODE_21109_length_640_cov_39.676525	524	597	47	1	73	0.0136986
NODE_21109_length_640_cov_39.676525	524	597	48	9	73	0.1232877
NODE_21109_length_640_cov_39.676525	524	597	49	6	73	0.0821918
NODE_21109_length_640_cov_39.676525	524	597	51	10	73	0.1369863
NODE_21109_length_640_cov_39.676525	524	597	52	1	73	0.0136986
NODE_21109_length_640_cov_39.676525	524	597	54	6	73	0.0821918
NODE_21109_length_640_cov_39.676525	524	597	55	5	73	0.0684932
NODE_21109_length_640_cov_39.676525	524	597	57	3	73	0.0410959
NODE_21109_length_640_cov_39.676525	524	597	59	19	73	0.2602740
NODE_21109_length_640_cov_39.676525	564	605	31	9	41	0.2195122
NODE_21109_length_640_cov_39.676525	564	605	33	1	41	0.0243902
NODE_21109_length_640_cov_39.676525	564	605	37	3	41	0.0731707
NODE_21109_length_640_cov_39.676525	564	605	39	1	41	0.0243902
NODE_21109_length_640_cov_39.676525	564	605	41	2	41	0.0487805
NODE_21109_length_640_cov_39.676525	564	605	45	5	41	0.1219512
NODE_21109_length_640_cov_39.676525	564	605	47	1	41	0.0243902
NODE_21109_length_640_cov_39.676525	564	605	48	9	41	0.2195122
NODE_21109_length_640_cov_39.676525	564	605	49	6	41	0.1463415
NODE_21109_length_640_cov_39.676525	564	605	51	4	41	0.0975610
NODE_21110_length_640_cov_19.578558	273	353	4	33	80	0.4125000
NODE_21110_length_640_cov_19.578558	273	353	6	47	80	0.5875000
NODE_21110_length_640_cov_19.578558	326	406	0	28	80	0.3500000
NODE_21110_length_640_cov_19.578558	326	406	1	11	80	0.1375000
NODE_21110_length_640_cov_19.578558	326	406	3	12	80	0.1500000
NODE_21110_length_640_cov_19.578558	326	406	4	29	80	0.3625000
NODE_21111_length_640_cov_15.717190	178	258	0	1	80	0.0125000
NODE_21111_length_640_cov_15.717190	178	258	8	79	80	0.9875000
NODE_21111_length_640_cov_15.717190	231	311	8	80	80	1.0000000
NODE_21112_length_640_cov_15.338262	319	399	3	1	80	0.0125000
NODE_21112_length_640_cov_15.338262	319	399	4	1	80	0.0125000
NODE_21112_length_640_cov_15.338262	319	399	6	39	80	0.4875000
NODE_21112_length_640_cov_15.338262	319	399	7	39	80	0.4875000
NODE_21112_length_640_cov_15.338262	372	452	4	30	80	0.3750000
NODE_21112_length_640_cov_15.338262	372	452	5	1	80	0.0125000
NODE_21112_length_640_cov_15.338262	372	452	7	49	80	0.6125000
NODE_21113_length_640_cov_9.523105	20	43	0	23	23	1.0000000
NODE_21118_length_640_cov_5.123845	272	335	0	63	63	1.0000000
NODE_21121_length_640_cov_4.410351	254	334	0	80	80	1.0000000
NODE_21121_length_640_cov_4.410351	307	387	0	80	80	1.0000000
NODE_21129_length_640_cov_3.406654	244	324	2	61	80	0.7625000
NODE_21129_length_640_cov_3.406654	244	324	4	19	80	0.2375000
NODE_21140_length_640_cov_2.316081	21	57	0	36	36	1.0000000
NODE_21190_length_639_cov_58.092593	302	377	0	75	75	1.0000000
NODE_21190_length_639_cov_58.092593	350	430	0	80	80	1.0000000
NODE_21191_length_639_cov_32.951852	213	293	0	37	80	0.4625000
NODE_21191_length_639_cov_32.951852	213	293	2	43	80	0.5375000
NODE_21191_length_639_cov_32.951852	266	346	0	62	80	0.7750000
NODE_21191_length_639_cov_32.951852	266	346	2	18	80	0.2250000
NODE_21192_length_639_cov_24.564815	290	370	0	80	80	1.0000000
NODE_21192_length_639_cov_24.564815	343	423	0	80	80	1.0000000
NODE_21193_length_639_cov_14.448148	288	368	0	80	80	1.0000000
NODE_21193_length_639_cov_14.448148	341	421	0	80	80	1.0000000
NODE_21195_length_639_cov_9.001852	265	345	0	80	80	1.0000000
NODE_21195_length_639_cov_9.001852	318	398	0	50	80	0.6250000
NODE_21195_length_639_cov_9.001852	318	398	2	30	80	0.3750000
NODE_21197_length_639_cov_8.444444	161	241	1	75	80	0.9375000
NODE_21197_length_639_cov_8.444444	161	241	2	5	80	0.0625000
NODE_21197_length_639_cov_8.444444	214	294	1	24	80	0.3000000
NODE_21197_length_639_cov_8.444444	214	294	2	56	80	0.7000000
NODE_21202_length_639_cov_6.283333	157	176	0	19	19	1.0000000
NODE_21207_length_639_cov_4.188889	258	335	0	77	77	1.0000000
NODE_21207_length_639_cov_4.188889	308	354	0	46	46	1.0000000
NODE_21213_length_639_cov_3.448148	126	206	0	80	80	1.0000000
NODE_21213_length_639_cov_3.448148	179	259	0	80	80	1.0000000
NODE_21223_length_639_cov_2.683333	256	288	0	14	32	0.4375000
NODE_21223_length_639_cov_2.683333	256	288	1	18	32	0.5625000
NODE_21224_length_639_cov_2.555556	189	240	12	15	51	0.2941177
NODE_21224_length_639_cov_2.555556	189	240	14	36	51	0.7058824
NODE_21225_length_639_cov_2.477778	562	635	0	73	73	1.0000000
NODE_21265_length_639_cov_1.179630	542	564	0	22	22	1.0000000
NODE_21269_length_639_cov_1.051852	404	455	2	21	51	0.4117647
NODE_21269_length_639_cov_1.051852	404	455	4	30	51	0.5882353
NODE_21278_length_638_cov_13.018553	273	353	0	9	80	0.1125000
NODE_21278_length_638_cov_13.018553	273	353	2	1	80	0.0125000
NODE_21278_length_638_cov_13.018553	273	353	3	2	80	0.0250000
NODE_21278_length_638_cov_13.018553	273	353	4	35	80	0.4375000
NODE_21278_length_638_cov_13.018553	273	353	5	33	80	0.4125000
NODE_21278_length_638_cov_13.018553	326	406	0	62	80	0.7750000
NODE_21278_length_638_cov_13.018553	326	406	2	1	80	0.0125000
NODE_21278_length_638_cov_13.018553	326	406	4	17	80	0.2125000
NODE_21279_length_638_cov_12.656772	343	423	1	26	80	0.3250000
NODE_21279_length_638_cov_12.656772	343	423	2	17	80	0.2125000
NODE_21279_length_638_cov_12.656772	343	423	4	6	80	0.0750000
NODE_21279_length_638_cov_12.656772	343	423	8	13	80	0.1625000
NODE_21279_length_638_cov_12.656772	343	423	11	7	80	0.0875000
NODE_21279_length_638_cov_12.656772	343	423	14	11	80	0.1375000
NODE_21279_length_638_cov_12.656772	396	476	8	9	80	0.1125000
NODE_21279_length_638_cov_12.656772	396	476	11	7	80	0.0875000
NODE_21279_length_638_cov_12.656772	396	476	14	15	80	0.1875000
NODE_21279_length_638_cov_12.656772	396	476	18	49	80	0.6125000
NODE_21280_length_638_cov_11.877551	298	378	2	10	80	0.1250000
NODE_21280_length_638_cov_11.877551	298	378	4	61	80	0.7625000
NODE_21280_length_638_cov_11.877551	298	378	5	9	80	0.1125000
NODE_21280_length_638_cov_11.877551	351	431	2	17	80	0.2125000
NODE_21280_length_638_cov_11.877551	351	431	3	6	80	0.0750000
NODE_21280_length_638_cov_11.877551	351	431	4	32	80	0.4000000
NODE_21280_length_638_cov_11.877551	351	431	5	25	80	0.3125000
NODE_21281_length_638_cov_8.779221	330	408	0	78	78	1.0000000
NODE_21281_length_638_cov_8.779221	383	461	0	78	78	1.0000000
NODE_21284_length_638_cov_5.543599	315	395	0	80	80	1.0000000
NODE_21290_length_638_cov_3.966605	307	387	0	80	80	1.0000000
NODE_21301_length_638_cov_2.786642	157	208	0	5	51	0.0980392
NODE_21301_length_638_cov_2.786642	157	208	2	46	51	0.9019608
NODE_21301_length_638_cov_2.786642	181	261	0	58	80	0.7250000
NODE_21301_length_638_cov_2.786642	181	261	2	22	80	0.2750000
NODE_21364_length_637_cov_67.157993	285	365	0	80	80	1.0000000
NODE_21364_length_637_cov_67.157993	338	418	0	80	80	1.0000000
NODE_21364_length_637_cov_67.157993	414	494	0	80	80	1.0000000
NODE_21364_length_637_cov_67.157993	467	547	0	80	80	1.0000000
NODE_21365_length_637_cov_63.029740	195	275	0	80	80	1.0000000
NODE_21365_length_637_cov_63.029740	248	328	0	80	80	1.0000000
NODE_21366_length_637_cov_44.923792	53	133	0	80	80	1.0000000
NODE_21366_length_637_cov_44.923792	54	133	0	79	79	1.0000000
NODE_21366_length_637_cov_44.923792	106	186	0	80	80	1.0000000
NODE_21366_length_637_cov_44.923792	106	186	0	80	80	1.0000000
NODE_21366_length_637_cov_44.923792	182	262	0	69	80	0.8625000
NODE_21366_length_637_cov_44.923792	182	262	2	11	80	0.1375000
NODE_21366_length_637_cov_44.923792	235	315	0	16	80	0.2000000
NODE_21366_length_637_cov_44.923792	235	315	2	64	80	0.8000000
NODE_21367_length_637_cov_44.193309	193	273	0	80	80	1.0000000
NODE_21367_length_637_cov_44.193309	246	326	0	80	80	1.0000000
NODE_21368_length_637_cov_37.855019	215	295	0	29	80	0.3625000
NODE_21368_length_637_cov_37.855019	215	295	2	15	80	0.1875000
NODE_21368_length_637_cov_37.855019	215	295	4	36	80	0.4500000
NODE_21368_length_637_cov_37.855019	268	347	0	17	79	0.2151899
NODE_21368_length_637_cov_37.855019	268	347	2	39	79	0.4936709
NODE_21368_length_637_cov_37.855019	268	347	3	10	79	0.1265823
NODE_21368_length_637_cov_37.855019	268	347	4	13	79	0.1645570
NODE_21369_length_637_cov_33.957249	332	412	0	32	80	0.4000000
NODE_21369_length_637_cov_33.957249	332	412	2	48	80	0.6000000
NODE_21369_length_637_cov_33.957249	385	465	0	80	80	1.0000000
NODE_21370_length_637_cov_23.682156	275	355	0	8	80	0.1000000
NODE_21370_length_637_cov_23.682156	275	355	4	72	80	0.9000000
NODE_21370_length_637_cov_23.682156	328	408	0	61	80	0.7625000
NODE_21370_length_637_cov_23.682156	328	408	4	19	80	0.2375000
NODE_21371_length_637_cov_19.676580	267	347	0	17	80	0.2125000
NODE_21371_length_637_cov_19.676580	267	347	2	63	80	0.7875000
NODE_21371_length_637_cov_19.676580	320	400	0	16	80	0.2000000
NODE_21371_length_637_cov_19.676580	320	400	2	64	80	0.8000000
NODE_21373_length_637_cov_9.182156	226	276	0	50	50	1.0000000
NODE_21373_length_637_cov_9.182156	312	357	0	45	45	1.0000000
NODE_21374_length_637_cov_9.078067	276	357	2	68	81	0.8395061
NODE_21374_length_637_cov_9.078067	276	357	4	7	81	0.0864198
NODE_21374_length_637_cov_9.078067	276	357	5	1	81	0.0123457
NODE_21374_length_637_cov_9.078067	276	357	7	5	81	0.0617284
NODE_21374_length_637_cov_9.078067	330	410	0	8	80	0.1000000
NODE_21374_length_637_cov_9.078067	330	410	2	72	80	0.9000000
NODE_21375_length_637_cov_8.566914	235	315	0	80	80	1.0000000
NODE_21375_length_637_cov_8.566914	288	368	0	80	80	1.0000000
NODE_21378_length_637_cov_6.652416	337	415	0	78	78	1.0000000
NODE_21378_length_637_cov_6.652416	390	472	0	82	82	1.0000000
NODE_21385_length_637_cov_4.522305	284	364	0	80	80	1.0000000
NODE_21385_length_637_cov_4.522305	337	417	0	80	80	1.0000000
NODE_21389_length_637_cov_4.131970	292	370	0	78	78	1.0000000
NODE_21389_length_637_cov_4.131970	343	423	0	80	80	1.0000000
NODE_21457_length_636_cov_19.938547	214	294	6	80	80	1.0000000
NODE_21457_length_636_cov_19.938547	267	347	0	26	80	0.3250000
NODE_21457_length_636_cov_19.938547	267	347	3	18	80	0.2250000
NODE_21457_length_636_cov_19.938547	267	347	5	1	80	0.0125000
NODE_21457_length_636_cov_19.938547	267	347	6	35	80	0.4375000
NODE_21458_length_636_cov_12.283054	295	375	0	80	80	1.0000000
NODE_21458_length_636_cov_12.283054	348	428	0	80	80	1.0000000
NODE_21460_length_636_cov_8.312849	346	413	0	67	67	1.0000000
NODE_21460_length_636_cov_8.312849	399	479	0	80	80	1.0000000
NODE_21467_length_636_cov_4.324022	185	251	0	66	66	1.0000000
NODE_21467_length_636_cov_4.324022	224	266	0	42	42	1.0000000
NODE_21467_length_636_cov_4.324022	224	264	0	40	40	1.0000000
NODE_21539_length_635_cov_45.483209	195	239	316	1	44	0.0227273
NODE_21539_length_635_cov_45.483209	195	239	326	1	44	0.0227273
NODE_21539_length_635_cov_45.483209	195	239	332	2	44	0.0454545
NODE_21539_length_635_cov_45.483209	195	239	346	1	44	0.0227273
NODE_21539_length_635_cov_45.483209	195	239	355	1	44	0.0227273
NODE_21539_length_635_cov_45.483209	195	239	356	1	44	0.0227273
NODE_21539_length_635_cov_45.483209	195	239	359	1	44	0.0227273
NODE_21539_length_635_cov_45.483209	195	239	361	1	44	0.0227273
NODE_21539_length_635_cov_45.483209	195	239	364	1	44	0.0227273
NODE_21539_length_635_cov_45.483209	195	239	368	3	44	0.0681818
NODE_21539_length_635_cov_45.483209	195	239	370	3	44	0.0681818
NODE_21539_length_635_cov_45.483209	195	239	372	3	44	0.0681818
NODE_21539_length_635_cov_45.483209	195	239	374	4	44	0.0909091
NODE_21539_length_635_cov_45.483209	195	239	376	5	44	0.1136364
NODE_21539_length_635_cov_45.483209	195	239	377	1	44	0.0227273
NODE_21539_length_635_cov_45.483209	195	239	378	5	44	0.1136364
NODE_21539_length_635_cov_45.483209	195	239	379	1	44	0.0227273
NODE_21539_length_635_cov_45.483209	195	239	380	3	44	0.0681818
NODE_21539_length_635_cov_45.483209	195	239	381	2	44	0.0454545
NODE_21539_length_635_cov_45.483209	195	239	382	2	44	0.0454545
NODE_21539_length_635_cov_45.483209	195	239	383	1	44	0.0227273
NODE_21539_length_635_cov_45.483209	195	239	384	1	44	0.0227273
NODE_21539_length_635_cov_45.483209	225	268	294	1	43	0.0232558
NODE_21539_length_635_cov_45.483209	225	268	296	1	43	0.0232558
NODE_21539_length_635_cov_45.483209	225	268	303	1	43	0.0232558
NODE_21539_length_635_cov_45.483209	225	268	319	1	43	0.0232558
NODE_21539_length_635_cov_45.483209	225	268	322	1	43	0.0232558
NODE_21539_length_635_cov_45.483209	225	268	326	1	43	0.0232558
NODE_21539_length_635_cov_45.483209	225	268	331	2	43	0.0465116
NODE_21539_length_635_cov_45.483209	225	268	332	1	43	0.0232558
NODE_21539_length_635_cov_45.483209	225	268	333	1	43	0.0232558
NODE_21539_length_635_cov_45.483209	225	268	343	1	43	0.0232558
NODE_21539_length_635_cov_45.483209	225	268	345	2	43	0.0465116
NODE_21539_length_635_cov_45.483209	225	268	351	4	43	0.0930233
NODE_21539_length_635_cov_45.483209	225	268	353	1	43	0.0232558
NODE_21539_length_635_cov_45.483209	225	268	355	2	43	0.0465116
NODE_21539_length_635_cov_45.483209	225	268	357	3	43	0.0697674
NODE_21539_length_635_cov_45.483209	225	268	358	2	43	0.0465116
NODE_21539_length_635_cov_45.483209	225	268	359	3	43	0.0697674
NODE_21539_length_635_cov_45.483209	225	268	361	1	43	0.0232558
NODE_21539_length_635_cov_45.483209	225	268	364	1	43	0.0232558
NODE_21539_length_635_cov_45.483209	225	268	368	1	43	0.0232558
NODE_21539_length_635_cov_45.483209	225	268	372	2	43	0.0465116
NODE_21539_length_635_cov_45.483209	225	268	376	4	43	0.0930233
NODE_21539_length_635_cov_45.483209	225	268	378	3	43	0.0697674
NODE_21539_length_635_cov_45.483209	225	268	380	1	43	0.0232558
NODE_21539_length_635_cov_45.483209	225	268	381	2	43	0.0465116
NODE_21539_length_635_cov_45.483209	248	298	168	1	50	0.0200000
NODE_21539_length_635_cov_45.483209	248	298	180	1	50	0.0200000
NODE_21539_length_635_cov_45.483209	248	298	185	1	50	0.0200000
NODE_21539_length_635_cov_45.483209	248	298	191	2	50	0.0400000
NODE_21539_length_635_cov_45.483209	248	298	199	1	50	0.0200000
NODE_21539_length_635_cov_45.483209	248	298	203	1	50	0.0200000
NODE_21539_length_635_cov_45.483209	248	298	205	1	50	0.0200000
NODE_21539_length_635_cov_45.483209	248	298	206	1	50	0.0200000
NODE_21539_length_635_cov_45.483209	248	298	207	2	50	0.0400000
NODE_21539_length_635_cov_45.483209	248	298	208	1	50	0.0200000
NODE_21539_length_635_cov_45.483209	248	298	209	1	50	0.0200000
NODE_21539_length_635_cov_45.483209	248	298	216	1	50	0.0200000
NODE_21539_length_635_cov_45.483209	248	298	223	1	50	0.0200000
NODE_21539_length_635_cov_45.483209	248	298	237	1	50	0.0200000
NODE_21539_length_635_cov_45.483209	248	298	251	2	50	0.0400000
NODE_21539_length_635_cov_45.483209	248	298	255	1	50	0.0200000
NODE_21539_length_635_cov_45.483209	248	298	257	2	50	0.0400000
NODE_21539_length_635_cov_45.483209	248	298	264	1	50	0.0200000
NODE_21539_length_635_cov_45.483209	248	298	266	1	50	0.0200000
NODE_21539_length_635_cov_45.483209	248	298	269	1	50	0.0200000
NODE_21539_length_635_cov_45.483209	248	298	271	1	50	0.0200000
NODE_21539_length_635_cov_45.483209	248	298	277	2	50	0.0400000
NODE_21539_length_635_cov_45.483209	248	298	281	1	50	0.0200000
NODE_21539_length_635_cov_45.483209	248	298	289	1	50	0.0200000
NODE_21539_length_635_cov_45.483209	248	298	293	1	50	0.0200000
NODE_21539_length_635_cov_45.483209	248	298	294	1	50	0.0200000
NODE_21539_length_635_cov_45.483209	248	298	296	1	50	0.0200000
NODE_21539_length_635_cov_45.483209	248	298	303	1	50	0.0200000
NODE_21539_length_635_cov_45.483209	248	298	319	1	50	0.0200000
NODE_21539_length_635_cov_45.483209	248	298	322	1	50	0.0200000
NODE_21539_length_635_cov_45.483209	248	298	326	1	50	0.0200000
NODE_21539_length_635_cov_45.483209	248	298	331	2	50	0.0400000
NODE_21539_length_635_cov_45.483209	248	298	332	1	50	0.0200000
NODE_21539_length_635_cov_45.483209	248	298	333	1	50	0.0200000
NODE_21539_length_635_cov_45.483209	248	298	343	1	50	0.0200000
NODE_21539_length_635_cov_45.483209	248	298	345	2	50	0.0400000
NODE_21539_length_635_cov_45.483209	248	298	351	4	50	0.0800000
NODE_21539_length_635_cov_45.483209	248	298	353	1	50	0.0200000
NODE_21539_length_635_cov_45.483209	248	298	355	1	50	0.0200000
NODE_21539_length_635_cov_45.483209	248	298	357	1	50	0.0200000
NODE_21541_length_635_cov_23.895522	179	259	0	80	80	1.0000000
NODE_21541_length_635_cov_23.895522	232	312	0	80	80	1.0000000
NODE_21543_length_635_cov_14.772388	48	128	0	80	80	1.0000000
NODE_21543_length_635_cov_14.772388	101	181	0	80	80	1.0000000
NODE_21549_length_635_cov_6.180970	276	356	0	80	80	1.0000000
NODE_21549_length_635_cov_6.180970	329	409	0	80	80	1.0000000
NODE_21554_length_635_cov_4.421642	442	522	0	80	80	1.0000000
NODE_21560_length_635_cov_2.985075	296	376	27	4	80	0.0500000
NODE_21560_length_635_cov_2.985075	296	376	28	2	80	0.0250000
NODE_21560_length_635_cov_2.985075	296	376	29	19	80	0.2375000
NODE_21560_length_635_cov_2.985075	296	376	30	22	80	0.2750000
NODE_21560_length_635_cov_2.985075	296	376	31	33	80	0.4125000
NODE_21625_length_634_cov_53.315888	349	429	0	80	80	1.0000000
NODE_21625_length_634_cov_53.315888	402	482	0	80	80	1.0000000
NODE_21626_length_634_cov_28.530841	156	236	0	80	80	1.0000000
NODE_21626_length_634_cov_28.530841	209	289	0	80	80	1.0000000
NODE_21627_length_634_cov_19.117757	151	229	0	48	78	0.6153846
NODE_21627_length_634_cov_19.117757	151	229	8	30	78	0.3846154
NODE_21627_length_634_cov_19.117757	204	268	8	64	64	1.0000000
NODE_21628_length_634_cov_18.762617	84	164	0	58	80	0.7250000
NODE_21628_length_634_cov_18.762617	84	164	2	22	80	0.2750000
NODE_21628_length_634_cov_18.762617	137	217	0	5	80	0.0625000
NODE_21628_length_634_cov_18.762617	137	217	2	75	80	0.9375000
NODE_21629_length_634_cov_18.136449	162	242	2	12	80	0.1500000
NODE_21629_length_634_cov_18.136449	162	242	6	46	80	0.5750000
NODE_21629_length_634_cov_18.136449	162	242	8	22	80	0.2750000
NODE_21629_length_634_cov_18.136449	215	295	2	24	80	0.3000000
NODE_21629_length_634_cov_18.136449	215	295	4	41	80	0.5125000
NODE_21629_length_634_cov_18.136449	215	295	8	15	80	0.1875000
NODE_21635_length_634_cov_9.988785	508	553	0	32	45	0.7111111
NODE_21635_length_634_cov_9.988785	508	553	2	13	45	0.2888889
NODE_21636_length_634_cov_9.381308	267	353	0	6	86	0.0697674
NODE_21636_length_634_cov_9.381308	267	353	2	80	86	0.9302326
NODE_21636_length_634_cov_9.381308	324	404	0	51	80	0.6375000
NODE_21636_length_634_cov_9.381308	324	404	2	29	80	0.3625000
NODE_21651_length_634_cov_3.702804	460	532	0	72	72	1.0000000
NODE_21720_length_633_cov_30.076779	180	214	0	34	34	1.0000000
NODE_21720_length_633_cov_30.076779	187	267	0	48	80	0.6000000
NODE_21720_length_633_cov_30.076779	187	267	2	32	80	0.4000000
NODE_21720_length_633_cov_30.076779	263	343	0	38	80	0.4750000
NODE_21720_length_633_cov_30.076779	263	343	2	42	80	0.5250000
NODE_21720_length_633_cov_30.076779	316	396	0	80	80	1.0000000
NODE_21721_length_633_cov_17.595506	282	362	2	80	80	1.0000000
NODE_21721_length_633_cov_17.595506	335	415	0	50	80	0.6250000
NODE_21721_length_633_cov_17.595506	335	415	2	30	80	0.3750000
NODE_21722_length_633_cov_17.327715	228	308	0	80	80	1.0000000
NODE_21722_length_633_cov_17.327715	281	361	0	29	80	0.3625000
NODE_21722_length_633_cov_17.327715	281	361	2	51	80	0.6375000
NODE_21723_length_633_cov_9.689139	79	147	0	1	68	0.0147059
NODE_21723_length_633_cov_9.689139	79	147	2	8	68	0.1176471
NODE_21723_length_633_cov_9.689139	79	147	4	19	68	0.2794118
NODE_21723_length_633_cov_9.689139	79	147	6	35	68	0.5147059
NODE_21723_length_633_cov_9.689139	79	147	8	5	68	0.0735294
NODE_21729_length_633_cov_7.018727	309	389	4	15	80	0.1875000
NODE_21729_length_633_cov_7.018727	309	389	8	65	80	0.8125000
NODE_21729_length_633_cov_7.018727	362	442	4	1	80	0.0125000
NODE_21729_length_633_cov_7.018727	362	442	6	1	80	0.0125000
NODE_21729_length_633_cov_7.018727	362	442	7	41	80	0.5125000
NODE_21729_length_633_cov_7.018727	362	442	8	37	80	0.4625000
NODE_21755_length_633_cov_2.644195	166	240	4	74	74	1.0000000
NODE_21816_length_632_cov_25.425891	332	412	0	6	80	0.0750000
NODE_21816_length_632_cov_25.425891	332	412	6	74	80	0.9250000
NODE_21816_length_632_cov_25.425891	385	465	0	8	80	0.1000000
NODE_21816_length_632_cov_25.425891	385	465	2	51	80	0.6375000
NODE_21816_length_632_cov_25.425891	385	465	6	21	80	0.2625000
NODE_21817_length_632_cov_21.613508	243	323	0	80	80	1.0000000
NODE_21817_length_632_cov_21.613508	296	376	0	80	80	1.0000000
NODE_21818_length_632_cov_16.465291	293	373	6	13	80	0.1625000
NODE_21818_length_632_cov_16.465291	293	373	8	67	80	0.8375000
NODE_21818_length_632_cov_16.465291	346	426	0	48	80	0.6000000
NODE_21818_length_632_cov_16.465291	346	426	6	18	80	0.2250000
NODE_21818_length_632_cov_16.465291	346	426	8	14	80	0.1750000
NODE_21819_length_632_cov_13.260788	232	312	0	45	80	0.5625000
NODE_21819_length_632_cov_13.260788	232	312	4	35	80	0.4375000
NODE_21819_length_632_cov_13.260788	285	365	0	14	80	0.1750000
NODE_21819_length_632_cov_13.260788	285	365	4	66	80	0.8250000
NODE_21821_length_632_cov_9.106942	188	268	0	80	80	1.0000000
NODE_21821_length_632_cov_9.106942	241	321	0	80	80	1.0000000
NODE_21834_length_632_cov_4.135084	229	309	0	80	80	1.0000000
NODE_21834_length_632_cov_4.135084	282	359	0	77	77	1.0000000
NODE_21841_length_632_cov_2.939962	216	274	4	15	58	0.2586207
NODE_21841_length_632_cov_2.939962	216	274	5	33	58	0.5689655
NODE_21841_length_632_cov_2.939962	216	274	6	10	58	0.1724138
NODE_21841_length_632_cov_2.939962	247	327	2	10	80	0.1250000
NODE_21841_length_632_cov_2.939962	247	327	4	44	80	0.5500000
NODE_21841_length_632_cov_2.939962	247	327	5	24	80	0.3000000
NODE_21841_length_632_cov_2.939962	247	327	6	2	80	0.0250000
NODE_21848_length_632_cov_2.330206	57	76	0	19	19	1.0000000
NODE_21912_length_631_cov_31.469925	321	396	4	23	75	0.3066667
NODE_21912_length_631_cov_31.469925	321	396	6	52	75	0.6933333
NODE_21912_length_631_cov_31.469925	369	449	0	19	80	0.2375000
NODE_21912_length_631_cov_31.469925	369	449	2	31	80	0.3875000
NODE_21912_length_631_cov_31.469925	369	449	6	30	80	0.3750000
NODE_21913_length_631_cov_26.453008	383	463	0	80	80	1.0000000
NODE_21913_length_631_cov_26.453008	436	516	0	80	80	1.0000000
NODE_21917_length_631_cov_8.374060	318	398	0	80	80	1.0000000
NODE_21917_length_631_cov_8.374060	371	451	0	80	80	1.0000000
NODE_21924_length_631_cov_5.507519	335	386	2	3	51	0.0588235
NODE_21924_length_631_cov_5.507519	335	386	8	6	51	0.1176471
NODE_21924_length_631_cov_5.507519	335	386	10	19	51	0.3725490
NODE_21924_length_631_cov_5.507519	335	386	12	13	51	0.2549020
NODE_21924_length_631_cov_5.507519	335	386	13	5	51	0.0980392
NODE_21924_length_631_cov_5.507519	335	386	14	5	51	0.0980392
NODE_21927_length_631_cov_5.227444	443	523	4	10	80	0.1250000
NODE_21927_length_631_cov_5.227444	443	523	6	70	80	0.8750000
NODE_21927_length_631_cov_5.227444	496	576	0	28	80	0.3500000
NODE_21927_length_631_cov_5.227444	496	576	2	10	80	0.1250000
NODE_21927_length_631_cov_5.227444	496	576	4	1	80	0.0125000
NODE_21927_length_631_cov_5.227444	496	576	6	41	80	0.5125000
NODE_21942_length_631_cov_2.926692	307	354	0	47	47	1.0000000
NODE_21983_length_631_cov_1.383459	248	267	0	14	19	0.7368421
NODE_21983_length_631_cov_1.383459	248	267	2	5	19	0.2631579
NODE_22011_length_630_cov_41.728814	6	86	0	80	80	1.0000000
NODE_22011_length_630_cov_41.728814	59	139	0	80	80	1.0000000
NODE_22012_length_630_cov_24.856874	421	501	4	29	80	0.3625000
NODE_22012_length_630_cov_24.856874	421	501	6	11	80	0.1375000
NODE_22012_length_630_cov_24.856874	421	501	8	40	80	0.5000000
NODE_22012_length_630_cov_24.856874	474	554	0	11	80	0.1375000
NODE_22012_length_630_cov_24.856874	474	554	4	33	80	0.4125000
NODE_22012_length_630_cov_24.856874	474	554	8	36	80	0.4500000
NODE_22013_length_630_cov_14.323917	196	276	0	80	80	1.0000000
NODE_22013_length_630_cov_14.323917	249	329	0	80	80	1.0000000
NODE_22014_length_630_cov_9.964218	284	364	0	80	80	1.0000000
NODE_22014_length_630_cov_9.964218	337	417	0	80	80	1.0000000
NODE_22086_length_629_cov_38.271698	288	368	0	80	80	1.0000000
NODE_22086_length_629_cov_38.271698	341	421	0	80	80	1.0000000
NODE_22087_length_629_cov_27.556604	212	292	0	80	80	1.0000000
NODE_22087_length_629_cov_27.556604	265	345	0	52	80	0.6500000
NODE_22087_length_629_cov_27.556604	265	345	4	28	80	0.3500000
NODE_22088_length_629_cov_24.150943	356	436	0	80	80	1.0000000
NODE_22088_length_629_cov_24.150943	409	489	0	80	80	1.0000000
NODE_22091_length_629_cov_13.641509	176	256	0	60	80	0.7500000
NODE_22091_length_629_cov_13.641509	176	256	4	20	80	0.2500000
NODE_22091_length_629_cov_13.641509	229	309	0	7	80	0.0875000
NODE_22091_length_629_cov_13.641509	229	309	4	29	80	0.3625000
NODE_22091_length_629_cov_13.641509	229	309	6	12	80	0.1500000
NODE_22091_length_629_cov_13.641509	229	309	14	32	80	0.4000000
NODE_22101_length_629_cov_4.264151	362	442	0	80	80	1.0000000
NODE_22188_length_628_cov_5.015123	210	274	13	41	64	0.6406250
NODE_22188_length_628_cov_5.015123	210	274	14	4	64	0.0625000
NODE_22188_length_628_cov_5.015123	210	274	15	19	64	0.2968750
NODE_22257_length_627_cov_24.500000	217	297	0	79	80	0.9875000
NODE_22257_length_627_cov_24.500000	217	297	2	1	80	0.0125000
NODE_22257_length_627_cov_24.500000	270	350	0	80	80	1.0000000
NODE_22258_length_627_cov_20.395833	84	164	0	80	80	1.0000000
NODE_22258_length_627_cov_20.395833	137	217	0	80	80	1.0000000
NODE_22259_length_627_cov_19.676136	308	388	2	6	80	0.0750000
NODE_22259_length_627_cov_19.676136	308	388	4	54	80	0.6750000
NODE_22259_length_627_cov_19.676136	308	388	6	20	80	0.2500000
NODE_22259_length_627_cov_19.676136	361	441	0	6	80	0.0750000
NODE_22259_length_627_cov_19.676136	361	441	2	53	80	0.6625000
NODE_22259_length_627_cov_19.676136	361	441	4	6	80	0.0750000
NODE_22259_length_627_cov_19.676136	361	441	6	15	80	0.1875000
NODE_22260_length_627_cov_17.634470	264	296	0	32	32	1.0000000
NODE_22260_length_627_cov_17.634470	360	385	0	25	25	1.0000000
NODE_22260_length_627_cov_17.634470	365	385	0	20	20	1.0000000
NODE_22260_length_627_cov_17.634470	385	424	0	39	39	1.0000000
NODE_22267_length_627_cov_5.634470	298	346	0	25	48	0.5208333
NODE_22267_length_627_cov_5.634470	298	346	2	23	48	0.4791667
NODE_22274_length_627_cov_4.517045	323	403	0	80	80	1.0000000
NODE_22274_length_627_cov_4.517045	376	456	0	60	80	0.7500000
NODE_22274_length_627_cov_4.517045	376	456	2	20	80	0.2500000
NODE_22357_length_626_cov_24.184061	140	220	0	80	80	1.0000000
NODE_22357_length_626_cov_24.184061	193	273	0	80	80	1.0000000
NODE_22358_length_626_cov_21.189753	342	419	18	25	77	0.3246753
NODE_22358_length_626_cov_21.189753	342	419	35	1	77	0.0129870
NODE_22358_length_626_cov_21.189753	342	419	36	8	77	0.1038961
NODE_22358_length_626_cov_21.189753	342	419	37	5	77	0.0649351
NODE_22358_length_626_cov_21.189753	342	419	38	7	77	0.0909091
NODE_22358_length_626_cov_21.189753	342	419	39	1	77	0.0129870
NODE_22358_length_626_cov_21.189753	342	419	40	29	77	0.3766234
NODE_22358_length_626_cov_21.189753	342	419	41	1	77	0.0129870
NODE_22358_length_626_cov_21.189753	342	419	18	25	77	0.3246753
NODE_22358_length_626_cov_21.189753	342	419	35	1	77	0.0129870
NODE_22358_length_626_cov_21.189753	342	419	36	8	77	0.1038961
NODE_22358_length_626_cov_21.189753	342	419	37	5	77	0.0649351
NODE_22358_length_626_cov_21.189753	342	419	38	7	77	0.0909091
NODE_22358_length_626_cov_21.189753	342	419	39	1	77	0.0129870
NODE_22358_length_626_cov_21.189753	342	419	40	29	77	0.3766234
NODE_22358_length_626_cov_21.189753	342	419	41	1	77	0.0129870
NODE_22358_length_626_cov_21.189753	392	453	29	11	61	0.1803279
NODE_22358_length_626_cov_21.189753	392	453	30	12	61	0.1967213
NODE_22358_length_626_cov_21.189753	392	453	31	9	61	0.1475410
NODE_22358_length_626_cov_21.189753	392	453	33	2	61	0.0327869
NODE_22358_length_626_cov_21.189753	392	453	35	1	61	0.0163934
NODE_22358_length_626_cov_21.189753	392	453	36	8	61	0.1311475
NODE_22358_length_626_cov_21.189753	392	453	37	5	61	0.0819672
NODE_22358_length_626_cov_21.189753	392	453	38	7	61	0.1147541
NODE_22358_length_626_cov_21.189753	392	453	40	6	61	0.0983607
NODE_22364_length_626_cov_7.100569	236	311	0	51	75	0.6800000
NODE_22364_length_626_cov_7.100569	236	311	2	24	75	0.3200000
NODE_22364_length_626_cov_7.100569	284	364	0	3	80	0.0375000
NODE_22364_length_626_cov_7.100569	284	364	2	77	80	0.9625000
NODE_22366_length_626_cov_6.296015	193	273	0	30	80	0.3750000
NODE_22366_length_626_cov_6.296015	193	273	7	1	80	0.0125000
NODE_22366_length_626_cov_6.296015	193	273	8	49	80	0.6125000
NODE_22366_length_626_cov_6.296015	246	326	8	80	80	1.0000000
NODE_22367_length_626_cov_6.163188	257	337	0	46	80	0.5750000
NODE_22367_length_626_cov_6.163188	257	337	2	34	80	0.4250000
NODE_22367_length_626_cov_6.163188	310	390	2	80	80	1.0000000
NODE_22438_length_625_cov_33.100760	239	319	0	80	80	1.0000000
NODE_22438_length_625_cov_33.100760	292	372	0	80	80	1.0000000
NODE_22438_length_625_cov_33.100760	368	448	0	80	80	1.0000000
NODE_22438_length_625_cov_33.100760	421	501	0	62	80	0.7750000
NODE_22438_length_625_cov_33.100760	421	501	3	1	80	0.0125000
NODE_22438_length_625_cov_33.100760	421	501	4	17	80	0.2125000
NODE_22439_length_625_cov_21.062738	267	347	8	33	80	0.4125000
NODE_22439_length_625_cov_21.062738	267	347	9	1	80	0.0125000
NODE_22439_length_625_cov_21.062738	267	347	10	38	80	0.4750000
NODE_22439_length_625_cov_21.062738	267	347	14	8	80	0.1000000
NODE_22439_length_625_cov_21.062738	320	400	10	19	80	0.2375000
NODE_22439_length_625_cov_21.062738	320	400	12	12	80	0.1500000
NODE_22439_length_625_cov_21.062738	320	400	14	49	80	0.6125000
NODE_22440_length_625_cov_14.237643	28	108	0	80	80	1.0000000
NODE_22440_length_625_cov_14.237643	81	161	0	80	80	1.0000000
NODE_22441_length_625_cov_14.207224	358	438	0	60	80	0.7500000
NODE_22441_length_625_cov_14.207224	358	438	6	1	80	0.0125000
NODE_22441_length_625_cov_14.207224	358	438	8	19	80	0.2375000
NODE_22441_length_625_cov_14.207224	411	491	0	7	80	0.0875000
NODE_22441_length_625_cov_14.207224	411	491	6	1	80	0.0125000
NODE_22441_length_625_cov_14.207224	411	491	8	72	80	0.9000000
NODE_22455_length_625_cov_4.157795	548	600	0	52	52	1.0000000
NODE_22466_length_625_cov_2.929658	118	198	0	80	80	1.0000000
NODE_22466_length_625_cov_2.929658	171	251	0	80	80	1.0000000
NODE_22491_length_625_cov_1.570342	471	502	0	31	31	1.0000000
NODE_22542_length_624_cov_9.598095	77	126	0	49	49	1.0000000
NODE_22542_length_624_cov_9.598095	103	183	0	80	80	1.0000000
NODE_22544_length_624_cov_8.485714	271	351	2	10	80	0.1250000
NODE_22544_length_624_cov_8.485714	271	351	6	56	80	0.7000000
NODE_22544_length_624_cov_8.485714	271	351	8	14	80	0.1750000
NODE_22544_length_624_cov_8.485714	324	404	2	11	80	0.1375000
NODE_22544_length_624_cov_8.485714	324	404	6	55	80	0.6875000
NODE_22544_length_624_cov_8.485714	324	404	8	14	80	0.1750000
NODE_22546_length_624_cov_6.691429	386	466	0	80	80	1.0000000
NODE_22546_length_624_cov_6.691429	439	519	0	80	80	1.0000000
NODE_22547_length_624_cov_5.592381	312	387	0	14	75	0.1866667
NODE_22547_length_624_cov_5.592381	312	387	2	61	75	0.8133333
NODE_22551_length_624_cov_4.638095	328	388	0	60	60	1.0000000
NODE_22642_length_623_cov_41.877863	419	499	0	80	80	1.0000000
NODE_22642_length_623_cov_41.877863	472	552	0	80	80	1.0000000
NODE_22643_length_623_cov_31.875954	148	228	0	5	80	0.0625000
NODE_22643_length_623_cov_31.875954	148	228	6	14	80	0.1750000
NODE_22643_length_623_cov_31.875954	148	228	10	61	80	0.7625000
NODE_22643_length_623_cov_31.875954	201	281	0	58	80	0.7250000
NODE_22643_length_623_cov_31.875954	201	281	6	5	80	0.0625000
NODE_22643_length_623_cov_31.875954	201	281	10	17	80	0.2125000
NODE_22644_length_623_cov_31.192748	313	393	0	80	80	1.0000000
NODE_22644_length_623_cov_31.192748	366	446	0	80	80	1.0000000
NODE_22645_length_623_cov_20.187023	287	367	0	44	80	0.5500000
NODE_22645_length_623_cov_20.187023	287	367	2	36	80	0.4500000
NODE_22645_length_623_cov_20.187023	340	420	0	80	80	1.0000000
NODE_22646_length_623_cov_12.045802	377	457	0	80	80	1.0000000
NODE_22646_length_623_cov_12.045802	430	510	0	80	80	1.0000000
NODE_22668_length_623_cov_2.891221	457	535	0	62	78	0.7948718
NODE_22668_length_623_cov_2.891221	457	535	2	16	78	0.2051282
NODE_22725_length_622_cov_19.042065	368	448	2	74	80	0.9250000
NODE_22725_length_622_cov_19.042065	368	448	4	6	80	0.0750000
NODE_22725_length_622_cov_19.042065	421	501	2	74	80	0.9250000
NODE_22725_length_622_cov_19.042065	421	501	4	6	80	0.0750000
NODE_22726_length_622_cov_13.470363	109	189	0	80	80	1.0000000
NODE_22726_length_622_cov_13.470363	162	242	0	80	80	1.0000000
NODE_22752_length_622_cov_2.407266	94	170	7	19	76	0.2500000
NODE_22752_length_622_cov_2.407266	94	170	8	8	76	0.1052632
NODE_22752_length_622_cov_2.407266	94	170	10	1	76	0.0131579
NODE_22752_length_622_cov_2.407266	94	170	12	4	76	0.0526316
NODE_22752_length_622_cov_2.407266	94	170	14	8	76	0.1052632
NODE_22752_length_622_cov_2.407266	94	170	16	5	76	0.0657895
NODE_22752_length_622_cov_2.407266	94	170	20	14	76	0.1842105
NODE_22752_length_622_cov_2.407266	94	170	23	6	76	0.0789474
NODE_22752_length_622_cov_2.407266	94	170	25	4	76	0.0526316
NODE_22752_length_622_cov_2.407266	94	170	27	7	76	0.0921053
NODE_22796_length_622_cov_1.353728	346	376	3	6	30	0.2000000
NODE_22796_length_622_cov_1.353728	346	376	5	14	30	0.4666667
NODE_22796_length_622_cov_1.353728	346	376	7	10	30	0.3333333
NODE_22819_length_621_cov_46.247126	0	52	0	42	52	0.8076923
NODE_22819_length_621_cov_46.247126	0	52	2	10	52	0.1923077
NODE_22819_length_621_cov_46.247126	25	105	0	17	80	0.2125000
NODE_22819_length_621_cov_46.247126	25	105	2	63	80	0.7875000
NODE_22819_length_621_cov_46.247126	101	181	0	31	80	0.3875000
NODE_22819_length_621_cov_46.247126	101	181	2	49	80	0.6125000
NODE_22819_length_621_cov_46.247126	154	234	0	80	80	1.0000000
NODE_22820_length_621_cov_45.764368	344	424	0	36	80	0.4500000
NODE_22820_length_621_cov_45.764368	344	424	4	44	80	0.5500000
NODE_22820_length_621_cov_45.764368	397	477	0	80	80	1.0000000
NODE_22821_length_621_cov_35.147510	393	473	0	53	80	0.6625000
NODE_22821_length_621_cov_35.147510	393	473	9	24	80	0.3000000
NODE_22821_length_621_cov_35.147510	393	473	10	3	80	0.0375000
NODE_22821_length_621_cov_35.147510	446	526	9	24	80	0.3000000
NODE_22821_length_621_cov_35.147510	446	526	10	56	80	0.7000000
NODE_22822_length_621_cov_13.842912	231	311	0	24	80	0.3000000
NODE_22822_length_621_cov_13.842912	231	311	2	56	80	0.7000000
NODE_22822_length_621_cov_13.842912	284	364	2	80	80	1.0000000
NODE_22825_length_621_cov_6.279693	376	406	0	30	30	1.0000000
NODE_22845_length_621_cov_2.645594	367	426	0	59	59	1.0000000
NODE_22914_length_620_cov_23.913628	433	513	0	31	80	0.3875000
NODE_22914_length_620_cov_23.913628	433	513	2	49	80	0.6125000
NODE_22914_length_620_cov_23.913628	486	566	0	80	80	1.0000000
NODE_22915_length_620_cov_9.222649	186	266	0	80	80	1.0000000
NODE_22915_length_620_cov_9.222649	239	319	0	80	80	1.0000000
NODE_22919_length_620_cov_7.804223	57	137	0	80	80	1.0000000
NODE_22919_length_620_cov_7.804223	110	190	0	80	80	1.0000000
NODE_22920_length_620_cov_6.909789	199	279	0	80	80	1.0000000
NODE_22920_length_620_cov_6.909789	252	332	0	80	80	1.0000000
NODE_22930_length_620_cov_4.560461	309	347	14	32	38	0.8421053
NODE_22930_length_620_cov_4.560461	309	347	16	6	38	0.1578947
NODE_22930_length_620_cov_4.560461	395	421	7	23	26	0.8846154
NODE_22930_length_620_cov_4.560461	395	421	9	2	26	0.0769231
NODE_22930_length_620_cov_4.560461	395	421	10	1	26	0.0384615
NODE_22930_length_620_cov_4.560461	395	451	0	14	56	0.2500000
NODE_22930_length_620_cov_4.560461	395	451	2	2	56	0.0357143
NODE_22930_length_620_cov_4.560461	395	451	4	7	56	0.1250000
NODE_22930_length_620_cov_4.560461	395	451	5	5	56	0.0892857
NODE_22930_length_620_cov_4.560461	395	451	7	25	56	0.4464286
NODE_22930_length_620_cov_4.560461	395	451	9	2	56	0.0357143
NODE_22930_length_620_cov_4.560461	395	451	10	1	56	0.0178571
NODE_23031_length_619_cov_26.309615	118	198	1	12	80	0.1500000
NODE_23031_length_619_cov_26.309615	118	198	2	68	80	0.8500000
NODE_23031_length_619_cov_26.309615	171	251	2	80	80	1.0000000
NODE_23033_length_619_cov_10.417308	427	487	5	13	60	0.2166667
NODE_23033_length_619_cov_10.417308	427	487	7	30	60	0.5000000
NODE_23033_length_619_cov_10.417308	427	487	8	17	60	0.2833333
NODE_23034_length_619_cov_7.944231	213	293	0	43	80	0.5375000
NODE_23034_length_619_cov_7.944231	213	293	4	37	80	0.4625000
NODE_23034_length_619_cov_7.944231	266	346	0	80	80	1.0000000
NODE_23135_length_618_cov_14.477842	223	299	0	76	76	1.0000000
NODE_23135_length_618_cov_14.477842	223	299	0	76	76	1.0000000
NODE_23135_length_618_cov_14.477842	276	337	0	36	61	0.5901639
NODE_23135_length_618_cov_14.477842	276	337	2	25	61	0.4098361
NODE_23136_length_618_cov_13.840077	377	457	0	80	80	1.0000000
NODE_23136_length_618_cov_13.840077	430	510	0	80	80	1.0000000
NODE_23137_length_618_cov_12.048170	348	428	0	12	80	0.1500000
NODE_23137_length_618_cov_12.048170	348	428	1	33	80	0.4125000
NODE_23137_length_618_cov_12.048170	348	428	2	35	80	0.4375000
NODE_23137_length_618_cov_12.048170	401	481	0	65	80	0.8125000
NODE_23137_length_618_cov_12.048170	401	481	1	15	80	0.1875000
NODE_23138_length_618_cov_8.799615	353	433	0	80	80	1.0000000
NODE_23138_length_618_cov_8.799615	406	486	0	80	80	1.0000000
NODE_23147_length_618_cov_3.793834	412	478	0	66	66	1.0000000
NODE_23148_length_618_cov_3.761079	305	385	0	12	80	0.1500000
NODE_23148_length_618_cov_3.761079	305	385	2	68	80	0.8500000
NODE_23252_length_617_cov_29.565637	378	458	0	80	80	1.0000000
NODE_23252_length_617_cov_29.565637	431	511	0	80	80	1.0000000
NODE_23253_length_617_cov_16.781853	253	333	0	32	80	0.4000000
NODE_23253_length_617_cov_16.781853	253	333	8	48	80	0.6000000
NODE_23253_length_617_cov_16.781853	306	386	0	28	80	0.3500000
NODE_23253_length_617_cov_16.781853	306	386	7	12	80	0.1500000
NODE_23253_length_617_cov_16.781853	306	386	8	40	80	0.5000000
NODE_23254_length_617_cov_9.175676	373	453	0	80	80	1.0000000
NODE_23254_length_617_cov_9.175676	426	506	0	80	80	1.0000000
NODE_23255_length_617_cov_8.774131	320	406	0	26	86	0.3023256
NODE_23255_length_617_cov_8.774131	320	406	6	30	86	0.3488372
NODE_23255_length_617_cov_8.774131	320	406	7	11	86	0.1279070
NODE_23255_length_617_cov_8.774131	320	406	8	19	86	0.2209302
NODE_23255_length_617_cov_8.774131	379	458	2	30	79	0.3797468
NODE_23255_length_617_cov_8.774131	379	458	7	8	79	0.1012658
NODE_23255_length_617_cov_8.774131	379	458	8	41	79	0.5189874
NODE_23257_length_617_cov_8.416988	359	439	0	80	80	1.0000000
NODE_23257_length_617_cov_8.416988	412	492	0	80	80	1.0000000
NODE_23259_length_617_cov_7.683398	197	275	0	78	78	1.0000000
NODE_23259_length_617_cov_7.683398	250	330	0	80	80	1.0000000
NODE_23263_length_617_cov_5.330116	288	360	0	72	72	1.0000000
NODE_23263_length_617_cov_5.330116	333	413	0	80	80	1.0000000
NODE_23302_length_617_cov_1.967181	384	430	0	46	46	1.0000000
NODE_23311_length_617_cov_1.847490	273	344	0	71	71	1.0000000
NODE_23331_length_617_cov_1.322394	269	318	25	18	49	0.3673469
NODE_23331_length_617_cov_1.322394	269	318	27	13	49	0.2653061
NODE_23331_length_617_cov_1.322394	269	318	29	5	49	0.1020408
NODE_23331_length_617_cov_1.322394	269	318	31	12	49	0.2448980
NODE_23331_length_617_cov_1.322394	269	318	33	1	49	0.0204082
NODE_23365_length_616_cov_15.914894	292	370	6	57	78	0.7307692
NODE_23365_length_616_cov_15.914894	292	370	8	21	78	0.2692308
NODE_23365_length_616_cov_15.914894	343	423	2	35	80	0.4375000
NODE_23365_length_616_cov_15.914894	343	423	6	44	80	0.5500000
NODE_23365_length_616_cov_15.914894	343	423	8	1	80	0.0125000
NODE_23366_length_616_cov_14.276596	191	271	0	80	80	1.0000000
NODE_23366_length_616_cov_14.276596	244	319	0	52	75	0.6933333
NODE_23366_length_616_cov_14.276596	244	319	2	23	75	0.3066667
NODE_23366_length_616_cov_14.276596	368	448	0	35	80	0.4375000
NODE_23366_length_616_cov_14.276596	368	448	2	11	80	0.1375000
NODE_23366_length_616_cov_14.276596	368	448	4	34	80	0.4250000
NODE_23367_length_616_cov_12.119923	273	353	0	80	80	1.0000000
NODE_23367_length_616_cov_12.119923	326	406	0	80	80	1.0000000
NODE_23373_length_616_cov_6.379110	305	385	0	80	80	1.0000000
NODE_23373_length_616_cov_6.379110	358	438	0	80	80	1.0000000
NODE_23381_length_616_cov_4.441006	286	350	0	64	64	1.0000000
NODE_23381_length_616_cov_4.441006	286	306	0	20	20	1.0000000
NODE_23400_length_616_cov_2.541586	375	415	0	40	40	1.0000000
NODE_23430_length_616_cov_1.491296	105	183	0	8	78	0.1025641
NODE_23430_length_616_cov_1.491296	105	183	2	22	78	0.2820513
NODE_23430_length_616_cov_1.491296	105	183	8	1	78	0.0128205
NODE_23430_length_616_cov_1.491296	105	183	12	47	78	0.6025641
NODE_23474_length_615_cov_27.519380	302	382	0	80	80	1.0000000
NODE_23474_length_615_cov_27.519380	355	435	0	80	80	1.0000000
NODE_23475_length_615_cov_17.792636	239	319	0	42	80	0.5250000
NODE_23475_length_615_cov_17.792636	239	319	2	38	80	0.4750000
NODE_23475_length_615_cov_17.792636	292	372	2	80	80	1.0000000
NODE_23477_length_615_cov_11.835271	240	320	0	80	80	1.0000000
NODE_23477_length_615_cov_11.835271	293	373	0	80	80	1.0000000
NODE_23478_length_615_cov_8.591085	287	367	0	80	80	1.0000000
NODE_23478_length_615_cov_8.591085	340	420	0	80	80	1.0000000
NODE_23513_length_615_cov_2.461240	429	509	0	80	80	1.0000000
NODE_23513_length_615_cov_2.461240	482	562	0	80	80	1.0000000
NODE_23516_length_615_cov_2.379845	405	467	2	2	62	0.0322581
NODE_23516_length_615_cov_2.379845	405	467	4	1	62	0.0161290
NODE_23516_length_615_cov_2.379845	405	467	6	17	62	0.2741936
NODE_23516_length_615_cov_2.379845	405	467	10	28	62	0.4516129
NODE_23516_length_615_cov_2.379845	405	467	12	14	62	0.2258064
NODE_23516_length_615_cov_2.379845	440	520	10	43	80	0.5375000
NODE_23516_length_615_cov_2.379845	440	520	12	37	80	0.4625000
NODE_23517_length_615_cov_2.294574	205	268	0	63	63	1.0000000
NODE_23554_length_615_cov_1.122093	255	335	0	80	80	1.0000000
NODE_23566_length_615_cov_0.887597	561	582	0	21	21	1.0000000
NODE_23575_length_614_cov_17.772816	257	337	0	80	80	1.0000000
NODE_23575_length_614_cov_17.772816	310	390	0	80	80	1.0000000
NODE_23576_length_614_cov_10.706796	425	505	0	80	80	1.0000000
NODE_23576_length_614_cov_10.706796	478	558	0	80	80	1.0000000
NODE_23578_length_614_cov_8.545631	193	273	0	38	80	0.4750000
NODE_23578_length_614_cov_8.545631	193	273	2	12	80	0.1500000
NODE_23578_length_614_cov_8.545631	193	273	4	1	80	0.0125000
NODE_23578_length_614_cov_8.545631	193	273	6	1	80	0.0125000
NODE_23578_length_614_cov_8.545631	193	273	11	2	80	0.0250000
NODE_23578_length_614_cov_8.545631	193	273	13	1	80	0.0125000
NODE_23578_length_614_cov_8.545631	193	273	21	1	80	0.0125000
NODE_23578_length_614_cov_8.545631	193	273	24	3	80	0.0375000
NODE_23578_length_614_cov_8.545631	193	273	26	4	80	0.0500000
NODE_23578_length_614_cov_8.545631	193	273	28	1	80	0.0125000
NODE_23578_length_614_cov_8.545631	193	273	30	1	80	0.0125000
NODE_23578_length_614_cov_8.545631	193	273	32	1	80	0.0125000
NODE_23578_length_614_cov_8.545631	193	273	36	1	80	0.0125000
NODE_23578_length_614_cov_8.545631	193	273	40	2	80	0.0250000
NODE_23578_length_614_cov_8.545631	193	273	42	4	80	0.0500000
NODE_23578_length_614_cov_8.545631	193	273	44	2	80	0.0250000
NODE_23578_length_614_cov_8.545631	193	273	46	3	80	0.0375000
NODE_23578_length_614_cov_8.545631	193	273	47	2	80	0.0250000
NODE_23578_length_614_cov_8.545631	246	326	0	16	80	0.2000000
NODE_23578_length_614_cov_8.545631	246	326	2	16	80	0.2000000
NODE_23578_length_614_cov_8.545631	246	326	5	7	80	0.0875000
NODE_23578_length_614_cov_8.545631	246	326	11	5	80	0.0625000
NODE_23578_length_614_cov_8.545631	246	326	13	12	80	0.1500000
NODE_23578_length_614_cov_8.545631	246	326	14	23	80	0.2875000
NODE_23578_length_614_cov_8.545631	246	326	15	1	80	0.0125000
NODE_23604_length_614_cov_2.450485	315	393	4	14	78	0.1794872
NODE_23604_length_614_cov_2.450485	315	393	6	9	78	0.1153846
NODE_23604_length_614_cov_2.450485	315	393	8	55	78	0.7051282
NODE_23604_length_614_cov_2.450485	355	383	4	4	28	0.1428571
NODE_23604_length_614_cov_2.450485	355	383	8	24	28	0.8571429
NODE_23604_length_614_cov_2.450485	368	448	0	14	80	0.1750000
NODE_23604_length_614_cov_2.450485	368	448	2	23	80	0.2875000
NODE_23604_length_614_cov_2.450485	368	448	4	32	80	0.4000000
NODE_23604_length_614_cov_2.450485	368	448	8	11	80	0.1375000
NODE_23604_length_614_cov_2.450485	379	448	0	14	69	0.2028985
NODE_23604_length_614_cov_2.450485	379	448	2	23	69	0.3333333
NODE_23604_length_614_cov_2.450485	379	448	4	32	69	0.4637681
NODE_23662_length_613_cov_18.075875	211	291	0	80	80	1.0000000
NODE_23662_length_613_cov_18.075875	264	344	0	80	80	1.0000000
NODE_23663_length_613_cov_16.118677	283	363	0	20	80	0.2500000
NODE_23663_length_613_cov_16.118677	283	363	2	60	80	0.7500000
NODE_23663_length_613_cov_16.118677	336	416	0	73	80	0.9125000
NODE_23663_length_613_cov_16.118677	336	416	2	7	80	0.0875000
NODE_23665_length_613_cov_12.883268	155	235	0	35	80	0.4375000
NODE_23665_length_613_cov_12.883268	155	235	4	45	80	0.5625000
NODE_23665_length_613_cov_12.883268	208	288	0	80	80	1.0000000
NODE_23674_length_613_cov_3.857977	167	247	0	33	80	0.4125000
NODE_23674_length_613_cov_3.857977	167	247	2	30	80	0.3750000
NODE_23674_length_613_cov_3.857977	167	247	4	17	80	0.2125000
NODE_23674_length_613_cov_3.857977	220	300	2	80	80	1.0000000
NODE_23771_length_612_cov_24.023392	173	253	0	80	80	1.0000000
NODE_23771_length_612_cov_24.023392	226	306	0	80	80	1.0000000
NODE_23772_length_612_cov_23.846004	141	221	6	8	80	0.1000000
NODE_23772_length_612_cov_23.846004	141	221	8	38	80	0.4750000
NODE_23772_length_612_cov_23.846004	141	221	10	34	80	0.4250000
NODE_23772_length_612_cov_23.846004	194	274	0	11	80	0.1375000
NODE_23772_length_612_cov_23.846004	194	274	1	1	80	0.0125000
NODE_23772_length_612_cov_23.846004	194	274	3	18	80	0.2250000
NODE_23772_length_612_cov_23.846004	194	274	4	16	80	0.2000000
NODE_23772_length_612_cov_23.846004	194	274	8	34	80	0.4250000
NODE_23773_length_612_cov_12.448343	244	324	0	80	80	1.0000000
NODE_23773_length_612_cov_12.448343	297	377	0	80	80	1.0000000
NODE_23774_length_612_cov_12.068226	267	347	0	80	80	1.0000000
NODE_23774_length_612_cov_12.068226	320	400	0	80	80	1.0000000
NODE_23779_length_612_cov_6.393762	242	322	2	5	80	0.0625000
NODE_23779_length_612_cov_6.393762	242	322	6	75	80	0.9375000
NODE_23779_length_612_cov_6.393762	295	375	0	15	80	0.1875000
NODE_23779_length_612_cov_6.393762	295	375	4	25	80	0.3125000
NODE_23779_length_612_cov_6.393762	295	375	6	40	80	0.5000000
NODE_23814_length_612_cov_1.904483	288	354	0	66	66	1.0000000
NODE_23869_length_611_cov_38.705078	132	212	0	18	80	0.2250000
NODE_23869_length_611_cov_38.705078	132	212	2	62	80	0.7750000
NODE_23869_length_611_cov_38.705078	185	262	0	68	77	0.8831169
NODE_23869_length_611_cov_38.705078	185	262	2	9	77	0.1168831
NODE_23869_length_611_cov_38.705078	185	262	0	68	77	0.8831169
NODE_23869_length_611_cov_38.705078	185	262	2	9	77	0.1168831
NODE_23871_length_611_cov_12.669922	264	344	0	41	80	0.5125000
NODE_23871_length_611_cov_12.669922	264	344	2	39	80	0.4875000
NODE_23871_length_611_cov_12.669922	317	397	2	80	80	1.0000000
NODE_23880_length_611_cov_4.943359	27	107	0	1	80	0.0125000
NODE_23880_length_611_cov_4.943359	27	107	2	79	80	0.9875000
NODE_23880_length_611_cov_4.943359	80	137	0	31	57	0.5438597
NODE_23880_length_611_cov_4.943359	80	137	2	26	57	0.4561403
NODE_23880_length_611_cov_4.943359	143	209	0	66	66	1.0000000
NODE_23880_length_611_cov_4.943359	182	262	0	51	80	0.6375000
NODE_23880_length_611_cov_4.943359	182	262	2	8	80	0.1000000
NODE_23880_length_611_cov_4.943359	182	262	4	21	80	0.2625000
NODE_23894_length_611_cov_3.294922	271	300	8	29	29	1.0000000
NODE_23894_length_611_cov_3.294922	434	469	2	35	35	1.0000000
NODE_23897_length_611_cov_3.162109	313	342	0	29	29	1.0000000
NODE_23973_length_610_cov_20.673190	87	167	0	10	80	0.1250000
NODE_23973_length_610_cov_20.673190	87	167	2	17	80	0.2125000
NODE_23973_length_610_cov_20.673190	87	167	4	5	80	0.0625000
NODE_23973_length_610_cov_20.673190	87	167	6	48	80	0.6000000
NODE_23973_length_610_cov_20.673190	140	220	0	27	80	0.3375000
NODE_23973_length_610_cov_20.673190	140	220	6	53	80	0.6625000
NODE_23974_length_610_cov_10.191781	250	330	0	80	80	1.0000000
NODE_23974_length_610_cov_10.191781	303	383	0	69	80	0.8625000
NODE_23974_length_610_cov_10.191781	303	383	2	11	80	0.1375000
NODE_23980_length_610_cov_4.998043	129	181	10	52	52	1.0000000
NODE_23980_length_610_cov_4.998043	182	234	0	5	52	0.0961538
NODE_23980_length_610_cov_4.998043	182	234	6	20	52	0.3846154
NODE_23980_length_610_cov_4.998043	182	234	8	7	52	0.1346154
NODE_23980_length_610_cov_4.998043	182	234	10	20	52	0.3846154
NODE_23989_length_610_cov_3.479452	215	267	0	52	52	1.0000000
NODE_24059_length_609_cov_21.117647	80	160	0	80	80	1.0000000
NODE_24059_length_609_cov_21.117647	133	213	0	80	80	1.0000000
NODE_24060_length_609_cov_11.300000	218	298	0	25	80	0.3125000
NODE_24060_length_609_cov_11.300000	218	298	4	55	80	0.6875000
NODE_24060_length_609_cov_11.300000	271	351	0	13	80	0.1625000
NODE_24060_length_609_cov_11.300000	271	351	4	67	80	0.8375000
NODE_24061_length_609_cov_10.778431	239	319	0	80	80	1.0000000
NODE_24061_length_609_cov_10.778431	292	372	0	80	80	1.0000000
NODE_24062_length_609_cov_10.298039	340	420	0	47	80	0.5875000
NODE_24062_length_609_cov_10.298039	340	420	2	33	80	0.4125000
NODE_24062_length_609_cov_10.298039	393	473	2	80	80	1.0000000
NODE_24062_length_609_cov_10.298039	469	537	0	63	68	0.9264706
NODE_24062_length_609_cov_10.298039	469	537	2	5	68	0.0735294
NODE_24063_length_609_cov_10.270588	217	297	0	2	80	0.0250000
NODE_24063_length_609_cov_10.270588	217	297	7	8	80	0.1000000
NODE_24063_length_609_cov_10.270588	217	297	11	4	80	0.0500000
NODE_24063_length_609_cov_10.270588	217	297	18	3	80	0.0375000
NODE_24063_length_609_cov_10.270588	217	297	28	63	80	0.7875000
NODE_24063_length_609_cov_10.270588	270	353	14	28	83	0.3373494
NODE_24063_length_609_cov_10.270588	270	353	22	11	83	0.1325301
NODE_24063_length_609_cov_10.270588	270	353	23	1	83	0.0120482
NODE_24063_length_609_cov_10.270588	270	353	27	4	83	0.0481928
NODE_24063_length_609_cov_10.270588	270	353	28	39	83	0.4698795
NODE_24064_length_609_cov_8.345098	408	488	0	16	80	0.2000000
NODE_24064_length_609_cov_8.345098	408	488	2	64	80	0.8000000
NODE_24064_length_609_cov_8.345098	461	515	0	37	54	0.6851852
NODE_24064_length_609_cov_8.345098	461	515	2	17	54	0.3148148
NODE_24064_length_609_cov_8.345098	537	566	0	29	29	1.0000000
NODE_24066_length_609_cov_6.054902	219	299	0	80	80	1.0000000
NODE_24066_length_609_cov_6.054902	272	352	0	56	80	0.7000000
NODE_24066_length_609_cov_6.054902	272	352	2	24	80	0.3000000
NODE_24067_length_609_cov_5.986275	219	299	0	80	80	1.0000000
NODE_24067_length_609_cov_5.986275	272	352	0	80	80	1.0000000
NODE_24160_length_608_cov_76.257367	300	380	0	26	80	0.3250000
NODE_24160_length_608_cov_76.257367	300	380	2	10	80	0.1250000
NODE_24160_length_608_cov_76.257367	300	380	6	44	80	0.5500000
NODE_24160_length_608_cov_76.257367	353	433	4	20	80	0.2500000
NODE_24160_length_608_cov_76.257367	353	433	6	60	80	0.7500000
NODE_24161_length_608_cov_13.271120	252	332	2	80	80	1.0000000
NODE_24161_length_608_cov_13.271120	305	385	0	47	80	0.5875000
NODE_24161_length_608_cov_13.271120	305	385	2	33	80	0.4125000
NODE_24162_length_608_cov_11.583497	63	139	0	62	76	0.8157895
NODE_24162_length_608_cov_11.583497	63	139	2	14	76	0.1842105
NODE_24162_length_608_cov_11.583497	112	192	0	13	80	0.1625000
NODE_24162_length_608_cov_11.583497	112	192	2	41	80	0.5125000
NODE_24162_length_608_cov_11.583497	112	192	4	26	80	0.3250000
NODE_24164_length_608_cov_8.076621	53	133	78	2	80	0.0250000
NODE_24164_length_608_cov_8.076621	53	133	82	2	80	0.0250000
NODE_24164_length_608_cov_8.076621	53	133	86	1	80	0.0125000
NODE_24164_length_608_cov_8.076621	53	133	90	1	80	0.0125000
NODE_24164_length_608_cov_8.076621	53	133	92	2	80	0.0250000
NODE_24164_length_608_cov_8.076621	53	133	98	2	80	0.0250000
NODE_24164_length_608_cov_8.076621	53	133	100	1	80	0.0125000
NODE_24164_length_608_cov_8.076621	53	133	102	1	80	0.0125000
NODE_24164_length_608_cov_8.076621	53	133	114	2	80	0.0250000
NODE_24164_length_608_cov_8.076621	53	133	116	2	80	0.0250000
NODE_24164_length_608_cov_8.076621	53	133	118	13	80	0.1625000
NODE_24164_length_608_cov_8.076621	53	133	122	1	80	0.0125000
NODE_24164_length_608_cov_8.076621	53	133	124	7	80	0.0875000
NODE_24164_length_608_cov_8.076621	53	133	125	2	80	0.0250000
NODE_24164_length_608_cov_8.076621	53	133	128	5	80	0.0625000
NODE_24164_length_608_cov_8.076621	53	133	129	2	80	0.0250000
NODE_24164_length_608_cov_8.076621	53	133	130	1	80	0.0125000
NODE_24164_length_608_cov_8.076621	53	133	132	10	80	0.1250000
NODE_24164_length_608_cov_8.076621	53	133	134	13	80	0.1625000
NODE_24164_length_608_cov_8.076621	53	133	136	5	80	0.0625000
NODE_24164_length_608_cov_8.076621	53	133	138	5	80	0.0625000
NODE_24164_length_608_cov_8.076621	106	186	1	1	80	0.0125000
NODE_24164_length_608_cov_8.076621	106	186	3	2	80	0.0250000
NODE_24164_length_608_cov_8.076621	106	186	5	7	80	0.0875000
NODE_24164_length_608_cov_8.076621	106	186	7	10	80	0.1250000
NODE_24164_length_608_cov_8.076621	106	186	8	4	80	0.0500000
NODE_24164_length_608_cov_8.076621	106	186	9	2	80	0.0250000
NODE_24164_length_608_cov_8.076621	106	186	16	1	80	0.0125000
NODE_24164_length_608_cov_8.076621	106	186	18	1	80	0.0125000
NODE_24164_length_608_cov_8.076621	106	186	28	1	80	0.0125000
NODE_24164_length_608_cov_8.076621	106	186	30	3	80	0.0375000
NODE_24164_length_608_cov_8.076621	106	186	32	3	80	0.0375000
NODE_24164_length_608_cov_8.076621	106	186	34	1	80	0.0125000
NODE_24164_length_608_cov_8.076621	106	186	40	1	80	0.0125000
NODE_24164_length_608_cov_8.076621	106	186	52	1	80	0.0125000
NODE_24164_length_608_cov_8.076621	106	186	56	1	80	0.0125000
NODE_24164_length_608_cov_8.076621	106	186	58	1	80	0.0125000
NODE_24164_length_608_cov_8.076621	106	186	62	2	80	0.0250000
NODE_24164_length_608_cov_8.076621	106	186	66	3	80	0.0375000
NODE_24164_length_608_cov_8.076621	106	186	68	1	80	0.0125000
NODE_24164_length_608_cov_8.076621	106	186	72	1	80	0.0125000
NODE_24164_length_608_cov_8.076621	106	186	74	1	80	0.0125000
NODE_24164_length_608_cov_8.076621	106	186	78	5	80	0.0625000
NODE_24164_length_608_cov_8.076621	106	186	80	2	80	0.0250000
NODE_24164_length_608_cov_8.076621	106	186	82	2	80	0.0250000
NODE_24164_length_608_cov_8.076621	106	186	86	1	80	0.0125000
NODE_24164_length_608_cov_8.076621	106	186	90	1	80	0.0125000
NODE_24164_length_608_cov_8.076621	106	186	92	2	80	0.0250000
NODE_24164_length_608_cov_8.076621	106	186	98	2	80	0.0250000
NODE_24164_length_608_cov_8.076621	106	186	100	1	80	0.0125000
NODE_24164_length_608_cov_8.076621	106	186	102	1	80	0.0125000
NODE_24164_length_608_cov_8.076621	106	186	114	2	80	0.0250000
NODE_24164_length_608_cov_8.076621	106	186	116	2	80	0.0250000
NODE_24164_length_608_cov_8.076621	106	186	118	11	80	0.1375000
NODE_24165_length_608_cov_7.994106	279	326	0	47	47	1.0000000
NODE_24165_length_608_cov_7.994106	348	373	0	25	25	1.0000000
NODE_24166_length_608_cov_7.939096	247	277	8	30	30	1.0000000
NODE_24177_length_608_cov_3.829077	313	393	0	80	80	1.0000000
NODE_24177_length_608_cov_3.829077	366	446	0	42	80	0.5250000
NODE_24177_length_608_cov_3.829077	366	446	2	1	80	0.0125000
NODE_24177_length_608_cov_3.829077	366	446	3	37	80	0.4625000
NODE_24251_length_608_cov_1.064833	472	512	3	24	40	0.6000000
NODE_24251_length_608_cov_1.064833	472	512	4	16	40	0.4000000
NODE_24281_length_607_cov_61.316929	347	427	6	32	80	0.4000000
NODE_24281_length_607_cov_61.316929	347	427	8	22	80	0.2750000
NODE_24281_length_607_cov_61.316929	347	427	10	1	80	0.0125000
NODE_24281_length_607_cov_61.316929	347	427	12	2	80	0.0250000
NODE_24281_length_607_cov_61.316929	347	427	18	23	80	0.2875000
NODE_24281_length_607_cov_61.316929	347	427	6	32	80	0.4000000
NODE_24281_length_607_cov_61.316929	347	427	8	22	80	0.2750000
NODE_24281_length_607_cov_61.316929	347	427	10	1	80	0.0125000
NODE_24281_length_607_cov_61.316929	347	427	12	2	80	0.0250000
NODE_24281_length_607_cov_61.316929	347	427	18	23	80	0.2875000
NODE_24281_length_607_cov_61.316929	347	427	6	32	80	0.4000000
NODE_24281_length_607_cov_61.316929	347	427	8	22	80	0.2750000
NODE_24281_length_607_cov_61.316929	347	427	10	1	80	0.0125000
NODE_24281_length_607_cov_61.316929	347	427	12	2	80	0.0250000
NODE_24281_length_607_cov_61.316929	347	427	18	23	80	0.2875000
NODE_24281_length_607_cov_61.316929	364	427	6	15	63	0.2380952
NODE_24281_length_607_cov_61.316929	364	427	8	22	63	0.3492064
NODE_24281_length_607_cov_61.316929	364	427	10	1	63	0.0158730
NODE_24281_length_607_cov_61.316929	364	427	12	2	63	0.0317460
NODE_24281_length_607_cov_61.316929	364	427	18	23	63	0.3650794
NODE_24281_length_607_cov_61.316929	400	480	8	5	80	0.0625000
NODE_24281_length_607_cov_61.316929	400	480	10	1	80	0.0125000
NODE_24281_length_607_cov_61.316929	400	480	12	5	80	0.0625000
NODE_24281_length_607_cov_61.316929	400	480	16	6	80	0.0750000
NODE_24281_length_607_cov_61.316929	400	480	18	63	80	0.7875000
NODE_24281_length_607_cov_61.316929	400	480	8	5	80	0.0625000
NODE_24281_length_607_cov_61.316929	400	480	10	1	80	0.0125000
NODE_24281_length_607_cov_61.316929	400	480	12	5	80	0.0625000
NODE_24281_length_607_cov_61.316929	400	480	16	6	80	0.0750000
NODE_24281_length_607_cov_61.316929	400	480	18	63	80	0.7875000
NODE_24281_length_607_cov_61.316929	400	480	8	5	80	0.0625000
NODE_24281_length_607_cov_61.316929	400	480	10	1	80	0.0125000
NODE_24281_length_607_cov_61.316929	400	480	12	5	80	0.0625000
NODE_24281_length_607_cov_61.316929	400	480	16	6	80	0.0750000
NODE_24281_length_607_cov_61.316929	400	480	18	63	80	0.7875000
NODE_24281_length_607_cov_61.316929	400	480	8	5	80	0.0625000
NODE_24281_length_607_cov_61.316929	400	480	10	1	80	0.0125000
NODE_24281_length_607_cov_61.316929	400	480	12	5	80	0.0625000
NODE_24281_length_607_cov_61.316929	400	480	16	6	80	0.0750000
NODE_24281_length_607_cov_61.316929	400	480	18	63	80	0.7875000
NODE_24281_length_607_cov_61.316929	476	556	0	47	80	0.5875000
NODE_24281_length_607_cov_61.316929	476	556	8	33	80	0.4125000
NODE_24281_length_607_cov_61.316929	476	556	0	47	80	0.5875000
NODE_24281_length_607_cov_61.316929	476	556	8	33	80	0.4125000
NODE_24281_length_607_cov_61.316929	476	556	0	47	80	0.5875000
NODE_24281_length_607_cov_61.316929	476	556	8	33	80	0.4125000
NODE_24281_length_607_cov_61.316929	529	595	0	66	66	1.0000000
NODE_24281_length_607_cov_61.316929	529	607	0	78	78	1.0000000
NODE_24281_length_607_cov_61.316929	529	600	0	71	71	1.0000000
NODE_24281_length_607_cov_61.316929	534	607	0	73	73	1.0000000
NODE_24282_length_607_cov_16.852362	383	463	0	54	80	0.6750000
NODE_24282_length_607_cov_16.852362	383	463	1	26	80	0.3250000
NODE_24282_length_607_cov_16.852362	436	516	0	1	80	0.0125000
NODE_24282_length_607_cov_16.852362	436	516	1	79	80	0.9875000
NODE_24283_length_607_cov_12.889764	67	147	0	80	80	1.0000000
NODE_24283_length_607_cov_12.889764	120	200	0	80	80	1.0000000
NODE_24284_length_607_cov_11.023622	122	202	0	80	80	1.0000000
NODE_24284_length_607_cov_11.023622	175	255	0	80	80	1.0000000
NODE_24285_length_607_cov_10.690945	199	279	0	80	80	1.0000000
NODE_24285_length_607_cov_10.690945	252	332	0	80	80	1.0000000
NODE_24290_length_607_cov_5.818898	301	386	0	85	85	1.0000000
NODE_24291_length_607_cov_5.771654	278	358	0	9	80	0.1125000
NODE_24291_length_607_cov_5.771654	278	358	2	70	80	0.8750000
NODE_24291_length_607_cov_5.771654	278	358	6	1	80	0.0125000
NODE_24291_length_607_cov_5.771654	331	411	0	9	80	0.1125000
NODE_24291_length_607_cov_5.771654	331	411	2	17	80	0.2125000
NODE_24291_length_607_cov_5.771654	331	411	6	54	80	0.6750000
NODE_24295_length_607_cov_4.816929	282	362	6	52	80	0.6500000
NODE_24295_length_607_cov_4.816929	282	362	8	28	80	0.3500000
NODE_24295_length_607_cov_4.816929	335	415	0	1	80	0.0125000
NODE_24295_length_607_cov_4.816929	335	415	2	24	80	0.3000000
NODE_24295_length_607_cov_4.816929	335	415	6	37	80	0.4625000
NODE_24295_length_607_cov_4.816929	335	415	8	18	80	0.2250000
NODE_24300_length_607_cov_4.015748	295	354	0	59	59	1.0000000
NODE_24310_length_607_cov_3.088583	107	158	2	51	51	1.0000000
NODE_24331_length_607_cov_1.791339	204	247	4	43	43	1.0000000
NODE_24400_length_606_cov_42.264300	182	262	0	70	80	0.8750000
NODE_24400_length_606_cov_42.264300	182	262	2	7	80	0.0875000
NODE_24400_length_606_cov_42.264300	182	262	4	3	80	0.0375000
NODE_24400_length_606_cov_42.264300	235	315	0	17	80	0.2125000
NODE_24400_length_606_cov_42.264300	235	315	2	7	80	0.0875000
NODE_24400_length_606_cov_42.264300	235	315	4	56	80	0.7000000
NODE_24402_length_606_cov_26.341223	371	451	0	80	80	1.0000000
NODE_24402_length_606_cov_26.341223	424	504	0	80	80	1.0000000
NODE_24403_length_606_cov_14.895464	308	388	0	32	80	0.4000000
NODE_24403_length_606_cov_14.895464	308	388	2	27	80	0.3375000
NODE_24403_length_606_cov_14.895464	308	388	3	21	80	0.2625000
NODE_24403_length_606_cov_14.895464	361	441	0	80	80	1.0000000
NODE_24406_length_606_cov_7.934911	412	492	0	80	80	1.0000000
NODE_24406_length_606_cov_7.934911	465	545	0	80	80	1.0000000
NODE_24407_length_606_cov_7.481262	250	330	6	1	80	0.0125000
NODE_24407_length_606_cov_7.481262	250	330	8	79	80	0.9875000
NODE_24407_length_606_cov_7.481262	303	383	0	9	80	0.1125000
NODE_24407_length_606_cov_7.481262	303	383	2	6	80	0.0750000
NODE_24407_length_606_cov_7.481262	303	383	4	5	80	0.0625000
NODE_24407_length_606_cov_7.481262	303	383	6	6	80	0.0750000
NODE_24407_length_606_cov_7.481262	303	383	7	1	80	0.0125000
NODE_24407_length_606_cov_7.481262	303	383	8	40	80	0.5000000
NODE_24407_length_606_cov_7.481262	303	383	10	6	80	0.0750000
NODE_24407_length_606_cov_7.481262	303	383	14	6	80	0.0750000
NODE_24407_length_606_cov_7.481262	303	383	16	1	80	0.0125000
NODE_24409_length_606_cov_6.842209	139	219	0	80	80	1.0000000
NODE_24409_length_606_cov_6.842209	192	272	0	80	80	1.0000000
NODE_24428_length_606_cov_3.384615	156	206	0	10	50	0.2000000
NODE_24428_length_606_cov_3.384615	156	206	6	40	50	0.8000000
NODE_24433_length_606_cov_2.670611	113	193	4	31	80	0.3875000
NODE_24433_length_606_cov_2.670611	113	193	5	1	80	0.0125000
NODE_24433_length_606_cov_2.670611	113	193	6	48	80	0.6000000
NODE_24525_length_605_cov_63.343874	7	83	2	4	76	0.0526316
NODE_24525_length_605_cov_63.343874	7	83	4	72	76	0.9473684
NODE_24525_length_605_cov_63.343874	12	83	4	71	71	1.0000000
NODE_24525_length_605_cov_63.343874	17	83	4	66	66	1.0000000
NODE_24525_length_605_cov_63.343874	56	136	3	5	80	0.0625000
NODE_24525_length_605_cov_63.343874	56	136	4	53	80	0.6625000
NODE_24525_length_605_cov_63.343874	56	136	6	19	80	0.2375000
NODE_24525_length_605_cov_63.343874	56	136	7	3	80	0.0375000
NODE_24525_length_605_cov_63.343874	56	136	3	5	80	0.0625000
NODE_24525_length_605_cov_63.343874	56	136	4	53	80	0.6625000
NODE_24525_length_605_cov_63.343874	56	136	6	19	80	0.2375000
NODE_24525_length_605_cov_63.343874	56	136	7	3	80	0.0375000
NODE_24525_length_605_cov_63.343874	56	136	3	5	80	0.0625000
NODE_24525_length_605_cov_63.343874	56	136	4	53	80	0.6625000
NODE_24525_length_605_cov_63.343874	56	136	6	19	80	0.2375000
NODE_24525_length_605_cov_63.343874	56	136	7	3	80	0.0375000
NODE_24525_length_605_cov_63.343874	132	212	6	50	80	0.6250000
NODE_24525_length_605_cov_63.343874	132	212	8	30	80	0.3750000
NODE_24525_length_605_cov_63.343874	132	212	6	50	80	0.6250000
NODE_24525_length_605_cov_63.343874	132	212	8	30	80	0.3750000
NODE_24525_length_605_cov_63.343874	132	210	6	50	78	0.6410257
NODE_24525_length_605_cov_63.343874	132	210	8	28	78	0.3589744
NODE_24525_length_605_cov_63.343874	132	212	6	50	80	0.6250000
NODE_24525_length_605_cov_63.343874	132	212	8	30	80	0.3750000
NODE_24525_length_605_cov_63.343874	132	212	6	50	80	0.6250000
NODE_24525_length_605_cov_63.343874	132	212	8	30	80	0.3750000
NODE_24525_length_605_cov_63.343874	185	265	5	9	80	0.1125000
NODE_24525_length_605_cov_63.343874	185	265	7	1	80	0.0125000
NODE_24525_length_605_cov_63.343874	185	265	8	70	80	0.8750000
NODE_24526_length_605_cov_48.191700	298	374	0	76	76	1.0000000
NODE_24526_length_605_cov_48.191700	347	427	0	80	80	1.0000000
NODE_24528_length_605_cov_33.328063	57	137	205	1	80	0.0125000
NODE_24528_length_605_cov_33.328063	57	137	206	1	80	0.0125000
NODE_24528_length_605_cov_33.328063	57	137	214	2	80	0.0250000
NODE_24528_length_605_cov_33.328063	57	137	216	1	80	0.0125000
NODE_24528_length_605_cov_33.328063	57	137	218	4	80	0.0500000
NODE_24528_length_605_cov_33.328063	57	137	221	1	80	0.0125000
NODE_24528_length_605_cov_33.328063	57	137	225	1	80	0.0125000
NODE_24528_length_605_cov_33.328063	57	137	229	1	80	0.0125000
NODE_24528_length_605_cov_33.328063	57	137	231	2	80	0.0250000
NODE_24528_length_605_cov_33.328063	57	137	237	1	80	0.0125000
NODE_24528_length_605_cov_33.328063	57	137	241	1	80	0.0125000
NODE_24528_length_605_cov_33.328063	57	137	247	1	80	0.0125000
NODE_24528_length_605_cov_33.328063	57	137	253	1	80	0.0125000
NODE_24528_length_605_cov_33.328063	57	137	257	1	80	0.0125000
NODE_24528_length_605_cov_33.328063	57	137	261	4	80	0.0500000
NODE_24528_length_605_cov_33.328063	57	137	265	1	80	0.0125000
NODE_24528_length_605_cov_33.328063	57	137	269	1	80	0.0125000
NODE_24528_length_605_cov_33.328063	57	137	271	3	80	0.0375000
NODE_24528_length_605_cov_33.328063	57	137	275	2	80	0.0250000
NODE_24528_length_605_cov_33.328063	57	137	279	2	80	0.0250000
NODE_24528_length_605_cov_33.328063	57	137	290	1	80	0.0125000
NODE_24528_length_605_cov_33.328063	57	137	292	1	80	0.0125000
NODE_24528_length_605_cov_33.328063	57	137	294	1	80	0.0125000
NODE_24528_length_605_cov_33.328063	57	137	298	1	80	0.0125000
NODE_24528_length_605_cov_33.328063	57	137	307	1	80	0.0125000
NODE_24528_length_605_cov_33.328063	57	137	308	1	80	0.0125000
NODE_24528_length_605_cov_33.328063	57	137	310	1	80	0.0125000
NODE_24528_length_605_cov_33.328063	57	137	311	1	80	0.0125000
NODE_24528_length_605_cov_33.328063	57	137	312	3	80	0.0375000
NODE_24528_length_605_cov_33.328063	57	137	313	3	80	0.0375000
NODE_24528_length_605_cov_33.328063	57	137	314	1	80	0.0125000
NODE_24528_length_605_cov_33.328063	57	137	316	1	80	0.0125000
NODE_24528_length_605_cov_33.328063	57	137	318	1	80	0.0125000
NODE_24528_length_605_cov_33.328063	57	137	331	1	80	0.0125000
NODE_24528_length_605_cov_33.328063	57	137	344	1	80	0.0125000
NODE_24528_length_605_cov_33.328063	57	137	347	1	80	0.0125000
NODE_24528_length_605_cov_33.328063	57	137	348	1	80	0.0125000
NODE_24528_length_605_cov_33.328063	57	137	351	1	80	0.0125000
NODE_24528_length_605_cov_33.328063	57	137	352	1	80	0.0125000
NODE_24528_length_605_cov_33.328063	57	137	356	1	80	0.0125000
NODE_24528_length_605_cov_33.328063	57	137	359	1	80	0.0125000
NODE_24528_length_605_cov_33.328063	57	137	360	2	80	0.0250000
NODE_24528_length_605_cov_33.328063	57	137	361	1	80	0.0125000
NODE_24528_length_605_cov_33.328063	57	137	364	1	80	0.0125000
NODE_24528_length_605_cov_33.328063	57	137	365	2	80	0.0250000
NODE_24528_length_605_cov_33.328063	57	137	366	1	80	0.0125000
NODE_24528_length_605_cov_33.328063	57	137	371	1	80	0.0125000
NODE_24528_length_605_cov_33.328063	57	137	372	3	80	0.0375000
NODE_24528_length_605_cov_33.328063	57	137	373	1	80	0.0125000
NODE_24528_length_605_cov_33.328063	57	137	374	2	80	0.0250000
NODE_24528_length_605_cov_33.328063	57	137	375	4	80	0.0500000
NODE_24528_length_605_cov_33.328063	57	137	376	2	80	0.0250000
NODE_24528_length_605_cov_33.328063	57	137	377	1	80	0.0125000
NODE_24528_length_605_cov_33.328063	57	137	379	1	80	0.0125000
NODE_24528_length_605_cov_33.328063	57	137	382	1	80	0.0125000
NODE_24528_length_605_cov_33.328063	140	175	457	1	35	0.0285714
NODE_24528_length_605_cov_33.328063	140	175	466	1	35	0.0285714
NODE_24528_length_605_cov_33.328063	140	175	468	1	35	0.0285714
NODE_24528_length_605_cov_33.328063	140	175	473	1	35	0.0285714
NODE_24528_length_605_cov_33.328063	140	175	474	2	35	0.0571429
NODE_24528_length_605_cov_33.328063	140	175	475	1	35	0.0285714
NODE_24528_length_605_cov_33.328063	140	175	476	1	35	0.0285714
NODE_24528_length_605_cov_33.328063	140	175	481	1	35	0.0285714
NODE_24528_length_605_cov_33.328063	140	175	489	2	35	0.0571429
NODE_24528_length_605_cov_33.328063	140	175	496	1	35	0.0285714
NODE_24528_length_605_cov_33.328063	140	175	497	1	35	0.0285714
NODE_24528_length_605_cov_33.328063	140	175	514	1	35	0.0285714
NODE_24528_length_605_cov_33.328063	140	175	537	1	35	0.0285714
NODE_24528_length_605_cov_33.328063	140	175	542	1	35	0.0285714
NODE_24528_length_605_cov_33.328063	140	175	546	1	35	0.0285714
NODE_24528_length_605_cov_33.328063	140	175	550	1	35	0.0285714
NODE_24528_length_605_cov_33.328063	140	175	558	1	35	0.0285714
NODE_24528_length_605_cov_33.328063	140	175	567	1	35	0.0285714
NODE_24528_length_605_cov_33.328063	140	175	568	1	35	0.0285714
NODE_24528_length_605_cov_33.328063	140	175	569	1	35	0.0285714
NODE_24528_length_605_cov_33.328063	140	175	571	1	35	0.0285714
NODE_24528_length_605_cov_33.328063	140	175	580	3	35	0.0857143
NODE_24528_length_605_cov_33.328063	140	175	586	1	35	0.0285714
NODE_24528_length_605_cov_33.328063	140	175	596	1	35	0.0285714
NODE_24528_length_605_cov_33.328063	140	175	600	1	35	0.0285714
NODE_24528_length_605_cov_33.328063	140	175	607	2	35	0.0571429
NODE_24528_length_605_cov_33.328063	140	175	608	2	35	0.0571429
NODE_24528_length_605_cov_33.328063	140	175	609	1	35	0.0285714
NODE_24528_length_605_cov_33.328063	140	175	623	1	35	0.0285714
NODE_24529_length_605_cov_26.717391	353	433	0	80	80	1.0000000
NODE_24529_length_605_cov_26.717391	406	486	0	80	80	1.0000000
NODE_24530_length_605_cov_17.677866	215	295	0	80	80	1.0000000
NODE_24530_length_605_cov_17.677866	268	348	0	80	80	1.0000000
NODE_24531_length_605_cov_15.225296	144	224	2	11	80	0.1375000
NODE_24531_length_605_cov_15.225296	144	224	3	69	80	0.8625000
NODE_24531_length_605_cov_15.225296	197	277	0	19	80	0.2375000
NODE_24531_length_605_cov_15.225296	197	277	3	61	80	0.7625000
NODE_24532_length_605_cov_14.990119	136	216	0	80	80	1.0000000
NODE_24532_length_605_cov_14.990119	189	269	0	80	80	1.0000000
NODE_24533_length_605_cov_10.835968	103	183	0	33	80	0.4125000
NODE_24533_length_605_cov_10.835968	103	183	2	47	80	0.5875000
NODE_24533_length_605_cov_10.835968	156	236	2	80	80	1.0000000
NODE_24534_length_605_cov_9.169960	306	377	4	3	71	0.0422535
NODE_24534_length_605_cov_9.169960	306	377	6	17	71	0.2394366
NODE_24534_length_605_cov_9.169960	306	377	8	20	71	0.2816902
NODE_24534_length_605_cov_9.169960	306	377	10	19	71	0.2676056
NODE_24534_length_605_cov_9.169960	306	377	12	12	71	0.1690141
NODE_24534_length_605_cov_9.169960	359	432	0	11	73	0.1506849
NODE_24534_length_605_cov_9.169960	359	432	2	3	73	0.0410959
NODE_24534_length_605_cov_9.169960	359	432	6	38	73	0.5205479
NODE_24534_length_605_cov_9.169960	359	432	8	18	73	0.2465753
NODE_24534_length_605_cov_9.169960	359	432	10	3	73	0.0410959
NODE_24546_length_605_cov_4.308300	159	239	2	80	80	1.0000000
NODE_24546_length_605_cov_4.308300	271	338	12	7	67	0.1044776
NODE_24546_length_605_cov_4.308300	271	338	14	6	67	0.0895522
NODE_24546_length_605_cov_4.308300	271	338	16	1	67	0.0149254
NODE_24546_length_605_cov_4.308300	271	338	18	14	67	0.2089552
NODE_24546_length_605_cov_4.308300	271	338	20	2	67	0.0298507
NODE_24546_length_605_cov_4.308300	271	338	22	37	67	0.5522388
NODE_24546_length_605_cov_4.308300	275	350	12	3	75	0.0400000
NODE_24546_length_605_cov_4.308300	275	350	14	6	75	0.0800000
NODE_24546_length_605_cov_4.308300	275	350	16	1	75	0.0133333
NODE_24546_length_605_cov_4.308300	275	350	18	22	75	0.2933333
NODE_24546_length_605_cov_4.308300	275	350	20	6	75	0.0800000
NODE_24546_length_605_cov_4.308300	275	350	22	37	75	0.4933333
NODE_24546_length_605_cov_4.308300	315	372	8	3	57	0.0526316
NODE_24546_length_605_cov_4.308300	315	372	12	6	57	0.1052632
NODE_24546_length_605_cov_4.308300	315	372	14	4	57	0.0701754
NODE_24546_length_605_cov_4.308300	315	372	16	1	57	0.0175439
NODE_24546_length_605_cov_4.308300	315	372	18	25	57	0.4385965
NODE_24546_length_605_cov_4.308300	315	372	20	5	57	0.0877193
NODE_24546_length_605_cov_4.308300	315	372	22	13	57	0.2280702
NODE_24546_length_605_cov_4.308300	328	373	4	1	45	0.0222222
NODE_24546_length_605_cov_4.308300	328	373	8	3	45	0.0666667
NODE_24546_length_605_cov_4.308300	328	373	12	6	45	0.1333333
NODE_24546_length_605_cov_4.308300	328	373	14	4	45	0.0888889
NODE_24546_length_605_cov_4.308300	328	373	16	1	45	0.0222222
NODE_24546_length_605_cov_4.308300	328	373	18	25	45	0.5555556
NODE_24546_length_605_cov_4.308300	328	373	20	5	45	0.1111111
NODE_24558_length_605_cov_3.120553	216	287	11	2	71	0.0281690
NODE_24558_length_605_cov_3.120553	216	287	12	7	71	0.0985916
NODE_24558_length_605_cov_3.120553	216	287	13	7	71	0.0985916
NODE_24558_length_605_cov_3.120553	216	287	18	16	71	0.2253521
NODE_24558_length_605_cov_3.120553	216	287	28	39	71	0.5492958
NODE_24561_length_605_cov_2.909091	408	487	6	44	79	0.5569620
NODE_24561_length_605_cov_2.909091	408	487	8	35	79	0.4430380
NODE_24577_length_605_cov_1.897233	230	273	0	43	43	1.0000000
NODE_24603_length_605_cov_1.339921	168	210	0	42	42	1.0000000
NODE_24636_length_604_cov_30.411881	93	173	0	9	80	0.1125000
NODE_24636_length_604_cov_30.411881	93	173	2	71	80	0.8875000
NODE_24636_length_604_cov_30.411881	146	226	0	62	80	0.7750000
NODE_24636_length_604_cov_30.411881	146	226	2	18	80	0.2250000
NODE_24637_length_604_cov_20.099010	414	494	0	80	80	1.0000000
NODE_24637_length_604_cov_20.099010	467	547	0	80	80	1.0000000
NODE_24639_length_604_cov_10.291089	184	264	0	8	80	0.1000000
NODE_24639_length_604_cov_10.291089	184	264	2	18	80	0.2250000
NODE_24639_length_604_cov_10.291089	184	264	4	54	80	0.6750000
NODE_24639_length_604_cov_10.291089	237	317	2	43	80	0.5375000
NODE_24639_length_604_cov_10.291089	237	317	4	37	80	0.4625000
NODE_24646_length_604_cov_6.033663	265	345	0	2	80	0.0250000
NODE_24646_length_604_cov_6.033663	265	345	1	5	80	0.0625000
NODE_24646_length_604_cov_6.033663	265	345	2	73	80	0.9125000
NODE_24646_length_604_cov_6.033663	318	397	2	27	79	0.3417721
NODE_24646_length_604_cov_6.033663	318	397	6	52	79	0.6582279
NODE_24654_length_604_cov_4.316832	40	106	0	66	66	1.0000000
NODE_24654_length_604_cov_4.316832	377	435	0	57	58	0.9827586
NODE_24654_length_604_cov_4.316832	377	435	2	1	58	0.0172414
NODE_24692_length_604_cov_1.805941	299	380	0	81	81	1.0000000
NODE_24692_length_604_cov_1.805941	353	433	0	80	80	1.0000000
NODE_24732_length_603_cov_18.761905	108	188	0	80	80	1.0000000
NODE_24732_length_603_cov_18.761905	161	241	0	80	80	1.0000000
NODE_24734_length_603_cov_8.996032	163	243	0	80	80	1.0000000
NODE_24734_length_603_cov_8.996032	216	296	0	80	80	1.0000000
NODE_24735_length_603_cov_8.970238	413	493	0	80	80	1.0000000
NODE_24736_length_603_cov_7.212302	324	404	0	80	80	1.0000000
NODE_24736_length_603_cov_7.212302	377	457	0	80	80	1.0000000
NODE_24739_length_603_cov_5.831349	351	385	0	34	34	1.0000000
NODE_24744_length_603_cov_4.744048	103	183	0	28	80	0.3500000
NODE_24744_length_603_cov_4.744048	103	183	2	52	80	0.6500000
NODE_24744_length_603_cov_4.744048	156	236	2	80	80	1.0000000
NODE_24748_length_603_cov_4.115079	219	259	0	40	40	1.0000000
NODE_24755_length_603_cov_3.269841	186	223	0	37	37	1.0000000
NODE_24755_length_603_cov_3.269841	196	276	0	80	80	1.0000000
NODE_24755_length_603_cov_3.269841	367	441	0	74	74	1.0000000
NODE_24843_length_602_cov_33.208748	106	186	0	24	80	0.3000000
NODE_24843_length_602_cov_33.208748	106	186	2	56	80	0.7000000
NODE_24843_length_602_cov_33.208748	159	239	0	4	80	0.0500000
NODE_24843_length_602_cov_33.208748	159	239	2	76	80	0.9500000
NODE_24844_length_602_cov_28.922465	319	399	0	58	80	0.7250000
NODE_24844_length_602_cov_28.922465	319	399	2	17	80	0.2125000
NODE_24844_length_602_cov_28.922465	319	399	3	5	80	0.0625000
NODE_24844_length_602_cov_28.922465	372	452	0	5	80	0.0625000
NODE_24844_length_602_cov_28.922465	372	452	2	17	80	0.2125000
NODE_24844_length_602_cov_28.922465	372	452	3	20	80	0.2500000
NODE_24844_length_602_cov_28.922465	372	452	5	18	80	0.2250000
NODE_24844_length_602_cov_28.922465	372	452	6	20	80	0.2500000
NODE_24846_length_602_cov_10.930417	248	328	0	80	80	1.0000000
NODE_24846_length_602_cov_10.930417	301	381	0	80	80	1.0000000
NODE_24847_length_602_cov_10.447316	148	207	8	2	59	0.0338983
NODE_24847_length_602_cov_10.447316	148	207	12	13	59	0.2203390
NODE_24847_length_602_cov_10.447316	148	207	14	2	59	0.0338983
NODE_24847_length_602_cov_10.447316	148	207	16	10	59	0.1694915
NODE_24847_length_602_cov_10.447316	148	207	18	1	59	0.0169492
NODE_24847_length_602_cov_10.447316	148	207	19	3	59	0.0508475
NODE_24847_length_602_cov_10.447316	148	207	20	18	59	0.3050847
NODE_24847_length_602_cov_10.447316	148	207	22	10	59	0.1694915
NODE_24847_length_602_cov_10.447316	181	207	8	2	26	0.0769231
NODE_24847_length_602_cov_10.447316	181	207	12	13	26	0.5000000
NODE_24847_length_602_cov_10.447316	181	207	14	2	26	0.0769231
NODE_24847_length_602_cov_10.447316	181	207	16	9	26	0.3461539
NODE_24847_length_602_cov_10.447316	259	291	0	1	32	0.0312500
NODE_24847_length_602_cov_10.447316	259	291	2	5	32	0.1562500
NODE_24847_length_602_cov_10.447316	259	291	4	26	32	0.8125000
NODE_24851_length_602_cov_7.787276	544	565	4	21	21	1.0000000
NODE_24875_length_602_cov_3.332008	157	239	0	22	82	0.2682927
NODE_24875_length_602_cov_3.332008	157	239	2	60	82	0.7317073
NODE_24957_length_601_cov_14.952191	183	263	0	80	80	1.0000000
NODE_24957_length_601_cov_14.952191	236	316	0	80	80	1.0000000
NODE_24958_length_601_cov_14.747012	324	404	0	52	80	0.6500000
NODE_24958_length_601_cov_14.747012	324	404	2	28	80	0.3500000
NODE_24958_length_601_cov_14.747012	377	457	0	12	80	0.1500000
NODE_24958_length_601_cov_14.747012	377	457	2	68	80	0.8500000
NODE_24959_length_601_cov_11.561753	226	306	2	80	80	1.0000000
NODE_24959_length_601_cov_11.561753	279	359	0	47	80	0.5875000
NODE_24959_length_601_cov_11.561753	279	359	2	33	80	0.4125000
NODE_24960_length_601_cov_10.826693	320	388	0	68	68	1.0000000
NODE_24961_length_601_cov_10.392430	243	323	0	50	80	0.6250000
NODE_24961_length_601_cov_10.392430	243	323	2	30	80	0.3750000
NODE_24961_length_601_cov_10.392430	296	375	0	6	79	0.0759494
NODE_24961_length_601_cov_10.392430	296	375	2	73	79	0.9240506
NODE_24965_length_601_cov_7.037849	236	316	0	80	80	1.0000000
NODE_24965_length_601_cov_7.037849	289	369	0	80	80	1.0000000
NODE_24969_length_601_cov_5.798805	290	361	0	71	71	1.0000000
NODE_24970_length_601_cov_5.657371	228	308	0	25	80	0.3125000
NODE_24970_length_601_cov_5.657371	228	308	4	11	80	0.1375000
NODE_24970_length_601_cov_5.657371	228	308	6	44	80	0.5500000
NODE_24973_length_601_cov_5.039841	395	462	0	67	67	1.0000000
NODE_24975_length_601_cov_4.735060	184	247	0	63	63	1.0000000
NODE_24995_length_601_cov_2.599602	371	430	0	59	59	1.0000000
NODE_24995_length_601_cov_2.599602	441	494	0	53	53	1.0000000
NODE_25090_length_600_cov_6.341317	125	147	0	22	22	1.0000000
NODE_25103_length_600_cov_3.754491	142	222	0	13	80	0.1625000
NODE_25103_length_600_cov_3.754491	142	222	4	67	80	0.8375000
NODE_25126_length_600_cov_2.081836	282	328	0	3	46	0.0652174
NODE_25126_length_600_cov_2.081836	282	328	2	43	46	0.9347826
NODE_25141_length_600_cov_1.728543	381	423	0	42	42	1.0000000
NODE_25190_length_599_cov_36.488000	25	105	28	1	80	0.0125000
NODE_25190_length_599_cov_36.488000	25	105	31	14	80	0.1750000
NODE_25190_length_599_cov_36.488000	25	105	35	2	80	0.0250000
NODE_25190_length_599_cov_36.488000	25	105	39	5	80	0.0625000
NODE_25190_length_599_cov_36.488000	25	105	43	4	80	0.0500000
NODE_25190_length_599_cov_36.488000	25	105	45	17	80	0.2125000
NODE_25190_length_599_cov_36.488000	25	105	46	37	80	0.4625000
NODE_25191_length_599_cov_27.870000	255	335	0	36	80	0.4500000
NODE_25191_length_599_cov_27.870000	255	335	2	17	80	0.2125000
NODE_25191_length_599_cov_27.870000	255	335	4	27	80	0.3375000
NODE_25191_length_599_cov_27.870000	308	388	2	4	80	0.0500000
NODE_25191_length_599_cov_27.870000	308	388	4	76	80	0.9500000
NODE_25192_length_599_cov_22.640000	229	309	16	20	80	0.2500000
NODE_25192_length_599_cov_22.640000	229	309	18	60	80	0.7500000
NODE_25192_length_599_cov_22.640000	229	309	16	20	80	0.2500000
NODE_25192_length_599_cov_22.640000	229	309	18	60	80	0.7500000
NODE_25192_length_599_cov_22.640000	229	309	16	20	80	0.2500000
NODE_25192_length_599_cov_22.640000	229	309	18	60	80	0.7500000
NODE_25192_length_599_cov_22.640000	229	309	16	20	80	0.2500000
NODE_25192_length_599_cov_22.640000	229	309	18	60	80	0.7500000
NODE_25192_length_599_cov_22.640000	229	309	16	20	80	0.2500000
NODE_25192_length_599_cov_22.640000	229	309	18	60	80	0.7500000
NODE_25192_length_599_cov_22.640000	282	362	0	2	80	0.0250000
NODE_25192_length_599_cov_22.640000	282	362	14	46	80	0.5750000
NODE_25192_length_599_cov_22.640000	282	362	16	25	80	0.3125000
NODE_25192_length_599_cov_22.640000	282	362	18	7	80	0.0875000
NODE_25192_length_599_cov_22.640000	282	362	0	2	80	0.0250000
NODE_25192_length_599_cov_22.640000	282	362	14	46	80	0.5750000
NODE_25192_length_599_cov_22.640000	282	362	16	25	80	0.3125000
NODE_25192_length_599_cov_22.640000	282	362	18	7	80	0.0875000
NODE_25192_length_599_cov_22.640000	282	353	14	39	71	0.5492958
NODE_25192_length_599_cov_22.640000	282	353	16	25	71	0.3521127
NODE_25192_length_599_cov_22.640000	282	353	18	7	71	0.0985916
NODE_25192_length_599_cov_22.640000	285	355	14	41	70	0.5857143
NODE_25192_length_599_cov_22.640000	285	355	16	25	70	0.3571429
NODE_25192_length_599_cov_22.640000	285	355	18	4	70	0.0571429
NODE_25192_length_599_cov_22.640000	287	362	0	2	75	0.0266667
NODE_25192_length_599_cov_22.640000	287	362	14	46	75	0.6133333
NODE_25192_length_599_cov_22.640000	287	362	16	25	75	0.3333333
NODE_25192_length_599_cov_22.640000	287	362	18	2	75	0.0266667
NODE_25193_length_599_cov_14.618000	279	359	0	54	80	0.6750000
NODE_25193_length_599_cov_14.618000	279	359	2	26	80	0.3250000
NODE_25193_length_599_cov_14.618000	332	412	0	15	80	0.1875000
NODE_25193_length_599_cov_14.618000	332	412	2	65	80	0.8125000
NODE_25195_length_599_cov_10.308000	245	325	0	80	80	1.0000000
NODE_25195_length_599_cov_10.308000	298	378	0	80	80	1.0000000
NODE_25196_length_599_cov_9.224000	160	240	4	20	80	0.2500000
NODE_25196_length_599_cov_9.224000	160	240	6	50	80	0.6250000
NODE_25196_length_599_cov_9.224000	160	240	7	10	80	0.1250000
NODE_25196_length_599_cov_9.224000	213	297	2	49	84	0.5833333
NODE_25196_length_599_cov_9.224000	213	297	4	3	84	0.0357143
NODE_25196_length_599_cov_9.224000	213	297	6	32	84	0.3809524
NODE_25201_length_599_cov_5.536000	58	112	0	54	54	1.0000000
NODE_25208_length_599_cov_3.810000	271	334	0	63	63	1.0000000
NODE_25208_length_599_cov_3.810000	324	390	0	66	66	1.0000000
NODE_25211_length_599_cov_3.598000	238	318	0	70	80	0.8750000
NODE_25211_length_599_cov_3.598000	238	318	2	10	80	0.1250000
NODE_25211_length_599_cov_3.598000	291	371	0	80	80	1.0000000
NODE_25308_length_598_cov_54.450902	264	344	0	80	80	1.0000000
NODE_25308_length_598_cov_54.450902	317	397	0	80	80	1.0000000
NODE_25309_length_598_cov_8.326653	204	284	0	80	80	1.0000000
NODE_25309_length_598_cov_8.326653	257	337	0	80	80	1.0000000
NODE_25316_length_598_cov_5.623246	169	240	1	3	71	0.0422535
NODE_25316_length_598_cov_5.623246	169	240	3	61	71	0.8591549
NODE_25316_length_598_cov_5.623246	169	240	5	2	71	0.0281690
NODE_25316_length_598_cov_5.623246	169	240	7	5	71	0.0704225
NODE_25320_length_598_cov_4.929860	73	153	0	80	80	1.0000000
NODE_25320_length_598_cov_4.929860	126	206	0	80	80	1.0000000
NODE_25421_length_597_cov_15.142570	197	277	2	5	80	0.0625000
NODE_25421_length_597_cov_15.142570	197	277	6	56	80	0.7000000
NODE_25421_length_597_cov_15.142570	197	277	8	19	80	0.2375000
NODE_25421_length_597_cov_15.142570	250	330	2	58	80	0.7250000
NODE_25421_length_597_cov_15.142570	250	330	6	3	80	0.0375000
NODE_25421_length_597_cov_15.142570	250	330	8	19	80	0.2375000
NODE_25422_length_597_cov_12.387550	118	198	0	80	80	1.0000000
NODE_25422_length_597_cov_12.387550	171	251	0	80	80	1.0000000
NODE_25423_length_597_cov_7.016064	213	293	0	80	80	1.0000000
NODE_25423_length_597_cov_7.016064	266	346	0	80	80	1.0000000
NODE_25426_length_597_cov_6.212851	374	449	0	2	75	0.0266667
NODE_25426_length_597_cov_6.212851	374	449	2	73	75	0.9733334
NODE_25434_length_597_cov_4.273092	368	448	0	80	80	1.0000000
NODE_25434_length_597_cov_4.273092	421	507	0	86	86	1.0000000
NODE_25464_length_597_cov_2.162651	92	172	0	18	80	0.2250000
NODE_25464_length_597_cov_2.162651	92	172	2	11	80	0.1375000
NODE_25464_length_597_cov_2.162651	92	172	4	51	80	0.6375000
NODE_25464_length_597_cov_2.162651	145	225	0	23	80	0.2875000
NODE_25464_length_597_cov_2.162651	145	225	2	10	80	0.1250000
NODE_25464_length_597_cov_2.162651	145	225	4	47	80	0.5875000
NODE_25467_length_597_cov_2.096386	440	509	2	69	69	1.0000000
NODE_25469_length_597_cov_1.977912	392	472	2	4	80	0.0500000
NODE_25469_length_597_cov_1.977912	392	472	4	9	80	0.1125000
NODE_25469_length_597_cov_1.977912	392	472	5	1	80	0.0125000
NODE_25469_length_597_cov_1.977912	392	472	6	60	80	0.7500000
NODE_25469_length_597_cov_1.977912	392	472	8	6	80	0.0750000
NODE_25469_length_597_cov_1.977912	437	494	4	6	57	0.1052632
NODE_25469_length_597_cov_1.977912	437	494	6	51	57	0.8947368
NODE_25469_length_597_cov_1.977912	445	525	0	11	80	0.1375000
NODE_25469_length_597_cov_1.977912	445	525	2	10	80	0.1250000
NODE_25469_length_597_cov_1.977912	445	525	4	16	80	0.2000000
NODE_25469_length_597_cov_1.977912	445	525	6	43	80	0.5375000
NODE_25552_length_596_cov_32.293763	221	301	0	17	80	0.2125000
NODE_25552_length_596_cov_32.293763	221	301	2	1	80	0.0125000
NODE_25552_length_596_cov_32.293763	221	301	3	14	80	0.1750000
NODE_25552_length_596_cov_32.293763	221	301	4	48	80	0.6000000
NODE_25552_length_596_cov_32.293763	274	354	0	70	80	0.8750000
NODE_25552_length_596_cov_32.293763	274	354	2	1	80	0.0125000
NODE_25552_length_596_cov_32.293763	274	354	3	9	80	0.1125000
NODE_25552_length_596_cov_32.293763	351	406	0	55	55	1.0000000
NODE_25552_length_596_cov_32.293763	381	459	0	38	78	0.4871795
NODE_25552_length_596_cov_32.293763	381	459	1	7	78	0.0897436
NODE_25552_length_596_cov_32.293763	381	459	2	33	78	0.4230769
NODE_25553_length_596_cov_26.891348	199	279	0	80	80	1.0000000
NODE_25553_length_596_cov_26.891348	252	332	0	80	80	1.0000000
NODE_25554_length_596_cov_17.082495	179	259	0	80	80	1.0000000
NODE_25554_length_596_cov_17.082495	232	312	0	80	80	1.0000000
NODE_25555_length_596_cov_10.372233	354	434	0	80	80	1.0000000
NODE_25555_length_596_cov_10.372233	407	487	0	80	80	1.0000000
NODE_25557_length_596_cov_6.955734	142	222	0	6	80	0.0750000
NODE_25557_length_596_cov_6.955734	142	222	1	14	80	0.1750000
NODE_25557_length_596_cov_6.955734	142	222	2	60	80	0.7500000
NODE_25558_length_596_cov_6.225352	242	322	0	80	80	1.0000000
NODE_25558_length_596_cov_6.225352	308	375	0	67	67	1.0000000
NODE_25567_length_596_cov_4.197183	369	444	0	52	75	0.6933333
NODE_25567_length_596_cov_4.197183	369	444	4	14	75	0.1866667
NODE_25567_length_596_cov_4.197183	369	444	6	9	75	0.1200000
NODE_25593_length_596_cov_2.066398	534	583	0	49	49	1.0000000
NODE_25666_length_595_cov_52.532258	248	328	0	3	80	0.0375000
NODE_25666_length_595_cov_52.532258	248	328	2	1	80	0.0125000
NODE_25666_length_595_cov_52.532258	248	328	4	16	80	0.2000000
NODE_25666_length_595_cov_52.532258	248	328	8	21	80	0.2625000
NODE_25666_length_595_cov_52.532258	248	328	10	39	80	0.4875000
NODE_25666_length_595_cov_52.532258	301	381	2	3	80	0.0375000
NODE_25666_length_595_cov_52.532258	301	381	4	34	80	0.4250000
NODE_25666_length_595_cov_52.532258	301	381	6	7	80	0.0875000
NODE_25666_length_595_cov_52.532258	301	381	10	36	80	0.4500000
NODE_25667_length_595_cov_38.584677	122	202	0	80	80	1.0000000
NODE_25667_length_595_cov_38.584677	175	255	0	80	80	1.0000000
NODE_25669_length_595_cov_10.576613	323	403	0	80	80	1.0000000
NODE_25669_length_595_cov_10.576613	376	456	0	80	80	1.0000000
NODE_25672_length_595_cov_7.917339	342	415	0	73	73	1.0000000
NODE_25672_length_595_cov_7.917339	388	438	0	50	50	1.0000000
NODE_25702_length_595_cov_2.792339	178	258	0	35	80	0.4375000
NODE_25702_length_595_cov_2.792339	178	258	2	45	80	0.5625000
NODE_25702_length_595_cov_2.792339	231	311	0	51	80	0.6375000
NODE_25702_length_595_cov_2.792339	231	311	2	29	80	0.3625000
NODE_25807_length_594_cov_34.157576	283	363	0	15	80	0.1875000
NODE_25807_length_594_cov_34.157576	283	363	2	13	80	0.1625000
NODE_25807_length_594_cov_34.157576	283	363	10	52	80	0.6500000
NODE_25807_length_594_cov_34.157576	336	416	2	27	80	0.3375000
NODE_25807_length_594_cov_34.157576	336	416	10	53	80	0.6625000
NODE_25811_length_594_cov_8.933333	258	338	0	80	80	1.0000000
NODE_25811_length_594_cov_8.933333	311	389	0	78	78	1.0000000
NODE_25815_length_594_cov_5.759596	82	118	0	36	36	1.0000000
NODE_25815_length_594_cov_5.759596	114	194	0	52	80	0.6500000
NODE_25815_length_594_cov_5.759596	114	194	2	11	80	0.1375000
NODE_25815_length_594_cov_5.759596	114	194	3	17	80	0.2125000
NODE_25815_length_594_cov_5.759596	167	242	2	13	75	0.1733333
NODE_25815_length_594_cov_5.759596	167	242	3	26	75	0.3466667
NODE_25815_length_594_cov_5.759596	167	242	4	36	75	0.4800000
NODE_25825_length_594_cov_3.913131	275	355	2	8	80	0.1000000
NODE_25825_length_594_cov_3.913131	275	355	6	37	80	0.4625000
NODE_25825_length_594_cov_3.913131	275	355	8	11	80	0.1375000
NODE_25825_length_594_cov_3.913131	275	355	10	12	80	0.1500000
NODE_25825_length_594_cov_3.913131	275	355	12	12	80	0.1500000
NODE_25844_length_594_cov_2.470707	209	247	2	7	38	0.1842105
NODE_25844_length_594_cov_2.470707	209	247	4	31	38	0.8157895
NODE_25919_length_594_cov_0.698990	33	73	0	40	40	1.0000000
NODE_25928_length_593_cov_124.985830	247	285	46	3	38	0.0789474
NODE_25928_length_593_cov_124.985830	247	285	50	2	38	0.0526316
NODE_25928_length_593_cov_124.985830	247	285	51	2	38	0.0526316
NODE_25928_length_593_cov_124.985830	247	285	52	3	38	0.0789474
NODE_25928_length_593_cov_124.985830	247	285	59	2	38	0.0526316
NODE_25928_length_593_cov_124.985830	247	285	61	2	38	0.0526316
NODE_25928_length_593_cov_124.985830	247	285	64	2	38	0.0526316
NODE_25928_length_593_cov_124.985830	247	285	72	2	38	0.0526316
NODE_25928_length_593_cov_124.985830	247	285	87	1	38	0.0263158
NODE_25928_length_593_cov_124.985830	247	285	90	2	38	0.0526316
NODE_25928_length_593_cov_124.985830	247	285	94	1	38	0.0263158
NODE_25928_length_593_cov_124.985830	247	285	96	2	38	0.0526316
NODE_25928_length_593_cov_124.985830	247	285	97	1	38	0.0263158
NODE_25928_length_593_cov_124.985830	247	285	103	2	38	0.0526316
NODE_25928_length_593_cov_124.985830	247	285	105	1	38	0.0263158
NODE_25928_length_593_cov_124.985830	247	285	108	1	38	0.0263158
NODE_25928_length_593_cov_124.985830	247	285	109	1	38	0.0263158
NODE_25928_length_593_cov_124.985830	247	285	118	1	38	0.0263158
NODE_25928_length_593_cov_124.985830	247	285	121	1	38	0.0263158
NODE_25928_length_593_cov_124.985830	247	285	124	1	38	0.0263158
NODE_25928_length_593_cov_124.985830	247	285	126	3	38	0.0789474
NODE_25928_length_593_cov_124.985830	247	285	137	2	38	0.0526316
NODE_25929_length_593_cov_36.161943	150	230	0	80	80	1.0000000
NODE_25929_length_593_cov_36.161943	203	283	0	80	80	1.0000000
NODE_25930_length_593_cov_14.979757	219	299	0	80	80	1.0000000
NODE_25930_length_593_cov_14.979757	272	352	0	80	80	1.0000000
NODE_25931_length_593_cov_11.018219	324	404	0	4	80	0.0500000
NODE_25931_length_593_cov_11.018219	324	404	2	76	80	0.9500000
NODE_25931_length_593_cov_11.018219	377	457	0	48	80	0.6000000
NODE_25931_length_593_cov_11.018219	377	457	2	32	80	0.4000000
NODE_25946_length_593_cov_3.232794	210	273	2	16	63	0.2539683
NODE_25946_length_593_cov_3.232794	210	273	4	47	63	0.7460318
NODE_25946_length_593_cov_3.232794	263	326	4	55	63	0.8730159
NODE_25946_length_593_cov_3.232794	263	326	6	8	63	0.1269841
NODE_25996_length_593_cov_1.261134	227	249	4	21	22	0.9545454
NODE_25996_length_593_cov_1.261134	227	249	6	1	22	0.0454545
NODE_26033_length_592_cov_18.908722	163	243	0	80	80	1.0000000
NODE_26033_length_592_cov_18.908722	230	296	0	66	66	1.0000000
NODE_26034_length_592_cov_7.531440	232	312	0	17	80	0.2125000
NODE_26034_length_592_cov_7.531440	232	312	2	63	80	0.7875000
NODE_26034_length_592_cov_7.531440	285	361	0	20	76	0.2631579
NODE_26034_length_592_cov_7.531440	285	361	2	56	76	0.7368421
NODE_26035_length_592_cov_7.000000	77	157	0	80	80	1.0000000
NODE_26035_length_592_cov_7.000000	130	210	0	80	80	1.0000000
NODE_26040_length_592_cov_5.036511	270	349	2	6	79	0.0759494
NODE_26040_length_592_cov_5.036511	270	349	6	28	79	0.3544304
NODE_26040_length_592_cov_5.036511	270	349	8	45	79	0.5696203
NODE_26041_length_592_cov_5.024341	205	285	0	14	80	0.1750000
NODE_26041_length_592_cov_5.024341	205	285	2	5	80	0.0625000
NODE_26041_length_592_cov_5.024341	205	285	4	18	80	0.2250000
NODE_26041_length_592_cov_5.024341	205	285	6	19	80	0.2375000
NODE_26041_length_592_cov_5.024341	205	285	8	24	80	0.3000000
NODE_26041_length_592_cov_5.024341	258	309	6	27	51	0.5294118
NODE_26041_length_592_cov_5.024341	258	309	8	24	51	0.4705882
NODE_26062_length_592_cov_2.866126	61	127	0	66	66	1.0000000
NODE_26069_length_592_cov_2.361055	476	526	4	8	50	0.1600000
NODE_26069_length_592_cov_2.361055	476	526	6	3	50	0.0600000
NODE_26069_length_592_cov_2.361055	476	526	8	2	50	0.0400000
NODE_26069_length_592_cov_2.361055	476	526	10	10	50	0.2000000
NODE_26069_length_592_cov_2.361055	476	526	12	27	50	0.5400000
NODE_26142_length_591_cov_11.286585	245	325	0	17	80	0.2125000
NODE_26142_length_591_cov_11.286585	245	325	2	38	80	0.4750000
NODE_26142_length_591_cov_11.286585	245	325	4	25	80	0.3125000
NODE_26142_length_591_cov_11.286585	298	378	0	70	80	0.8750000
NODE_26142_length_591_cov_11.286585	298	378	2	10	80	0.1250000
NODE_26143_length_591_cov_9.432927	241	321	0	80	80	1.0000000
NODE_26143_length_591_cov_9.432927	294	374	0	80	80	1.0000000
NODE_26184_length_591_cov_2.365854	396	476	0	80	80	1.0000000
NODE_26184_length_591_cov_2.365854	449	529	0	80	80	1.0000000
NODE_26272_length_590_cov_29.661914	26	106	0	80	80	1.0000000
NODE_26272_length_590_cov_29.661914	79	159	0	80	80	1.0000000
NODE_26272_length_590_cov_29.661914	155	235	0	80	80	1.0000000
NODE_26272_length_590_cov_29.661914	208	288	0	80	80	1.0000000
NODE_26273_length_590_cov_21.360489	178	258	0	18	80	0.2250000
NODE_26273_length_590_cov_21.360489	178	258	2	62	80	0.7750000
NODE_26273_length_590_cov_21.360489	231	311	0	6	80	0.0750000
NODE_26273_length_590_cov_21.360489	231	311	2	74	80	0.9250000
NODE_26274_length_590_cov_18.395112	161	241	2	26	80	0.3250000
NODE_26274_length_590_cov_18.395112	161	241	4	15	80	0.1875000
NODE_26274_length_590_cov_18.395112	161	241	9	2	80	0.0250000
NODE_26274_length_590_cov_18.395112	161	241	10	37	80	0.4625000
NODE_26274_length_590_cov_18.395112	214	294	0	2	80	0.0250000
NODE_26274_length_590_cov_18.395112	214	294	5	1	80	0.0125000
NODE_26274_length_590_cov_18.395112	214	294	6	19	80	0.2375000
NODE_26274_length_590_cov_18.395112	214	294	8	30	80	0.3750000
NODE_26274_length_590_cov_18.395112	214	294	10	28	80	0.3500000
NODE_26275_length_590_cov_17.376782	238	318	0	80	80	1.0000000
NODE_26275_length_590_cov_17.376782	291	371	0	80	80	1.0000000
NODE_26279_length_590_cov_6.205703	262	333	0	71	71	1.0000000
NODE_26283_length_590_cov_5.319756	224	304	0	30	80	0.3750000
NODE_26283_length_590_cov_5.319756	224	304	2	50	80	0.6250000
NODE_26283_length_590_cov_5.319756	277	357	0	25	80	0.3125000
NODE_26283_length_590_cov_5.319756	277	357	1	7	80	0.0875000
NODE_26283_length_590_cov_5.319756	277	357	2	48	80	0.6000000
NODE_26366_length_590_cov_0.971487	0	32	0	32	32	1.0000000
NODE_26390_length_589_cov_15.810204	384	464	0	17	80	0.2125000
NODE_26390_length_589_cov_15.810204	384	464	2	63	80	0.7875000
NODE_26390_length_589_cov_15.810204	437	517	0	40	80	0.5000000
NODE_26390_length_589_cov_15.810204	437	517	2	40	80	0.5000000
NODE_26391_length_589_cov_13.855102	320	400	0	80	80	1.0000000
NODE_26391_length_589_cov_13.855102	373	453	0	80	80	1.0000000
NODE_26395_length_589_cov_6.297959	186	266	0	80	80	1.0000000
NODE_26395_length_589_cov_6.297959	239	319	0	65	80	0.8125000
NODE_26395_length_589_cov_6.297959	239	319	1	15	80	0.1875000
NODE_26430_length_589_cov_2.320408	431	511	4	35	80	0.4375000
NODE_26430_length_589_cov_2.320408	431	511	6	21	80	0.2625000
NODE_26430_length_589_cov_2.320408	431	511	8	18	80	0.2250000
NODE_26430_length_589_cov_2.320408	431	511	10	6	80	0.0750000
NODE_26515_length_588_cov_49.936605	264	341	0	38	77	0.4935065
NODE_26515_length_588_cov_49.936605	264	341	2	39	77	0.5064935
NODE_26515_length_588_cov_49.936605	314	394	0	32	80	0.4000000
NODE_26515_length_588_cov_49.936605	314	394	2	48	80	0.6000000
NODE_26516_length_588_cov_33.691207	273	353	0	21	80	0.2625000
NODE_26516_length_588_cov_33.691207	273	353	2	59	80	0.7375000
NODE_26516_length_588_cov_33.691207	326	406	0	74	80	0.9250000
NODE_26516_length_588_cov_33.691207	326	406	2	6	80	0.0750000
NODE_26517_length_588_cov_16.564417	245	325	0	80	80	1.0000000
NODE_26517_length_588_cov_16.564417	298	378	0	80	80	1.0000000
NODE_26518_length_588_cov_14.595092	266	346	2	12	80	0.1500000
NODE_26518_length_588_cov_14.595092	266	346	6	66	80	0.8250000
NODE_26518_length_588_cov_14.595092	266	346	8	2	80	0.0250000
NODE_26518_length_588_cov_14.595092	319	399	0	25	80	0.3125000
NODE_26518_length_588_cov_14.595092	319	399	2	13	80	0.1625000
NODE_26518_length_588_cov_14.595092	319	399	6	42	80	0.5250000
NODE_26522_length_588_cov_7.439673	155	235	0	80	80	1.0000000
NODE_26522_length_588_cov_7.439673	208	288	0	80	80	1.0000000
NODE_26523_length_588_cov_7.094070	191	263	4	1	72	0.0138889
NODE_26523_length_588_cov_7.094070	191	263	6	8	72	0.1111111
NODE_26523_length_588_cov_7.094070	191	263	8	26	72	0.3611111
NODE_26523_length_588_cov_7.094070	191	263	10	9	72	0.1250000
NODE_26523_length_588_cov_7.094070	191	263	12	12	72	0.1666667
NODE_26523_length_588_cov_7.094070	191	263	14	16	72	0.2222222
NODE_26523_length_588_cov_7.094070	244	310	0	1	66	0.0151515
NODE_26523_length_588_cov_7.094070	244	310	4	4	66	0.0606061
NODE_26523_length_588_cov_7.094070	244	310	6	51	66	0.7727273
NODE_26523_length_588_cov_7.094070	244	310	8	10	66	0.1515152
NODE_26523_length_588_cov_7.094070	439	519	0	80	80	1.0000000
NODE_26523_length_588_cov_7.094070	492	572	0	80	80	1.0000000
NODE_26534_length_588_cov_4.167689	65	122	2	57	57	1.0000000
NODE_26634_length_587_cov_39.782787	123	203	0	80	80	1.0000000
NODE_26634_length_587_cov_39.782787	176	256	0	80	80	1.0000000
NODE_26634_length_587_cov_39.782787	252	332	0	45	80	0.5625000
NODE_26634_length_587_cov_39.782787	252	332	2	18	80	0.2250000
NODE_26634_length_587_cov_39.782787	252	332	4	17	80	0.2125000
NODE_26634_length_587_cov_39.782787	305	385	2	18	80	0.2250000
NODE_26634_length_587_cov_39.782787	305	385	4	62	80	0.7750000
NODE_26635_length_587_cov_31.807377	141	221	0	80	80	1.0000000
NODE_26635_length_587_cov_31.807377	194	274	0	80	80	1.0000000
NODE_26636_length_587_cov_12.629098	219	299	5	11	80	0.1375000
NODE_26636_length_587_cov_12.629098	219	299	8	18	80	0.2250000
NODE_26636_length_587_cov_12.629098	219	299	9	3	80	0.0375000
NODE_26636_length_587_cov_12.629098	219	299	10	3	80	0.0375000
NODE_26636_length_587_cov_12.629098	219	299	11	19	80	0.2375000
NODE_26636_length_587_cov_12.629098	219	299	13	26	80	0.3250000
NODE_26636_length_587_cov_12.629098	272	352	6	15	80	0.1875000
NODE_26636_length_587_cov_12.629098	272	352	8	56	80	0.7000000
NODE_26636_length_587_cov_12.629098	272	352	10	3	80	0.0375000
NODE_26636_length_587_cov_12.629098	272	352	11	6	80	0.0750000
NODE_26639_length_587_cov_9.067623	203	283	0	29	80	0.3625000
NODE_26639_length_587_cov_9.067623	203	283	2	51	80	0.6375000
NODE_26639_length_587_cov_9.067623	256	336	0	4	80	0.0500000
NODE_26639_length_587_cov_9.067623	256	336	2	76	80	0.9500000
NODE_26640_length_587_cov_8.411885	253	311	0	15	58	0.2586207
NODE_26640_length_587_cov_8.411885	253	311	2	1	58	0.0172414
NODE_26640_length_587_cov_8.411885	253	311	4	42	58	0.7241379
NODE_26656_length_587_cov_3.231557	201	256	1	5	55	0.0909091
NODE_26656_length_587_cov_3.231557	201	256	2	50	55	0.9090909
NODE_26665_length_587_cov_2.850410	255	288	6	4	33	0.1212121
NODE_26665_length_587_cov_2.850410	255	288	8	25	33	0.7575758
NODE_26665_length_587_cov_2.850410	255	288	10	4	33	0.1212121
NODE_26749_length_586_cov_37.843943	268	348	0	80	80	1.0000000
NODE_26749_length_586_cov_37.843943	321	401	0	80	80	1.0000000
NODE_26749_length_586_cov_37.843943	397	477	0	80	80	1.0000000
NODE_26749_length_586_cov_37.843943	450	531	0	81	81	1.0000000
NODE_26750_length_586_cov_12.831622	186	266	0	18	80	0.2250000
NODE_26750_length_586_cov_12.831622	186	266	2	62	80	0.7750000
NODE_26750_length_586_cov_12.831622	239	319	0	71	80	0.8875000
NODE_26750_length_586_cov_12.831622	239	319	2	9	80	0.1125000
NODE_26752_length_586_cov_11.264887	108	188	2	49	80	0.6125000
NODE_26752_length_586_cov_11.264887	108	188	4	31	80	0.3875000
NODE_26752_length_586_cov_11.264887	161	241	0	30	80	0.3750000
NODE_26752_length_586_cov_11.264887	161	241	2	25	80	0.3125000
NODE_26752_length_586_cov_11.264887	161	241	4	25	80	0.3125000
NODE_26754_length_586_cov_9.624230	299	360	6	61	61	1.0000000
NODE_26754_length_586_cov_9.624230	299	360	6	61	61	1.0000000
NODE_26754_length_586_cov_9.624230	299	360	6	61	61	1.0000000
NODE_26754_length_586_cov_9.624230	301	360	6	59	59	1.0000000
NODE_26756_length_586_cov_8.591376	273	353	0	76	80	0.9500000
NODE_26756_length_586_cov_8.591376	273	353	6	4	80	0.0500000
NODE_26756_length_586_cov_8.591376	326	406	0	80	80	1.0000000
NODE_26758_length_586_cov_6.135524	334	375	0	41	41	1.0000000
NODE_26758_length_586_cov_6.135524	334	375	0	41	41	1.0000000
NODE_26760_length_586_cov_5.634497	150	230	0	80	80	1.0000000
NODE_26760_length_586_cov_5.634497	203	283	0	80	80	1.0000000
NODE_26765_length_586_cov_4.626283	296	362	7	56	66	0.8484849
NODE_26765_length_586_cov_4.626283	296	362	9	10	66	0.1515152
NODE_26765_length_586_cov_4.626283	453	533	0	11	80	0.1375000
NODE_26765_length_586_cov_4.626283	453	533	2	69	80	0.8625000
NODE_26885_length_585_cov_112.094650	456	536	109	1	80	0.0125000
NODE_26885_length_585_cov_112.094650	456	536	113	5	80	0.0625000
NODE_26885_length_585_cov_112.094650	456	536	115	1	80	0.0125000
NODE_26885_length_585_cov_112.094650	456	536	117	2	80	0.0250000
NODE_26885_length_585_cov_112.094650	456	536	121	1	80	0.0125000
NODE_26885_length_585_cov_112.094650	456	536	122	2	80	0.0250000
NODE_26885_length_585_cov_112.094650	456	536	123	2	80	0.0250000
NODE_26885_length_585_cov_112.094650	456	536	125	1	80	0.0125000
NODE_26885_length_585_cov_112.094650	456	536	126	1	80	0.0125000
NODE_26885_length_585_cov_112.094650	456	536	134	6	80	0.0750000
NODE_26885_length_585_cov_112.094650	456	536	138	3	80	0.0375000
NODE_26885_length_585_cov_112.094650	456	536	139	1	80	0.0125000
NODE_26885_length_585_cov_112.094650	456	536	143	8	80	0.1000000
NODE_26885_length_585_cov_112.094650	456	536	144	5	80	0.0625000
NODE_26885_length_585_cov_112.094650	456	536	145	4	80	0.0500000
NODE_26885_length_585_cov_112.094650	456	536	147	1	80	0.0125000
NODE_26885_length_585_cov_112.094650	456	536	148	6	80	0.0750000
NODE_26885_length_585_cov_112.094650	456	536	149	3	80	0.0375000
NODE_26885_length_585_cov_112.094650	456	536	150	4	80	0.0500000
NODE_26885_length_585_cov_112.094650	456	536	151	2	80	0.0250000
NODE_26885_length_585_cov_112.094650	456	536	152	3	80	0.0375000
NODE_26885_length_585_cov_112.094650	456	536	154	1	80	0.0125000
NODE_26885_length_585_cov_112.094650	456	536	155	1	80	0.0125000
NODE_26885_length_585_cov_112.094650	456	536	156	11	80	0.1375000
NODE_26885_length_585_cov_112.094650	456	536	158	1	80	0.0125000
NODE_26885_length_585_cov_112.094650	456	536	159	2	80	0.0250000
NODE_26885_length_585_cov_112.094650	456	536	160	2	80	0.0250000
NODE_26885_length_585_cov_112.094650	509	585	0	4	76	0.0526316
NODE_26885_length_585_cov_112.094650	509	585	2	2	76	0.0263158
NODE_26885_length_585_cov_112.094650	509	585	3	2	76	0.0263158
NODE_26885_length_585_cov_112.094650	509	585	12	7	76	0.0921053
NODE_26885_length_585_cov_112.094650	509	585	28	1	76	0.0131579
NODE_26885_length_585_cov_112.094650	509	585	29	3	76	0.0394737
NODE_26885_length_585_cov_112.094650	509	585	33	1	76	0.0131579
NODE_26885_length_585_cov_112.094650	509	585	35	2	76	0.0263158
NODE_26885_length_585_cov_112.094650	509	585	43	6	76	0.0789474
NODE_26885_length_585_cov_112.094650	509	585	48	1	76	0.0131579
NODE_26885_length_585_cov_112.094650	509	585	54	2	76	0.0263158
NODE_26885_length_585_cov_112.094650	509	585	56	5	76	0.0657895
NODE_26885_length_585_cov_112.094650	509	585	61	1	76	0.0131579
NODE_26885_length_585_cov_112.094650	509	585	63	2	76	0.0263158
NODE_26885_length_585_cov_112.094650	509	585	74	1	76	0.0131579
NODE_26885_length_585_cov_112.094650	509	585	84	5	76	0.0657895
NODE_26885_length_585_cov_112.094650	509	585	94	1	76	0.0131579
NODE_26885_length_585_cov_112.094650	509	585	98	1	76	0.0131579
NODE_26885_length_585_cov_112.094650	509	585	109	3	76	0.0394737
NODE_26885_length_585_cov_112.094650	509	585	113	5	76	0.0657895
NODE_26885_length_585_cov_112.094650	509	585	115	1	76	0.0131579
NODE_26885_length_585_cov_112.094650	509	585	117	2	76	0.0263158
NODE_26885_length_585_cov_112.094650	509	585	125	1	76	0.0131579
NODE_26885_length_585_cov_112.094650	509	585	138	1	76	0.0131579
NODE_26885_length_585_cov_112.094650	509	585	139	1	76	0.0131579
NODE_26885_length_585_cov_112.094650	509	585	143	6	76	0.0789474
NODE_26885_length_585_cov_112.094650	509	585	145	4	76	0.0526316
NODE_26885_length_585_cov_112.094650	509	585	149	1	76	0.0131579
NODE_26885_length_585_cov_112.094650	509	585	150	1	76	0.0131579
NODE_26885_length_585_cov_112.094650	509	585	151	1	76	0.0131579
NODE_26885_length_585_cov_112.094650	509	585	152	2	76	0.0263158
NODE_26886_length_585_cov_23.872428	168	248	4	34	80	0.4250000
NODE_26886_length_585_cov_23.872428	168	248	6	3	80	0.0375000
NODE_26886_length_585_cov_23.872428	168	248	8	43	80	0.5375000
NODE_26886_length_585_cov_23.872428	222	301	0	10	79	0.1265823
NODE_26886_length_585_cov_23.872428	222	301	2	9	79	0.1139240
NODE_26886_length_585_cov_23.872428	222	301	4	18	79	0.2278481
NODE_26886_length_585_cov_23.872428	222	301	8	42	79	0.5316456
NODE_26887_length_585_cov_18.981481	360	440	6	15	80	0.1875000
NODE_26887_length_585_cov_18.981481	360	440	8	65	80	0.8125000
NODE_26887_length_585_cov_18.981481	413	493	0	11	80	0.1375000
NODE_26887_length_585_cov_18.981481	413	493	2	40	80	0.5000000
NODE_26887_length_585_cov_18.981481	413	493	8	29	80	0.3625000
NODE_26888_length_585_cov_13.967078	323	387	0	64	64	1.0000000
NODE_26889_length_585_cov_10.555556	229	309	5	58	80	0.7250000
NODE_26889_length_585_cov_10.555556	229	309	6	22	80	0.2750000
NODE_26889_length_585_cov_10.555556	282	362	0	40	80	0.5000000
NODE_26889_length_585_cov_10.555556	282	362	4	1	80	0.0125000
NODE_26889_length_585_cov_10.555556	282	362	5	36	80	0.4500000
NODE_26889_length_585_cov_10.555556	282	362	6	3	80	0.0375000
NODE_26891_length_585_cov_9.216049	233	313	0	68	80	0.8500000
NODE_26891_length_585_cov_9.216049	233	313	4	12	80	0.1500000
NODE_26891_length_585_cov_9.216049	286	366	0	80	80	1.0000000
NODE_26894_length_585_cov_8.090535	292	372	0	80	80	1.0000000
NODE_26894_length_585_cov_8.090535	345	425	0	80	80	1.0000000
NODE_26895_length_585_cov_8.018519	339	381	0	42	42	1.0000000
NODE_26895_length_585_cov_8.018519	354	419	0	65	65	1.0000000
NODE_26900_length_585_cov_4.954733	147	227	0	9	80	0.1125000
NODE_26900_length_585_cov_4.954733	147	227	4	71	80	0.8875000
NODE_26912_length_585_cov_3.751029	288	368	0	80	80	1.0000000
NODE_26912_length_585_cov_3.751029	341	421	0	80	80	1.0000000
NODE_27019_length_584_cov_21.657732	57	137	2	35	80	0.4375000
NODE_27019_length_584_cov_21.657732	57	137	6	45	80	0.5625000
NODE_27019_length_584_cov_21.657732	110	190	0	12	80	0.1500000
NODE_27019_length_584_cov_21.657732	110	190	4	27	80	0.3375000
NODE_27019_length_584_cov_21.657732	110	190	6	41	80	0.5125000
NODE_27020_length_584_cov_11.915464	280	360	0	80	80	1.0000000
NODE_27020_length_584_cov_11.915464	333	413	0	80	80	1.0000000
NODE_27021_length_584_cov_11.197938	217	297	0	77	80	0.9625000
NODE_27021_length_584_cov_11.197938	217	297	2	3	80	0.0375000
NODE_27021_length_584_cov_11.197938	270	350	0	80	80	1.0000000
NODE_27022_length_584_cov_9.824742	375	441	0	66	66	1.0000000
NODE_27022_length_584_cov_9.824742	375	441	0	66	66	1.0000000
NODE_27023_length_584_cov_9.160825	369	449	0	25	80	0.3125000
NODE_27023_length_584_cov_9.160825	369	449	2	3	80	0.0375000
NODE_27023_length_584_cov_9.160825	369	449	4	52	80	0.6500000
NODE_27023_length_584_cov_9.160825	422	502	0	78	80	0.9750000
NODE_27023_length_584_cov_9.160825	422	502	2	2	80	0.0250000
NODE_27023_length_584_cov_9.160825	422	502	0	78	80	0.9750000
NODE_27023_length_584_cov_9.160825	422	502	2	2	80	0.0250000
NODE_27026_length_584_cov_7.736082	51	131	0	80	80	1.0000000
NODE_27026_length_584_cov_7.736082	104	184	0	80	80	1.0000000
NODE_27031_length_584_cov_7.113402	213	293	0	80	80	1.0000000
NODE_27031_length_584_cov_7.113402	266	346	0	80	80	1.0000000
NODE_27035_length_584_cov_5.843299	281	341	0	2	60	0.0333333
NODE_27035_length_584_cov_5.843299	281	341	2	3	60	0.0500000
NODE_27035_length_584_cov_5.843299	281	341	4	17	60	0.2833333
NODE_27035_length_584_cov_5.843299	281	341	6	22	60	0.3666667
NODE_27035_length_584_cov_5.843299	281	341	8	16	60	0.2666667
NODE_27039_length_584_cov_5.032990	240	320	0	80	80	1.0000000
NODE_27039_length_584_cov_5.032990	293	373	0	80	80	1.0000000
NODE_27061_length_584_cov_2.707216	186	257	0	17	71	0.2394366
NODE_27061_length_584_cov_2.707216	186	257	2	46	71	0.6478873
NODE_27061_length_584_cov_2.707216	186	257	4	8	71	0.1126761
NODE_27147_length_583_cov_7.973140	232	312	0	80	80	1.0000000
NODE_27147_length_583_cov_7.973140	285	365	0	80	80	1.0000000
NODE_27148_length_583_cov_6.731405	328	408	0	80	80	1.0000000
NODE_27148_length_583_cov_6.731405	381	461	0	80	80	1.0000000
NODE_27149_length_583_cov_6.363636	161	231	0	23	70	0.3285714
NODE_27149_length_583_cov_6.363636	161	231	2	47	70	0.6714286
NODE_27152_length_583_cov_5.766529	132	186	0	54	54	1.0000000
NODE_27263_length_583_cov_0.762397	9	50	0	41	41	1.0000000
NODE_27278_length_582_cov_74.269151	295	375	0	8	80	0.1000000
NODE_27278_length_582_cov_74.269151	295	375	2	9	80	0.1125000
NODE_27278_length_582_cov_74.269151	295	375	6	22	80	0.2750000
NODE_27278_length_582_cov_74.269151	295	375	8	32	80	0.4000000
NODE_27278_length_582_cov_74.269151	295	375	12	9	80	0.1125000
NODE_27278_length_582_cov_74.269151	348	428	6	30	80	0.3750000
NODE_27278_length_582_cov_74.269151	348	428	8	17	80	0.2125000
NODE_27278_length_582_cov_74.269151	348	428	12	33	80	0.4125000
NODE_27279_length_582_cov_53.093168	11	91	0	80	80	1.0000000
NODE_27279_length_582_cov_53.093168	64	144	0	80	80	1.0000000
NODE_27279_length_582_cov_53.093168	140	220	0	34	80	0.4250000
NODE_27279_length_582_cov_53.093168	140	220	2	46	80	0.5750000
NODE_27279_length_582_cov_53.093168	193	273	0	27	80	0.3375000
NODE_27279_length_582_cov_53.093168	193	273	2	53	80	0.6625000
NODE_27280_length_582_cov_47.393375	345	425	0	80	80	1.0000000
NODE_27280_length_582_cov_47.393375	398	478	0	80	80	1.0000000
NODE_27281_length_582_cov_16.358178	297	377	0	80	80	1.0000000
NODE_27281_length_582_cov_16.358178	350	431	0	81	81	1.0000000
NODE_27282_length_582_cov_14.107660	128	208	6	1	80	0.0125000
NODE_27282_length_582_cov_14.107660	128	208	8	79	80	0.9875000
NODE_27282_length_582_cov_14.107660	181	261	2	11	80	0.1375000
NODE_27282_length_582_cov_14.107660	181	261	3	7	80	0.0875000
NODE_27282_length_582_cov_14.107660	181	261	4	4	80	0.0500000
NODE_27282_length_582_cov_14.107660	181	261	6	32	80	0.4000000
NODE_27282_length_582_cov_14.107660	181	261	8	26	80	0.3250000
NODE_27283_length_582_cov_7.923395	208	287	0	79	79	1.0000000
NODE_27283_length_582_cov_7.923395	262	340	0	78	78	1.0000000
NODE_27284_length_582_cov_7.722567	216	296	2	18	80	0.2250000
NODE_27284_length_582_cov_7.722567	216	296	4	62	80	0.7750000
NODE_27284_length_582_cov_7.722567	269	349	0	53	80	0.6625000
NODE_27284_length_582_cov_7.722567	269	349	2	18	80	0.2250000
NODE_27284_length_582_cov_7.722567	269	349	4	9	80	0.1125000
NODE_27289_length_582_cov_4.956522	294	325	0	31	31	1.0000000
NODE_27295_length_582_cov_4.308489	151	192	8	9	41	0.2195122
NODE_27295_length_582_cov_4.308489	151	192	9	14	41	0.3414634
NODE_27295_length_582_cov_4.308489	151	192	10	18	41	0.4390244
NODE_27297_length_582_cov_3.838509	223	299	8	41	76	0.5394737
NODE_27297_length_582_cov_3.838509	223	299	10	35	76	0.4605263
NODE_27297_length_582_cov_3.838509	272	354	1	29	82	0.3536585
NODE_27297_length_582_cov_3.838509	272	354	5	2	82	0.0243902
NODE_27297_length_582_cov_3.838509	272	354	6	4	82	0.0487805
NODE_27297_length_582_cov_3.838509	272	354	8	47	82	0.5731707
NODE_27350_length_582_cov_1.650104	375	450	0	75	75	1.0000000
NODE_27405_length_581_cov_16.890041	244	316	0	72	72	1.0000000
NODE_27413_length_581_cov_6.340249	262	342	0	80	80	1.0000000
NODE_27413_length_581_cov_6.340249	315	395	0	80	80	1.0000000
NODE_27416_length_581_cov_5.827801	122	192	0	16	70	0.2285714
NODE_27416_length_581_cov_5.827801	122	192	4	1	70	0.0142857
NODE_27416_length_581_cov_5.827801	122	192	6	39	70	0.5571429
NODE_27416_length_581_cov_5.827801	122	192	8	1	70	0.0142857
NODE_27416_length_581_cov_5.827801	122	192	10	10	70	0.1428571
NODE_27416_length_581_cov_5.827801	122	192	12	3	70	0.0428571
NODE_27420_length_581_cov_5.072614	392	466	0	74	74	1.0000000
NODE_27420_length_581_cov_5.072614	424	444	0	20	20	1.0000000
NODE_27464_length_581_cov_1.881743	474	538	0	64	64	1.0000000
NODE_27541_length_580_cov_39.353430	358	438	0	47	80	0.5875000
NODE_27541_length_580_cov_39.353430	358	438	2	33	80	0.4125000
NODE_27541_length_580_cov_39.353430	411	491	0	33	80	0.4125000
NODE_27541_length_580_cov_39.353430	411	491	2	13	80	0.1625000
NODE_27541_length_580_cov_39.353430	411	491	4	17	80	0.2125000
NODE_27541_length_580_cov_39.353430	411	491	8	8	80	0.1000000
NODE_27541_length_580_cov_39.353430	411	491	10	9	80	0.1125000
NODE_27541_length_580_cov_39.353430	487	567	6	8	80	0.1000000
NODE_27541_length_580_cov_39.353430	487	567	8	72	80	0.9000000
NODE_27541_length_580_cov_39.353430	487	567	6	8	80	0.1000000
NODE_27541_length_580_cov_39.353430	487	567	8	72	80	0.9000000
NODE_27541_length_580_cov_39.353430	487	567	6	8	80	0.1000000
NODE_27541_length_580_cov_39.353430	487	567	8	72	80	0.9000000
NODE_27541_length_580_cov_39.353430	487	567	6	8	80	0.1000000
NODE_27541_length_580_cov_39.353430	487	567	8	72	80	0.9000000
NODE_27541_length_580_cov_39.353430	487	567	6	8	80	0.1000000
NODE_27541_length_580_cov_39.353430	487	567	8	72	80	0.9000000
NODE_27541_length_580_cov_39.353430	487	567	6	8	80	0.1000000
NODE_27541_length_580_cov_39.353430	487	567	8	72	80	0.9000000
NODE_27544_length_580_cov_8.925156	198	238	0	40	40	1.0000000
NODE_27544_length_580_cov_8.925156	258	338	0	80	80	1.0000000
NODE_27545_length_580_cov_8.634096	197	277	6	53	80	0.6625000
NODE_27545_length_580_cov_8.634096	197	277	8	27	80	0.3375000
NODE_27545_length_580_cov_8.634096	250	330	0	26	80	0.3250000
NODE_27545_length_580_cov_8.634096	250	330	6	54	80	0.6750000
NODE_27551_length_580_cov_6.291060	356	398	0	42	42	1.0000000
NODE_27554_length_580_cov_5.494802	110	190	0	80	80	1.0000000
NODE_27554_length_580_cov_5.494802	163	243	0	80	80	1.0000000
NODE_27559_length_580_cov_4.563410	231	292	0	7	61	0.1147541
NODE_27559_length_580_cov_4.563410	231	292	2	51	61	0.8360656
NODE_27559_length_580_cov_4.563410	231	292	4	3	61	0.0491803
NODE_27559_length_580_cov_4.563410	322	357	2	35	35	1.0000000
NODE_27590_length_580_cov_2.264033	215	277	0	62	62	1.0000000
NODE_27597_length_580_cov_2.116424	265	345	0	80	80	1.0000000
NODE_27659_length_579_cov_24.231250	159	239	0	80	80	1.0000000
NODE_27659_length_579_cov_24.231250	212	287	0	75	75	1.0000000
NODE_27660_length_579_cov_12.602083	246	326	0	80	80	1.0000000
NODE_27660_length_579_cov_12.602083	299	377	0	78	78	1.0000000
NODE_27663_length_579_cov_9.195833	254	334	4	1	80	0.0125000
NODE_27663_length_579_cov_9.195833	254	334	6	48	80	0.6000000
NODE_27663_length_579_cov_9.195833	254	334	8	31	80	0.3875000
NODE_27663_length_579_cov_9.195833	307	387	2	29	80	0.3625000
NODE_27663_length_579_cov_9.195833	307	387	4	9	80	0.1125000
NODE_27663_length_579_cov_9.195833	307	387	6	6	80	0.0750000
NODE_27663_length_579_cov_9.195833	307	387	8	36	80	0.4500000
NODE_27663_length_579_cov_9.195833	383	463	0	43	80	0.5375000
NODE_27663_length_579_cov_9.195833	383	463	2	37	80	0.4625000
NODE_27664_length_579_cov_6.600000	169	249	0	80	80	1.0000000
NODE_27664_length_579_cov_6.600000	222	302	0	80	80	1.0000000
NODE_27667_length_579_cov_5.956250	225	295	5	6	70	0.0857143
NODE_27667_length_579_cov_5.956250	225	295	8	4	70	0.0571429
NODE_27667_length_579_cov_5.956250	225	295	9	12	70	0.1714286
NODE_27667_length_579_cov_5.956250	225	295	10	21	70	0.3000000
NODE_27667_length_579_cov_5.956250	225	295	12	27	70	0.3857143
NODE_27667_length_579_cov_5.956250	279	316	4	14	37	0.3783784
NODE_27667_length_579_cov_5.956250	279	316	5	8	37	0.2162162
NODE_27667_length_579_cov_5.956250	279	316	6	5	37	0.1351351
NODE_27667_length_579_cov_5.956250	279	316	9	10	37	0.2702703
NODE_27674_length_579_cov_4.850000	105	185	0	38	80	0.4750000
NODE_27674_length_579_cov_4.850000	105	185	2	42	80	0.5250000
NODE_27674_length_579_cov_4.850000	158	238	2	80	80	1.0000000
NODE_27688_length_579_cov_3.291667	290	343	2	53	53	1.0000000
NODE_27695_length_579_cov_2.420833	251	331	0	36	80	0.4500000
NODE_27695_length_579_cov_2.420833	251	331	1	13	80	0.1625000
NODE_27695_length_579_cov_2.420833	251	331	2	31	80	0.3875000
NODE_27695_length_579_cov_2.420833	304	384	0	4	80	0.0500000
NODE_27695_length_579_cov_2.420833	304	384	2	26	80	0.3250000
NODE_27695_length_579_cov_2.420833	304	384	4	50	80	0.6250000
NODE_27724_length_579_cov_1.435417	463	497	0	34	34	1.0000000
NODE_27781_length_578_cov_70.192067	100	180	0	30	80	0.3750000
NODE_27781_length_578_cov_70.192067	100	180	2	10	80	0.1250000
NODE_27781_length_578_cov_70.192067	100	180	4	11	80	0.1375000
NODE_27781_length_578_cov_70.192067	100	180	6	29	80	0.3625000
NODE_27781_length_578_cov_70.192067	153	233	4	18	80	0.2250000
NODE_27781_length_578_cov_70.192067	153	233	6	62	80	0.7750000
NODE_27782_length_578_cov_51.676409	129	209	0	80	80	1.0000000
NODE_27782_length_578_cov_51.676409	182	262	0	80	80	1.0000000
NODE_27783_length_578_cov_32.152401	310	390	2	62	80	0.7750000
NODE_27783_length_578_cov_32.152401	310	390	4	18	80	0.2250000
NODE_27783_length_578_cov_32.152401	363	443	2	61	80	0.7625000
NODE_27783_length_578_cov_32.152401	363	443	4	19	80	0.2375000
NODE_27784_length_578_cov_30.484342	215	295	0	80	80	1.0000000
NODE_27784_length_578_cov_30.484342	268	348	0	80	80	1.0000000
NODE_27785_length_578_cov_15.983299	213	265	4	45	52	0.8653846
NODE_27785_length_578_cov_15.983299	213	265	6	7	52	0.1346154
NODE_27786_length_578_cov_14.968685	147	227	2	29	80	0.3625000
NODE_27786_length_578_cov_14.968685	147	227	4	6	80	0.0750000
NODE_27786_length_578_cov_14.968685	147	227	6	45	80	0.5625000
NODE_27786_length_578_cov_14.968685	200	280	0	16	80	0.2000000
NODE_27786_length_578_cov_14.968685	200	280	4	43	80	0.5375000
NODE_27786_length_578_cov_14.968685	200	280	6	21	80	0.2625000
NODE_27787_length_578_cov_9.567850	273	328	4	55	55	1.0000000
NODE_27792_length_578_cov_6.670146	273	353	6	10	80	0.1250000
NODE_27792_length_578_cov_6.670146	273	353	7	17	80	0.2125000
NODE_27792_length_578_cov_6.670146	273	353	8	20	80	0.2500000
NODE_27792_length_578_cov_6.670146	273	353	9	2	80	0.0250000
NODE_27792_length_578_cov_6.670146	273	353	10	31	80	0.3875000
NODE_27792_length_578_cov_6.670146	326	406	5	11	80	0.1375000
NODE_27792_length_578_cov_6.670146	326	406	6	11	80	0.1375000
NODE_27792_length_578_cov_6.670146	326	406	7	5	80	0.0625000
NODE_27792_length_578_cov_6.670146	326	406	8	53	80	0.6625000
NODE_27793_length_578_cov_6.465553	320	400	0	80	80	1.0000000
NODE_27793_length_578_cov_6.465553	373	453	0	80	80	1.0000000
NODE_27863_length_578_cov_1.480167	185	265	0	14	80	0.1750000
NODE_27863_length_578_cov_1.480167	185	265	2	66	80	0.8250000
NODE_27863_length_578_cov_1.480167	238	318	0	67	80	0.8375000
NODE_27863_length_578_cov_1.480167	238	318	2	13	80	0.1625000
NODE_27935_length_577_cov_11.638075	312	392	0	80	80	1.0000000
NODE_27942_length_577_cov_4.912134	218	249	4	31	31	1.0000000
NODE_27942_length_577_cov_4.912134	301	330	2	29	29	1.0000000
NODE_27961_length_577_cov_2.970711	78	126	22	4	48	0.0833333
NODE_27961_length_577_cov_2.970711	78	126	24	16	48	0.3333333
NODE_27961_length_577_cov_2.970711	78	126	26	8	48	0.1666667
NODE_27961_length_577_cov_2.970711	78	126	28	20	48	0.4166667
NODE_27968_length_577_cov_2.631799	169	253	16	2	84	0.0238095
NODE_27968_length_577_cov_2.631799	169	253	18	13	84	0.1547619
NODE_27968_length_577_cov_2.631799	169	253	19	2	84	0.0238095
NODE_27968_length_577_cov_2.631799	169	253	20	25	84	0.2976190
NODE_27968_length_577_cov_2.631799	169	253	21	25	84	0.2976190
NODE_27968_length_577_cov_2.631799	169	253	22	6	84	0.0714286
NODE_27968_length_577_cov_2.631799	169	253	23	1	84	0.0119048
NODE_27968_length_577_cov_2.631799	169	253	24	10	84	0.1190476
NODE_27968_length_577_cov_2.631799	226	269	16	2	43	0.0465116
NODE_27968_length_577_cov_2.631799	226	269	18	29	43	0.6744186
NODE_27968_length_577_cov_2.631799	226	269	20	11	43	0.2558140
NODE_27968_length_577_cov_2.631799	226	269	21	1	43	0.0232558
NODE_28003_length_577_cov_1.468619	71	146	0	15	75	0.2000000
NODE_28003_length_577_cov_1.468619	71	146	2	60	75	0.8000000
NODE_28003_length_577_cov_1.468619	119	199	0	25	80	0.3125000
NODE_28003_length_577_cov_1.468619	119	199	2	55	80	0.6875000
NODE_28058_length_576_cov_10.903564	194	274	0	45	80	0.5625000
NODE_28058_length_576_cov_10.903564	194	274	2	35	80	0.4375000
NODE_28059_length_576_cov_9.039832	271	351	0	80	80	1.0000000
NODE_28059_length_576_cov_9.039832	324	404	0	80	80	1.0000000
NODE_28060_length_576_cov_8.490566	338	418	0	31	80	0.3875000
NODE_28060_length_576_cov_8.490566	338	418	2	49	80	0.6125000
NODE_28060_length_576_cov_8.490566	391	471	0	20	80	0.2500000
NODE_28060_length_576_cov_8.490566	391	471	2	60	80	0.7500000
NODE_28061_length_576_cov_7.002096	157	237	0	80	80	1.0000000
NODE_28061_length_576_cov_7.002096	210	290	0	80	80	1.0000000
NODE_28076_length_576_cov_3.322851	118	183	2	7	65	0.1076923
NODE_28076_length_576_cov_3.322851	118	183	6	15	65	0.2307692
NODE_28076_length_576_cov_3.322851	118	183	8	29	65	0.4461538
NODE_28076_length_576_cov_3.322851	118	183	10	14	65	0.2153846
NODE_28102_length_576_cov_1.964361	148	228	0	80	80	1.0000000
NODE_28102_length_576_cov_1.964361	201	281	0	80	80	1.0000000
NODE_28104_length_576_cov_1.951782	159	239	0	80	80	1.0000000
NODE_28104_length_576_cov_1.951782	212	292	0	80	80	1.0000000
NODE_28116_length_576_cov_1.584906	381	455	0	50	74	0.6756757
NODE_28116_length_576_cov_1.584906	381	455	2	24	74	0.3243243
NODE_28179_length_575_cov_15.319328	319	399	0	12	80	0.1500000
NODE_28179_length_575_cov_15.319328	319	399	4	68	80	0.8500000
NODE_28179_length_575_cov_15.319328	372	452	0	2	80	0.0250000
NODE_28179_length_575_cov_15.319328	372	452	4	78	80	0.9750000
NODE_28181_length_575_cov_8.254202	286	366	0	80	80	1.0000000
NODE_28181_length_575_cov_8.254202	339	419	0	80	80	1.0000000
NODE_28182_length_575_cov_7.558824	300	380	0	80	80	1.0000000
NODE_28313_length_574_cov_6.282105	185	265	0	7	80	0.0875000
NODE_28313_length_574_cov_6.282105	185	265	5	1	80	0.0125000
NODE_28313_length_574_cov_6.282105	185	265	6	10	80	0.1250000
NODE_28313_length_574_cov_6.282105	185	265	9	13	80	0.1625000
NODE_28313_length_574_cov_6.282105	185	265	10	3	80	0.0375000
NODE_28313_length_574_cov_6.282105	185	265	13	21	80	0.2625000
NODE_28313_length_574_cov_6.282105	185	265	14	9	80	0.1125000
NODE_28313_length_574_cov_6.282105	185	265	16	15	80	0.1875000
NODE_28313_length_574_cov_6.282105	185	265	18	1	80	0.0125000
NODE_28313_length_574_cov_6.282105	238	318	0	60	80	0.7500000
NODE_28313_length_574_cov_6.282105	238	318	5	1	80	0.0125000
NODE_28313_length_574_cov_6.282105	238	318	6	10	80	0.1250000
NODE_28313_length_574_cov_6.282105	238	318	9	9	80	0.1125000
NODE_28330_length_574_cov_2.993684	215	234	0	19	19	1.0000000
NODE_28438_length_573_cov_53.668776	393	473	0	4	80	0.0500000
NODE_28438_length_573_cov_53.668776	393	473	2	76	80	0.9500000
NODE_28438_length_573_cov_53.668776	446	526	2	80	80	1.0000000
NODE_28439_length_573_cov_30.658228	451	531	4	79	80	0.9875000
NODE_28439_length_573_cov_30.658228	451	531	6	1	80	0.0125000
NODE_28440_length_573_cov_30.116034	435	515	38	5	80	0.0625000
NODE_28440_length_573_cov_30.116034	435	515	39	3	80	0.0375000
NODE_28440_length_573_cov_30.116034	435	515	40	4	80	0.0500000
NODE_28440_length_573_cov_30.116034	435	515	42	20	80	0.2500000
NODE_28440_length_573_cov_30.116034	435	515	44	8	80	0.1000000
NODE_28440_length_573_cov_30.116034	435	515	45	1	80	0.0125000
NODE_28440_length_573_cov_30.116034	435	515	46	5	80	0.0625000
NODE_28440_length_573_cov_30.116034	435	515	47	2	80	0.0250000
NODE_28440_length_573_cov_30.116034	435	515	48	8	80	0.1000000
NODE_28440_length_573_cov_30.116034	435	515	49	1	80	0.0125000
NODE_28440_length_573_cov_30.116034	435	515	50	11	80	0.1375000
NODE_28440_length_573_cov_30.116034	435	515	52	4	80	0.0500000
NODE_28440_length_573_cov_30.116034	435	515	53	8	80	0.1000000
NODE_28440_length_573_cov_30.116034	488	568	0	1	80	0.0125000
NODE_28440_length_573_cov_30.116034	488	568	2	7	80	0.0875000
NODE_28440_length_573_cov_30.116034	488	568	4	2	80	0.0250000
NODE_28440_length_573_cov_30.116034	488	568	8	1	80	0.0125000
NODE_28440_length_573_cov_30.116034	488	568	10	2	80	0.0250000
NODE_28440_length_573_cov_30.116034	488	568	14	3	80	0.0375000
NODE_28440_length_573_cov_30.116034	488	568	16	3	80	0.0375000
NODE_28440_length_573_cov_30.116034	488	568	20	1	80	0.0125000
NODE_28440_length_573_cov_30.116034	488	568	22	1	80	0.0125000
NODE_28440_length_573_cov_30.116034	488	568	24	3	80	0.0375000
NODE_28440_length_573_cov_30.116034	488	568	26	1	80	0.0125000
NODE_28440_length_573_cov_30.116034	488	568	28	1	80	0.0125000
NODE_28440_length_573_cov_30.116034	488	568	30	4	80	0.0500000
NODE_28440_length_573_cov_30.116034	488	568	32	4	80	0.0500000
NODE_28440_length_573_cov_30.116034	488	568	34	4	80	0.0500000
NODE_28440_length_573_cov_30.116034	488	568	38	1	80	0.0125000
NODE_28440_length_573_cov_30.116034	488	568	40	9	80	0.1125000
NODE_28440_length_573_cov_30.116034	488	568	42	24	80	0.3000000
NODE_28440_length_573_cov_30.116034	488	568	44	6	80	0.0750000
NODE_28440_length_573_cov_30.116034	488	568	46	2	80	0.0250000
NODE_28441_length_573_cov_24.234177	210	290	0	6	80	0.0750000
NODE_28441_length_573_cov_24.234177	210	290	6	53	80	0.6625000
NODE_28441_length_573_cov_24.234177	210	290	10	21	80	0.2625000
NODE_28441_length_573_cov_24.234177	263	343	4	20	80	0.2500000
NODE_28441_length_573_cov_24.234177	263	343	6	6	80	0.0750000
NODE_28441_length_573_cov_24.234177	263	343	10	54	80	0.6750000
NODE_28442_length_573_cov_13.464135	278	358	0	18	80	0.2250000
NODE_28442_length_573_cov_13.464135	278	358	2	62	80	0.7750000
NODE_28442_length_573_cov_13.464135	331	411	0	71	80	0.8875000
NODE_28442_length_573_cov_13.464135	331	411	2	9	80	0.1125000
NODE_28443_length_573_cov_8.761603	124	204	0	80	80	1.0000000
NODE_28443_length_573_cov_8.761603	177	257	0	80	80	1.0000000
NODE_28456_length_573_cov_3.364979	365	398	49	1	33	0.0303030
NODE_28456_length_573_cov_3.364979	365	398	51	11	33	0.3333333
NODE_28456_length_573_cov_3.364979	365	398	53	1	33	0.0303030
NODE_28456_length_573_cov_3.364979	365	398	59	12	33	0.3636364
NODE_28456_length_573_cov_3.364979	365	398	61	2	33	0.0606061
NODE_28456_length_573_cov_3.364979	365	398	63	1	33	0.0303030
NODE_28456_length_573_cov_3.364979	365	398	64	1	33	0.0303030
NODE_28456_length_573_cov_3.364979	365	398	65	1	33	0.0303030
NODE_28456_length_573_cov_3.364979	365	398	66	1	33	0.0303030
NODE_28456_length_573_cov_3.364979	365	398	67	2	33	0.0606061
NODE_28565_length_572_cov_17.530655	312	392	0	80	80	1.0000000
NODE_28565_length_572_cov_17.530655	365	445	0	80	80	1.0000000
NODE_28567_length_572_cov_8.059197	250	321	1	32	71	0.4507042
NODE_28567_length_572_cov_8.059197	250	321	2	39	71	0.5492958
NODE_28568_length_572_cov_7.873150	134	214	0	80	80	1.0000000
NODE_28568_length_572_cov_7.873150	187	267	0	80	80	1.0000000
NODE_28570_length_572_cov_6.706131	365	445	0	80	80	1.0000000
NODE_28570_length_572_cov_6.706131	418	498	0	80	80	1.0000000
NODE_28573_length_572_cov_5.625793	137	217	0	80	80	1.0000000
NODE_28573_length_572_cov_5.625793	190	270	0	80	80	1.0000000
NODE_28574_length_572_cov_5.617336	331	401	6	10	70	0.1428571
NODE_28574_length_572_cov_5.617336	331	401	8	19	70	0.2714286
NODE_28574_length_572_cov_5.617336	331	401	16	39	70	0.5571429
NODE_28574_length_572_cov_5.617336	331	401	18	2	70	0.0285714
NODE_28578_length_572_cov_4.596195	212	288	0	61	76	0.8026316
NODE_28578_length_572_cov_4.596195	212	288	2	15	76	0.1973684
NODE_28578_length_572_cov_4.596195	261	341	0	12	80	0.1500000
NODE_28578_length_572_cov_4.596195	261	341	2	68	80	0.8500000
NODE_28585_length_572_cov_3.843552	210	290	0	36	80	0.4500000
NODE_28585_length_572_cov_3.843552	210	290	2	18	80	0.2250000
NODE_28585_length_572_cov_3.843552	210	290	3	1	80	0.0125000
NODE_28585_length_572_cov_3.843552	210	290	6	21	80	0.2625000
NODE_28585_length_572_cov_3.843552	210	290	8	4	80	0.0500000
NODE_28585_length_572_cov_3.843552	263	343	0	1	80	0.0125000
NODE_28585_length_572_cov_3.843552	263	343	3	1	80	0.0125000
NODE_28585_length_572_cov_3.843552	263	343	6	21	80	0.2625000
NODE_28585_length_572_cov_3.843552	263	343	8	17	80	0.2125000
NODE_28585_length_572_cov_3.843552	263	343	12	32	80	0.4000000
NODE_28585_length_572_cov_3.843552	263	343	14	8	80	0.1000000
NODE_28621_length_572_cov_2.319239	357	431	0	68	74	0.9189189
NODE_28621_length_572_cov_2.319239	357	431	2	6	74	0.0810811
NODE_28621_length_572_cov_2.319239	410	478	0	68	68	1.0000000
NODE_28625_length_572_cov_2.107822	184	254	2	70	70	1.0000000
NODE_28625_length_572_cov_2.107822	415	493	4	78	78	1.0000000
NODE_28631_length_572_cov_1.947146	327	363	2	36	36	1.0000000
NODE_28631_length_572_cov_1.947146	328	354	2	26	26	1.0000000
NODE_28700_length_571_cov_14.262712	237	317	0	80	80	1.0000000
NODE_28700_length_571_cov_14.262712	290	370	0	80	80	1.0000000
NODE_28717_length_571_cov_4.033898	154	234	4	24	80	0.3000000
NODE_28717_length_571_cov_4.033898	154	234	6	11	80	0.1375000
NODE_28717_length_571_cov_4.033898	154	234	8	30	80	0.3750000
NODE_28717_length_571_cov_4.033898	154	234	10	15	80	0.1875000
NODE_28717_length_571_cov_4.033898	207	273	6	5	66	0.0757576
NODE_28717_length_571_cov_4.033898	207	273	8	46	66	0.6969697
NODE_28717_length_571_cov_4.033898	207	273	10	15	66	0.2272727
NODE_28809_length_570_cov_28.269639	487	559	14	1	72	0.0138889
NODE_28809_length_570_cov_28.269639	487	559	40	4	72	0.0555556
NODE_28809_length_570_cov_28.269639	487	559	42	6	72	0.0833333
NODE_28809_length_570_cov_28.269639	487	559	44	4	72	0.0555556
NODE_28809_length_570_cov_28.269639	487	559	48	5	72	0.0694444
NODE_28809_length_570_cov_28.269639	487	559	52	1	72	0.0138889
NODE_28809_length_570_cov_28.269639	487	559	55	4	72	0.0555556
NODE_28809_length_570_cov_28.269639	487	559	56	2	72	0.0277778
NODE_28809_length_570_cov_28.269639	487	559	60	1	72	0.0138889
NODE_28809_length_570_cov_28.269639	487	559	63	1	72	0.0138889
NODE_28809_length_570_cov_28.269639	487	559	64	7	72	0.0972222
NODE_28809_length_570_cov_28.269639	487	559	65	7	72	0.0972222
NODE_28809_length_570_cov_28.269639	487	559	66	23	72	0.3194444
NODE_28809_length_570_cov_28.269639	487	559	76	1	72	0.0138889
NODE_28809_length_570_cov_28.269639	487	559	77	1	72	0.0138889
NODE_28809_length_570_cov_28.269639	487	559	78	4	72	0.0555556
NODE_28812_length_570_cov_10.161359	167	247	0	30	80	0.3750000
NODE_28812_length_570_cov_10.161359	167	247	2	50	80	0.6250000
NODE_28812_length_570_cov_10.161359	220	256	2	36	36	1.0000000
NODE_28819_length_570_cov_5.010616	179	216	8	18	37	0.4864865
NODE_28819_length_570_cov_5.010616	179	216	10	19	37	0.5135135
NODE_28819_length_570_cov_5.010616	189	269	6	4	80	0.0500000
NODE_28819_length_570_cov_5.010616	189	269	8	57	80	0.7125000
NODE_28819_length_570_cov_5.010616	189	269	10	19	80	0.2375000
NODE_28828_length_570_cov_3.898089	236	316	0	68	80	0.8500000
NODE_28828_length_570_cov_3.898089	236	316	2	12	80	0.1500000
NODE_28828_length_570_cov_3.898089	289	369	0	15	80	0.1875000
NODE_28828_length_570_cov_3.898089	289	369	2	65	80	0.8125000
NODE_28840_length_570_cov_2.938429	202	280	0	17	78	0.2179487
NODE_28840_length_570_cov_2.938429	202	280	2	11	78	0.1410256
NODE_28840_length_570_cov_2.938429	202	280	4	2	78	0.0256410
NODE_28840_length_570_cov_2.938429	202	280	6	5	78	0.0641026
NODE_28840_length_570_cov_2.938429	202	280	7	9	78	0.1153846
NODE_28840_length_570_cov_2.938429	202	280	8	34	78	0.4358974
NODE_28840_length_570_cov_2.938429	262	333	0	8	71	0.1126761
NODE_28840_length_570_cov_2.938429	262	333	2	63	71	0.8873239
NODE_28842_length_570_cov_2.891720	204	260	0	56	56	1.0000000
NODE_28950_length_569_cov_20.559574	275	355	0	21	80	0.2625000
NODE_28950_length_569_cov_20.559574	275	355	4	59	80	0.7375000
NODE_28950_length_569_cov_20.559574	328	408	4	80	80	1.0000000
NODE_28951_length_569_cov_15.282979	272	352	2	3	80	0.0375000
NODE_28951_length_569_cov_15.282979	272	352	4	77	80	0.9625000
NODE_28951_length_569_cov_15.282979	325	405	0	15	80	0.1875000
NODE_28951_length_569_cov_15.282979	325	405	2	38	80	0.4750000
NODE_28951_length_569_cov_15.282979	325	405	4	27	80	0.3375000
NODE_28952_length_569_cov_11.023404	280	360	0	80	80	1.0000000
NODE_28952_length_569_cov_11.023404	333	413	0	80	80	1.0000000
NODE_28953_length_569_cov_9.310638	231	277	4	2	46	0.0434783
NODE_28953_length_569_cov_9.310638	231	277	8	7	46	0.1521739
NODE_28953_length_569_cov_9.310638	231	277	10	37	46	0.8043478
NODE_28956_length_569_cov_6.989362	258	338	19	6	80	0.0750000
NODE_28956_length_569_cov_6.989362	258	338	22	44	80	0.5500000
NODE_28956_length_569_cov_6.989362	258	338	23	3	80	0.0375000
NODE_28956_length_569_cov_6.989362	258	338	24	12	80	0.1500000
NODE_28956_length_569_cov_6.989362	258	338	27	8	80	0.1000000
NODE_28956_length_569_cov_6.989362	258	338	28	7	80	0.0875000
NODE_28956_length_569_cov_6.989362	294	329	22	8	35	0.2285714
NODE_28956_length_569_cov_6.989362	294	329	24	12	35	0.3428572
NODE_28956_length_569_cov_6.989362	294	329	27	8	35	0.2285714
NODE_28956_length_569_cov_6.989362	294	329	28	7	35	0.2000000
NODE_28956_length_569_cov_6.989362	296	338	19	6	42	0.1428571
NODE_28956_length_569_cov_6.989362	296	338	22	6	42	0.1428571
NODE_28956_length_569_cov_6.989362	296	338	23	3	42	0.0714286
NODE_28956_length_569_cov_6.989362	296	338	24	12	42	0.2857143
NODE_28956_length_569_cov_6.989362	296	338	27	8	42	0.1904762
NODE_28956_length_569_cov_6.989362	296	338	28	7	42	0.1666667
NODE_28957_length_569_cov_6.978723	264	344	0	80	80	1.0000000
NODE_28957_length_569_cov_6.978723	317	397	0	64	80	0.8000000
NODE_28957_length_569_cov_6.978723	317	397	2	16	80	0.2000000
NODE_28960_length_569_cov_6.434043	228	308	0	80	80	1.0000000
NODE_28973_length_569_cov_3.353191	340	419	2	79	79	1.0000000
NODE_28981_length_569_cov_3.027660	277	348	0	26	71	0.3661972
NODE_28981_length_569_cov_3.027660	277	348	2	30	71	0.4225352
NODE_28981_length_569_cov_3.027660	277	348	5	15	71	0.2112676
NODE_29072_length_568_cov_59.729211	124	204	0	80	80	1.0000000
NODE_29072_length_568_cov_59.729211	177	257	0	80	80	1.0000000
NODE_29075_length_568_cov_7.763326	215	294	0	79	79	1.0000000
NODE_29075_length_568_cov_7.763326	267	347	0	45	80	0.5625000
NODE_29075_length_568_cov_7.763326	267	347	2	35	80	0.4375000
NODE_29078_length_568_cov_6.257996	397	471	0	74	74	1.0000000
NODE_29091_length_568_cov_3.748401	170	236	0	66	66	1.0000000
NODE_29091_length_568_cov_3.748401	262	311	0	49	49	1.0000000
NODE_29133_length_568_cov_1.769723	192	233	0	41	41	1.0000000
NODE_29160_length_568_cov_1.358209	355	432	11	7	77	0.0909091
NODE_29160_length_568_cov_1.358209	355	432	12	52	77	0.6753247
NODE_29160_length_568_cov_1.358209	355	432	14	4	77	0.0519481
NODE_29160_length_568_cov_1.358209	355	432	15	8	77	0.1038961
NODE_29160_length_568_cov_1.358209	355	432	16	6	77	0.0779221
NODE_29182_length_568_cov_1.038380	195	275	0	80	80	1.0000000
NODE_29216_length_567_cov_21.155983	347	427	0	41	80	0.5125000
NODE_29216_length_567_cov_21.155983	347	427	2	39	80	0.4875000
NODE_29216_length_567_cov_21.155983	400	480	2	80	80	1.0000000
NODE_29217_length_567_cov_18.292735	367	447	0	80	80	1.0000000
NODE_29217_length_567_cov_18.292735	420	500	0	80	80	1.0000000
NODE_29218_length_567_cov_17.579060	259	339	0	1	80	0.0125000
NODE_29218_length_567_cov_17.579060	259	339	4	79	80	0.9875000
NODE_29218_length_567_cov_17.579060	312	392	0	24	80	0.3000000
NODE_29218_length_567_cov_17.579060	312	392	2	7	80	0.0875000
NODE_29218_length_567_cov_17.579060	312	392	4	49	80	0.6125000
NODE_29220_length_567_cov_15.457265	276	356	0	2	80	0.0250000
NODE_29220_length_567_cov_15.457265	276	356	6	7	80	0.0875000
NODE_29220_length_567_cov_15.457265	276	356	8	50	80	0.6250000
NODE_29220_length_567_cov_15.457265	276	356	10	21	80	0.2625000
NODE_29220_length_567_cov_15.457265	329	409	2	37	80	0.4625000
NODE_29220_length_567_cov_15.457265	329	409	8	13	80	0.1625000
NODE_29220_length_567_cov_15.457265	329	409	10	30	80	0.3750000
NODE_29221_length_567_cov_14.393162	270	350	0	80	80	1.0000000
NODE_29221_length_567_cov_14.393162	323	403	0	80	80	1.0000000
NODE_29225_length_567_cov_6.611111	356	436	0	34	80	0.4250000
NODE_29225_length_567_cov_6.611111	356	436	2	46	80	0.5750000
NODE_29225_length_567_cov_6.611111	409	489	0	79	80	0.9875000
NODE_29225_length_567_cov_6.611111	409	489	2	1	80	0.0125000
NODE_29245_length_567_cov_2.884615	204	284	0	80	80	1.0000000
NODE_29245_length_567_cov_2.884615	204	254	0	50	50	1.0000000
NODE_29245_length_567_cov_2.884615	266	297	0	31	31	1.0000000
NODE_29363_length_566_cov_47.747323	157	237	2	5	80	0.0625000
NODE_29363_length_566_cov_47.747323	157	237	6	52	80	0.6500000
NODE_29363_length_566_cov_47.747323	157	237	8	4	80	0.0500000
NODE_29363_length_566_cov_47.747323	157	237	10	19	80	0.2375000
NODE_29363_length_566_cov_47.747323	210	290	4	3	80	0.0375000
NODE_29363_length_566_cov_47.747323	210	290	6	4	80	0.0500000
NODE_29363_length_566_cov_47.747323	210	290	8	54	80	0.6750000
NODE_29363_length_566_cov_47.747323	210	290	10	19	80	0.2375000
NODE_29364_length_566_cov_44.824411	14	94	34	3	80	0.0375000
NODE_29364_length_566_cov_44.824411	14	94	36	8	80	0.1000000
NODE_29364_length_566_cov_44.824411	14	94	38	1	80	0.0125000
NODE_29364_length_566_cov_44.824411	14	94	40	2	80	0.0250000
NODE_29364_length_566_cov_44.824411	14	94	42	2	80	0.0250000
NODE_29364_length_566_cov_44.824411	14	94	44	1	80	0.0125000
NODE_29364_length_566_cov_44.824411	14	94	48	1	80	0.0125000
NODE_29364_length_566_cov_44.824411	14	94	52	4	80	0.0500000
NODE_29364_length_566_cov_44.824411	14	94	56	3	80	0.0375000
NODE_29364_length_566_cov_44.824411	14	94	58	8	80	0.1000000
NODE_29364_length_566_cov_44.824411	14	94	62	1	80	0.0125000
NODE_29364_length_566_cov_44.824411	14	94	64	2	80	0.0250000
NODE_29364_length_566_cov_44.824411	14	94	68	2	80	0.0250000
NODE_29364_length_566_cov_44.824411	14	94	70	2	80	0.0250000
NODE_29364_length_566_cov_44.824411	14	94	74	40	80	0.5000000
NODE_29364_length_566_cov_44.824411	15	94	34	2	79	0.0253165
NODE_29364_length_566_cov_44.824411	15	94	36	8	79	0.1012658
NODE_29364_length_566_cov_44.824411	15	94	38	1	79	0.0126582
NODE_29364_length_566_cov_44.824411	15	94	40	2	79	0.0253165
NODE_29364_length_566_cov_44.824411	15	94	42	2	79	0.0253165
NODE_29364_length_566_cov_44.824411	15	94	44	1	79	0.0126582
NODE_29364_length_566_cov_44.824411	15	94	48	1	79	0.0126582
NODE_29364_length_566_cov_44.824411	15	94	52	4	79	0.0506329
NODE_29364_length_566_cov_44.824411	15	94	56	3	79	0.0379747
NODE_29364_length_566_cov_44.824411	15	94	58	8	79	0.1012658
NODE_29364_length_566_cov_44.824411	15	94	62	1	79	0.0126582
NODE_29364_length_566_cov_44.824411	15	94	64	2	79	0.0253165
NODE_29364_length_566_cov_44.824411	15	94	68	2	79	0.0253165
NODE_29364_length_566_cov_44.824411	15	94	70	2	79	0.0253165
NODE_29364_length_566_cov_44.824411	15	94	74	40	79	0.5063291
NODE_29364_length_566_cov_44.824411	67	147	12	7	80	0.0875000
NODE_29364_length_566_cov_44.824411	67	147	14	1	80	0.0125000
NODE_29364_length_566_cov_44.824411	67	147	18	3	80	0.0375000
NODE_29364_length_566_cov_44.824411	67	147	26	2	80	0.0250000
NODE_29364_length_566_cov_44.824411	67	147	28	1	80	0.0125000
NODE_29364_length_566_cov_44.824411	67	147	32	2	80	0.0250000
NODE_29364_length_566_cov_44.824411	67	147	34	1	80	0.0125000
NODE_29364_length_566_cov_44.824411	67	147	36	1	80	0.0125000
NODE_29364_length_566_cov_44.824411	67	147	40	2	80	0.0250000
NODE_29364_length_566_cov_44.824411	67	147	42	1	80	0.0125000
NODE_29364_length_566_cov_44.824411	67	147	44	3	80	0.0375000
NODE_29364_length_566_cov_44.824411	67	147	49	1	80	0.0125000
NODE_29364_length_566_cov_44.824411	67	147	58	3	80	0.0375000
NODE_29364_length_566_cov_44.824411	67	147	62	10	80	0.1250000
NODE_29364_length_566_cov_44.824411	67	147	64	2	80	0.0250000
NODE_29364_length_566_cov_44.824411	67	147	70	1	80	0.0125000
NODE_29364_length_566_cov_44.824411	67	147	72	3	80	0.0375000
NODE_29364_length_566_cov_44.824411	67	147	74	36	80	0.4500000
NODE_29364_length_566_cov_44.824411	67	147	12	7	80	0.0875000
NODE_29364_length_566_cov_44.824411	67	147	14	1	80	0.0125000
NODE_29364_length_566_cov_44.824411	67	147	18	3	80	0.0375000
NODE_29364_length_566_cov_44.824411	67	147	26	2	80	0.0250000
NODE_29364_length_566_cov_44.824411	67	147	28	1	80	0.0125000
NODE_29364_length_566_cov_44.824411	67	147	32	2	80	0.0250000
NODE_29364_length_566_cov_44.824411	67	147	34	1	80	0.0125000
NODE_29364_length_566_cov_44.824411	67	147	36	1	80	0.0125000
NODE_29364_length_566_cov_44.824411	67	147	40	2	80	0.0250000
NODE_29364_length_566_cov_44.824411	67	147	42	1	80	0.0125000
NODE_29364_length_566_cov_44.824411	67	147	44	3	80	0.0375000
NODE_29364_length_566_cov_44.824411	67	147	49	1	80	0.0125000
NODE_29364_length_566_cov_44.824411	67	147	58	3	80	0.0375000
NODE_29364_length_566_cov_44.824411	67	147	62	10	80	0.1250000
NODE_29364_length_566_cov_44.824411	67	147	64	2	80	0.0250000
NODE_29364_length_566_cov_44.824411	67	147	70	1	80	0.0125000
NODE_29364_length_566_cov_44.824411	67	147	72	3	80	0.0375000
NODE_29364_length_566_cov_44.824411	67	147	74	36	80	0.4500000
NODE_29364_length_566_cov_44.824411	77	147	12	7	70	0.1000000
NODE_29364_length_566_cov_44.824411	77	147	14	1	70	0.0142857
NODE_29364_length_566_cov_44.824411	77	147	18	3	70	0.0428571
NODE_29364_length_566_cov_44.824411	77	147	26	2	70	0.0285714
NODE_29364_length_566_cov_44.824411	77	147	28	1	70	0.0142857
NODE_29364_length_566_cov_44.824411	77	147	32	2	70	0.0285714
NODE_29364_length_566_cov_44.824411	77	147	34	1	70	0.0142857
NODE_29364_length_566_cov_44.824411	77	147	36	1	70	0.0142857
NODE_29364_length_566_cov_44.824411	77	147	40	2	70	0.0285714
NODE_29364_length_566_cov_44.824411	77	147	42	1	70	0.0142857
NODE_29364_length_566_cov_44.824411	77	147	44	3	70	0.0428571
NODE_29364_length_566_cov_44.824411	77	147	49	1	70	0.0142857
NODE_29364_length_566_cov_44.824411	77	147	58	3	70	0.0428571
NODE_29364_length_566_cov_44.824411	77	147	62	10	70	0.1428571
NODE_29364_length_566_cov_44.824411	77	147	64	2	70	0.0285714
NODE_29364_length_566_cov_44.824411	77	147	70	1	70	0.0142857
NODE_29364_length_566_cov_44.824411	77	147	72	3	70	0.0428571
NODE_29364_length_566_cov_44.824411	77	147	74	26	70	0.3714286
NODE_29364_length_566_cov_44.824411	143	223	0	68	80	0.8500000
NODE_29364_length_566_cov_44.824411	143	223	2	1	80	0.0125000
NODE_29364_length_566_cov_44.824411	143	223	4	3	80	0.0375000
NODE_29364_length_566_cov_44.824411	143	223	6	2	80	0.0250000
NODE_29364_length_566_cov_44.824411	143	223	12	6	80	0.0750000
NODE_29364_length_566_cov_44.824411	196	276	0	80	80	1.0000000
NODE_29367_length_566_cov_18.494647	344	424	0	80	80	1.0000000
NODE_29367_length_566_cov_18.494647	397	477	0	80	80	1.0000000
NODE_29368_length_566_cov_17.537473	324	404	0	80	80	1.0000000
NODE_29368_length_566_cov_17.537473	377	457	0	80	80	1.0000000
NODE_29369_length_566_cov_13.019272	157	237	0	23	80	0.2875000
NODE_29369_length_566_cov_13.019272	157	237	2	57	80	0.7125000
NODE_29369_length_566_cov_13.019272	210	290	0	76	80	0.9500000
NODE_29369_length_566_cov_13.019272	210	290	2	4	80	0.0500000
NODE_29371_length_566_cov_9.513919	191	279	0	7	88	0.0795455
NODE_29371_length_566_cov_9.513919	191	279	6	58	88	0.6590909
NODE_29371_length_566_cov_9.513919	191	279	8	23	88	0.2613636
NODE_29371_length_566_cov_9.513919	252	332	6	8	80	0.1000000
NODE_29371_length_566_cov_9.513919	252	332	8	72	80	0.9000000
NODE_29397_length_566_cov_3.239829	292	334	0	42	42	1.0000000
NODE_29397_length_566_cov_3.239829	351	375	0	24	24	1.0000000
NODE_29437_length_566_cov_1.698073	432	481	0	49	49	1.0000000
NODE_29472_length_566_cov_0.957173	378	405	4	1	27	0.0370370
NODE_29472_length_566_cov_0.957173	378	405	6	26	27	0.9629630
NODE_29503_length_565_cov_10.508584	202	280	0	78	78	1.0000000
NODE_29503_length_565_cov_10.508584	253	334	0	81	81	1.0000000
NODE_29509_length_565_cov_7.560086	170	246	4	2	76	0.0263158
NODE_29509_length_565_cov_7.560086	170	246	6	1	76	0.0131579
NODE_29509_length_565_cov_7.560086	170	246	8	6	76	0.0789474
NODE_29509_length_565_cov_7.560086	170	246	10	2	76	0.0263158
NODE_29509_length_565_cov_7.560086	170	246	12	4	76	0.0526316
NODE_29509_length_565_cov_7.560086	170	246	16	36	76	0.4736842
NODE_29509_length_565_cov_7.560086	170	246	17	9	76	0.1184211
NODE_29509_length_565_cov_7.560086	170	246	18	16	76	0.2105263
NODE_29520_length_565_cov_4.045064	231	311	0	5	80	0.0625000
NODE_29520_length_565_cov_4.045064	231	311	2	72	80	0.9000000
NODE_29520_length_565_cov_4.045064	231	311	4	3	80	0.0375000
NODE_29520_length_565_cov_4.045064	284	364	2	35	80	0.4375000
NODE_29520_length_565_cov_4.045064	284	364	4	9	80	0.1125000
NODE_29520_length_565_cov_4.045064	284	364	8	36	80	0.4500000
NODE_29528_length_565_cov_3.399142	161	241	0	68	80	0.8500000
NODE_29528_length_565_cov_3.399142	161	241	2	12	80	0.1500000
NODE_29528_length_565_cov_3.399142	214	294	0	15	80	0.1875000
NODE_29528_length_565_cov_3.399142	214	294	2	65	80	0.8125000
NODE_29542_length_565_cov_2.542918	302	382	0	49	80	0.6125000
NODE_29542_length_565_cov_2.542918	302	382	2	31	80	0.3875000
NODE_29542_length_565_cov_2.542918	355	435	0	80	80	1.0000000
NODE_29650_length_564_cov_46.901075	129	209	0	50	80	0.6250000
NODE_29650_length_564_cov_46.901075	129	209	4	30	80	0.3750000
NODE_29650_length_564_cov_46.901075	182	262	4	78	80	0.9750000
NODE_29650_length_564_cov_46.901075	182	262	6	2	80	0.0250000
NODE_29651_length_564_cov_13.520430	300	380	0	28	80	0.3500000
NODE_29651_length_564_cov_13.520430	300	380	2	52	80	0.6500000
NODE_29651_length_564_cov_13.520430	353	433	0	46	80	0.5750000
NODE_29651_length_564_cov_13.520430	353	433	2	34	80	0.4250000
NODE_29653_length_564_cov_7.965591	291	332	0	41	41	1.0000000
NODE_29796_length_563_cov_24.487069	97	177	6	55	80	0.6875000
NODE_29796_length_563_cov_24.487069	97	177	10	25	80	0.3125000
NODE_29796_length_563_cov_24.487069	150	230	4	33	80	0.4125000
NODE_29796_length_563_cov_24.487069	150	230	6	2	80	0.0250000
NODE_29796_length_563_cov_24.487069	150	230	8	9	80	0.1125000
NODE_29796_length_563_cov_24.487069	150	230	10	36	80	0.4500000
NODE_29800_length_563_cov_6.758621	301	367	4	13	66	0.1969697
NODE_29800_length_563_cov_6.758621	301	367	6	20	66	0.3030303
NODE_29800_length_563_cov_6.758621	301	367	8	2	66	0.0303030
NODE_29800_length_563_cov_6.758621	301	367	10	4	66	0.0606061
NODE_29800_length_563_cov_6.758621	301	367	12	24	66	0.3636364
NODE_29800_length_563_cov_6.758621	301	367	14	3	66	0.0454545
NODE_29800_length_563_cov_6.758621	378	422	0	3	44	0.0681818
NODE_29800_length_563_cov_6.758621	378	422	2	41	44	0.9318182
NODE_29802_length_563_cov_5.762931	48	135	0	87	87	1.0000000
NODE_29802_length_563_cov_5.762931	108	188	0	80	80	1.0000000
NODE_29808_length_563_cov_4.176724	197	277	0	80	80	1.0000000
NODE_29808_length_563_cov_4.176724	250	330	0	80	80	1.0000000
NODE_29809_length_563_cov_4.155172	273	315	7	25	42	0.5952381
NODE_29809_length_563_cov_4.155172	273	315	13	2	42	0.0476190
NODE_29809_length_563_cov_4.155172	273	315	14	5	42	0.1190476
NODE_29809_length_563_cov_4.155172	273	315	18	10	42	0.2380952
NODE_29809_length_563_cov_4.155172	288	358	7	10	70	0.1428571
NODE_29809_length_563_cov_4.155172	288	358	13	2	70	0.0285714
NODE_29809_length_563_cov_4.155172	288	358	14	5	70	0.0714286
NODE_29809_length_563_cov_4.155172	288	358	18	53	70	0.7571428
NODE_29925_length_562_cov_31.194384	47	127	4	66	80	0.8250000
NODE_29925_length_562_cov_31.194384	47	127	6	1	80	0.0125000
NODE_29925_length_562_cov_31.194384	47	127	7	13	80	0.1625000
NODE_29925_length_562_cov_31.194384	100	180	4	34	80	0.4250000
NODE_29925_length_562_cov_31.194384	100	180	6	1	80	0.0125000
NODE_29925_length_562_cov_31.194384	100	180	7	14	80	0.1750000
NODE_29925_length_562_cov_31.194384	100	180	8	31	80	0.3875000
NODE_29926_length_562_cov_29.857451	33	113	0	33	80	0.4125000
NODE_29926_length_562_cov_29.857451	33	113	12	21	80	0.2625000
NODE_29926_length_562_cov_29.857451	33	113	14	26	80	0.3250000
NODE_29926_length_562_cov_29.857451	86	166	12	22	80	0.2750000
NODE_29926_length_562_cov_29.857451	86	166	14	58	80	0.7250000
NODE_29927_length_562_cov_23.194384	245	325	0	3	80	0.0375000
NODE_29927_length_562_cov_23.194384	245	325	2	77	80	0.9625000
NODE_29927_length_562_cov_23.194384	298	378	0	29	80	0.3625000
NODE_29927_length_562_cov_23.194384	298	378	2	51	80	0.6375000
NODE_29930_length_562_cov_10.304536	271	321	0	23	50	0.4600000
NODE_29930_length_562_cov_10.304536	271	321	2	27	50	0.5400000
NODE_29931_length_562_cov_9.131749	265	346	0	35	81	0.4320988
NODE_29931_length_562_cov_9.131749	265	346	2	46	81	0.5679013
NODE_29931_length_562_cov_9.131749	319	399	0	80	80	1.0000000
NODE_29960_length_562_cov_2.961123	350	398	3	5	48	0.1041667
NODE_29960_length_562_cov_2.961123	350	398	7	1	48	0.0208333
NODE_29960_length_562_cov_2.961123	350	398	9	1	48	0.0208333
NODE_29960_length_562_cov_2.961123	350	398	11	4	48	0.0833333
NODE_29960_length_562_cov_2.961123	350	398	12	1	48	0.0208333
NODE_29960_length_562_cov_2.961123	350	398	18	32	48	0.6666667
NODE_29960_length_562_cov_2.961123	350	398	20	4	48	0.0833333
NODE_30083_length_561_cov_18.049784	54	134	12	3	80	0.0375000
NODE_30083_length_561_cov_18.049784	54	134	16	21	80	0.2625000
NODE_30083_length_561_cov_18.049784	54	134	20	31	80	0.3875000
NODE_30083_length_561_cov_18.049784	54	134	27	1	80	0.0125000
NODE_30083_length_561_cov_18.049784	54	134	28	24	80	0.3000000
NODE_30083_length_561_cov_18.049784	107	187	6	7	80	0.0875000
NODE_30083_length_561_cov_18.049784	107	187	8	41	80	0.5125000
NODE_30083_length_561_cov_18.049784	107	187	12	8	80	0.1000000
NODE_30083_length_561_cov_18.049784	107	187	28	24	80	0.3000000
NODE_30087_length_561_cov_5.348485	208	274	0	53	66	0.8030303
NODE_30087_length_561_cov_5.348485	208	274	2	13	66	0.1969697
NODE_30105_length_561_cov_2.787879	216	285	0	30	69	0.4347826
NODE_30105_length_561_cov_2.787879	216	285	2	39	69	0.5652174
NODE_30120_length_561_cov_2.233766	339	419	0	80	80	1.0000000
NODE_30120_length_561_cov_2.233766	391	445	0	54	54	1.0000000
NODE_30120_length_561_cov_2.233766	392	438	0	46	46	1.0000000
NODE_30133_length_561_cov_1.803030	258	334	0	76	76	1.0000000
NODE_30224_length_560_cov_41.433839	67	147	2	80	80	1.0000000
NODE_30224_length_560_cov_41.433839	120	200	0	38	80	0.4750000
NODE_30224_length_560_cov_41.433839	120	200	2	42	80	0.5250000
NODE_30225_length_560_cov_35.993492	366	446	0	14	80	0.1750000
NODE_30225_length_560_cov_35.993492	366	446	2	66	80	0.8250000
NODE_30225_length_560_cov_35.993492	419	499	0	61	80	0.7625000
NODE_30225_length_560_cov_35.993492	419	499	2	19	80	0.2375000
NODE_30226_length_560_cov_20.433839	342	422	0	51	80	0.6375000
NODE_30226_length_560_cov_20.433839	342	422	2	29	80	0.3625000
NODE_30226_length_560_cov_20.433839	395	475	0	32	80	0.4000000
NODE_30226_length_560_cov_20.433839	395	475	2	48	80	0.6000000
NODE_30227_length_560_cov_13.850325	274	327	6	53	53	1.0000000
NODE_30228_length_560_cov_12.075922	233	314	10	2	81	0.0246914
NODE_30228_length_560_cov_12.075922	233	314	12	15	81	0.1851852
NODE_30228_length_560_cov_12.075922	233	314	14	2	81	0.0246914
NODE_30228_length_560_cov_12.075922	233	314	16	19	81	0.2345679
NODE_30228_length_560_cov_12.075922	233	314	18	2	81	0.0246914
NODE_30228_length_560_cov_12.075922	233	314	22	4	81	0.0493827
NODE_30228_length_560_cov_12.075922	233	314	24	37	81	0.4567901
NODE_30229_length_560_cov_8.594360	263	343	0	56	80	0.7000000
NODE_30229_length_560_cov_8.594360	263	343	2	24	80	0.3000000
NODE_30229_length_560_cov_8.594360	316	396	0	80	80	1.0000000
NODE_30237_length_560_cov_5.227766	264	328	4	9	64	0.1406250
NODE_30237_length_560_cov_5.227766	264	328	6	2	64	0.0312500
NODE_30237_length_560_cov_5.227766	264	328	8	5	64	0.0781250
NODE_30237_length_560_cov_5.227766	264	328	10	1	64	0.0156250
NODE_30237_length_560_cov_5.227766	264	328	12	3	64	0.0468750
NODE_30237_length_560_cov_5.227766	264	328	16	44	64	0.6875000
NODE_30238_length_560_cov_5.056399	299	379	0	80	80	1.0000000
NODE_30238_length_560_cov_5.056399	352	432	0	80	80	1.0000000
NODE_30244_length_560_cov_4.518438	156	236	2	80	80	1.0000000
NODE_30281_length_560_cov_2.154013	204	275	0	13	71	0.1830986
NODE_30281_length_560_cov_2.154013	204	275	2	42	71	0.5915493
NODE_30281_length_560_cov_2.154013	204	275	4	16	71	0.2253521
NODE_30281_length_560_cov_2.154013	255	335	2	22	80	0.2750000
NODE_30281_length_560_cov_2.154013	255	335	4	58	80	0.7250000
NODE_30288_length_560_cov_2.017354	52	114	0	62	62	1.0000000
NODE_30363_length_559_cov_37.526087	289	370	0	81	81	1.0000000
NODE_30363_length_559_cov_37.526087	343	423	0	80	80	1.0000000
NODE_30363_length_559_cov_37.526087	419	500	0	81	81	1.0000000
NODE_30363_length_559_cov_37.526087	473	553	0	80	80	1.0000000
NODE_30365_length_559_cov_19.126087	388	468	0	1	80	0.0125000
NODE_30365_length_559_cov_19.126087	388	468	8	79	80	0.9875000
NODE_30365_length_559_cov_19.126087	441	521	0	54	80	0.6750000
NODE_30365_length_559_cov_19.126087	441	521	8	26	80	0.3250000
NODE_30366_length_559_cov_12.489130	262	341	0	50	79	0.6329114
NODE_30366_length_559_cov_12.489130	262	341	4	29	79	0.3670886
NODE_30366_length_559_cov_12.489130	316	394	4	78	78	1.0000000
NODE_30370_length_559_cov_6.530435	283	363	0	80	80	1.0000000
NODE_30377_length_559_cov_4.930435	112	192	0	20	80	0.2500000
NODE_30377_length_559_cov_4.930435	112	192	2	43	80	0.5375000
NODE_30377_length_559_cov_4.930435	112	192	4	17	80	0.2125000
NODE_30377_length_559_cov_4.930435	165	244	0	5	79	0.0632911
NODE_30377_length_559_cov_4.930435	165	244	2	5	79	0.0632911
NODE_30377_length_559_cov_4.930435	165	244	4	69	79	0.8734177
NODE_30419_length_559_cov_1.776087	395	433	105	4	38	0.1052632
NODE_30419_length_559_cov_1.776087	395	433	107	5	38	0.1315790
NODE_30419_length_559_cov_1.776087	395	433	108	4	38	0.1052632
NODE_30419_length_559_cov_1.776087	395	433	109	11	38	0.2894737
NODE_30419_length_559_cov_1.776087	395	433	111	7	38	0.1842105
NODE_30419_length_559_cov_1.776087	395	433	112	2	38	0.0526316
NODE_30419_length_559_cov_1.776087	395	433	113	2	38	0.0526316
NODE_30419_length_559_cov_1.776087	395	433	115	3	38	0.0789474
NODE_30480_length_558_cov_13.102397	297	364	0	67	67	1.0000000
NODE_30482_length_558_cov_9.309368	369	449	0	53	80	0.6625000
NODE_30482_length_558_cov_9.309368	369	449	4	27	80	0.3375000
NODE_30482_length_558_cov_9.309368	422	502	0	80	80	1.0000000
NODE_30489_length_558_cov_5.921569	304	361	0	29	57	0.5087720
NODE_30489_length_558_cov_5.921569	304	361	2	28	57	0.4912281
NODE_30493_length_558_cov_4.801743	197	266	0	52	69	0.7536232
NODE_30493_length_558_cov_4.801743	197	266	2	17	69	0.2463768
NODE_30493_length_558_cov_4.801743	197	277	0	63	80	0.7875000
NODE_30493_length_558_cov_4.801743	197	277	2	17	80	0.2125000
NODE_30493_length_558_cov_4.801743	250	330	0	80	80	1.0000000
NODE_30493_length_558_cov_4.801743	250	330	0	80	80	1.0000000
NODE_30495_length_558_cov_4.570806	188	244	6	1	56	0.0178571
NODE_30495_length_558_cov_4.570806	188	244	8	13	56	0.2321429
NODE_30495_length_558_cov_4.570806	188	244	10	6	56	0.1071429
NODE_30495_length_558_cov_4.570806	188	244	12	36	56	0.6428571
NODE_30536_length_558_cov_2.259259	236	294	2	55	58	0.9482759
NODE_30536_length_558_cov_2.259259	236	294	4	3	58	0.0517241
NODE_30536_length_558_cov_2.259259	267	347	2	24	80	0.3000000
NODE_30536_length_558_cov_2.259259	267	347	4	3	80	0.0375000
NODE_30536_length_558_cov_2.259259	267	347	6	14	80	0.1750000
NODE_30536_length_558_cov_2.259259	267	347	8	39	80	0.4875000
NODE_30568_length_558_cov_1.544662	403	483	0	71	80	0.8875000
NODE_30568_length_558_cov_1.544662	403	483	2	9	80	0.1125000
NODE_30568_length_558_cov_1.544662	456	536	0	18	80	0.2250000
NODE_30568_length_558_cov_1.544662	456	536	2	62	80	0.7750000
NODE_30623_length_557_cov_9.141921	255	335	0	80	80	1.0000000
NODE_30623_length_557_cov_9.141921	308	388	0	80	80	1.0000000
NODE_30626_length_557_cov_7.316594	210	290	0	8	80	0.1000000
NODE_30626_length_557_cov_7.316594	210	290	2	72	80	0.9000000
NODE_30626_length_557_cov_7.316594	263	341	0	59	78	0.7564102
NODE_30626_length_557_cov_7.316594	263	341	2	19	78	0.2435897
NODE_30636_length_557_cov_4.259825	185	267	2	57	82	0.6951219
NODE_30636_length_557_cov_4.259825	185	267	4	23	82	0.2804878
NODE_30636_length_557_cov_4.259825	185	267	7	2	82	0.0243902
NODE_30646_length_557_cov_3.794760	131	188	0	5	57	0.0877193
NODE_30646_length_557_cov_3.794760	131	188	1	3	57	0.0526316
NODE_30646_length_557_cov_3.794760	131	188	2	49	57	0.8596491
NODE_30646_length_557_cov_3.794760	139	219	2	80	80	1.0000000
NODE_30650_length_557_cov_3.517467	246	325	0	53	79	0.6708861
NODE_30650_length_557_cov_3.517467	246	325	2	26	79	0.3291139
NODE_30650_length_557_cov_3.517467	298	378	0	3	80	0.0375000
NODE_30650_length_557_cov_3.517467	298	378	2	77	80	0.9625000
NODE_30652_length_557_cov_3.390830	366	395	23	2	29	0.0689655
NODE_30652_length_557_cov_3.390830	366	395	25	4	29	0.1379310
NODE_30652_length_557_cov_3.390830	366	395	27	4	29	0.1379310
NODE_30652_length_557_cov_3.390830	366	395	29	2	29	0.0689655
NODE_30652_length_557_cov_3.390830	366	395	31	6	29	0.2068966
NODE_30652_length_557_cov_3.390830	366	395	33	8	29	0.2758621
NODE_30652_length_557_cov_3.390830	366	395	35	3	29	0.1034483
NODE_30792_length_556_cov_37.258206	122	202	0	80	80	1.0000000
NODE_30792_length_556_cov_37.258206	175	255	0	80	80	1.0000000
NODE_30793_length_556_cov_15.266958	360	440	2	59	80	0.7375000
NODE_30793_length_556_cov_15.266958	360	440	4	21	80	0.2625000
NODE_30793_length_556_cov_15.266958	413	493	0	28	80	0.3500000
NODE_30793_length_556_cov_15.266958	413	493	2	48	80	0.6000000
NODE_30793_length_556_cov_15.266958	413	493	4	4	80	0.0500000
NODE_30794_length_556_cov_12.781182	341	421	0	80	80	1.0000000
NODE_30794_length_556_cov_12.781182	394	474	0	80	80	1.0000000
NODE_30795_length_556_cov_11.131291	304	384	6	80	80	1.0000000
NODE_30795_length_556_cov_11.131291	357	437	0	10	80	0.1250000
NODE_30795_length_556_cov_11.131291	357	437	6	70	80	0.8750000
NODE_30797_length_556_cov_7.168490	163	243	0	14	80	0.1750000
NODE_30797_length_556_cov_7.168490	163	243	2	66	80	0.8250000
NODE_30797_length_556_cov_7.168490	216	296	0	31	80	0.3875000
NODE_30797_length_556_cov_7.168490	216	296	2	49	80	0.6125000
NODE_30798_length_556_cov_7.089716	325	379	0	54	54	1.0000000
NODE_30801_length_556_cov_6.505470	232	312	0	38	80	0.4750000
NODE_30801_length_556_cov_6.505470	232	312	2	42	80	0.5250000
NODE_30801_length_556_cov_6.505470	285	365	2	80	80	1.0000000
NODE_30802_length_556_cov_6.496718	140	179	4	34	39	0.8717949
NODE_30802_length_556_cov_6.496718	140	179	6	5	39	0.1282051
NODE_30802_length_556_cov_6.496718	226	255	2	29	29	1.0000000
NODE_30809_length_556_cov_4.457330	197	277	2	1	80	0.0125000
NODE_30809_length_556_cov_4.457330	197	277	6	4	80	0.0500000
NODE_30809_length_556_cov_4.457330	197	277	7	21	80	0.2625000
NODE_30809_length_556_cov_4.457330	197	277	9	1	80	0.0125000
NODE_30809_length_556_cov_4.457330	197	277	13	1	80	0.0125000
NODE_30809_length_556_cov_4.457330	197	277	14	4	80	0.0500000
NODE_30809_length_556_cov_4.457330	197	277	16	6	80	0.0750000
NODE_30809_length_556_cov_4.457330	197	277	18	8	80	0.1000000
NODE_30809_length_556_cov_4.457330	197	277	20	6	80	0.0750000
NODE_30809_length_556_cov_4.457330	197	277	22	1	80	0.0125000
NODE_30809_length_556_cov_4.457330	197	277	24	15	80	0.1875000
NODE_30809_length_556_cov_4.457330	197	277	26	7	80	0.0875000
NODE_30809_length_556_cov_4.457330	197	277	28	5	80	0.0625000
NODE_30818_length_556_cov_3.761488	234	307	0	73	73	1.0000000
NODE_30930_length_555_cov_20.949561	322	402	0	80	80	1.0000000
NODE_30930_length_555_cov_20.949561	375	455	0	80	80	1.0000000
NODE_30931_length_555_cov_16.822368	268	348	0	80	80	1.0000000
NODE_30931_length_555_cov_16.822368	321	401	0	80	80	1.0000000
NODE_30933_length_555_cov_9.912281	313	393	0	80	80	1.0000000
NODE_30935_length_555_cov_8.057018	277	357	0	19	80	0.2375000
NODE_30935_length_555_cov_8.057018	277	357	2	61	80	0.7625000
NODE_30935_length_555_cov_8.057018	330	410	0	18	80	0.2250000
NODE_30935_length_555_cov_8.057018	330	410	2	62	80	0.7750000
NODE_30938_length_555_cov_6.778509	62	92	0	30	30	1.0000000
NODE_30986_length_555_cov_2.177632	208	288	0	68	80	0.8500000
NODE_30986_length_555_cov_2.177632	208	288	2	12	80	0.1500000
NODE_30986_length_555_cov_2.177632	261	329	0	15	68	0.2205882
NODE_30986_length_555_cov_2.177632	261	329	2	53	68	0.7794118
NODE_31092_length_554_cov_11.942857	118	198	0	80	80	1.0000000
NODE_31092_length_554_cov_11.942857	171	251	0	80	80	1.0000000
NODE_31096_length_554_cov_8.426374	242	322	0	16	80	0.2000000
NODE_31096_length_554_cov_8.426374	242	322	2	64	80	0.8000000
NODE_31096_length_554_cov_8.426374	295	375	0	52	80	0.6500000
NODE_31096_length_554_cov_8.426374	295	375	2	28	80	0.3500000
NODE_31101_length_554_cov_6.116484	264	344	0	80	80	1.0000000
NODE_31101_length_554_cov_6.116484	317	393	0	34	76	0.4473684
NODE_31101_length_554_cov_6.116484	317	393	2	42	76	0.5526316
NODE_31115_length_554_cov_3.586813	207	286	0	58	79	0.7341772
NODE_31115_length_554_cov_3.586813	207	286	2	21	79	0.2658228
NODE_31240_length_553_cov_42.017621	197	277	0	41	80	0.5125000
NODE_31240_length_553_cov_42.017621	197	277	2	39	80	0.4875000
NODE_31240_length_553_cov_42.017621	250	330	0	22	80	0.2750000
NODE_31240_length_553_cov_42.017621	250	330	2	58	80	0.7250000
NODE_31241_length_553_cov_28.944934	333	413	0	36	80	0.4500000
NODE_31241_length_553_cov_28.944934	333	413	2	44	80	0.5500000
NODE_31241_length_553_cov_28.944934	386	466	0	80	80	1.0000000
NODE_31242_length_553_cov_12.176211	242	322	0	80	80	1.0000000
NODE_31242_length_553_cov_12.176211	295	375	0	80	80	1.0000000
NODE_31244_length_553_cov_9.876652	232	312	0	80	80	1.0000000
NODE_31244_length_553_cov_9.876652	285	365	0	80	80	1.0000000
NODE_31246_length_553_cov_9.306167	207	287	0	80	80	1.0000000
NODE_31246_length_553_cov_9.306167	207	287	0	80	80	1.0000000
NODE_31246_length_553_cov_9.306167	260	340	0	80	80	1.0000000
NODE_31259_length_553_cov_3.729075	36	93	28	5	57	0.0877193
NODE_31259_length_553_cov_3.729075	36	93	30	4	57	0.0701754
NODE_31259_length_553_cov_3.729075	36	93	32	14	57	0.2456140
NODE_31259_length_553_cov_3.729075	36	93	34	34	57	0.5964912
NODE_31259_length_553_cov_3.729075	89	146	14	5	57	0.0877193
NODE_31259_length_553_cov_3.729075	89	146	16	8	57	0.1403509
NODE_31259_length_553_cov_3.729075	89	146	19	1	57	0.0175439
NODE_31259_length_553_cov_3.729075	89	146	20	4	57	0.0701754
NODE_31259_length_553_cov_3.729075	89	146	22	2	57	0.0350877
NODE_31259_length_553_cov_3.729075	89	146	26	9	57	0.1578947
NODE_31259_length_553_cov_3.729075	89	146	28	8	57	0.1403509
NODE_31259_length_553_cov_3.729075	89	146	30	3	57	0.0526316
NODE_31259_length_553_cov_3.729075	89	146	32	14	57	0.2456140
NODE_31259_length_553_cov_3.729075	89	146	34	3	57	0.0526316
NODE_31266_length_553_cov_3.310573	226	293	0	67	67	1.0000000
NODE_31279_length_553_cov_2.678414	102	180	0	54	78	0.6923077
NODE_31279_length_553_cov_2.678414	102	180	2	24	78	0.3076923
NODE_31279_length_553_cov_2.678414	248	275	0	12	27	0.4444444
NODE_31279_length_553_cov_2.678414	248	275	2	15	27	0.5555556
NODE_31295_length_553_cov_1.958150	416	462	0	4	46	0.0869565
NODE_31295_length_553_cov_1.958150	416	462	2	2	46	0.0434783
NODE_31295_length_553_cov_1.958150	416	462	4	5	46	0.1086956
NODE_31295_length_553_cov_1.958150	416	462	8	8	46	0.1739130
NODE_31295_length_553_cov_1.958150	416	462	12	1	46	0.0217391
NODE_31295_length_553_cov_1.958150	416	462	14	3	46	0.0652174
NODE_31295_length_553_cov_1.958150	416	462	16	11	46	0.2391304
NODE_31295_length_553_cov_1.958150	416	462	18	12	46	0.2608696
NODE_31295_length_553_cov_1.958150	469	515	10	3	46	0.0652174
NODE_31295_length_553_cov_1.958150	469	515	14	4	46	0.0869565
NODE_31295_length_553_cov_1.958150	469	515	16	12	46	0.2608696
NODE_31295_length_553_cov_1.958150	469	515	18	27	46	0.5869565
NODE_31377_length_552_cov_92.070640	298	378	0	80	80	1.0000000
NODE_31377_length_552_cov_92.070640	298	378	0	80	80	1.0000000
NODE_31377_length_552_cov_92.070640	374	454	0	16	80	0.2000000
NODE_31377_length_552_cov_92.070640	374	454	1	6	80	0.0750000
NODE_31377_length_552_cov_92.070640	374	454	3	52	80	0.6500000
NODE_31377_length_552_cov_92.070640	374	454	4	6	80	0.0750000
NODE_31377_length_552_cov_92.070640	374	454	0	16	80	0.2000000
NODE_31377_length_552_cov_92.070640	374	454	1	6	80	0.0750000
NODE_31377_length_552_cov_92.070640	374	454	3	52	80	0.6500000
NODE_31377_length_552_cov_92.070640	374	454	4	6	80	0.0750000
NODE_31377_length_552_cov_92.070640	374	454	0	16	80	0.2000000
NODE_31377_length_552_cov_92.070640	374	454	1	6	80	0.0750000
NODE_31377_length_552_cov_92.070640	374	454	3	52	80	0.6500000
NODE_31377_length_552_cov_92.070640	374	454	4	6	80	0.0750000
NODE_31377_length_552_cov_92.070640	374	454	0	16	80	0.2000000
NODE_31377_length_552_cov_92.070640	374	454	1	6	80	0.0750000
NODE_31377_length_552_cov_92.070640	374	454	3	52	80	0.6500000
NODE_31377_length_552_cov_92.070640	374	454	4	6	80	0.0750000
NODE_31377_length_552_cov_92.070640	374	450	0	16	76	0.2105263
NODE_31377_length_552_cov_92.070640	374	450	1	6	76	0.0789474
NODE_31377_length_552_cov_92.070640	374	450	3	48	76	0.6315789
NODE_31377_length_552_cov_92.070640	374	450	4	6	76	0.0789474
NODE_31377_length_552_cov_92.070640	427	507	3	74	80	0.9250000
NODE_31377_length_552_cov_92.070640	427	507	4	6	80	0.0750000
NODE_31377_length_552_cov_92.070640	427	507	3	74	80	0.9250000
NODE_31377_length_552_cov_92.070640	427	507	4	6	80	0.0750000
NODE_31377_length_552_cov_92.070640	427	498	3	65	71	0.9154930
NODE_31377_length_552_cov_92.070640	427	498	4	6	71	0.0845070
NODE_31377_length_552_cov_92.070640	430	500	3	64	70	0.9142857
NODE_31377_length_552_cov_92.070640	430	500	4	6	70	0.0857143
NODE_31377_length_552_cov_92.070640	432	507	3	70	75	0.9333333
NODE_31377_length_552_cov_92.070640	432	507	4	5	75	0.0666667
NODE_31378_length_552_cov_20.432671	151	231	0	13	80	0.1625000
NODE_31378_length_552_cov_20.432671	151	231	2	67	80	0.8375000
NODE_31378_length_552_cov_20.432671	204	284	0	66	80	0.8250000
NODE_31378_length_552_cov_20.432671	204	284	2	14	80	0.1750000
NODE_31379_length_552_cov_18.075055	257	333	4	14	76	0.1842105
NODE_31379_length_552_cov_18.075055	257	333	6	62	76	0.8157895
NODE_31380_length_552_cov_13.331126	214	294	0	15	80	0.1875000
NODE_31380_length_552_cov_13.331126	214	294	2	16	80	0.2000000
NODE_31380_length_552_cov_13.331126	214	294	4	25	80	0.3125000
NODE_31380_length_552_cov_13.331126	214	294	6	12	80	0.1500000
NODE_31380_length_552_cov_13.331126	214	294	8	2	80	0.0250000
NODE_31380_length_552_cov_13.331126	214	294	9	1	80	0.0125000
NODE_31380_length_552_cov_13.331126	214	294	11	5	80	0.0625000
NODE_31380_length_552_cov_13.331126	214	294	13	4	80	0.0500000
NODE_31380_length_552_cov_13.331126	267	347	0	68	80	0.8500000
NODE_31380_length_552_cov_13.331126	267	347	2	12	80	0.1500000
NODE_31381_length_552_cov_12.774834	360	440	0	47	80	0.5875000
NODE_31381_length_552_cov_12.774834	360	440	2	33	80	0.4125000
NODE_31381_length_552_cov_12.774834	413	493	0	15	80	0.1875000
NODE_31381_length_552_cov_12.774834	413	493	2	65	80	0.8125000
NODE_31384_length_552_cov_8.883002	310	390	0	7	80	0.0875000
NODE_31384_length_552_cov_8.883002	310	390	4	73	80	0.9125000
NODE_31384_length_552_cov_8.883002	363	443	0	39	80	0.4875000
NODE_31384_length_552_cov_8.883002	363	443	3	1	80	0.0125000
NODE_31384_length_552_cov_8.883002	363	443	4	40	80	0.5000000
NODE_31385_length_552_cov_6.916115	206	281	0	75	75	1.0000000
NODE_31538_length_551_cov_34.070796	324	406	0	82	82	1.0000000
NODE_31538_length_551_cov_34.070796	379	444	0	65	65	1.0000000
NODE_31541_length_551_cov_10.252212	164	244	0	42	80	0.5250000
NODE_31541_length_551_cov_10.252212	164	244	2	38	80	0.4750000
NODE_31541_length_551_cov_10.252212	217	297	0	7	80	0.0875000
NODE_31541_length_551_cov_10.252212	217	297	2	73	80	0.9125000
NODE_31543_length_551_cov_8.075221	363	406	0	11	43	0.2558140
NODE_31543_length_551_cov_8.075221	363	406	2	32	43	0.7441860
NODE_31547_length_551_cov_5.668142	213	293	0	4	80	0.0500000
NODE_31547_length_551_cov_5.668142	213	293	6	4	80	0.0500000
NODE_31547_length_551_cov_5.668142	213	293	8	1	80	0.0125000
NODE_31547_length_551_cov_5.668142	213	293	10	71	80	0.8875000
NODE_31547_length_551_cov_5.668142	266	346	0	9	80	0.1125000
NODE_31547_length_551_cov_5.668142	266	346	2	14	80	0.1750000
NODE_31547_length_551_cov_5.668142	266	346	4	6	80	0.0750000
NODE_31547_length_551_cov_5.668142	266	346	10	51	80	0.6375000
NODE_31552_length_551_cov_4.212389	171	242	10	5	71	0.0704225
NODE_31552_length_551_cov_4.212389	171	242	12	35	71	0.4929577
NODE_31552_length_551_cov_4.212389	171	242	14	31	71	0.4366197
NODE_31552_length_551_cov_4.212389	215	263	6	6	48	0.1250000
NODE_31552_length_551_cov_4.212389	215	263	8	10	48	0.2083333
NODE_31552_length_551_cov_4.212389	215	263	14	32	48	0.6666667
NODE_31563_length_551_cov_3.307522	227	307	2	80	80	1.0000000
NODE_31563_length_551_cov_3.307522	280	360	0	41	80	0.5125000
NODE_31563_length_551_cov_3.307522	280	360	2	39	80	0.4875000
NODE_31693_length_550_cov_17.308204	101	181	0	80	80	1.0000000
NODE_31693_length_550_cov_17.308204	154	234	0	80	80	1.0000000
NODE_31700_length_550_cov_5.580931	286	329	0	32	43	0.7441860
NODE_31700_length_550_cov_5.580931	286	329	2	11	43	0.2558140
NODE_31701_length_550_cov_5.490022	458	500	0	5	42	0.1190476
NODE_31701_length_550_cov_5.490022	458	500	2	37	42	0.8809524
NODE_31701_length_550_cov_5.490022	459	523	0	9	64	0.1406250
NODE_31701_length_550_cov_5.490022	459	523	2	55	64	0.8593750
NODE_31703_length_550_cov_5.243902	194	274	0	80	80	1.0000000
NODE_31703_length_550_cov_5.243902	247	327	0	80	80	1.0000000
NODE_31706_length_550_cov_4.815965	184	264	0	80	80	1.0000000
NODE_31726_length_550_cov_3.252772	308	388	12	2	80	0.0250000
NODE_31726_length_550_cov_3.252772	308	388	14	52	80	0.6500000
NODE_31726_length_550_cov_3.252772	308	388	16	26	80	0.3250000
NODE_31756_length_550_cov_1.864745	189	259	0	13	70	0.1857143
NODE_31756_length_550_cov_1.864745	189	259	2	57	70	0.8142857
NODE_31756_length_550_cov_1.864745	189	258	0	13	69	0.1884058
NODE_31756_length_550_cov_1.864745	189	258	2	56	69	0.8115942
NODE_31847_length_549_cov_31.826667	216	292	16	7	76	0.0921053
NODE_31847_length_549_cov_31.826667	216	292	18	3	76	0.0394737
NODE_31847_length_549_cov_31.826667	216	292	22	20	76	0.2631579
NODE_31847_length_549_cov_31.826667	216	292	26	7	76	0.0921053
NODE_31847_length_549_cov_31.826667	216	292	28	12	76	0.1578947
NODE_31847_length_549_cov_31.826667	216	292	30	20	76	0.2631579
NODE_31847_length_549_cov_31.826667	216	292	32	7	76	0.0921053
NODE_31847_length_549_cov_31.826667	267	331	11	2	64	0.0312500
NODE_31847_length_549_cov_31.826667	267	331	13	1	64	0.0156250
NODE_31847_length_549_cov_31.826667	267	331	15	3	64	0.0468750
NODE_31847_length_549_cov_31.826667	267	331	16	8	64	0.1250000
NODE_31847_length_549_cov_31.826667	267	331	18	1	64	0.0156250
NODE_31847_length_549_cov_31.826667	267	331	20	18	64	0.2812500
NODE_31847_length_549_cov_31.826667	267	331	22	20	64	0.3125000
NODE_31847_length_549_cov_31.826667	267	331	26	3	64	0.0468750
NODE_31847_length_549_cov_31.826667	267	331	28	1	64	0.0156250
NODE_31847_length_549_cov_31.826667	267	331	30	7	64	0.1093750
NODE_31848_length_549_cov_14.124444	174	263	0	78	89	0.8764045
NODE_31848_length_549_cov_14.124444	174	263	2	11	89	0.1235955
NODE_31848_length_549_cov_14.124444	242	315	0	10	73	0.1369863
NODE_31848_length_549_cov_14.124444	242	315	2	63	73	0.8630137
NODE_31857_length_549_cov_5.375556	181	257	112	1	76	0.0131579
NODE_31857_length_549_cov_5.375556	181	257	116	1	76	0.0131579
NODE_31857_length_549_cov_5.375556	181	257	119	1	76	0.0131579
NODE_31857_length_549_cov_5.375556	181	257	120	2	76	0.0263158
NODE_31857_length_549_cov_5.375556	181	257	121	2	76	0.0263158
NODE_31857_length_549_cov_5.375556	181	257	123	1	76	0.0131579
NODE_31857_length_549_cov_5.375556	181	257	129	2	76	0.0263158
NODE_31857_length_549_cov_5.375556	181	257	131	1	76	0.0131579
NODE_31857_length_549_cov_5.375556	181	257	133	5	76	0.0657895
NODE_31857_length_549_cov_5.375556	181	257	134	2	76	0.0263158
NODE_31857_length_549_cov_5.375556	181	257	135	1	76	0.0131579
NODE_31857_length_549_cov_5.375556	181	257	138	1	76	0.0131579
NODE_31857_length_549_cov_5.375556	181	257	139	1	76	0.0131579
NODE_31857_length_549_cov_5.375556	181	257	140	1	76	0.0131579
NODE_31857_length_549_cov_5.375556	181	257	142	3	76	0.0394737
NODE_31857_length_549_cov_5.375556	181	257	144	2	76	0.0263158
NODE_31857_length_549_cov_5.375556	181	257	145	1	76	0.0131579
NODE_31857_length_549_cov_5.375556	181	257	146	3	76	0.0394737
NODE_31857_length_549_cov_5.375556	181	257	149	1	76	0.0131579
NODE_31857_length_549_cov_5.375556	181	257	151	3	76	0.0394737
NODE_31857_length_549_cov_5.375556	181	257	153	3	76	0.0394737
NODE_31857_length_549_cov_5.375556	181	257	157	1	76	0.0131579
NODE_31857_length_549_cov_5.375556	181	257	159	2	76	0.0263158
NODE_31857_length_549_cov_5.375556	181	257	161	6	76	0.0789474
NODE_31857_length_549_cov_5.375556	181	257	163	6	76	0.0789474
NODE_31857_length_549_cov_5.375556	181	257	165	14	76	0.1842105
NODE_31857_length_549_cov_5.375556	181	257	166	2	76	0.0263158
NODE_31857_length_549_cov_5.375556	181	257	167	3	76	0.0394737
NODE_31857_length_549_cov_5.375556	181	257	169	1	76	0.0131579
NODE_31857_length_549_cov_5.375556	181	257	173	3	76	0.0394737
NODE_31859_length_549_cov_4.933333	260	340	0	80	80	1.0000000
NODE_31864_length_549_cov_4.537778	345	430	0	85	85	1.0000000
NODE_31864_length_549_cov_4.537778	403	483	0	80	80	1.0000000
NODE_31865_length_549_cov_4.124444	406	486	15	26	80	0.3250000
NODE_31865_length_549_cov_4.124444	406	486	17	2	80	0.0250000
NODE_31865_length_549_cov_4.124444	406	486	19	52	80	0.6500000
NODE_31866_length_549_cov_3.931111	182	219	0	37	37	1.0000000
NODE_31868_length_549_cov_3.893333	287	367	0	10	80	0.1250000
NODE_31868_length_549_cov_3.893333	287	367	2	25	80	0.3125000
NODE_31868_length_549_cov_3.893333	287	367	4	45	80	0.5625000
NODE_31868_length_549_cov_3.893333	340	420	2	22	80	0.2750000
NODE_31868_length_549_cov_3.893333	340	420	4	58	80	0.7250000
NODE_31887_length_549_cov_2.673333	282	343	4	27	61	0.4426230
NODE_31887_length_549_cov_2.673333	282	343	10	34	61	0.5573770
NODE_31890_length_549_cov_2.622222	144	220	4	76	76	1.0000000
NODE_32013_length_548_cov_13.962138	285	371	0	86	86	1.0000000
NODE_32013_length_548_cov_13.962138	344	424	0	80	80	1.0000000
NODE_32022_length_548_cov_4.683742	261	336	2	29	75	0.3866667
NODE_32022_length_548_cov_4.683742	261	336	3	46	75	0.6133333
NODE_32023_length_548_cov_4.670379	140	182	0	42	42	1.0000000
NODE_32023_length_548_cov_4.670379	282	311	4	29	29	1.0000000
NODE_32023_length_548_cov_4.670379	410	455	0	45	45	1.0000000
NODE_32029_length_548_cov_3.630290	111	177	2	1	66	0.0151515
NODE_32029_length_548_cov_3.630290	111	177	4	65	66	0.9848485
NODE_32039_length_548_cov_3.080178	142	191	1	49	49	1.0000000
NODE_32180_length_547_cov_23.982143	243	323	11	18	80	0.2250000
NODE_32180_length_547_cov_23.982143	243	323	13	8	80	0.1000000
NODE_32180_length_547_cov_23.982143	243	323	14	39	80	0.4875000
NODE_32180_length_547_cov_23.982143	243	323	15	3	80	0.0375000
NODE_32180_length_547_cov_23.982143	243	323	18	4	80	0.0500000
NODE_32180_length_547_cov_23.982143	243	323	22	8	80	0.1000000
NODE_32180_length_547_cov_23.982143	243	323	11	18	80	0.2250000
NODE_32180_length_547_cov_23.982143	243	323	13	8	80	0.1000000
NODE_32180_length_547_cov_23.982143	243	323	14	39	80	0.4875000
NODE_32180_length_547_cov_23.982143	243	323	15	3	80	0.0375000
NODE_32180_length_547_cov_23.982143	243	323	18	4	80	0.0500000
NODE_32180_length_547_cov_23.982143	243	323	22	8	80	0.1000000
NODE_32180_length_547_cov_23.982143	252	323	11	9	71	0.1267606
NODE_32180_length_547_cov_23.982143	252	323	13	8	71	0.1126761
NODE_32180_length_547_cov_23.982143	252	323	14	39	71	0.5492958
NODE_32180_length_547_cov_23.982143	252	323	15	3	71	0.0422535
NODE_32180_length_547_cov_23.982143	252	323	18	4	71	0.0563380
NODE_32180_length_547_cov_23.982143	252	323	22	8	71	0.1126761
NODE_32181_length_547_cov_23.555804	42	122	0	80	80	1.0000000
NODE_32181_length_547_cov_23.555804	95	175	0	80	80	1.0000000
NODE_32183_length_547_cov_12.819196	190	270	0	3	80	0.0375000
NODE_32183_length_547_cov_12.819196	190	270	4	19	80	0.2375000
NODE_32183_length_547_cov_12.819196	190	270	12	58	80	0.7250000
NODE_32195_length_547_cov_5.207589	290	370	2	52	80	0.6500000
NODE_32195_length_547_cov_5.207589	290	370	4	18	80	0.2250000
NODE_32195_length_547_cov_5.207589	290	370	9	5	80	0.0625000
NODE_32195_length_547_cov_5.207589	290	370	10	1	80	0.0125000
NODE_32195_length_547_cov_5.207589	290	370	13	4	80	0.0500000
NODE_32195_length_547_cov_5.207589	343	423	4	17	80	0.2125000
NODE_32195_length_547_cov_5.207589	343	423	9	5	80	0.0625000
NODE_32195_length_547_cov_5.207589	343	423	10	1	80	0.0125000
NODE_32195_length_547_cov_5.207589	343	423	13	5	80	0.0625000
NODE_32195_length_547_cov_5.207589	343	423	14	2	80	0.0250000
NODE_32195_length_547_cov_5.207589	343	423	15	19	80	0.2375000
NODE_32195_length_547_cov_5.207589	343	423	16	2	80	0.0250000
NODE_32195_length_547_cov_5.207589	343	423	18	29	80	0.3625000
NODE_32197_length_547_cov_4.975446	411	488	0	77	77	1.0000000
NODE_32197_length_547_cov_4.975446	461	542	0	81	81	1.0000000
NODE_32199_length_547_cov_4.683036	451	492	0	41	41	1.0000000
NODE_32204_length_547_cov_4.138393	97	175	2	32	78	0.4102564
NODE_32204_length_547_cov_4.138393	97	175	4	46	78	0.5897436
NODE_32204_length_547_cov_4.138393	151	228	2	69	77	0.8961039
NODE_32204_length_547_cov_4.138393	151	228	4	8	77	0.1038961
NODE_32206_length_547_cov_4.026786	136	216	0	30	80	0.3750000
NODE_32206_length_547_cov_4.026786	136	216	2	50	80	0.6250000
NODE_32206_length_547_cov_4.026786	189	269	0	14	80	0.1750000
NODE_32206_length_547_cov_4.026786	189	269	2	66	80	0.8250000
NODE_32215_length_547_cov_3.468750	219	299	0	29	80	0.3625000
NODE_32215_length_547_cov_3.468750	219	299	2	51	80	0.6375000
NODE_32222_length_547_cov_2.901786	304	384	0	80	80	1.0000000
NODE_32347_length_546_cov_17.733781	159	239	0	80	80	1.0000000
NODE_32347_length_546_cov_17.733781	212	293	0	81	81	1.0000000
NODE_32348_length_546_cov_16.275168	272	352	0	80	80	1.0000000
NODE_32348_length_546_cov_16.275168	325	405	0	71	80	0.8875000
NODE_32348_length_546_cov_16.275168	325	405	2	9	80	0.1125000
NODE_32349_length_546_cov_8.201342	179	259	8	13	80	0.1625000
NODE_32349_length_546_cov_8.201342	179	259	10	26	80	0.3250000
NODE_32349_length_546_cov_8.201342	179	259	12	41	80	0.5125000
NODE_32351_length_546_cov_7.454139	241	321	0	80	80	1.0000000
NODE_32351_length_546_cov_7.454139	294	374	0	80	80	1.0000000
NODE_32380_length_546_cov_3.192394	171	251	0	80	80	1.0000000
NODE_32510_length_545_cov_31.524664	38	118	0	56	80	0.7000000
NODE_32510_length_545_cov_31.524664	38	118	2	1	80	0.0125000
NODE_32510_length_545_cov_31.524664	38	118	4	9	80	0.1125000
NODE_32510_length_545_cov_31.524664	38	118	6	14	80	0.1750000
NODE_32510_length_545_cov_31.524664	91	171	0	3	80	0.0375000
NODE_32510_length_545_cov_31.524664	91	171	2	1	80	0.0125000
NODE_32510_length_545_cov_31.524664	91	171	4	9	80	0.1125000
NODE_32510_length_545_cov_31.524664	91	171	6	67	80	0.8375000
NODE_32517_length_545_cov_5.524664	268	348	0	16	80	0.2000000
NODE_32517_length_545_cov_5.524664	268	348	4	64	80	0.8000000
NODE_32525_length_545_cov_3.885650	137	217	8	24	80	0.3000000
NODE_32525_length_545_cov_3.885650	137	217	10	10	80	0.1250000
NODE_32525_length_545_cov_3.885650	137	217	12	20	80	0.2500000
NODE_32525_length_545_cov_3.885650	137	217	14	9	80	0.1125000
NODE_32525_length_545_cov_3.885650	137	217	16	17	80	0.2125000
NODE_32571_length_545_cov_2.013453	246	318	3	3	72	0.0416667
NODE_32571_length_545_cov_2.013453	246	318	7	47	72	0.6527778
NODE_32571_length_545_cov_2.013453	246	318	8	22	72	0.3055556
NODE_32599_length_545_cov_1.450673	130	179	0	30	49	0.6122449
NODE_32599_length_545_cov_1.450673	130	179	2	19	49	0.3877551
NODE_32616_length_545_cov_1.179372	431	469	0	38	38	1.0000000
NODE_32673_length_544_cov_37.705618	258	338	0	80	80	1.0000000
NODE_32673_length_544_cov_37.705618	311	391	0	80	80	1.0000000
NODE_32674_length_544_cov_33.847191	189	269	0	80	80	1.0000000
NODE_32674_length_544_cov_33.847191	242	327	0	85	85	1.0000000
NODE_32675_length_544_cov_19.467416	251	331	8	39	80	0.4875000
NODE_32675_length_544_cov_19.467416	251	331	10	41	80	0.5125000
NODE_32675_length_544_cov_19.467416	304	384	0	27	80	0.3375000
NODE_32675_length_544_cov_19.467416	304	384	2	14	80	0.1750000
NODE_32675_length_544_cov_19.467416	304	384	8	32	80	0.4000000
NODE_32675_length_544_cov_19.467416	304	384	10	7	80	0.0875000
NODE_32676_length_544_cov_16.775281	163	243	0	9	80	0.1125000
NODE_32676_length_544_cov_16.775281	163	243	2	71	80	0.8875000
NODE_32676_length_544_cov_16.775281	216	296	0	62	80	0.7750000
NODE_32676_length_544_cov_16.775281	216	296	2	18	80	0.2250000
NODE_32677_length_544_cov_8.943820	81	161	0	80	80	1.0000000
NODE_32677_length_544_cov_8.943820	134	214	0	80	80	1.0000000
NODE_32678_length_544_cov_8.537079	283	363	0	3	80	0.0375000
NODE_32678_length_544_cov_8.537079	283	363	2	77	80	0.9625000
NODE_32678_length_544_cov_8.537079	336	416	0	56	80	0.7000000
NODE_32678_length_544_cov_8.537079	336	416	2	24	80	0.3000000
NODE_32680_length_544_cov_8.440449	209	289	0	5	80	0.0625000
NODE_32680_length_544_cov_8.440449	209	289	2	69	80	0.8625000
NODE_32680_length_544_cov_8.440449	209	289	4	6	80	0.0750000
NODE_32680_length_544_cov_8.440449	262	342	0	58	80	0.7250000
NODE_32680_length_544_cov_8.440449	262	342	2	22	80	0.2750000
NODE_32681_length_544_cov_7.604494	332	412	0	80	80	1.0000000
NODE_32681_length_544_cov_7.604494	385	465	0	80	80	1.0000000
NODE_32684_length_544_cov_6.000000	461	513	9	4	52	0.0769231
NODE_32684_length_544_cov_6.000000	461	513	13	21	52	0.4038461
NODE_32684_length_544_cov_6.000000	461	513	15	6	52	0.1153846
NODE_32684_length_544_cov_6.000000	461	513	16	13	52	0.2500000
NODE_32684_length_544_cov_6.000000	461	513	17	5	52	0.0961538
NODE_32684_length_544_cov_6.000000	461	513	23	3	52	0.0576923
NODE_32830_length_543_cov_38.790541	116	196	0	20	80	0.2500000
NODE_32830_length_543_cov_38.790541	116	196	5	43	80	0.5375000
NODE_32830_length_543_cov_38.790541	116	196	6	17	80	0.2125000
NODE_32830_length_543_cov_38.790541	169	249	5	10	80	0.1250000
NODE_32830_length_543_cov_38.790541	169	249	6	70	80	0.8750000
NODE_32831_length_543_cov_31.713964	193	273	2	80	80	1.0000000
NODE_32831_length_543_cov_31.713964	246	326	1	28	80	0.3500000
NODE_32831_length_543_cov_31.713964	246	326	2	52	80	0.6500000
NODE_32832_length_543_cov_13.689189	118	198	0	40	80	0.5000000
NODE_32832_length_543_cov_13.689189	118	198	2	40	80	0.5000000
NODE_32832_length_543_cov_13.689189	171	251	2	80	80	1.0000000
NODE_32833_length_543_cov_10.601351	271	351	0	80	80	1.0000000
NODE_32833_length_543_cov_10.601351	324	404	0	35	80	0.4375000
NODE_32833_length_543_cov_10.601351	324	404	2	45	80	0.5625000
NODE_32833_length_543_cov_10.601351	400	480	2	80	80	1.0000000
NODE_32833_length_543_cov_10.601351	453	533	0	51	80	0.6375000
NODE_32833_length_543_cov_10.601351	453	533	2	29	80	0.3625000
NODE_32834_length_543_cov_9.202703	291	341	8	43	50	0.8600000
NODE_32834_length_543_cov_9.202703	291	341	10	7	50	0.1400000
NODE_32834_length_543_cov_9.202703	347	384	2	1	37	0.0270270
NODE_32834_length_543_cov_9.202703	347	384	6	27	37	0.7297297
NODE_32834_length_543_cov_9.202703	347	384	8	9	37	0.2432432
NODE_32835_length_543_cov_7.722973	300	378	0	78	78	1.0000000
NODE_32835_length_543_cov_7.722973	351	431	0	80	80	1.0000000
NODE_32836_length_543_cov_6.815315	181	260	0	79	79	1.0000000
NODE_32845_length_543_cov_4.704955	145	225	0	80	80	1.0000000
NODE_32845_length_543_cov_4.704955	198	275	0	77	77	1.0000000
NODE_32864_length_543_cov_3.301802	247	312	0	3	65	0.0461538
NODE_32864_length_543_cov_3.301802	247	312	2	62	65	0.9538462
NODE_32875_length_543_cov_2.635135	253	316	2	2	63	0.0317460
NODE_32875_length_543_cov_2.635135	253	316	3	41	63	0.6507937
NODE_32875_length_543_cov_2.635135	253	316	4	2	63	0.0317460
NODE_32875_length_543_cov_2.635135	253	316	6	14	63	0.2222222
NODE_32875_length_543_cov_2.635135	253	316	8	4	63	0.0634921
NODE_32875_length_543_cov_2.635135	293	373	3	3	80	0.0375000
NODE_32875_length_543_cov_2.635135	293	373	4	2	80	0.0250000
NODE_32875_length_543_cov_2.635135	293	373	6	14	80	0.1750000
NODE_32875_length_543_cov_2.635135	293	373	8	8	80	0.1000000
NODE_32875_length_543_cov_2.635135	293	373	10	20	80	0.2500000
NODE_32875_length_543_cov_2.635135	293	373	12	13	80	0.1625000
NODE_32875_length_543_cov_2.635135	293	373	14	3	80	0.0375000
NODE_32875_length_543_cov_2.635135	293	373	16	17	80	0.2125000
NODE_33002_length_543_cov_0.682432	98	178	0	80	80	1.0000000
NODE_33012_length_542_cov_57.370203	287	367	0	80	80	1.0000000
NODE_33012_length_542_cov_57.370203	340	378	0	38	38	1.0000000
NODE_33014_length_542_cov_11.616253	277	357	0	80	80	1.0000000
NODE_33014_length_542_cov_11.616253	330	410	0	80	80	1.0000000
NODE_33015_length_542_cov_9.988713	253	333	0	80	80	1.0000000
NODE_33015_length_542_cov_9.988713	306	386	0	70	80	0.8750000
NODE_33015_length_542_cov_9.988713	306	386	2	10	80	0.1250000
NODE_33018_length_542_cov_7.934537	215	295	0	80	80	1.0000000
NODE_33018_length_542_cov_7.934537	268	348	0	80	80	1.0000000
NODE_33020_length_542_cov_7.266366	159	239	0	62	80	0.7750000
NODE_33020_length_542_cov_7.266366	159	239	4	18	80	0.2250000
NODE_33021_length_542_cov_7.069977	230	304	0	18	74	0.2432432
NODE_33021_length_542_cov_7.069977	230	304	2	56	74	0.7567568
NODE_33021_length_542_cov_7.069977	284	362	0	76	78	0.9743590
NODE_33021_length_542_cov_7.069977	284	362	2	2	78	0.0256410
NODE_33025_length_542_cov_4.783296	237	267	6	30	30	1.0000000
NODE_33035_length_542_cov_3.882619	275	303	2	28	28	1.0000000
NODE_33040_length_542_cov_3.600451	82	131	0	42	49	0.8571429
NODE_33040_length_542_cov_3.600451	82	131	1	1	49	0.0204082
NODE_33040_length_542_cov_3.600451	82	131	5	2	49	0.0408163
NODE_33040_length_542_cov_3.600451	82	131	9	2	49	0.0408163
NODE_33040_length_542_cov_3.600451	82	131	11	2	49	0.0408163
NODE_33188_length_541_cov_22.463801	247	327	0	80	80	1.0000000
NODE_33188_length_541_cov_22.463801	300	380	0	80	80	1.0000000
NODE_33190_length_541_cov_11.070136	60	140	0	80	80	1.0000000
NODE_33190_length_541_cov_11.070136	113	193	0	80	80	1.0000000
NODE_33204_length_541_cov_3.690045	179	250	2	71	71	1.0000000
NODE_33300_length_541_cov_1.187783	352	400	6	48	48	1.0000000
NODE_33359_length_540_cov_78.353741	219	299	12	27	80	0.3375000
NODE_33359_length_540_cov_78.353741	219	299	14	53	80	0.6625000
NODE_33359_length_540_cov_78.353741	272	352	0	27	80	0.3375000
NODE_33359_length_540_cov_78.353741	272	352	11	10	80	0.1250000
NODE_33359_length_540_cov_78.353741	272	352	12	43	80	0.5375000
NODE_33360_length_540_cov_33.473923	59	139	0	80	80	1.0000000
NODE_33360_length_540_cov_33.473923	112	192	0	80	80	1.0000000
NODE_33361_length_540_cov_20.380952	97	177	0	80	80	1.0000000
NODE_33361_length_540_cov_20.380952	150	230	0	80	80	1.0000000
NODE_33362_length_540_cov_12.657596	248	328	0	80	80	1.0000000
NODE_33362_length_540_cov_12.657596	301	381	0	80	80	1.0000000
NODE_33363_length_540_cov_11.111111	180	260	2	19	80	0.2375000
NODE_33363_length_540_cov_11.111111	180	260	4	61	80	0.7625000
NODE_33363_length_540_cov_11.111111	233	313	0	52	80	0.6500000
NODE_33363_length_540_cov_11.111111	233	313	2	20	80	0.2500000
NODE_33363_length_540_cov_11.111111	233	313	4	8	80	0.1000000
NODE_33365_length_540_cov_6.328798	260	340	0	80	80	1.0000000
NODE_33365_length_540_cov_6.328798	313	393	0	80	80	1.0000000
NODE_33382_length_540_cov_3.587302	351	411	0	60	60	1.0000000
NODE_33503_length_539_cov_1023.604545	264	344	570	1	80	0.0125000
NODE_33503_length_539_cov_1023.604545	264	344	575	1	80	0.0125000
NODE_33503_length_539_cov_1023.604545	264	344	584	1	80	0.0125000
NODE_33503_length_539_cov_1023.604545	264	344	591	1	80	0.0125000
NODE_33503_length_539_cov_1023.604545	264	344	625	1	80	0.0125000
NODE_33503_length_539_cov_1023.604545	264	344	649	1	80	0.0125000
NODE_33503_length_539_cov_1023.604545	264	344	674	1	80	0.0125000
NODE_33503_length_539_cov_1023.604545	264	344	712	1	80	0.0125000
NODE_33503_length_539_cov_1023.604545	264	344	729	1	80	0.0125000
NODE_33503_length_539_cov_1023.604545	264	344	741	1	80	0.0125000
NODE_33503_length_539_cov_1023.604545	264	344	756	1	80	0.0125000
NODE_33503_length_539_cov_1023.604545	264	344	806	1	80	0.0125000
NODE_33503_length_539_cov_1023.604545	264	344	821	1	80	0.0125000
NODE_33503_length_539_cov_1023.604545	264	344	845	1	80	0.0125000
NODE_33503_length_539_cov_1023.604545	264	344	857	1	80	0.0125000
NODE_33503_length_539_cov_1023.604545	264	344	875	1	80	0.0125000
NODE_33503_length_539_cov_1023.604545	264	344	899	1	80	0.0125000
NODE_33503_length_539_cov_1023.604545	264	344	925	1	80	0.0125000
NODE_33503_length_539_cov_1023.604545	264	344	946	1	80	0.0125000
NODE_33503_length_539_cov_1023.604545	264	344	975	1	80	0.0125000
NODE_33503_length_539_cov_1023.604545	264	344	994	1	80	0.0125000
NODE_33503_length_539_cov_1023.604545	264	344	1015	1	80	0.0125000
NODE_33503_length_539_cov_1023.604545	264	344	1029	1	80	0.0125000
NODE_33503_length_539_cov_1023.604545	264	344	1083	1	80	0.0125000
NODE_33503_length_539_cov_1023.604545	264	344	1168	1	80	0.0125000
NODE_33503_length_539_cov_1023.604545	264	344	1218	1	80	0.0125000
NODE_33503_length_539_cov_1023.604545	264	344	1254	1	80	0.0125000
NODE_33503_length_539_cov_1023.604545	264	344	1289	1	80	0.0125000
NODE_33503_length_539_cov_1023.604545	264	344	1317	1	80	0.0125000
NODE_33503_length_539_cov_1023.604545	264	344	1353	1	80	0.0125000
NODE_33503_length_539_cov_1023.604545	264	344	1367	1	80	0.0125000
NODE_33503_length_539_cov_1023.604545	264	344	1376	1	80	0.0125000
NODE_33503_length_539_cov_1023.604545	264	344	1404	1	80	0.0125000
NODE_33503_length_539_cov_1023.604545	264	344	1422	1	80	0.0125000
NODE_33503_length_539_cov_1023.604545	264	344	1425	1	80	0.0125000
NODE_33503_length_539_cov_1023.604545	264	344	1433	1	80	0.0125000
NODE_33503_length_539_cov_1023.604545	264	344	1472	1	80	0.0125000
NODE_33503_length_539_cov_1023.604545	264	344	1495	1	80	0.0125000
NODE_33503_length_539_cov_1023.604545	264	344	1530	1	80	0.0125000
NODE_33503_length_539_cov_1023.604545	264	344	1537	1	80	0.0125000
NODE_33503_length_539_cov_1023.604545	264	344	1575	1	80	0.0125000
NODE_33503_length_539_cov_1023.604545	264	344	1597	1	80	0.0125000
NODE_33503_length_539_cov_1023.604545	264	344	1630	1	80	0.0125000
NODE_33503_length_539_cov_1023.604545	264	344	1645	1	80	0.0125000
NODE_33503_length_539_cov_1023.604545	264	344	1654	1	80	0.0125000
NODE_33503_length_539_cov_1023.604545	264	344	1666	1	80	0.0125000
NODE_33503_length_539_cov_1023.604545	264	344	1674	1	80	0.0125000
NODE_33503_length_539_cov_1023.604545	264	344	1702	1	80	0.0125000
NODE_33503_length_539_cov_1023.604545	264	344	1711	1	80	0.0125000
NODE_33503_length_539_cov_1023.604545	264	344	1719	1	80	0.0125000
NODE_33503_length_539_cov_1023.604545	264	344	1738	1	80	0.0125000
NODE_33503_length_539_cov_1023.604545	264	344	1759	1	80	0.0125000
NODE_33503_length_539_cov_1023.604545	264	344	1785	1	80	0.0125000
NODE_33503_length_539_cov_1023.604545	264	344	1787	1	80	0.0125000
NODE_33503_length_539_cov_1023.604545	264	344	1791	1	80	0.0125000
NODE_33503_length_539_cov_1023.604545	264	344	1825	1	80	0.0125000
NODE_33503_length_539_cov_1023.604545	264	344	1835	1	80	0.0125000
NODE_33503_length_539_cov_1023.604545	264	344	1855	1	80	0.0125000
NODE_33503_length_539_cov_1023.604545	264	344	1869	1	80	0.0125000
NODE_33503_length_539_cov_1023.604545	264	344	1871	1	80	0.0125000
NODE_33503_length_539_cov_1023.604545	264	344	1880	1	80	0.0125000
NODE_33503_length_539_cov_1023.604545	264	344	1901	1	80	0.0125000
NODE_33503_length_539_cov_1023.604545	264	344	1912	1	80	0.0125000
NODE_33503_length_539_cov_1023.604545	264	344	1959	1	80	0.0125000
NODE_33503_length_539_cov_1023.604545	264	344	1967	1	80	0.0125000
NODE_33503_length_539_cov_1023.604545	264	344	1989	1	80	0.0125000
NODE_33503_length_539_cov_1023.604545	264	344	2006	1	80	0.0125000
NODE_33503_length_539_cov_1023.604545	264	344	2052	1	80	0.0125000
NODE_33503_length_539_cov_1023.604545	264	344	2076	1	80	0.0125000
NODE_33503_length_539_cov_1023.604545	264	344	2083	1	80	0.0125000
NODE_33503_length_539_cov_1023.604545	264	344	2122	1	80	0.0125000
NODE_33503_length_539_cov_1023.604545	264	344	2132	1	80	0.0125000
NODE_33503_length_539_cov_1023.604545	264	344	2146	1	80	0.0125000
NODE_33503_length_539_cov_1023.604545	264	344	2148	1	80	0.0125000
NODE_33503_length_539_cov_1023.604545	264	344	2152	1	80	0.0125000
NODE_33503_length_539_cov_1023.604545	264	344	2157	1	80	0.0125000
NODE_33503_length_539_cov_1023.604545	264	344	2168	1	80	0.0125000
NODE_33503_length_539_cov_1023.604545	264	344	2179	1	80	0.0125000
NODE_33503_length_539_cov_1023.604545	264	344	2183	1	80	0.0125000
NODE_33503_length_539_cov_1023.604545	264	344	2190	1	80	0.0125000
NODE_33503_length_539_cov_1023.604545	317	397	1787	1	80	0.0125000
NODE_33503_length_539_cov_1023.604545	317	397	1791	1	80	0.0125000
NODE_33503_length_539_cov_1023.604545	317	397	1825	1	80	0.0125000
NODE_33503_length_539_cov_1023.604545	317	397	1835	1	80	0.0125000
NODE_33503_length_539_cov_1023.604545	317	397	1855	1	80	0.0125000
NODE_33503_length_539_cov_1023.604545	317	397	1869	1	80	0.0125000
NODE_33503_length_539_cov_1023.604545	317	397	1871	1	80	0.0125000
NODE_33503_length_539_cov_1023.604545	317	397	1880	1	80	0.0125000
NODE_33503_length_539_cov_1023.604545	317	397	1901	1	80	0.0125000
NODE_33503_length_539_cov_1023.604545	317	397	1912	1	80	0.0125000
NODE_33503_length_539_cov_1023.604545	317	397	1959	1	80	0.0125000
NODE_33503_length_539_cov_1023.604545	317	397	1967	1	80	0.0125000
NODE_33503_length_539_cov_1023.604545	317	397	1989	1	80	0.0125000
NODE_33503_length_539_cov_1023.604545	317	397	2006	1	80	0.0125000
NODE_33503_length_539_cov_1023.604545	317	397	2052	1	80	0.0125000
NODE_33503_length_539_cov_1023.604545	317	397	2076	1	80	0.0125000
NODE_33503_length_539_cov_1023.604545	317	397	2083	1	80	0.0125000
NODE_33503_length_539_cov_1023.604545	317	397	2099	1	80	0.0125000
NODE_33503_length_539_cov_1023.604545	317	397	2100	2	80	0.0250000
NODE_33503_length_539_cov_1023.604545	317	397	2103	1	80	0.0125000
NODE_33503_length_539_cov_1023.604545	317	397	2122	1	80	0.0125000
NODE_33503_length_539_cov_1023.604545	317	397	2125	1	80	0.0125000
NODE_33503_length_539_cov_1023.604545	317	397	2132	1	80	0.0125000
NODE_33503_length_539_cov_1023.604545	317	397	2136	1	80	0.0125000
NODE_33503_length_539_cov_1023.604545	317	397	2146	2	80	0.0250000
NODE_33503_length_539_cov_1023.604545	317	397	2147	2	80	0.0250000
NODE_33503_length_539_cov_1023.604545	317	397	2148	1	80	0.0125000
NODE_33503_length_539_cov_1023.604545	317	397	2152	1	80	0.0125000
NODE_33503_length_539_cov_1023.604545	317	397	2153	1	80	0.0125000
NODE_33503_length_539_cov_1023.604545	317	397	2157	1	80	0.0125000
NODE_33503_length_539_cov_1023.604545	317	397	2163	1	80	0.0125000
NODE_33503_length_539_cov_1023.604545	317	397	2165	1	80	0.0125000
NODE_33503_length_539_cov_1023.604545	317	397	2168	1	80	0.0125000
NODE_33503_length_539_cov_1023.604545	317	397	2169	1	80	0.0125000
NODE_33503_length_539_cov_1023.604545	317	397	2170	1	80	0.0125000
NODE_33503_length_539_cov_1023.604545	317	397	2172	1	80	0.0125000
NODE_33503_length_539_cov_1023.604545	317	397	2176	2	80	0.0250000
NODE_33503_length_539_cov_1023.604545	317	397	2179	1	80	0.0125000
NODE_33503_length_539_cov_1023.604545	317	397	2183	1	80	0.0125000
NODE_33503_length_539_cov_1023.604545	317	397	2189	1	80	0.0125000
NODE_33503_length_539_cov_1023.604545	317	397	2190	1	80	0.0125000
NODE_33503_length_539_cov_1023.604545	317	397	2191	1	80	0.0125000
NODE_33503_length_539_cov_1023.604545	317	397	2194	2	80	0.0250000
NODE_33503_length_539_cov_1023.604545	317	397	2198	1	80	0.0125000
NODE_33503_length_539_cov_1023.604545	317	397	2199	2	80	0.0250000
NODE_33503_length_539_cov_1023.604545	317	397	2201	1	80	0.0125000
NODE_33503_length_539_cov_1023.604545	317	397	2203	1	80	0.0125000
NODE_33503_length_539_cov_1023.604545	317	397	2214	2	80	0.0250000
NODE_33503_length_539_cov_1023.604545	317	397	2218	1	80	0.0125000
NODE_33503_length_539_cov_1023.604545	317	397	2219	1	80	0.0125000
NODE_33503_length_539_cov_1023.604545	317	397	2229	1	80	0.0125000
NODE_33503_length_539_cov_1023.604545	317	397	2230	1	80	0.0125000
NODE_33503_length_539_cov_1023.604545	317	397	2231	1	80	0.0125000
NODE_33503_length_539_cov_1023.604545	317	397	2234	1	80	0.0125000
NODE_33503_length_539_cov_1023.604545	317	397	2237	1	80	0.0125000
NODE_33503_length_539_cov_1023.604545	317	397	2239	1	80	0.0125000
NODE_33503_length_539_cov_1023.604545	317	397	2252	1	80	0.0125000
NODE_33503_length_539_cov_1023.604545	317	397	2261	1	80	0.0125000
NODE_33503_length_539_cov_1023.604545	317	397	2264	1	80	0.0125000
NODE_33503_length_539_cov_1023.604545	317	397	2269	1	80	0.0125000
NODE_33503_length_539_cov_1023.604545	317	397	2270	1	80	0.0125000
NODE_33503_length_539_cov_1023.604545	317	397	2272	1	80	0.0125000
NODE_33503_length_539_cov_1023.604545	317	397	2285	3	80	0.0375000
NODE_33503_length_539_cov_1023.604545	317	397	2291	1	80	0.0125000
NODE_33503_length_539_cov_1023.604545	317	397	2295	1	80	0.0125000
NODE_33503_length_539_cov_1023.604545	317	397	2296	1	80	0.0125000
NODE_33503_length_539_cov_1023.604545	317	397	2304	2	80	0.0250000
NODE_33503_length_539_cov_1023.604545	317	397	2310	1	80	0.0125000
NODE_33503_length_539_cov_1023.604545	317	397	2315	2	80	0.0250000
NODE_33504_length_539_cov_99.579545	478	539	0	61	61	1.0000000
NODE_33505_length_539_cov_15.247727	217	297	0	80	80	1.0000000
NODE_33505_length_539_cov_15.247727	270	350	0	80	80	1.0000000
NODE_33506_length_539_cov_14.172727	278	350	0	57	72	0.7916667
NODE_33506_length_539_cov_14.172727	278	350	1	15	72	0.2083333
NODE_33507_length_539_cov_13.154545	118	198	2	20	80	0.2500000
NODE_33507_length_539_cov_13.154545	118	198	3	5	80	0.0625000
NODE_33507_length_539_cov_13.154545	118	198	4	55	80	0.6875000
NODE_33507_length_539_cov_13.154545	171	251	2	42	80	0.5250000
NODE_33507_length_539_cov_13.154545	171	251	4	38	80	0.4750000
NODE_33508_length_539_cov_10.811364	48	128	0	19	80	0.2375000
NODE_33508_length_539_cov_10.811364	48	128	4	61	80	0.7625000
NODE_33508_length_539_cov_10.811364	101	181	0	31	80	0.3875000
NODE_33508_length_539_cov_10.811364	101	181	3	11	80	0.1375000
NODE_33508_length_539_cov_10.811364	101	181	4	38	80	0.4750000
NODE_33509_length_539_cov_9.563636	201	277	12	19	76	0.2500000
NODE_33509_length_539_cov_9.563636	201	277	14	8	76	0.1052632
NODE_33509_length_539_cov_9.563636	201	277	16	26	76	0.3421053
NODE_33509_length_539_cov_9.563636	201	277	20	23	76	0.3026316
NODE_33510_length_539_cov_7.934091	311	369	4	1	58	0.0172414
NODE_33510_length_539_cov_7.934091	311	369	6	20	58	0.3448276
NODE_33510_length_539_cov_7.934091	311	369	8	37	58	0.6379310
NODE_33510_length_539_cov_7.934091	342	422	0	4	80	0.0500000
NODE_33510_length_539_cov_7.934091	342	422	2	10	80	0.1250000
NODE_33510_length_539_cov_7.934091	342	422	4	6	80	0.0750000
NODE_33510_length_539_cov_7.934091	342	422	6	40	80	0.5000000
NODE_33510_length_539_cov_7.934091	342	422	8	20	80	0.2500000
NODE_33517_length_539_cov_5.740909	251	319	0	45	68	0.6617647
NODE_33517_length_539_cov_5.740909	251	319	2	23	68	0.3382353
NODE_33517_length_539_cov_5.740909	301	372	0	25	71	0.3521127
NODE_33517_length_539_cov_5.740909	301	372	2	46	71	0.6478873
NODE_33533_length_539_cov_3.627273	80	157	0	33	77	0.4285714
NODE_33533_length_539_cov_3.627273	80	157	2	44	77	0.5714286
NODE_33533_length_539_cov_3.627273	130	175	2	45	45	1.0000000
NODE_33569_length_539_cov_2.143182	325	371	0	46	46	1.0000000
NODE_33595_length_539_cov_1.618182	408	456	2	48	48	1.0000000
NODE_33623_length_539_cov_1.129545	97	134	0	37	37	1.0000000
NODE_33669_length_538_cov_23.193622	171	256	0	85	85	1.0000000
NODE_33669_length_538_cov_23.193622	225	305	0	80	80	1.0000000
NODE_33672_length_538_cov_7.378132	145	225	0	22	80	0.2750000
NODE_33672_length_538_cov_7.378132	145	225	2	58	80	0.7250000
NODE_33672_length_538_cov_7.378132	198	278	0	53	80	0.6625000
NODE_33672_length_538_cov_7.378132	198	278	2	27	80	0.3375000
NODE_33683_length_538_cov_4.496583	277	357	0	80	80	1.0000000
NODE_33683_length_538_cov_4.496583	330	410	0	80	80	1.0000000
NODE_33687_length_538_cov_3.753986	251	309	0	56	58	0.9655172
NODE_33687_length_538_cov_3.753986	251	309	2	2	58	0.0344828
NODE_33713_length_538_cov_2.239180	256	338	0	38	82	0.4634146
NODE_33713_length_538_cov_2.239180	256	338	2	6	82	0.0731707
NODE_33713_length_538_cov_2.239180	256	338	4	20	82	0.2439024
NODE_33713_length_538_cov_2.239180	256	338	8	14	82	0.1707317
NODE_33713_length_538_cov_2.239180	256	338	10	4	82	0.0487805
NODE_33814_length_538_cov_0.822323	397	477	2	1	80	0.0125000
NODE_33814_length_538_cov_0.822323	397	477	4	17	80	0.2125000
NODE_33814_length_538_cov_0.822323	397	477	6	62	80	0.7750000
NODE_33852_length_537_cov_13.031963	258	309	0	51	51	1.0000000
NODE_33854_length_537_cov_9.552511	198	278	0	80	80	1.0000000
NODE_33854_length_537_cov_9.552511	251	332	0	81	81	1.0000000
NODE_33960_length_537_cov_1.244292	107	187	5	4	80	0.0500000
NODE_33960_length_537_cov_1.244292	107	187	7	1	80	0.0125000
NODE_33960_length_537_cov_1.244292	107	187	9	9	80	0.1125000
NODE_33960_length_537_cov_1.244292	107	187	13	2	80	0.0250000
NODE_33960_length_537_cov_1.244292	107	187	15	2	80	0.0250000
NODE_33960_length_537_cov_1.244292	107	187	21	2	80	0.0250000
NODE_33960_length_537_cov_1.244292	107	187	23	1	80	0.0125000
NODE_33960_length_537_cov_1.244292	107	187	25	3	80	0.0375000
NODE_33960_length_537_cov_1.244292	107	187	26	2	80	0.0250000
NODE_33960_length_537_cov_1.244292	107	187	28	4	80	0.0500000
NODE_33960_length_537_cov_1.244292	107	187	34	1	80	0.0125000
NODE_33960_length_537_cov_1.244292	107	187	39	1	80	0.0125000
NODE_33960_length_537_cov_1.244292	107	187	45	4	80	0.0500000
NODE_33960_length_537_cov_1.244292	107	187	50	4	80	0.0500000
NODE_33960_length_537_cov_1.244292	107	187	55	1	80	0.0125000
NODE_33960_length_537_cov_1.244292	107	187	57	1	80	0.0125000
NODE_33960_length_537_cov_1.244292	107	187	65	1	80	0.0125000
NODE_33960_length_537_cov_1.244292	107	187	68	2	80	0.0250000
NODE_33960_length_537_cov_1.244292	107	187	71	1	80	0.0125000
NODE_33960_length_537_cov_1.244292	107	187	77	5	80	0.0625000
NODE_33960_length_537_cov_1.244292	107	187	78	1	80	0.0125000
NODE_33960_length_537_cov_1.244292	107	187	80	4	80	0.0500000
NODE_33960_length_537_cov_1.244292	107	187	82	2	80	0.0250000
NODE_33960_length_537_cov_1.244292	107	187	86	7	80	0.0875000
NODE_33960_length_537_cov_1.244292	107	187	88	4	80	0.0500000
NODE_33960_length_537_cov_1.244292	107	187	90	3	80	0.0375000
NODE_33960_length_537_cov_1.244292	107	187	92	4	80	0.0500000
NODE_33960_length_537_cov_1.244292	107	187	94	1	80	0.0125000
NODE_33960_length_537_cov_1.244292	107	187	98	3	80	0.0375000
NODE_34029_length_536_cov_87.622426	430	462	111	1	32	0.0312500
NODE_34029_length_536_cov_87.622426	430	462	113	1	32	0.0312500
NODE_34029_length_536_cov_87.622426	430	462	116	5	32	0.1562500
NODE_34029_length_536_cov_87.622426	430	462	120	1	32	0.0312500
NODE_34029_length_536_cov_87.622426	430	462	121	6	32	0.1875000
NODE_34029_length_536_cov_87.622426	430	462	123	1	32	0.0312500
NODE_34029_length_536_cov_87.622426	430	462	127	1	32	0.0312500
NODE_34029_length_536_cov_87.622426	430	462	131	2	32	0.0625000
NODE_34029_length_536_cov_87.622426	430	462	133	3	32	0.0937500
NODE_34029_length_536_cov_87.622426	430	462	135	2	32	0.0625000
NODE_34029_length_536_cov_87.622426	430	462	137	2	32	0.0625000
NODE_34029_length_536_cov_87.622426	430	462	141	3	32	0.0937500
NODE_34029_length_536_cov_87.622426	430	462	143	4	32	0.1250000
NODE_34030_length_536_cov_11.629291	119	199	0	19	80	0.2375000
NODE_34030_length_536_cov_11.629291	119	199	2	61	80	0.7625000
NODE_34030_length_536_cov_11.629291	172	252	0	72	80	0.9000000
NODE_34030_length_536_cov_11.629291	172	252	2	8	80	0.1000000
NODE_34032_length_536_cov_6.613272	286	372	0	75	86	0.8720930
NODE_34032_length_536_cov_6.613272	286	372	2	11	86	0.1279070
NODE_34035_length_536_cov_5.810069	191	271	0	80	80	1.0000000
NODE_34035_length_536_cov_5.810069	244	324	0	80	80	1.0000000
NODE_34035_length_536_cov_5.810069	374	404	0	30	30	1.0000000
NODE_34039_length_536_cov_4.729977	202	245	0	43	43	1.0000000
NODE_34057_length_536_cov_3.297483	86	126	0	3	40	0.0750000
NODE_34057_length_536_cov_3.297483	86	126	2	37	40	0.9250000
NODE_34068_length_536_cov_2.796339	223	280	0	57	57	1.0000000
NODE_34094_length_536_cov_1.956522	181	230	8	9	49	0.1836735
NODE_34094_length_536_cov_1.956522	181	230	11	3	49	0.0612245
NODE_34094_length_536_cov_1.956522	181	230	14	1	49	0.0204082
NODE_34094_length_536_cov_1.956522	181	230	16	4	49	0.0816327
NODE_34094_length_536_cov_1.956522	181	230	20	6	49	0.1224490
NODE_34094_length_536_cov_1.956522	181	230	21	6	49	0.1224490
NODE_34094_length_536_cov_1.956522	181	230	23	1	49	0.0204082
NODE_34094_length_536_cov_1.956522	181	230	24	9	49	0.1836735
NODE_34094_length_536_cov_1.956522	181	230	26	6	49	0.1224490
NODE_34094_length_536_cov_1.956522	181	230	28	4	49	0.0816327
NODE_34095_length_536_cov_1.951945	203	284	3	5	81	0.0617284
NODE_34095_length_536_cov_1.951945	203	284	7	10	81	0.1234568
NODE_34095_length_536_cov_1.951945	203	284	9	11	81	0.1358025
NODE_34095_length_536_cov_1.951945	203	284	11	37	81	0.4567901
NODE_34095_length_536_cov_1.951945	203	284	12	5	81	0.0617284
NODE_34095_length_536_cov_1.951945	203	284	13	13	81	0.1604938
NODE_34095_length_536_cov_1.951945	306	368	0	38	62	0.6129032
NODE_34095_length_536_cov_1.951945	306	368	1	22	62	0.3548387
NODE_34095_length_536_cov_1.951945	306	368	3	2	62	0.0322581
NODE_34209_length_535_cov_32.277523	158	238	0	58	80	0.7250000
NODE_34209_length_535_cov_32.277523	158	238	2	22	80	0.2750000
NODE_34209_length_535_cov_32.277523	211	291	0	5	80	0.0625000
NODE_34209_length_535_cov_32.277523	211	291	2	75	80	0.9375000
NODE_34215_length_535_cov_5.910550	110	162	2	34	52	0.6538461
NODE_34215_length_535_cov_5.910550	110	162	3	3	52	0.0576923
NODE_34215_length_535_cov_5.910550	110	162	4	5	52	0.0961538
NODE_34215_length_535_cov_5.910550	110	162	5	4	52	0.0769231
NODE_34215_length_535_cov_5.910550	110	162	6	6	52	0.1153846
NODE_34229_length_535_cov_3.795872	217	297	2	1	80	0.0125000
NODE_34229_length_535_cov_3.795872	217	297	4	9	80	0.1125000
NODE_34229_length_535_cov_3.795872	217	297	6	70	80	0.8750000
NODE_34375_length_534_cov_54.331034	435	498	0	57	63	0.9047619
NODE_34375_length_534_cov_54.331034	435	498	4	1	63	0.0158730
NODE_34375_length_534_cov_54.331034	435	498	18	1	63	0.0158730
NODE_34375_length_534_cov_54.331034	435	498	61	1	63	0.0158730
NODE_34375_length_534_cov_54.331034	435	498	62	1	63	0.0158730
NODE_34375_length_534_cov_54.331034	435	498	64	1	63	0.0158730
NODE_34375_length_534_cov_54.331034	435	498	66	1	63	0.0158730
NODE_34375_length_534_cov_54.331034	471	534	0	63	63	1.0000000
NODE_34377_length_534_cov_15.462069	460	534	0	8	74	0.1081081
NODE_34377_length_534_cov_15.462069	460	534	6	66	74	0.8918919
NODE_34377_length_534_cov_15.462069	512	534	0	8	22	0.3636364
NODE_34377_length_534_cov_15.462069	512	534	6	14	22	0.6363636
NODE_34378_length_534_cov_10.308046	268	348	0	80	80	1.0000000
NODE_34378_length_534_cov_10.308046	321	401	0	80	80	1.0000000
NODE_34380_length_534_cov_9.041379	204	284	0	80	80	1.0000000
NODE_34380_length_534_cov_9.041379	257	332	0	75	75	1.0000000
NODE_34383_length_534_cov_6.958621	273	303	0	30	30	1.0000000
NODE_34392_length_534_cov_5.022989	291	371	11	4	80	0.0500000
NODE_34392_length_534_cov_5.022989	291	371	14	1	80	0.0125000
NODE_34392_length_534_cov_5.022989	291	371	15	3	80	0.0375000
NODE_34392_length_534_cov_5.022989	291	371	18	5	80	0.0625000
NODE_34392_length_534_cov_5.022989	291	371	20	4	80	0.0500000
NODE_34392_length_534_cov_5.022989	291	371	21	13	80	0.1625000
NODE_34392_length_534_cov_5.022989	291	371	22	50	80	0.6250000
NODE_34402_length_534_cov_3.873563	110	190	0	21	80	0.2625000
NODE_34402_length_534_cov_3.873563	110	190	2	59	80	0.7375000
NODE_34409_length_534_cov_3.202299	221	301	2	80	80	1.0000000
NODE_34411_length_534_cov_3.158621	171	200	2	29	29	1.0000000
NODE_34418_length_534_cov_3.002299	175	219	11	16	44	0.3636364
NODE_34418_length_534_cov_3.002299	175	219	12	28	44	0.6363636
NODE_34489_length_534_cov_1.344828	475	518	0	5	43	0.1162791
NODE_34489_length_534_cov_1.344828	475	518	2	38	43	0.8837209
NODE_34494_length_534_cov_1.291954	273	336	2	8	63	0.1269841
NODE_34494_length_534_cov_1.291954	273	336	4	6	63	0.0952381
NODE_34494_length_534_cov_1.291954	273	336	6	6	63	0.0952381
NODE_34494_length_534_cov_1.291954	273	336	7	3	63	0.0476190
NODE_34494_length_534_cov_1.291954	273	336	8	1	63	0.0158730
NODE_34494_length_534_cov_1.291954	273	336	10	39	63	0.6190476
NODE_34511_length_534_cov_1.160920	227	264	0	6	37	0.1621622
NODE_34511_length_534_cov_1.160920	227	264	2	6	37	0.1621622
NODE_34511_length_534_cov_1.160920	227	264	4	3	37	0.0810811
NODE_34511_length_534_cov_1.160920	227	264	6	22	37	0.5945946
NODE_34570_length_533_cov_13.956221	216	296	0	80	80	1.0000000
NODE_34570_length_533_cov_13.956221	269	349	0	80	80	1.0000000
NODE_34575_length_533_cov_8.207373	244	322	0	78	78	1.0000000
NODE_34576_length_533_cov_8.023041	230	310	0	50	80	0.6250000
NODE_34576_length_533_cov_8.023041	230	310	2	24	80	0.3000000
NODE_34576_length_533_cov_8.023041	230	310	4	6	80	0.0750000
NODE_34576_length_533_cov_8.023041	283	364	0	21	81	0.2592593
NODE_34576_length_533_cov_8.023041	283	364	4	60	81	0.7407407
NODE_34585_length_533_cov_5.170507	308	369	0	61	61	1.0000000
NODE_34588_length_533_cov_4.988479	229	309	0	80	80	1.0000000
NODE_34588_length_533_cov_4.988479	282	362	0	80	80	1.0000000
NODE_34600_length_533_cov_3.638249	201	265	2	45	64	0.7031250
NODE_34600_length_533_cov_3.638249	201	265	4	19	64	0.2968750
NODE_34603_length_533_cov_3.511521	138	218	2	27	80	0.3375000
NODE_34603_length_533_cov_3.511521	138	218	4	12	80	0.1500000
NODE_34603_length_533_cov_3.511521	138	218	6	4	80	0.0500000
NODE_34603_length_533_cov_3.511521	138	218	7	1	80	0.0125000
NODE_34603_length_533_cov_3.511521	138	218	8	12	80	0.1500000
NODE_34603_length_533_cov_3.511521	138	218	10	21	80	0.2625000
NODE_34603_length_533_cov_3.511521	138	218	12	3	80	0.0375000
NODE_34615_length_533_cov_3.073733	294	340	0	46	46	1.0000000
NODE_34617_length_533_cov_3.052995	256	304	6	48	48	1.0000000
NODE_34631_length_533_cov_2.366359	229	311	2	29	82	0.3536585
NODE_34631_length_533_cov_2.366359	229	311	4	50	82	0.6097561
NODE_34631_length_533_cov_2.366359	229	311	5	1	82	0.0121951
NODE_34631_length_533_cov_2.366359	229	311	6	2	82	0.0243902
NODE_34635_length_533_cov_2.288018	468	490	0	22	22	1.0000000
NODE_34767_length_532_cov_73.279446	0	64	16	3	64	0.0468750
NODE_34767_length_532_cov_73.279446	0	64	20	1	64	0.0156250
NODE_34767_length_532_cov_73.279446	0	64	22	5	64	0.0781250
NODE_34767_length_532_cov_73.279446	0	64	24	1	64	0.0156250
NODE_34767_length_532_cov_73.279446	0	64	26	1	64	0.0156250
NODE_34767_length_532_cov_73.279446	0	64	36	2	64	0.0312500
NODE_34767_length_532_cov_73.279446	0	64	42	3	64	0.0468750
NODE_34767_length_532_cov_73.279446	0	64	46	1	64	0.0156250
NODE_34767_length_532_cov_73.279446	0	64	50	1	64	0.0156250
NODE_34767_length_532_cov_73.279446	0	64	52	1	64	0.0156250
NODE_34767_length_532_cov_73.279446	0	64	62	1	64	0.0156250
NODE_34767_length_532_cov_73.279446	0	64	64	1	64	0.0156250
NODE_34767_length_532_cov_73.279446	0	64	66	3	64	0.0468750
NODE_34767_length_532_cov_73.279446	0	64	68	2	64	0.0312500
NODE_34767_length_532_cov_73.279446	0	64	70	1	64	0.0156250
NODE_34767_length_532_cov_73.279446	0	64	74	31	64	0.4843750
NODE_34767_length_532_cov_73.279446	0	64	76	6	64	0.0937500
NODE_34768_length_532_cov_23.055427	168	248	15	35	80	0.4375000
NODE_34768_length_532_cov_23.055427	168	248	19	25	80	0.3125000
NODE_34768_length_532_cov_23.055427	168	248	22	10	80	0.1250000
NODE_34768_length_532_cov_23.055427	168	248	24	1	80	0.0125000
NODE_34768_length_532_cov_23.055427	168	248	25	9	80	0.1125000
NODE_34768_length_532_cov_23.055427	221	301	5	12	80	0.1500000
NODE_34768_length_532_cov_23.055427	221	301	19	7	80	0.0875000
NODE_34768_length_532_cov_23.055427	221	301	21	1	80	0.0125000
NODE_34768_length_532_cov_23.055427	221	301	22	10	80	0.1250000
NODE_34768_length_532_cov_23.055427	221	301	24	1	80	0.0125000
NODE_34768_length_532_cov_23.055427	221	301	25	49	80	0.6125000
NODE_34769_length_532_cov_22.778291	256	336	9	10	80	0.1250000
NODE_34769_length_532_cov_22.778291	256	336	10	5	80	0.0625000
NODE_34769_length_532_cov_22.778291	256	336	11	64	80	0.8000000
NODE_34769_length_532_cov_22.778291	256	336	12	1	80	0.0125000
NODE_34769_length_532_cov_22.778291	309	389	0	21	80	0.2625000
NODE_34769_length_532_cov_22.778291	309	389	1	1	80	0.0125000
NODE_34769_length_532_cov_22.778291	309	389	3	7	80	0.0875000
NODE_34769_length_532_cov_22.778291	309	389	5	13	80	0.1625000
NODE_34769_length_532_cov_22.778291	309	389	9	20	80	0.2500000
NODE_34769_length_532_cov_22.778291	309	389	11	18	80	0.2250000
NODE_34770_length_532_cov_13.279446	85	165	0	41	80	0.5125000
NODE_34770_length_532_cov_13.279446	85	165	2	14	80	0.1750000
NODE_34770_length_532_cov_13.279446	85	165	4	25	80	0.3125000
NODE_34770_length_532_cov_13.279446	138	218	2	7	80	0.0875000
NODE_34770_length_532_cov_13.279446	138	218	4	73	80	0.9125000
NODE_34774_length_532_cov_7.591224	171	235	0	30	64	0.4687500
NODE_34774_length_532_cov_7.591224	171	235	2	3	64	0.0468750
NODE_34774_length_532_cov_7.591224	171	235	3	8	64	0.1250000
NODE_34774_length_532_cov_7.591224	171	235	6	4	64	0.0625000
NODE_34774_length_532_cov_7.591224	171	235	7	19	64	0.2968750
NODE_34774_length_532_cov_7.591224	172	235	0	29	63	0.4603175
NODE_34774_length_532_cov_7.591224	172	235	2	3	63	0.0476190
NODE_34774_length_532_cov_7.591224	172	235	3	8	63	0.1269841
NODE_34774_length_532_cov_7.591224	172	235	6	4	63	0.0634921
NODE_34774_length_532_cov_7.591224	172	235	7	19	63	0.3015873
NODE_34774_length_532_cov_7.591224	173	226	0	28	53	0.5283019
NODE_34774_length_532_cov_7.591224	173	226	2	3	53	0.0566038
NODE_34774_length_532_cov_7.591224	173	226	3	8	53	0.1509434
NODE_34774_length_532_cov_7.591224	173	226	6	4	53	0.0754717
NODE_34774_length_532_cov_7.591224	173	226	7	10	53	0.1886792
NODE_34774_length_532_cov_7.591224	173	228	0	28	55	0.5090909
NODE_34774_length_532_cov_7.591224	173	228	2	3	55	0.0545455
NODE_34774_length_532_cov_7.591224	173	228	3	8	55	0.1454545
NODE_34774_length_532_cov_7.591224	173	228	6	4	55	0.0727273
NODE_34774_length_532_cov_7.591224	173	228	7	12	55	0.2181818
NODE_34774_length_532_cov_7.591224	208	282	3	4	74	0.0540541
NODE_34774_length_532_cov_7.591224	208	282	6	4	74	0.0540541
NODE_34774_length_532_cov_7.591224	208	282	7	24	74	0.3243243
NODE_34774_length_532_cov_7.591224	208	282	8	42	74	0.5675676
NODE_34774_length_532_cov_7.591224	208	282	3	4	74	0.0540541
NODE_34774_length_532_cov_7.591224	208	282	6	4	74	0.0540541
NODE_34774_length_532_cov_7.591224	208	282	7	24	74	0.3243243
NODE_34774_length_532_cov_7.591224	208	282	8	42	74	0.5675676
NODE_34774_length_532_cov_7.591224	208	282	3	4	74	0.0540541
NODE_34774_length_532_cov_7.591224	208	282	6	4	74	0.0540541
NODE_34774_length_532_cov_7.591224	208	282	7	24	74	0.3243243
NODE_34774_length_532_cov_7.591224	208	282	8	42	74	0.5675676
NODE_34774_length_532_cov_7.591224	208	282	3	4	74	0.0540541
NODE_34774_length_532_cov_7.591224	208	282	6	4	74	0.0540541
NODE_34774_length_532_cov_7.591224	208	282	7	24	74	0.3243243
NODE_34774_length_532_cov_7.591224	208	282	8	42	74	0.5675676
NODE_34788_length_532_cov_4.524249	84	151	0	67	67	1.0000000
NODE_34788_length_532_cov_4.524249	137	218	0	81	81	1.0000000
NODE_34838_length_532_cov_1.866051	263	309	0	46	46	1.0000000
NODE_34845_length_532_cov_1.757506	126	146	1	20	20	1.0000000
NODE_34948_length_531_cov_35.539352	7	45	0	38	38	1.0000000
NODE_34948_length_531_cov_35.539352	18	98	0	80	80	1.0000000
NODE_34949_length_531_cov_13.162037	129	209	0	80	80	1.0000000
NODE_34949_length_531_cov_13.162037	182	251	0	69	69	1.0000000
NODE_34953_length_531_cov_6.821759	242	322	0	80	80	1.0000000
NODE_34953_length_531_cov_6.821759	295	375	0	80	80	1.0000000
NODE_34958_length_531_cov_5.261574	261	336	26	8	75	0.1066667
NODE_34958_length_531_cov_5.261574	261	336	28	5	75	0.0666667
NODE_34958_length_531_cov_5.261574	261	336	30	6	75	0.0800000
NODE_34958_length_531_cov_5.261574	261	336	34	6	75	0.0800000
NODE_34958_length_531_cov_5.261574	261	336	36	2	75	0.0266667
NODE_34958_length_531_cov_5.261574	261	336	38	19	75	0.2533333
NODE_34958_length_531_cov_5.261574	261	336	40	23	75	0.3066667
NODE_34958_length_531_cov_5.261574	261	336	42	6	75	0.0800000
NODE_34958_length_531_cov_5.261574	309	362	12	1	53	0.0188679
NODE_34958_length_531_cov_5.261574	309	362	18	2	53	0.0377358
NODE_34958_length_531_cov_5.261574	309	362	20	1	53	0.0188679
NODE_34958_length_531_cov_5.261574	309	362	22	6	53	0.1132075
NODE_34958_length_531_cov_5.261574	309	362	26	10	53	0.1886792
NODE_34958_length_531_cov_5.261574	309	362	28	11	53	0.2075472
NODE_34958_length_531_cov_5.261574	309	362	30	6	53	0.1132075
NODE_34958_length_531_cov_5.261574	309	362	34	2	53	0.0377358
NODE_34958_length_531_cov_5.261574	309	362	36	2	53	0.0377358
NODE_34958_length_531_cov_5.261574	309	362	38	5	53	0.0943396
NODE_34958_length_531_cov_5.261574	309	362	40	7	53	0.1320755
NODE_34963_length_531_cov_4.527778	177	255	0	78	78	1.0000000
NODE_34965_length_531_cov_4.319444	283	363	0	80	80	1.0000000
NODE_34965_length_531_cov_4.319444	336	416	0	80	80	1.0000000
NODE_34979_length_531_cov_3.488426	238	318	0	76	80	0.9500000
NODE_34979_length_531_cov_3.488426	238	318	2	4	80	0.0500000
NODE_34979_length_531_cov_3.488426	291	371	0	23	80	0.2875000
NODE_34979_length_531_cov_3.488426	291	371	2	57	80	0.7125000
NODE_34980_length_531_cov_3.375000	153	207	7	14	54	0.2592593
NODE_34980_length_531_cov_3.375000	153	207	10	10	54	0.1851852
NODE_34980_length_531_cov_3.375000	153	207	14	6	54	0.1111111
NODE_34980_length_531_cov_3.375000	153	207	15	1	54	0.0185185
NODE_34980_length_531_cov_3.375000	153	207	16	14	54	0.2592593
NODE_34980_length_531_cov_3.375000	153	207	18	3	54	0.0555556
NODE_34980_length_531_cov_3.375000	153	207	19	6	54	0.1111111
NODE_34980_length_531_cov_3.375000	180	260	14	3	80	0.0375000
NODE_34980_length_531_cov_3.375000	180	260	15	12	80	0.1500000
NODE_34980_length_531_cov_3.375000	180	260	16	14	80	0.1750000
NODE_34980_length_531_cov_3.375000	180	260	17	2	80	0.0250000
NODE_34980_length_531_cov_3.375000	180	260	18	3	80	0.0375000
NODE_34980_length_531_cov_3.375000	180	260	19	21	80	0.2625000
NODE_34980_length_531_cov_3.375000	180	260	21	25	80	0.3125000
NODE_34986_length_531_cov_3.111111	243	323	0	80	80	1.0000000
NODE_34986_length_531_cov_3.111111	296	376	0	80	80	1.0000000
NODE_35008_length_531_cov_2.201389	302	373	0	18	71	0.2535211
NODE_35008_length_531_cov_2.201389	302	373	2	13	71	0.1830986
NODE_35008_length_531_cov_2.201389	302	373	4	40	71	0.5633803
NODE_35008_length_531_cov_2.201389	350	426	2	16	76	0.2105263
NODE_35008_length_531_cov_2.201389	350	426	4	60	76	0.7894737
NODE_35141_length_530_cov_30.605568	250	330	2	5	80	0.0625000
NODE_35141_length_530_cov_30.605568	250	330	4	20	80	0.2500000
NODE_35141_length_530_cov_30.605568	250	330	6	55	80	0.6875000
NODE_35141_length_530_cov_30.605568	303	383	0	51	80	0.6375000
NODE_35141_length_530_cov_30.605568	303	383	2	7	80	0.0875000
NODE_35141_length_530_cov_30.605568	303	383	6	22	80	0.2750000
NODE_35142_length_530_cov_16.937355	404	484	18	3	80	0.0375000
NODE_35142_length_530_cov_16.937355	404	484	21	2	80	0.0250000
NODE_35142_length_530_cov_16.937355	404	484	22	5	80	0.0625000
NODE_35142_length_530_cov_16.937355	404	484	23	1	80	0.0125000
NODE_35142_length_530_cov_16.937355	404	484	30	8	80	0.1000000
NODE_35142_length_530_cov_16.937355	404	484	32	61	80	0.7625000
NODE_35142_length_530_cov_16.937355	457	530	10	2	73	0.0273973
NODE_35142_length_530_cov_16.937355	457	530	12	2	73	0.0273973
NODE_35142_length_530_cov_16.937355	457	530	14	3	73	0.0410959
NODE_35142_length_530_cov_16.937355	457	530	18	3	73	0.0410959
NODE_35142_length_530_cov_16.937355	457	530	20	1	73	0.0136986
NODE_35142_length_530_cov_16.937355	457	530	24	6	73	0.0821918
NODE_35142_length_530_cov_16.937355	457	530	29	2	73	0.0273973
NODE_35142_length_530_cov_16.937355	457	530	32	54	73	0.7397260
NODE_35143_length_530_cov_9.902552	273	353	0	80	80	1.0000000
NODE_35143_length_530_cov_9.902552	326	406	0	80	80	1.0000000
NODE_35144_length_530_cov_7.928074	46	126	0	56	80	0.7000000
NODE_35144_length_530_cov_7.928074	46	126	4	24	80	0.3000000
NODE_35144_length_530_cov_7.928074	99	179	0	3	80	0.0375000
NODE_35144_length_530_cov_7.928074	99	179	4	77	80	0.9625000
NODE_35150_length_530_cov_4.647332	188	268	0	80	80	1.0000000
NODE_35150_length_530_cov_4.647332	241	321	0	80	80	1.0000000
NODE_35154_length_530_cov_4.389791	162	242	0	80	80	1.0000000
NODE_35159_length_530_cov_4.046404	76	111	0	35	35	1.0000000
NODE_35319_length_529_cov_38.983721	140	220	0	80	80	1.0000000
NODE_35320_length_529_cov_18.223256	189	269	0	80	80	1.0000000
NODE_35320_length_529_cov_18.223256	242	322	0	80	80	1.0000000
NODE_35321_length_529_cov_17.009302	358	438	0	80	80	1.0000000
NODE_35321_length_529_cov_17.009302	411	491	0	80	80	1.0000000
NODE_35331_length_529_cov_6.195349	211	291	4	80	80	1.0000000
NODE_35331_length_529_cov_6.195349	264	322	0	23	58	0.3965517
NODE_35331_length_529_cov_6.195349	264	322	4	35	58	0.6034483
NODE_35336_length_529_cov_5.176744	139	207	0	23	68	0.3382353
NODE_35336_length_529_cov_5.176744	139	207	4	45	68	0.6617647
NODE_35336_length_529_cov_5.176744	185	260	4	75	75	1.0000000
NODE_35364_length_529_cov_2.883721	223	281	0	29	58	0.5000000
NODE_35364_length_529_cov_2.883721	223	281	2	5	58	0.0862069
NODE_35364_length_529_cov_2.883721	223	281	4	24	58	0.4137931
NODE_35374_length_529_cov_2.660465	89	168	0	20	79	0.2531646
NODE_35374_length_529_cov_2.660465	89	168	2	59	79	0.7468355
NODE_35375_length_529_cov_2.595349	278	321	0	43	43	1.0000000
NODE_35384_length_529_cov_2.272093	247	313	0	66	66	1.0000000
NODE_35427_length_529_cov_1.597674	289	332	0	32	43	0.7441860
NODE_35427_length_529_cov_1.597674	289	332	2	11	43	0.2558140
NODE_35521_length_528_cov_25.808858	233	313	0	48	80	0.6000000
NODE_35521_length_528_cov_25.808858	233	313	2	32	80	0.4000000
NODE_35521_length_528_cov_25.808858	286	366	0	80	80	1.0000000
NODE_35522_length_528_cov_17.331002	219	299	0	16	80	0.2000000
NODE_35522_length_528_cov_17.331002	219	299	4	20	80	0.2500000
NODE_35522_length_528_cov_17.331002	219	299	6	44	80	0.5500000
NODE_35522_length_528_cov_17.331002	272	352	0	69	80	0.8625000
NODE_35522_length_528_cov_17.331002	272	352	4	11	80	0.1375000
NODE_35523_length_528_cov_16.165501	262	342	0	80	80	1.0000000
NODE_35523_length_528_cov_16.165501	315	395	0	80	80	1.0000000
NODE_35529_length_528_cov_5.776224	204	284	0	80	80	1.0000000
NODE_35529_length_528_cov_5.776224	257	337	0	80	80	1.0000000
NODE_35542_length_528_cov_4.016317	235	315	0	36	80	0.4500000
NODE_35542_length_528_cov_4.016317	235	315	2	44	80	0.5500000
NODE_35542_length_528_cov_4.016317	288	368	0	18	80	0.2250000
NODE_35542_length_528_cov_4.016317	288	368	2	62	80	0.7750000
NODE_35545_length_528_cov_3.799534	144	192	0	48	48	1.0000000
NODE_35561_length_528_cov_2.902098	252	305	4	23	53	0.4339623
NODE_35561_length_528_cov_2.902098	252	305	6	30	53	0.5660377
NODE_35575_length_528_cov_2.324009	137	188	0	51	51	1.0000000
NODE_35575_length_528_cov_2.324009	161	241	0	80	80	1.0000000
NODE_35597_length_528_cov_1.755245	268	348	2	37	80	0.4625000
NODE_35597_length_528_cov_1.755245	268	348	3	9	80	0.1125000
NODE_35597_length_528_cov_1.755245	268	348	4	34	80	0.4250000
NODE_35597_length_528_cov_1.755245	321	401	0	2	80	0.0250000
NODE_35597_length_528_cov_1.755245	321	401	2	76	80	0.9500000
NODE_35597_length_528_cov_1.755245	321	401	4	2	80	0.0250000
NODE_35687_length_527_cov_19.247664	306	386	0	13	80	0.1625000
NODE_35687_length_527_cov_19.247664	306	386	2	67	80	0.8375000
NODE_35687_length_527_cov_19.247664	359	439	0	24	80	0.3000000
NODE_35687_length_527_cov_19.247664	359	439	2	56	80	0.7000000
NODE_35688_length_527_cov_15.974299	250	349	0	99	99	1.0000000
NODE_35688_length_527_cov_15.974299	322	402	0	80	80	1.0000000
NODE_35691_length_527_cov_8.221963	235	315	0	16	80	0.2000000
NODE_35691_length_527_cov_8.221963	235	315	2	52	80	0.6500000
NODE_35691_length_527_cov_8.221963	235	315	4	1	80	0.0125000
NODE_35691_length_527_cov_8.221963	235	315	6	9	80	0.1125000
NODE_35691_length_527_cov_8.221963	235	315	8	2	80	0.0250000
NODE_35691_length_527_cov_8.221963	288	368	0	14	80	0.1750000
NODE_35691_length_527_cov_8.221963	288	368	2	1	80	0.0125000
NODE_35691_length_527_cov_8.221963	288	368	4	1	80	0.0125000
NODE_35691_length_527_cov_8.221963	288	368	6	9	80	0.1125000
NODE_35691_length_527_cov_8.221963	288	368	8	27	80	0.3375000
NODE_35691_length_527_cov_8.221963	288	368	10	19	80	0.2375000
NODE_35691_length_527_cov_8.221963	288	368	12	9	80	0.1125000
NODE_35693_length_527_cov_7.200935	190	270	0	32	80	0.4000000
NODE_35693_length_527_cov_7.200935	190	270	2	48	80	0.6000000
NODE_35693_length_527_cov_7.200935	243	346	0	82	103	0.7961165
NODE_35693_length_527_cov_7.200935	243	346	2	21	103	0.2038835
NODE_35693_length_527_cov_7.200935	342	422	0	80	80	1.0000000
NODE_35693_length_527_cov_7.200935	395	475	0	80	80	1.0000000
NODE_35696_length_527_cov_6.862150	279	359	0	80	80	1.0000000
NODE_35697_length_527_cov_6.046729	155	235	2	80	80	1.0000000
NODE_35697_length_527_cov_6.046729	208	288	0	50	80	0.6250000
NODE_35697_length_527_cov_6.046729	208	288	2	30	80	0.3750000
NODE_35736_length_527_cov_2.238318	226	306	0	1	80	0.0125000
NODE_35736_length_527_cov_2.238318	226	306	2	20	80	0.2500000
NODE_35736_length_527_cov_2.238318	226	306	7	1	80	0.0125000
NODE_35736_length_527_cov_2.238318	226	306	8	13	80	0.1625000
NODE_35736_length_527_cov_2.238318	226	306	12	45	80	0.5625000
NODE_35858_length_526_cov_50.866511	169	242	0	73	73	1.0000000
NODE_35858_length_526_cov_50.866511	215	295	0	80	80	1.0000000
NODE_35858_length_526_cov_50.866511	291	371	0	66	80	0.8250000
NODE_35858_length_526_cov_50.866511	291	371	2	14	80	0.1750000
NODE_35858_length_526_cov_50.866511	344	424	0	13	80	0.1625000
NODE_35858_length_526_cov_50.866511	344	424	2	67	80	0.8375000
NODE_35860_length_526_cov_26.395785	315	395	0	50	80	0.6250000
NODE_35860_length_526_cov_26.395785	315	395	2	30	80	0.3750000
NODE_35860_length_526_cov_26.395785	368	448	2	80	80	1.0000000
NODE_35861_length_526_cov_16.611241	305	385	0	10	80	0.1250000
NODE_35861_length_526_cov_16.611241	305	385	2	61	80	0.7625000
NODE_35861_length_526_cov_16.611241	305	385	4	9	80	0.1125000
NODE_35861_length_526_cov_16.611241	358	438	0	63	80	0.7875000
NODE_35861_length_526_cov_16.611241	358	438	2	17	80	0.2125000
NODE_35866_length_526_cov_6.215457	303	351	6	5	48	0.1041667
NODE_35866_length_526_cov_6.215457	303	351	8	1	48	0.0208333
NODE_35866_length_526_cov_6.215457	303	351	13	1	48	0.0208333
NODE_35866_length_526_cov_6.215457	303	351	14	4	48	0.0833333
NODE_35866_length_526_cov_6.215457	303	351	18	1	48	0.0208333
NODE_35866_length_526_cov_6.215457	303	351	19	3	48	0.0625000
NODE_35866_length_526_cov_6.215457	303	351	20	6	48	0.1250000
NODE_35866_length_526_cov_6.215457	303	351	22	1	48	0.0208333
NODE_35866_length_526_cov_6.215457	303	351	23	1	48	0.0208333
NODE_35866_length_526_cov_6.215457	303	351	33	2	48	0.0416667
NODE_35866_length_526_cov_6.215457	303	351	35	2	48	0.0416667
NODE_35866_length_526_cov_6.215457	303	351	36	3	48	0.0625000
NODE_35866_length_526_cov_6.215457	303	351	39	3	48	0.0625000
NODE_35866_length_526_cov_6.215457	303	351	40	1	48	0.0208333
NODE_35866_length_526_cov_6.215457	303	351	46	2	48	0.0416667
NODE_35866_length_526_cov_6.215457	303	351	50	1	48	0.0208333
NODE_35866_length_526_cov_6.215457	303	351	52	2	48	0.0416667
NODE_35866_length_526_cov_6.215457	303	351	54	1	48	0.0208333
NODE_35866_length_526_cov_6.215457	303	351	58	2	48	0.0416667
NODE_35866_length_526_cov_6.215457	303	351	60	4	48	0.0833333
NODE_35866_length_526_cov_6.215457	303	351	62	1	48	0.0208333
NODE_35866_length_526_cov_6.215457	303	351	64	1	48	0.0208333
NODE_35877_length_526_cov_3.936768	118	142	0	24	24	1.0000000
NODE_35877_length_526_cov_3.936768	118	163	0	45	45	1.0000000
NODE_35901_length_526_cov_2.466042	138	184	0	46	46	1.0000000
NODE_36055_length_525_cov_33.910798	98	178	2	1	80	0.0125000
NODE_36055_length_525_cov_33.910798	98	178	4	2	80	0.0250000
NODE_36055_length_525_cov_33.910798	98	178	6	23	80	0.2875000
NODE_36055_length_525_cov_33.910798	98	178	13	1	80	0.0125000
NODE_36055_length_525_cov_33.910798	98	178	20	1	80	0.0125000
NODE_36055_length_525_cov_33.910798	98	178	21	1	80	0.0125000
NODE_36055_length_525_cov_33.910798	98	178	23	2	80	0.0250000
NODE_36055_length_525_cov_33.910798	98	178	28	1	80	0.0125000
NODE_36055_length_525_cov_33.910798	98	178	29	1	80	0.0125000
NODE_36055_length_525_cov_33.910798	98	178	30	4	80	0.0500000
NODE_36055_length_525_cov_33.910798	98	178	31	2	80	0.0250000
NODE_36055_length_525_cov_33.910798	98	178	33	3	80	0.0375000
NODE_36055_length_525_cov_33.910798	98	178	34	3	80	0.0375000
NODE_36055_length_525_cov_33.910798	98	178	35	1	80	0.0125000
NODE_36055_length_525_cov_33.910798	98	178	37	12	80	0.1500000
NODE_36055_length_525_cov_33.910798	98	178	39	2	80	0.0250000
NODE_36055_length_525_cov_33.910798	98	178	41	4	80	0.0500000
NODE_36055_length_525_cov_33.910798	98	178	43	3	80	0.0375000
NODE_36055_length_525_cov_33.910798	98	178	47	6	80	0.0750000
NODE_36055_length_525_cov_33.910798	98	178	50	1	80	0.0125000
NODE_36055_length_525_cov_33.910798	98	178	51	6	80	0.0750000
NODE_36055_length_525_cov_33.910798	151	231	2	1	80	0.0125000
NODE_36055_length_525_cov_33.910798	151	231	4	20	80	0.2500000
NODE_36055_length_525_cov_33.910798	151	231	6	43	80	0.5375000
NODE_36055_length_525_cov_33.910798	151	231	8	8	80	0.1000000
NODE_36055_length_525_cov_33.910798	151	231	10	7	80	0.0875000
NODE_36055_length_525_cov_33.910798	151	231	13	1	80	0.0125000
NODE_36055_length_525_cov_33.910798	159	231	4	18	72	0.2500000
NODE_36055_length_525_cov_33.910798	159	231	6	39	72	0.5416667
NODE_36055_length_525_cov_33.910798	159	231	8	8	72	0.1111111
NODE_36055_length_525_cov_33.910798	159	231	10	7	72	0.0972222
NODE_36058_length_525_cov_8.788732	175	255	0	80	80	1.0000000
NODE_36058_length_525_cov_8.788732	228	308	0	80	80	1.0000000
NODE_36059_length_525_cov_7.880282	242	285	2	43	43	1.0000000
NODE_36098_length_525_cov_2.417840	229	306	0	77	77	1.0000000
NODE_36230_length_524_cov_21.649412	262	342	0	80	80	1.0000000
NODE_36230_length_524_cov_21.649412	315	395	0	80	80	1.0000000
NODE_36231_length_524_cov_14.131765	136	201	0	65	65	1.0000000
NODE_36232_length_524_cov_10.392941	237	317	0	80	80	1.0000000
NODE_36232_length_524_cov_10.392941	290	370	0	80	80	1.0000000
NODE_36262_length_524_cov_3.221176	195	272	0	77	77	1.0000000
NODE_36262_length_524_cov_3.221176	253	324	0	71	71	1.0000000
NODE_36264_length_524_cov_3.148235	317	397	0	80	80	1.0000000
NODE_36410_length_523_cov_113.438679	0	48	0	21	48	0.4375000
NODE_36410_length_523_cov_113.438679	0	48	2	27	48	0.5625000
NODE_36410_length_523_cov_113.438679	14	69	0	7	55	0.1272727
NODE_36410_length_523_cov_113.438679	14	69	2	31	55	0.5636364
NODE_36410_length_523_cov_113.438679	14	69	4	17	55	0.3090909
NODE_36410_length_523_cov_113.438679	25	101	2	27	76	0.3552631
NODE_36410_length_523_cov_113.438679	25	101	4	33	76	0.4342105
NODE_36410_length_523_cov_113.438679	25	101	9	1	76	0.0131579
NODE_36410_length_523_cov_113.438679	25	101	12	1	76	0.0131579
NODE_36410_length_523_cov_113.438679	25	101	14	8	76	0.1052632
NODE_36410_length_523_cov_113.438679	25	101	16	1	76	0.0131579
NODE_36410_length_523_cov_113.438679	25	101	18	5	76	0.0657895
NODE_36410_length_523_cov_113.438679	105	181	18	1	76	0.0131579
NODE_36410_length_523_cov_113.438679	105	181	20	10	76	0.1315790
NODE_36410_length_523_cov_113.438679	105	181	21	4	76	0.0526316
NODE_36410_length_523_cov_113.438679	105	181	23	2	76	0.0263158
NODE_36410_length_523_cov_113.438679	105	181	27	1	76	0.0131579
NODE_36410_length_523_cov_113.438679	105	181	29	2	76	0.0263158
NODE_36410_length_523_cov_113.438679	105	181	31	2	76	0.0263158
NODE_36410_length_523_cov_113.438679	105	181	35	1	76	0.0131579
NODE_36410_length_523_cov_113.438679	105	181	38	1	76	0.0131579
NODE_36410_length_523_cov_113.438679	105	181	42	1	76	0.0131579
NODE_36410_length_523_cov_113.438679	105	181	44	1	76	0.0131579
NODE_36410_length_523_cov_113.438679	105	181	48	2	76	0.0263158
NODE_36410_length_523_cov_113.438679	105	181	52	3	76	0.0394737
NODE_36410_length_523_cov_113.438679	105	181	56	3	76	0.0394737
NODE_36410_length_523_cov_113.438679	105	181	58	10	76	0.1315790
NODE_36410_length_523_cov_113.438679	105	181	60	5	76	0.0657895
NODE_36410_length_523_cov_113.438679	105	181	61	1	76	0.0131579
NODE_36410_length_523_cov_113.438679	105	181	63	4	76	0.0526316
NODE_36410_length_523_cov_113.438679	105	181	67	2	76	0.0263158
NODE_36410_length_523_cov_113.438679	105	181	69	14	76	0.1842105
NODE_36410_length_523_cov_113.438679	105	181	71	6	76	0.0789474
NODE_36410_length_523_cov_113.438679	154	234	56	1	80	0.0125000
NODE_36410_length_523_cov_113.438679	154	234	58	1	80	0.0125000
NODE_36410_length_523_cov_113.438679	154	234	60	5	80	0.0625000
NODE_36410_length_523_cov_113.438679	154	234	61	1	80	0.0125000
NODE_36410_length_523_cov_113.438679	154	234	62	9	80	0.1125000
NODE_36410_length_523_cov_113.438679	154	234	63	4	80	0.0500000
NODE_36410_length_523_cov_113.438679	154	234	67	2	80	0.0250000
NODE_36410_length_523_cov_113.438679	154	234	69	14	80	0.1750000
NODE_36410_length_523_cov_113.438679	154	234	70	4	80	0.0500000
NODE_36410_length_523_cov_113.438679	154	234	71	9	80	0.1125000
NODE_36410_length_523_cov_113.438679	154	234	74	4	80	0.0500000
NODE_36410_length_523_cov_113.438679	154	234	75	2	80	0.0250000
NODE_36410_length_523_cov_113.438679	154	234	77	2	80	0.0250000
NODE_36410_length_523_cov_113.438679	154	234	78	7	80	0.0875000
NODE_36410_length_523_cov_113.438679	154	234	79	1	80	0.0125000
NODE_36410_length_523_cov_113.438679	154	234	80	6	80	0.0750000
NODE_36410_length_523_cov_113.438679	154	234	84	8	80	0.1000000
NODE_36410_length_523_cov_113.438679	312	355	15	7	43	0.1627907
NODE_36410_length_523_cov_113.438679	312	355	17	1	43	0.0232558
NODE_36410_length_523_cov_113.438679	312	355	19	3	43	0.0697674
NODE_36410_length_523_cov_113.438679	312	355	20	8	43	0.1860465
NODE_36410_length_523_cov_113.438679	312	355	21	8	43	0.1860465
NODE_36410_length_523_cov_113.438679	312	355	23	7	43	0.1627907
NODE_36410_length_523_cov_113.438679	312	355	24	3	43	0.0697674
NODE_36410_length_523_cov_113.438679	312	355	25	6	43	0.1395349
NODE_36412_length_523_cov_64.695755	35	115	0	80	80	1.0000000
NODE_36412_length_523_cov_64.695755	88	168	0	80	80	1.0000000
NODE_36414_length_523_cov_20.724057	235	315	0	11	80	0.1375000
NODE_36414_length_523_cov_20.724057	235	315	2	69	80	0.8625000
NODE_36414_length_523_cov_20.724057	288	368	0	64	80	0.8000000
NODE_36414_length_523_cov_20.724057	288	368	2	16	80	0.2000000
NODE_36415_length_523_cov_18.500000	164	244	0	80	80	1.0000000
NODE_36415_length_523_cov_18.500000	217	297	0	80	80	1.0000000
NODE_36416_length_523_cov_15.216981	62	142	0	80	80	1.0000000
NODE_36416_length_523_cov_15.216981	115	195	0	80	80	1.0000000
NODE_36417_length_523_cov_10.575472	157	183	0	26	26	1.0000000
NODE_36418_length_523_cov_9.962264	212	292	0	80	80	1.0000000
NODE_36418_length_523_cov_9.962264	265	345	0	80	80	1.0000000
NODE_36427_length_523_cov_4.943396	108	188	14	22	80	0.2750000
NODE_36427_length_523_cov_4.943396	108	188	16	29	80	0.3625000
NODE_36427_length_523_cov_4.943396	108	188	18	13	80	0.1625000
NODE_36427_length_523_cov_4.943396	108	188	20	9	80	0.1125000
NODE_36427_length_523_cov_4.943396	108	188	22	7	80	0.0875000
NODE_36427_length_523_cov_4.943396	161	241	18	29	80	0.3625000
NODE_36427_length_523_cov_4.943396	161	241	20	13	80	0.1625000
NODE_36427_length_523_cov_4.943396	161	241	22	17	80	0.2125000
NODE_36427_length_523_cov_4.943396	161	241	23	5	80	0.0625000
NODE_36427_length_523_cov_4.943396	161	241	24	5	80	0.0625000
NODE_36427_length_523_cov_4.943396	161	241	25	6	80	0.0750000
NODE_36427_length_523_cov_4.943396	161	241	26	5	80	0.0625000
NODE_36429_length_523_cov_4.787736	110	141	22	30	31	0.9677419
NODE_36429_length_523_cov_4.787736	110	141	26	1	31	0.0322581
NODE_36429_length_523_cov_4.787736	131	194	6	2	63	0.0317460
NODE_36429_length_523_cov_4.787736	131	194	8	1	63	0.0158730
NODE_36429_length_523_cov_4.787736	131	194	14	2	63	0.0317460
NODE_36429_length_523_cov_4.787736	131	194	16	1	63	0.0158730
NODE_36429_length_523_cov_4.787736	131	194	18	9	63	0.1428571
NODE_36429_length_523_cov_4.787736	131	194	20	5	63	0.0793651
NODE_36429_length_523_cov_4.787736	131	194	22	9	63	0.1428571
NODE_36429_length_523_cov_4.787736	131	194	24	11	63	0.1746032
NODE_36429_length_523_cov_4.787736	131	194	26	21	63	0.3333333
NODE_36429_length_523_cov_4.787736	131	194	28	2	63	0.0317460
NODE_36439_length_523_cov_3.792453	139	219	0	46	80	0.5750000
NODE_36439_length_523_cov_3.792453	139	219	2	34	80	0.4250000
NODE_36439_length_523_cov_3.792453	192	272	2	78	80	0.9750000
NODE_36439_length_523_cov_3.792453	192	272	3	1	80	0.0125000
NODE_36439_length_523_cov_3.792453	192	272	4	1	80	0.0125000
NODE_36481_length_523_cov_2.259434	337	372	2	33	35	0.9428571
NODE_36481_length_523_cov_2.259434	337	372	5	2	35	0.0571429
NODE_36490_length_523_cov_2.096698	307	351	6	1	44	0.0227273
NODE_36490_length_523_cov_2.096698	307	351	7	4	44	0.0909091
NODE_36490_length_523_cov_2.096698	307	351	8	3	44	0.0681818
NODE_36490_length_523_cov_2.096698	307	351	12	1	44	0.0227273
NODE_36490_length_523_cov_2.096698	307	351	13	3	44	0.0681818
NODE_36490_length_523_cov_2.096698	307	351	15	1	44	0.0227273
NODE_36490_length_523_cov_2.096698	307	351	17	10	44	0.2272727
NODE_36490_length_523_cov_2.096698	307	351	18	3	44	0.0681818
NODE_36490_length_523_cov_2.096698	307	351	20	17	44	0.3863636
NODE_36490_length_523_cov_2.096698	307	351	22	1	44	0.0227273
NODE_36518_length_523_cov_1.700472	176	195	0	19	19	1.0000000
NODE_36632_length_522_cov_33.579196	55	135	0	69	80	0.8625000
NODE_36632_length_522_cov_33.579196	55	135	4	11	80	0.1375000
NODE_36632_length_522_cov_33.579196	108	188	0	16	80	0.2000000
NODE_36632_length_522_cov_33.579196	108	188	4	64	80	0.8000000
NODE_36634_length_522_cov_12.851064	266	342	0	76	76	1.0000000
NODE_36634_length_522_cov_12.851064	319	395	0	52	76	0.6842105
NODE_36634_length_522_cov_12.851064	319	395	1	24	76	0.3157895
NODE_36637_length_522_cov_7.349882	212	283	3	1	71	0.0140845
NODE_36637_length_522_cov_7.349882	212	283	4	70	71	0.9859155
NODE_36637_length_522_cov_7.349882	400	469	0	69	69	1.0000000
NODE_36670_length_522_cov_2.933806	178	258	0	80	80	1.0000000
NODE_36670_length_522_cov_2.933806	231	311	0	80	80	1.0000000
NODE_36676_length_522_cov_2.661939	187	241	0	14	54	0.2592593
NODE_36676_length_522_cov_2.661939	187	241	6	40	54	0.7407407
NODE_36820_length_521_cov_9.303318	106	186	0	80	80	1.0000000
NODE_36820_length_521_cov_9.303318	159	239	0	80	80	1.0000000
NODE_36832_length_521_cov_4.971564	218	298	2	25	80	0.3125000
NODE_36832_length_521_cov_4.971564	218	298	4	55	80	0.6875000
NODE_36832_length_521_cov_4.971564	271	351	0	32	80	0.4000000
NODE_36832_length_521_cov_4.971564	271	351	2	46	80	0.5750000
NODE_36832_length_521_cov_4.971564	271	351	4	2	80	0.0250000
NODE_36845_length_521_cov_3.504739	113	191	0	78	78	1.0000000
NODE_36845_length_521_cov_3.504739	164	205	0	41	41	1.0000000
NODE_36848_length_521_cov_3.324645	158	244	0	1	86	0.0116279
NODE_36848_length_521_cov_3.324645	158	244	3	1	86	0.0116279
NODE_36848_length_521_cov_3.324645	158	244	4	36	86	0.4186046
NODE_36848_length_521_cov_3.324645	158	244	8	1	86	0.0116279
NODE_36848_length_521_cov_3.324645	158	244	10	47	86	0.5465117
NODE_36848_length_521_cov_3.324645	217	280	4	2	63	0.0317460
NODE_36848_length_521_cov_3.324645	217	280	6	11	63	0.1746032
NODE_36848_length_521_cov_3.324645	217	280	10	50	63	0.7936508
NODE_36916_length_521_cov_1.613744	165	227	2	40	62	0.6451613
NODE_36916_length_521_cov_1.613744	165	227	4	22	62	0.3548387
NODE_37036_length_520_cov_50.676960	0	75	0	75	75	1.0000000
NODE_37036_length_520_cov_50.676960	48	128	0	80	80	1.0000000
NODE_37036_length_520_cov_50.676960	124	204	0	80	80	1.0000000
NODE_37036_length_520_cov_50.676960	177	257	0	80	80	1.0000000
NODE_37037_length_520_cov_43.294537	10	90	0	28	80	0.3500000
NODE_37037_length_520_cov_43.294537	10	90	2	52	80	0.6500000
NODE_37037_length_520_cov_43.294537	10	90	0	28	80	0.3500000
NODE_37037_length_520_cov_43.294537	10	90	2	52	80	0.6500000
NODE_37037_length_520_cov_43.294537	10	90	0	28	80	0.3500000
NODE_37037_length_520_cov_43.294537	10	90	2	52	80	0.6500000
NODE_37037_length_520_cov_43.294537	10	90	0	28	80	0.3500000
NODE_37037_length_520_cov_43.294537	10	90	2	52	80	0.6500000
NODE_37037_length_520_cov_43.294537	10	90	0	28	80	0.3500000
NODE_37037_length_520_cov_43.294537	10	90	2	52	80	0.6500000
NODE_37037_length_520_cov_43.294537	10	90	0	28	80	0.3500000
NODE_37037_length_520_cov_43.294537	10	90	2	52	80	0.6500000
NODE_37037_length_520_cov_43.294537	63	129	0	6	66	0.0909091
NODE_37037_length_520_cov_43.294537	63	129	2	60	66	0.9090909
NODE_37037_length_520_cov_43.294537	63	142	0	19	79	0.2405063
NODE_37037_length_520_cov_43.294537	63	142	2	60	79	0.7594936
NODE_37037_length_520_cov_43.294537	63	143	0	20	80	0.2500000
NODE_37037_length_520_cov_43.294537	63	143	2	60	80	0.7500000
NODE_37037_length_520_cov_43.294537	63	133	0	10	70	0.1428571
NODE_37037_length_520_cov_43.294537	63	133	2	60	70	0.8571429
NODE_37037_length_520_cov_43.294537	66	133	0	10	67	0.1492537
NODE_37037_length_520_cov_43.294537	66	133	2	57	67	0.8507463
NODE_37037_length_520_cov_43.294537	68	143	0	20	75	0.2666667
NODE_37037_length_520_cov_43.294537	68	143	2	55	75	0.7333333
NODE_37038_length_520_cov_29.427553	224	304	0	80	80	1.0000000
NODE_37038_length_520_cov_29.427553	277	357	0	80	80	1.0000000
NODE_37038_length_520_cov_29.427553	353	433	0	80	80	1.0000000
NODE_37038_length_520_cov_29.427553	406	486	0	80	80	1.0000000
NODE_37039_length_520_cov_14.365796	103	183	0	80	80	1.0000000
NODE_37039_length_520_cov_14.365796	156	237	0	81	81	1.0000000
NODE_37059_length_520_cov_4.121140	79	159	0	80	80	1.0000000
NODE_37059_length_520_cov_4.121140	132	212	0	80	80	1.0000000
NODE_37063_length_520_cov_3.900238	203	233	0	30	30	1.0000000
NODE_37235_length_519_cov_42.842857	8	88	8	11	80	0.1375000
NODE_37235_length_519_cov_42.842857	8	88	10	22	80	0.2750000
NODE_37235_length_519_cov_42.842857	8	88	14	3	80	0.0375000
NODE_37235_length_519_cov_42.842857	8	88	16	12	80	0.1500000
NODE_37235_length_519_cov_42.842857	8	88	18	29	80	0.3625000
NODE_37235_length_519_cov_42.842857	8	88	19	3	80	0.0375000
NODE_37235_length_519_cov_42.842857	61	139	5	3	78	0.0384615
NODE_37235_length_519_cov_42.842857	61	139	6	1	78	0.0128205
NODE_37235_length_519_cov_42.842857	61	139	9	5	78	0.0641026
NODE_37235_length_519_cov_42.842857	61	139	10	2	78	0.0256410
NODE_37235_length_519_cov_42.842857	61	139	11	2	78	0.0256410
NODE_37235_length_519_cov_42.842857	61	139	13	13	78	0.1666667
NODE_37235_length_519_cov_42.842857	61	139	18	24	78	0.3076923
NODE_37235_length_519_cov_42.842857	61	139	19	7	78	0.0897436
NODE_37235_length_519_cov_42.842857	61	139	21	21	78	0.2692308
NODE_37236_length_519_cov_19.269048	284	363	10	13	79	0.1645570
NODE_37236_length_519_cov_19.269048	284	363	14	4	79	0.0506329
NODE_37236_length_519_cov_19.269048	284	363	16	10	79	0.1265823
NODE_37236_length_519_cov_19.269048	284	363	18	52	79	0.6582279
NODE_37236_length_519_cov_19.269048	336	416	0	34	80	0.4250000
NODE_37236_length_519_cov_19.269048	336	416	4	8	80	0.1000000
NODE_37236_length_519_cov_19.269048	336	416	7	5	80	0.0625000
NODE_37236_length_519_cov_19.269048	336	416	17	4	80	0.0500000
NODE_37236_length_519_cov_19.269048	336	416	18	29	80	0.3625000
NODE_37237_length_519_cov_8.500000	195	267	0	10	72	0.1388889
NODE_37237_length_519_cov_8.500000	195	267	4	47	72	0.6527778
NODE_37237_length_519_cov_8.500000	195	267	6	8	72	0.1111111
NODE_37237_length_519_cov_8.500000	195	267	8	7	72	0.0972222
NODE_37245_length_519_cov_5.169048	282	346	0	64	64	1.0000000
NODE_37290_length_519_cov_2.783333	174	235	0	61	61	1.0000000
NODE_37349_length_519_cov_1.538095	147	213	0	66	66	1.0000000
NODE_37447_length_518_cov_40.026253	385	465	0	80	80	1.0000000
NODE_37447_length_518_cov_40.026253	438	518	0	80	80	1.0000000
NODE_37449_length_518_cov_12.083532	144	224	0	80	80	1.0000000
NODE_37449_length_518_cov_12.083532	197	277	0	80	80	1.0000000
NODE_37449_length_518_cov_12.083532	407	481	0	20	74	0.2702703
NODE_37449_length_518_cov_12.083532	407	481	2	54	74	0.7297297
NODE_37449_length_518_cov_12.083532	454	518	2	64	64	1.0000000
NODE_37450_length_518_cov_11.467780	171	200	2	29	29	1.0000000
NODE_37450_length_518_cov_11.467780	253	320	0	67	67	1.0000000
NODE_37450_length_518_cov_11.467780	253	282	0	29	29	1.0000000
NODE_37454_length_518_cov_7.441527	188	273	0	85	85	1.0000000
NODE_37461_length_518_cov_5.563246	315	366	2	28	51	0.5490196
NODE_37461_length_518_cov_5.563246	315	366	4	7	51	0.1372549
NODE_37461_length_518_cov_5.563246	315	366	5	1	51	0.0196078
NODE_37461_length_518_cov_5.563246	315	366	6	15	51	0.2941177
NODE_37461_length_518_cov_5.563246	339	383	2	4	44	0.0909091
NODE_37461_length_518_cov_5.563246	339	383	4	7	44	0.1590909
NODE_37461_length_518_cov_5.563246	339	383	5	1	44	0.0227273
NODE_37461_length_518_cov_5.563246	339	383	6	32	44	0.7272727
NODE_37465_length_518_cov_4.732697	214	276	0	42	62	0.6774194
NODE_37465_length_518_cov_4.732697	214	276	2	2	62	0.0322581
NODE_37465_length_518_cov_4.732697	214	276	4	2	62	0.0322581
NODE_37465_length_518_cov_4.732697	214	276	8	16	62	0.2580645
NODE_37465_length_518_cov_4.732697	350	430	2	80	80	1.0000000
NODE_37479_length_518_cov_3.503580	291	333	2	10	42	0.2380952
NODE_37479_length_518_cov_3.503580	291	333	4	32	42	0.7619048
NODE_37479_length_518_cov_3.503580	306	363	2	29	57	0.5087720
NODE_37479_length_518_cov_3.503580	306	363	4	28	57	0.4912281
NODE_37483_length_518_cov_3.136038	269	338	0	5	69	0.0724638
NODE_37483_length_518_cov_3.136038	269	338	2	19	69	0.2753623
NODE_37483_length_518_cov_3.136038	269	338	4	1	69	0.0144928
NODE_37483_length_518_cov_3.136038	269	338	10	44	69	0.6376812
NODE_37483_length_518_cov_3.136038	269	348	0	5	79	0.0632911
NODE_37483_length_518_cov_3.136038	269	348	2	19	79	0.2405063
NODE_37483_length_518_cov_3.136038	269	348	4	1	79	0.0126582
NODE_37483_length_518_cov_3.136038	269	348	10	54	79	0.6835443
NODE_37483_length_518_cov_3.136038	269	349	0	5	80	0.0625000
NODE_37483_length_518_cov_3.136038	269	349	2	19	80	0.2375000
NODE_37483_length_518_cov_3.136038	269	349	4	1	80	0.0125000
NODE_37483_length_518_cov_3.136038	269	349	10	55	80	0.6875000
NODE_37483_length_518_cov_3.136038	322	402	2	28	80	0.3500000
NODE_37483_length_518_cov_3.136038	322	402	6	3	80	0.0375000
NODE_37483_length_518_cov_3.136038	322	402	8	19	80	0.2375000
NODE_37483_length_518_cov_3.136038	322	402	10	30	80	0.3750000
NODE_37483_length_518_cov_3.136038	322	364	8	12	42	0.2857143
NODE_37483_length_518_cov_3.136038	322	364	10	30	42	0.7142857
NODE_37483_length_518_cov_3.136038	322	368	8	16	46	0.3478261
NODE_37483_length_518_cov_3.136038	322	368	10	30	46	0.6521739
NODE_37483_length_518_cov_3.136038	331	366	8	14	35	0.4000000
NODE_37483_length_518_cov_3.136038	331	366	10	21	35	0.6000000
NODE_37637_length_517_cov_55.267943	177	257	0	80	80	1.0000000
NODE_37637_length_517_cov_55.267943	230	310	0	80	80	1.0000000
NODE_37639_length_517_cov_30.863636	0	72	0	37	72	0.5138889
NODE_37639_length_517_cov_30.863636	0	72	2	35	72	0.4861111
NODE_37639_length_517_cov_30.863636	0	72	0	37	72	0.5138889
NODE_37639_length_517_cov_30.863636	0	72	2	35	72	0.4861111
NODE_37639_length_517_cov_30.863636	45	125	2	80	80	1.0000000
NODE_37639_length_517_cov_30.863636	45	99	2	54	54	1.0000000
NODE_37641_length_517_cov_12.258373	305	385	0	80	80	1.0000000
NODE_37641_length_517_cov_12.258373	358	438	0	80	80	1.0000000
NODE_37643_length_517_cov_7.131579	100	152	0	52	52	1.0000000
NODE_37662_length_517_cov_4.492823	140	220	0	80	80	1.0000000
NODE_37662_length_517_cov_4.492823	193	273	0	80	80	1.0000000
NODE_37697_length_517_cov_2.437799	331	388	6	57	57	1.0000000
NODE_37850_length_516_cov_17.570743	147	227	0	24	80	0.3000000
NODE_37850_length_516_cov_17.570743	147	227	2	56	80	0.7000000
NODE_37850_length_516_cov_17.570743	200	280	1	2	80	0.0250000
NODE_37850_length_516_cov_17.570743	200	280	2	57	80	0.7125000
NODE_37850_length_516_cov_17.570743	200	280	3	21	80	0.2625000
NODE_37861_length_516_cov_5.268585	402	448	2	46	46	1.0000000
NODE_37862_length_516_cov_5.067146	114	194	0	80	80	1.0000000
NODE_37862_length_516_cov_5.067146	167	247	0	80	80	1.0000000
NODE_37864_length_516_cov_4.788969	156	236	0	80	80	1.0000000
NODE_37864_length_516_cov_4.788969	209	277	0	68	68	1.0000000
NODE_37881_length_516_cov_3.167866	48	93	0	45	45	1.0000000
NODE_37881_length_516_cov_3.167866	103	177	0	2	74	0.0270270
NODE_37881_length_516_cov_3.167866	103	177	4	16	74	0.2162162
NODE_37881_length_516_cov_3.167866	103	177	6	56	74	0.7567568
NODE_38044_length_515_cov_69.442308	177	257	3	11	80	0.1375000
NODE_38044_length_515_cov_69.442308	177	257	4	21	80	0.2625000
NODE_38044_length_515_cov_69.442308	177	257	6	1	80	0.0125000
NODE_38044_length_515_cov_69.442308	177	257	7	47	80	0.5875000
NODE_38044_length_515_cov_69.442308	177	257	3	11	80	0.1375000
NODE_38044_length_515_cov_69.442308	177	257	4	21	80	0.2625000
NODE_38044_length_515_cov_69.442308	177	257	6	1	80	0.0125000
NODE_38044_length_515_cov_69.442308	177	257	7	47	80	0.5875000
NODE_38044_length_515_cov_69.442308	177	257	3	11	80	0.1375000
NODE_38044_length_515_cov_69.442308	177	257	4	21	80	0.2625000
NODE_38044_length_515_cov_69.442308	177	257	6	1	80	0.0125000
NODE_38044_length_515_cov_69.442308	177	257	7	47	80	0.5875000
NODE_38044_length_515_cov_69.442308	230	291	3	45	61	0.7377049
NODE_38044_length_515_cov_69.442308	230	291	7	16	61	0.2622951
NODE_38044_length_515_cov_69.442308	230	308	1	3	78	0.0384615
NODE_38044_length_515_cov_69.442308	230	308	2	4	78	0.0512821
NODE_38044_length_515_cov_69.442308	230	308	3	55	78	0.7051282
NODE_38044_length_515_cov_69.442308	230	308	7	16	78	0.2051282
NODE_38044_length_515_cov_69.442308	235	308	1	3	73	0.0410959
NODE_38044_length_515_cov_69.442308	235	308	2	4	73	0.0547945
NODE_38044_length_515_cov_69.442308	235	308	3	55	73	0.7534246
NODE_38044_length_515_cov_69.442308	235	308	7	11	73	0.1506849
NODE_38045_length_515_cov_13.271635	168	248	0	80	80	1.0000000
NODE_38045_length_515_cov_13.271635	221	301	0	80	80	1.0000000
NODE_38048_length_515_cov_8.314904	213	290	0	77	77	1.0000000
NODE_38054_length_515_cov_5.487981	317	402	0	85	85	1.0000000
NODE_38242_length_514_cov_26.910843	170	250	0	80	80	1.0000000
NODE_38242_length_514_cov_26.910843	223	303	0	80	80	1.0000000
NODE_38243_length_514_cov_12.775904	85	149	0	64	64	1.0000000
NODE_38243_length_514_cov_12.775904	123	202	0	79	79	1.0000000
NODE_38244_length_514_cov_11.156627	124	204	0	80	80	1.0000000
NODE_38244_length_514_cov_11.156627	177	257	0	80	80	1.0000000
NODE_38253_length_514_cov_5.802410	165	217	0	11	52	0.2115385
NODE_38253_length_514_cov_5.802410	165	217	4	41	52	0.7884616
NODE_38253_length_514_cov_5.802410	190	270	4	80	80	1.0000000
NODE_38254_length_514_cov_5.554217	192	272	0	80	80	1.0000000
NODE_38254_length_514_cov_5.554217	294	340	0	46	46	1.0000000
NODE_38257_length_514_cov_5.322892	230	260	0	1	30	0.0333333
NODE_38257_length_514_cov_5.322892	230	260	2	29	30	0.9666666
NODE_38262_length_514_cov_4.337349	220	300	0	80	80	1.0000000
NODE_38286_length_514_cov_3.012048	264	328	0	61	64	0.9531250
NODE_38286_length_514_cov_3.012048	264	328	4	1	64	0.0156250
NODE_38286_length_514_cov_3.012048	264	328	6	2	64	0.0312500
NODE_38432_length_513_cov_14.613527	118	198	0	80	80	1.0000000
NODE_38432_length_513_cov_14.613527	171	251	0	80	80	1.0000000
NODE_38433_length_513_cov_9.898551	253	333	0	80	80	1.0000000
NODE_38433_length_513_cov_9.898551	306	386	0	46	80	0.5750000
NODE_38433_length_513_cov_9.898551	306	386	2	34	80	0.4250000
NODE_38434_length_513_cov_9.164251	185	265	0	11	80	0.1375000
NODE_38434_length_513_cov_9.164251	185	265	4	69	80	0.8625000
NODE_38434_length_513_cov_9.164251	238	318	0	15	80	0.1875000
NODE_38434_length_513_cov_9.164251	238	318	4	65	80	0.8125000
NODE_38441_length_513_cov_6.123188	284	364	0	80	80	1.0000000
NODE_38441_length_513_cov_6.123188	337	417	0	80	80	1.0000000
NODE_38460_length_513_cov_3.456522	283	350	2	13	67	0.1940299
NODE_38460_length_513_cov_3.456522	283	350	4	7	67	0.1044776
NODE_38460_length_513_cov_3.456522	283	350	8	23	67	0.3432836
NODE_38460_length_513_cov_3.456522	283	350	9	3	67	0.0447761
NODE_38460_length_513_cov_3.456522	283	350	11	5	67	0.0746269
NODE_38460_length_513_cov_3.456522	283	350	12	16	67	0.2388060
NODE_38460_length_513_cov_3.456522	336	398	10	13	62	0.2096774
NODE_38460_length_513_cov_3.456522	336	398	12	49	62	0.7903226
NODE_38482_length_513_cov_2.309179	134	174	2	40	40	1.0000000
NODE_38482_length_513_cov_2.309179	170	223	0	29	53	0.5471698
NODE_38482_length_513_cov_2.309179	170	223	2	24	53	0.4528302
NODE_38482_length_513_cov_2.309179	238	285	0	47	47	1.0000000
NODE_38515_length_513_cov_1.671498	427	476	4	49	49	1.0000000
NODE_38646_length_512_cov_45.070218	34	114	0	80	80	1.0000000
NODE_38646_length_512_cov_45.070218	87	167	0	28	80	0.3500000
NODE_38646_length_512_cov_45.070218	87	167	2	52	80	0.6500000
NODE_38647_length_512_cov_39.639225	323	404	0	23	81	0.2839506
NODE_38647_length_512_cov_39.639225	323	404	5	19	81	0.2345679
NODE_38647_length_512_cov_39.639225	323	404	9	1	81	0.0123457
NODE_38647_length_512_cov_39.639225	323	404	10	38	81	0.4691358
NODE_38647_length_512_cov_39.639225	377	457	0	76	80	0.9500000
NODE_38647_length_512_cov_39.639225	377	457	5	4	80	0.0500000
NODE_38648_length_512_cov_8.581114	192	256	0	6	64	0.0937500
NODE_38648_length_512_cov_8.581114	192	256	1	19	64	0.2968750
NODE_38648_length_512_cov_8.581114	192	256	4	39	64	0.6093750
NODE_38661_length_512_cov_4.869249	327	407	0	72	80	0.9000000
NODE_38661_length_512_cov_4.869249	327	407	2	8	80	0.1000000
NODE_38661_length_512_cov_4.869249	380	460	0	80	80	1.0000000
NODE_38668_length_512_cov_4.157385	161	204	0	14	43	0.3255814
NODE_38668_length_512_cov_4.157385	161	204	5	25	43	0.5813953
NODE_38668_length_512_cov_4.157385	161	204	9	1	43	0.0232558
NODE_38668_length_512_cov_4.157385	161	204	10	3	43	0.0697674
NODE_38668_length_512_cov_4.157385	178	257	5	22	79	0.2784810
NODE_38668_length_512_cov_4.157385	178	257	9	1	79	0.0126582
NODE_38668_length_512_cov_4.157385	178	257	10	56	79	0.7088608
NODE_38677_length_512_cov_3.435835	138	218	0	80	80	1.0000000
NODE_38677_length_512_cov_3.435835	191	271	0	80	80	1.0000000
NODE_38693_length_512_cov_2.888620	320	400	0	80	80	1.0000000
NODE_38768_length_512_cov_1.341404	198	269	0	5	71	0.0704225
NODE_38768_length_512_cov_1.341404	198	269	2	2	71	0.0281690
NODE_38768_length_512_cov_1.341404	198	269	4	8	71	0.1126761
NODE_38768_length_512_cov_1.341404	198	269	5	1	71	0.0140845
NODE_38768_length_512_cov_1.341404	198	269	6	2	71	0.0281690
NODE_38768_length_512_cov_1.341404	198	269	12	12	71	0.1690141
NODE_38768_length_512_cov_1.341404	198	269	14	2	71	0.0281690
NODE_38768_length_512_cov_1.341404	198	269	16	3	71	0.0422535
NODE_38768_length_512_cov_1.341404	198	269	18	3	71	0.0422535
NODE_38768_length_512_cov_1.341404	198	269	19	6	71	0.0845070
NODE_38768_length_512_cov_1.341404	198	269	21	12	71	0.1690141
NODE_38768_length_512_cov_1.341404	198	269	23	12	71	0.1690141
NODE_38768_length_512_cov_1.341404	198	269	24	2	71	0.0281690
NODE_38768_length_512_cov_1.341404	198	269	26	1	71	0.0140845
NODE_38866_length_511_cov_9.796117	251	331	0	80	80	1.0000000
NODE_38866_length_511_cov_9.796117	304	370	0	66	66	1.0000000
NODE_38869_length_511_cov_8.873786	239	319	4	15	80	0.1875000
NODE_38869_length_511_cov_8.873786	239	319	5	1	80	0.0125000
NODE_38869_length_511_cov_8.873786	239	319	7	8	80	0.1000000
NODE_38869_length_511_cov_8.873786	239	319	8	56	80	0.7000000
NODE_38869_length_511_cov_8.873786	292	356	4	51	64	0.7968750
NODE_38869_length_511_cov_8.873786	292	356	5	1	64	0.0156250
NODE_38869_length_511_cov_8.873786	292	356	7	8	64	0.1250000
NODE_38869_length_511_cov_8.873786	292	356	8	4	64	0.0625000
NODE_38870_length_511_cov_8.434466	232	312	0	80	80	1.0000000
NODE_38870_length_511_cov_8.434466	285	366	0	81	81	1.0000000
NODE_38872_length_511_cov_7.519417	157	237	2	20	80	0.2500000
NODE_38872_length_511_cov_7.519417	157	237	6	22	80	0.2750000
NODE_38872_length_511_cov_7.519417	157	237	11	6	80	0.0750000
NODE_38872_length_511_cov_7.519417	157	237	13	32	80	0.4000000
NODE_38872_length_511_cov_7.519417	210	290	13	49	80	0.6125000
NODE_38872_length_511_cov_7.519417	210	290	15	24	80	0.3000000
NODE_38872_length_511_cov_7.519417	210	290	17	7	80	0.0875000
NODE_38877_length_511_cov_5.762136	102	179	0	2	77	0.0259740
NODE_38877_length_511_cov_5.762136	102	179	1	2	77	0.0259740
NODE_38877_length_511_cov_5.762136	102	179	2	8	77	0.1038961
NODE_38877_length_511_cov_5.762136	102	179	10	65	77	0.8441558
NODE_38877_length_511_cov_5.762136	155	230	2	29	75	0.3866667
NODE_38877_length_511_cov_5.762136	155	230	9	1	75	0.0133333
NODE_38877_length_511_cov_5.762136	155	230	10	45	75	0.6000000
NODE_38878_length_511_cov_5.655340	133	213	0	80	80	1.0000000
NODE_38878_length_511_cov_5.655340	186	266	0	80	80	1.0000000
NODE_38911_length_511_cov_2.978155	219	255	2	36	36	1.0000000
NODE_39013_length_511_cov_1.225728	99	127	0	28	28	1.0000000
NODE_39092_length_511_cov_0.708738	98	146	0	48	48	1.0000000
NODE_39105_length_510_cov_18.206813	334	414	0	80	80	1.0000000
NODE_39105_length_510_cov_18.206813	387	467	0	80	80	1.0000000
NODE_39110_length_510_cov_8.017032	211	291	0	80	80	1.0000000
NODE_39110_length_510_cov_8.017032	264	344	0	47	80	0.5875000
NODE_39110_length_510_cov_8.017032	264	344	2	33	80	0.4125000
NODE_39110_length_510_cov_8.017032	391	413	0	22	22	1.0000000
NODE_39112_length_510_cov_6.476886	208	251	6	4	43	0.0930233
NODE_39112_length_510_cov_6.476886	208	251	8	39	43	0.9069768
NODE_39115_length_510_cov_6.133820	149	200	0	51	51	1.0000000
NODE_39122_length_510_cov_4.313869	32	106	0	15	74	0.2027027
NODE_39122_length_510_cov_4.313869	32	106	1	59	74	0.7972973
NODE_39131_length_510_cov_3.435523	149	213	1	7	64	0.1093750
NODE_39131_length_510_cov_3.435523	149	213	2	45	64	0.7031250
NODE_39131_length_510_cov_3.435523	149	213	3	6	64	0.0937500
NODE_39131_length_510_cov_3.435523	149	213	5	6	64	0.0937500
NODE_39131_length_510_cov_3.435523	191	249	2	24	58	0.4137931
NODE_39131_length_510_cov_3.435523	191	249	4	34	58	0.5862069
NODE_39293_length_509_cov_13.378049	160	240	10	80	80	1.0000000
NODE_39293_length_509_cov_13.378049	213	294	0	37	81	0.4567901
NODE_39293_length_509_cov_13.378049	213	294	10	44	81	0.5432099
NODE_39302_length_509_cov_5.190244	203	283	14	2	80	0.0250000
NODE_39302_length_509_cov_5.190244	203	283	16	1	80	0.0125000
NODE_39302_length_509_cov_5.190244	203	283	18	13	80	0.1625000
NODE_39302_length_509_cov_5.190244	203	283	20	5	80	0.0625000
NODE_39302_length_509_cov_5.190244	203	283	22	19	80	0.2375000
NODE_39302_length_509_cov_5.190244	203	283	24	40	80	0.5000000
NODE_39302_length_509_cov_5.190244	256	336	2	18	80	0.2250000
NODE_39302_length_509_cov_5.190244	256	336	4	6	80	0.0750000
NODE_39302_length_509_cov_5.190244	256	336	6	16	80	0.2000000
NODE_39302_length_509_cov_5.190244	256	336	10	2	80	0.0250000
NODE_39302_length_509_cov_5.190244	256	336	12	2	80	0.0250000
NODE_39302_length_509_cov_5.190244	256	336	14	3	80	0.0375000
NODE_39302_length_509_cov_5.190244	256	336	20	5	80	0.0625000
NODE_39302_length_509_cov_5.190244	256	336	24	28	80	0.3500000
NODE_39309_length_509_cov_4.478049	221	301	0	80	80	1.0000000
NODE_39309_length_509_cov_4.478049	274	354	0	80	80	1.0000000
NODE_39311_length_509_cov_4.451220	203	283	0	8	80	0.1000000
NODE_39311_length_509_cov_4.451220	203	283	2	72	80	0.9000000
NODE_39322_length_509_cov_3.443902	133	185	0	52	52	1.0000000
NODE_39326_length_509_cov_3.207317	367	445	0	16	78	0.2051282
NODE_39326_length_509_cov_3.207317	367	445	2	62	78	0.7948718
NODE_39337_length_509_cov_2.853659	194	274	0	80	80	1.0000000
NODE_39480_length_509_cov_0.809756	229	272	0	7	43	0.1627907
NODE_39480_length_509_cov_0.809756	229	272	2	36	43	0.8372093
NODE_39506_length_508_cov_22.009780	440	508	0	68	68	1.0000000
NODE_39512_length_508_cov_5.158924	248	284	0	36	36	1.0000000
NODE_39539_length_508_cov_2.662592	165	244	6	8	79	0.1012658
NODE_39539_length_508_cov_2.662592	165	244	8	6	79	0.0759494
NODE_39539_length_508_cov_2.662592	165	244	10	35	79	0.4430380
NODE_39539_length_508_cov_2.662592	165	244	12	5	79	0.0632911
NODE_39539_length_508_cov_2.662592	165	244	14	16	79	0.2025317
NODE_39539_length_508_cov_2.662592	165	244	16	9	79	0.1139240
NODE_39698_length_507_cov_32.286765	0	61	6	1	61	0.0163934
NODE_39698_length_507_cov_32.286765	0	61	8	1	61	0.0163934
NODE_39698_length_507_cov_32.286765	0	61	10	1	61	0.0163934
NODE_39698_length_507_cov_32.286765	0	61	12	2	61	0.0327869
NODE_39698_length_507_cov_32.286765	0	61	18	1	61	0.0163934
NODE_39698_length_507_cov_32.286765	0	61	20	1	61	0.0163934
NODE_39698_length_507_cov_32.286765	0	61	26	2	61	0.0327869
NODE_39698_length_507_cov_32.286765	0	61	28	2	61	0.0327869
NODE_39698_length_507_cov_32.286765	0	61	32	1	61	0.0163934
NODE_39698_length_507_cov_32.286765	0	61	42	1	61	0.0163934
NODE_39698_length_507_cov_32.286765	0	61	43	2	61	0.0327869
NODE_39698_length_507_cov_32.286765	0	61	47	1	61	0.0163934
NODE_39698_length_507_cov_32.286765	0	61	49	1	61	0.0163934
NODE_39698_length_507_cov_32.286765	0	61	55	1	61	0.0163934
NODE_39698_length_507_cov_32.286765	0	61	57	1	61	0.0163934
NODE_39698_length_507_cov_32.286765	0	61	60	3	61	0.0491803
NODE_39698_length_507_cov_32.286765	0	61	62	2	61	0.0327869
NODE_39698_length_507_cov_32.286765	0	61	64	1	61	0.0163934
NODE_39698_length_507_cov_32.286765	0	61	71	1	61	0.0163934
NODE_39698_length_507_cov_32.286765	0	61	75	1	61	0.0163934
NODE_39698_length_507_cov_32.286765	0	61	86	1	61	0.0163934
NODE_39698_length_507_cov_32.286765	0	61	101	1	61	0.0163934
NODE_39698_length_507_cov_32.286765	0	61	111	1	61	0.0163934
NODE_39698_length_507_cov_32.286765	0	61	126	1	61	0.0163934
NODE_39698_length_507_cov_32.286765	0	61	130	2	61	0.0327869
NODE_39698_length_507_cov_32.286765	0	61	134	1	61	0.0163934
NODE_39698_length_507_cov_32.286765	0	61	136	1	61	0.0163934
NODE_39698_length_507_cov_32.286765	0	61	142	1	61	0.0163934
NODE_39698_length_507_cov_32.286765	0	61	146	4	61	0.0655738
NODE_39698_length_507_cov_32.286765	0	61	148	6	61	0.0983607
NODE_39698_length_507_cov_32.286765	0	61	152	3	61	0.0491803
NODE_39698_length_507_cov_32.286765	0	61	162	1	61	0.0163934
NODE_39698_length_507_cov_32.286765	0	61	170	3	61	0.0491803
NODE_39698_length_507_cov_32.286765	0	61	175	1	61	0.0163934
NODE_39698_length_507_cov_32.286765	0	61	181	1	61	0.0163934
NODE_39698_length_507_cov_32.286765	0	61	182	1	61	0.0163934
NODE_39698_length_507_cov_32.286765	0	61	184	1	61	0.0163934
NODE_39698_length_507_cov_32.286765	0	61	188	1	61	0.0163934
NODE_39698_length_507_cov_32.286765	0	61	190	3	61	0.0491803
NODE_39698_length_507_cov_32.286765	53	97	175	1	44	0.0227273
NODE_39698_length_507_cov_32.286765	53	97	181	1	44	0.0227273
NODE_39698_length_507_cov_32.286765	53	97	182	1	44	0.0227273
NODE_39698_length_507_cov_32.286765	53	97	184	1	44	0.0227273
NODE_39698_length_507_cov_32.286765	53	97	188	1	44	0.0227273
NODE_39698_length_507_cov_32.286765	53	97	190	3	44	0.0681818
NODE_39698_length_507_cov_32.286765	53	97	192	1	44	0.0227273
NODE_39698_length_507_cov_32.286765	53	97	194	2	44	0.0454545
NODE_39698_length_507_cov_32.286765	53	97	195	1	44	0.0227273
NODE_39698_length_507_cov_32.286765	53	97	196	1	44	0.0227273
NODE_39698_length_507_cov_32.286765	53	97	200	2	44	0.0454545
NODE_39698_length_507_cov_32.286765	53	97	202	1	44	0.0227273
NODE_39698_length_507_cov_32.286765	53	97	205	1	44	0.0227273
NODE_39698_length_507_cov_32.286765	53	97	215	3	44	0.0681818
NODE_39698_length_507_cov_32.286765	53	97	225	1	44	0.0227273
NODE_39698_length_507_cov_32.286765	53	97	228	1	44	0.0227273
NODE_39698_length_507_cov_32.286765	53	97	230	1	44	0.0227273
NODE_39698_length_507_cov_32.286765	53	97	231	1	44	0.0227273
NODE_39698_length_507_cov_32.286765	53	97	233	1	44	0.0227273
NODE_39698_length_507_cov_32.286765	53	97	241	1	44	0.0227273
NODE_39698_length_507_cov_32.286765	53	97	245	1	44	0.0227273
NODE_39698_length_507_cov_32.286765	53	97	247	1	44	0.0227273
NODE_39698_length_507_cov_32.286765	53	97	249	1	44	0.0227273
NODE_39698_length_507_cov_32.286765	53	97	253	1	44	0.0227273
NODE_39698_length_507_cov_32.286765	53	97	263	1	44	0.0227273
NODE_39698_length_507_cov_32.286765	53	97	268	1	44	0.0227273
NODE_39698_length_507_cov_32.286765	53	97	272	1	44	0.0227273
NODE_39698_length_507_cov_32.286765	53	97	278	1	44	0.0227273
NODE_39698_length_507_cov_32.286765	53	97	282	3	44	0.0681818
NODE_39698_length_507_cov_32.286765	53	97	286	1	44	0.0227273
NODE_39698_length_507_cov_32.286765	53	97	288	1	44	0.0227273
NODE_39698_length_507_cov_32.286765	53	97	290	1	44	0.0227273
NODE_39698_length_507_cov_32.286765	53	97	292	1	44	0.0227273
NODE_39698_length_507_cov_32.286765	53	97	294	1	44	0.0227273
NODE_39698_length_507_cov_32.286765	53	97	296	2	44	0.0454545
NODE_39701_length_507_cov_7.553922	203	283	1	39	80	0.4875000
NODE_39701_length_507_cov_7.553922	203	283	3	41	80	0.5125000
NODE_39709_length_507_cov_5.154412	296	362	0	66	66	1.0000000
NODE_39714_length_507_cov_4.710784	248	328	0	1	80	0.0125000
NODE_39714_length_507_cov_4.710784	248	328	2	8	80	0.1000000
NODE_39714_length_507_cov_4.710784	248	328	4	71	80	0.8875000
NODE_39714_length_507_cov_4.710784	308	379	0	14	71	0.1971831
NODE_39714_length_507_cov_4.710784	308	379	2	8	71	0.1126761
NODE_39714_length_507_cov_4.710784	308	379	4	30	71	0.4225352
NODE_39714_length_507_cov_4.710784	308	379	6	19	71	0.2676056
NODE_39728_length_507_cov_3.649510	80	109	6	29	29	1.0000000
NODE_39728_length_507_cov_3.649510	184	266	14	15	82	0.1829268
NODE_39728_length_507_cov_3.649510	184	266	16	32	82	0.3902439
NODE_39728_length_507_cov_3.649510	184	266	17	3	82	0.0365854
NODE_39728_length_507_cov_3.649510	184	266	18	32	82	0.3902439
NODE_39728_length_507_cov_3.649510	189	273	14	16	84	0.1904762
NODE_39728_length_507_cov_3.649510	189	273	16	32	84	0.3809524
NODE_39728_length_507_cov_3.649510	189	273	17	3	84	0.0357143
NODE_39728_length_507_cov_3.649510	189	273	18	32	84	0.3809524
NODE_39728_length_507_cov_3.649510	189	273	21	1	84	0.0119048
NODE_39728_length_507_cov_3.649510	207	266	14	4	59	0.0677966
NODE_39728_length_507_cov_3.649510	207	266	16	31	59	0.5254237
NODE_39728_length_507_cov_3.649510	207	266	17	3	59	0.0508475
NODE_39728_length_507_cov_3.649510	207	266	18	21	59	0.3559322
NODE_39747_length_507_cov_2.754902	345	425	0	80	80	1.0000000
NODE_39747_length_507_cov_2.754902	428	463	0	35	35	1.0000000
NODE_39918_length_506_cov_31.987715	71	156	15	34	85	0.4000000
NODE_39918_length_506_cov_31.987715	71	156	16	6	85	0.0705882
NODE_39918_length_506_cov_31.987715	71	156	21	6	85	0.0705882
NODE_39918_length_506_cov_31.987715	71	156	27	8	85	0.0941176
NODE_39918_length_506_cov_31.987715	71	156	28	19	85	0.2235294
NODE_39918_length_506_cov_31.987715	71	156	29	5	85	0.0588235
NODE_39918_length_506_cov_31.987715	71	156	30	7	85	0.0823529
NODE_39918_length_506_cov_31.987715	71	156	15	34	85	0.4000000
NODE_39918_length_506_cov_31.987715	71	156	16	6	85	0.0705882
NODE_39918_length_506_cov_31.987715	71	156	21	6	85	0.0705882
NODE_39918_length_506_cov_31.987715	71	156	27	8	85	0.0941176
NODE_39918_length_506_cov_31.987715	71	156	28	19	85	0.2235294
NODE_39918_length_506_cov_31.987715	71	156	29	5	85	0.0588235
NODE_39918_length_506_cov_31.987715	71	156	30	7	85	0.0823529
NODE_39918_length_506_cov_31.987715	71	156	15	34	85	0.4000000
NODE_39918_length_506_cov_31.987715	71	156	16	6	85	0.0705882
NODE_39918_length_506_cov_31.987715	71	156	21	6	85	0.0705882
NODE_39918_length_506_cov_31.987715	71	156	27	8	85	0.0941176
NODE_39918_length_506_cov_31.987715	71	156	28	19	85	0.2235294
NODE_39918_length_506_cov_31.987715	71	156	29	5	85	0.0588235
NODE_39918_length_506_cov_31.987715	71	156	30	7	85	0.0823529
NODE_39918_length_506_cov_31.987715	129	209	16	5	80	0.0625000
NODE_39918_length_506_cov_31.987715	129	209	18	3	80	0.0375000
NODE_39918_length_506_cov_31.987715	129	209	19	28	80	0.3500000
NODE_39918_length_506_cov_31.987715	129	209	21	10	80	0.1250000
NODE_39918_length_506_cov_31.987715	129	209	27	8	80	0.1000000
NODE_39918_length_506_cov_31.987715	129	209	28	19	80	0.2375000
NODE_39918_length_506_cov_31.987715	129	209	30	7	80	0.0875000
NODE_39919_length_506_cov_15.877150	210	279	8	58	69	0.8405797
NODE_39919_length_506_cov_15.877150	210	279	10	1	69	0.0144928
NODE_39919_length_506_cov_15.877150	210	279	12	10	69	0.1449275
NODE_39920_length_506_cov_15.461916	334	414	0	28	80	0.3500000
NODE_39920_length_506_cov_15.461916	334	414	2	52	80	0.6500000
NODE_39920_length_506_cov_15.461916	387	467	0	69	80	0.8625000
NODE_39920_length_506_cov_15.461916	387	467	2	11	80	0.1375000
NODE_39921_length_506_cov_9.749386	197	276	0	79	79	1.0000000
NODE_39921_length_506_cov_9.749386	249	329	0	80	80	1.0000000
NODE_39947_length_506_cov_3.122850	218	298	0	44	80	0.5500000
NODE_39947_length_506_cov_3.122850	218	298	2	36	80	0.4500000
NODE_39947_length_506_cov_3.122850	271	351	0	80	80	1.0000000
NODE_39951_length_506_cov_2.894349	190	270	4	29	80	0.3625000
NODE_39951_length_506_cov_2.894349	190	270	6	51	80	0.6375000
NODE_40133_length_505_cov_35.541872	373	453	9	1	80	0.0125000
NODE_40133_length_505_cov_35.541872	373	453	10	7	80	0.0875000
NODE_40133_length_505_cov_35.541872	373	453	12	4	80	0.0500000
NODE_40133_length_505_cov_35.541872	373	453	15	3	80	0.0375000
NODE_40133_length_505_cov_35.541872	373	453	17	1	80	0.0125000
NODE_40133_length_505_cov_35.541872	373	453	18	3	80	0.0375000
NODE_40133_length_505_cov_35.541872	373	453	21	15	80	0.1875000
NODE_40133_length_505_cov_35.541872	373	453	24	46	80	0.5750000
NODE_40135_length_505_cov_10.339901	30	110	0	21	80	0.2625000
NODE_40135_length_505_cov_10.339901	30	110	4	59	80	0.7375000
NODE_40135_length_505_cov_10.339901	83	163	0	44	80	0.5500000
NODE_40135_length_505_cov_10.339901	83	163	4	36	80	0.4500000
NODE_40158_length_505_cov_3.554187	225	305	0	80	80	1.0000000
NODE_40158_length_505_cov_3.554187	278	358	0	80	80	1.0000000
NODE_40160_length_505_cov_3.403941	207	287	0	80	80	1.0000000
NODE_40175_length_505_cov_2.975369	162	227	0	65	65	1.0000000
NODE_40222_length_505_cov_1.864532	55	126	0	71	71	1.0000000
NODE_40368_length_504_cov_115.891358	122	202	233	1	80	0.0125000
NODE_40368_length_504_cov_115.891358	122	202	234	1	80	0.0125000
NODE_40368_length_504_cov_115.891358	122	202	241	1	80	0.0125000
NODE_40368_length_504_cov_115.891358	122	202	246	2	80	0.0250000
NODE_40368_length_504_cov_115.891358	122	202	258	4	80	0.0500000
NODE_40368_length_504_cov_115.891358	122	202	262	2	80	0.0250000
NODE_40368_length_504_cov_115.891358	122	202	280	3	80	0.0375000
NODE_40368_length_504_cov_115.891358	122	202	282	1	80	0.0125000
NODE_40368_length_504_cov_115.891358	122	202	283	1	80	0.0125000
NODE_40368_length_504_cov_115.891358	122	202	289	2	80	0.0250000
NODE_40368_length_504_cov_115.891358	122	202	291	3	80	0.0375000
NODE_40368_length_504_cov_115.891358	122	202	300	1	80	0.0125000
NODE_40368_length_504_cov_115.891358	122	202	312	1	80	0.0125000
NODE_40368_length_504_cov_115.891358	122	202	318	2	80	0.0250000
NODE_40368_length_504_cov_115.891358	122	202	322	1	80	0.0125000
NODE_40368_length_504_cov_115.891358	122	202	333	1	80	0.0125000
NODE_40368_length_504_cov_115.891358	122	202	343	1	80	0.0125000
NODE_40368_length_504_cov_115.891358	122	202	348	2	80	0.0250000
NODE_40368_length_504_cov_115.891358	122	202	362	1	80	0.0125000
NODE_40368_length_504_cov_115.891358	122	202	368	1	80	0.0125000
NODE_40368_length_504_cov_115.891358	122	202	369	1	80	0.0125000
NODE_40368_length_504_cov_115.891358	122	202	370	3	80	0.0375000
NODE_40368_length_504_cov_115.891358	122	202	371	1	80	0.0125000
NODE_40368_length_504_cov_115.891358	122	202	372	2	80	0.0250000
NODE_40368_length_504_cov_115.891358	122	202	373	3	80	0.0375000
NODE_40368_length_504_cov_115.891358	122	202	374	2	80	0.0250000
NODE_40368_length_504_cov_115.891358	122	202	375	2	80	0.0250000
NODE_40368_length_504_cov_115.891358	122	202	376	1	80	0.0125000
NODE_40368_length_504_cov_115.891358	122	202	377	2	80	0.0250000
NODE_40368_length_504_cov_115.891358	122	202	378	4	80	0.0500000
NODE_40368_length_504_cov_115.891358	122	202	379	6	80	0.0750000
NODE_40368_length_504_cov_115.891358	122	202	380	2	80	0.0250000
NODE_40368_length_504_cov_115.891358	122	202	381	2	80	0.0250000
NODE_40368_length_504_cov_115.891358	122	202	382	2	80	0.0250000
NODE_40368_length_504_cov_115.891358	122	202	383	1	80	0.0125000
NODE_40368_length_504_cov_115.891358	122	202	384	2	80	0.0250000
NODE_40368_length_504_cov_115.891358	122	202	389	1	80	0.0125000
NODE_40368_length_504_cov_115.891358	122	202	390	1	80	0.0125000
NODE_40368_length_504_cov_115.891358	122	202	391	1	80	0.0125000
NODE_40368_length_504_cov_115.891358	122	202	393	1	80	0.0125000
NODE_40368_length_504_cov_115.891358	122	202	395	1	80	0.0125000
NODE_40368_length_504_cov_115.891358	122	202	401	1	80	0.0125000
NODE_40368_length_504_cov_115.891358	122	202	402	1	80	0.0125000
NODE_40368_length_504_cov_115.891358	122	202	403	2	80	0.0250000
NODE_40368_length_504_cov_115.891358	122	202	404	2	80	0.0250000
NODE_40368_length_504_cov_115.891358	122	202	405	1	80	0.0125000
NODE_40368_length_504_cov_115.891358	175	255	250	1	80	0.0125000
NODE_40368_length_504_cov_115.891358	175	255	264	1	80	0.0125000
NODE_40368_length_504_cov_115.891358	175	255	265	1	80	0.0125000
NODE_40368_length_504_cov_115.891358	175	255	267	1	80	0.0125000
NODE_40368_length_504_cov_115.891358	175	255	269	1	80	0.0125000
NODE_40368_length_504_cov_115.891358	175	255	274	1	80	0.0125000
NODE_40368_length_504_cov_115.891358	175	255	281	1	80	0.0125000
NODE_40368_length_504_cov_115.891358	175	255	283	1	80	0.0125000
NODE_40368_length_504_cov_115.891358	175	255	285	1	80	0.0125000
NODE_40368_length_504_cov_115.891358	175	255	287	2	80	0.0250000
NODE_40368_length_504_cov_115.891358	175	255	289	3	80	0.0375000
NODE_40368_length_504_cov_115.891358	175	255	296	1	80	0.0125000
NODE_40368_length_504_cov_115.891358	175	255	303	1	80	0.0125000
NODE_40368_length_504_cov_115.891358	175	255	313	2	80	0.0250000
NODE_40368_length_504_cov_115.891358	175	255	317	2	80	0.0250000
NODE_40368_length_504_cov_115.891358	175	255	319	1	80	0.0125000
NODE_40368_length_504_cov_115.891358	175	255	321	1	80	0.0125000
NODE_40368_length_504_cov_115.891358	175	255	327	1	80	0.0125000
NODE_40368_length_504_cov_115.891358	175	255	332	1	80	0.0125000
NODE_40368_length_504_cov_115.891358	175	255	337	1	80	0.0125000
NODE_40368_length_504_cov_115.891358	175	255	345	1	80	0.0125000
NODE_40368_length_504_cov_115.891358	175	255	356	1	80	0.0125000
NODE_40368_length_504_cov_115.891358	175	255	358	1	80	0.0125000
NODE_40368_length_504_cov_115.891358	175	255	368	1	80	0.0125000
NODE_40368_length_504_cov_115.891358	175	255	369	1	80	0.0125000
NODE_40368_length_504_cov_115.891358	175	255	371	1	80	0.0125000
NODE_40368_length_504_cov_115.891358	175	255	375	4	80	0.0500000
NODE_40368_length_504_cov_115.891358	175	255	376	1	80	0.0125000
NODE_40368_length_504_cov_115.891358	175	255	379	4	80	0.0500000
NODE_40368_length_504_cov_115.891358	175	255	381	2	80	0.0250000
NODE_40368_length_504_cov_115.891358	175	255	382	2	80	0.0250000
NODE_40368_length_504_cov_115.891358	175	255	383	1	80	0.0125000
NODE_40368_length_504_cov_115.891358	175	255	384	4	80	0.0500000
NODE_40368_length_504_cov_115.891358	175	255	389	1	80	0.0125000
NODE_40368_length_504_cov_115.891358	175	255	390	4	80	0.0500000
NODE_40368_length_504_cov_115.891358	175	255	391	1	80	0.0125000
NODE_40368_length_504_cov_115.891358	175	255	392	5	80	0.0625000
NODE_40368_length_504_cov_115.891358	175	255	393	1	80	0.0125000
NODE_40368_length_504_cov_115.891358	175	255	394	3	80	0.0375000
NODE_40368_length_504_cov_115.891358	175	255	395	1	80	0.0125000
NODE_40368_length_504_cov_115.891358	175	255	399	1	80	0.0125000
NODE_40368_length_504_cov_115.891358	175	255	401	1	80	0.0125000
NODE_40368_length_504_cov_115.891358	175	255	402	1	80	0.0125000
NODE_40368_length_504_cov_115.891358	175	255	403	2	80	0.0250000
NODE_40368_length_504_cov_115.891358	175	255	404	4	80	0.0500000
NODE_40368_length_504_cov_115.891358	175	255	405	1	80	0.0125000
NODE_40368_length_504_cov_115.891358	175	255	406	1	80	0.0125000
NODE_40368_length_504_cov_115.891358	175	255	408	1	80	0.0125000
NODE_40368_length_504_cov_115.891358	175	255	409	1	80	0.0125000
NODE_40368_length_504_cov_115.891358	175	255	411	2	80	0.0250000
NODE_40369_length_504_cov_33.360494	28	108	0	80	80	1.0000000
NODE_40369_length_504_cov_33.360494	81	161	0	80	80	1.0000000
NODE_40370_length_504_cov_15.669136	176	256	0	80	80	1.0000000
NODE_40370_length_504_cov_15.669136	229	309	0	43	80	0.5375000
NODE_40370_length_504_cov_15.669136	229	309	2	37	80	0.4625000
NODE_40371_length_504_cov_13.202469	134	215	0	17	81	0.2098765
NODE_40371_length_504_cov_13.202469	134	215	4	64	81	0.7901235
NODE_40371_length_504_cov_13.202469	188	268	0	70	80	0.8750000
NODE_40371_length_504_cov_13.202469	188	268	4	10	80	0.1250000
NODE_40377_length_504_cov_6.770370	55	135	0	80	80	1.0000000
NODE_40377_length_504_cov_6.770370	108	188	0	80	80	1.0000000
NODE_40427_length_504_cov_2.234568	359	407	0	48	48	1.0000000
NODE_40428_length_504_cov_2.227160	307	370	0	41	63	0.6507937
NODE_40428_length_504_cov_2.227160	307	370	2	22	63	0.3492064
NODE_40434_length_504_cov_2.116049	245	325	0	80	80	1.0000000
NODE_40434_length_504_cov_2.116049	298	378	0	40	80	0.5000000
NODE_40434_length_504_cov_2.116049	298	378	1	40	80	0.5000000
NODE_40446_length_504_cov_1.925926	196	262	6	15	66	0.2272727
NODE_40446_length_504_cov_1.925926	196	262	8	51	66	0.7727273
NODE_40601_length_503_cov_11.356436	268	348	0	80	80	1.0000000
NODE_40601_length_503_cov_11.356436	321	401	0	80	80	1.0000000
NODE_40615_length_503_cov_5.537129	314	381	0	67	67	1.0000000
NODE_40645_length_503_cov_3.012376	264	285	0	21	21	1.0000000
NODE_40652_length_503_cov_2.757426	266	334	4	1	68	0.0147059
NODE_40652_length_503_cov_2.757426	266	334	6	1	68	0.0147059
NODE_40652_length_503_cov_2.757426	266	334	8	7	68	0.1029412
NODE_40652_length_503_cov_2.757426	266	334	10	58	68	0.8529412
NODE_40652_length_503_cov_2.757426	266	334	12	1	68	0.0147059
NODE_40652_length_503_cov_2.757426	307	387	6	23	80	0.2875000
NODE_40652_length_503_cov_2.757426	307	387	8	30	80	0.3750000
NODE_40652_length_503_cov_2.757426	307	387	10	27	80	0.3375000
NODE_40655_length_503_cov_2.705446	158	237	0	57	79	0.7215190
NODE_40655_length_503_cov_2.705446	158	237	2	6	79	0.0759494
NODE_40655_length_503_cov_2.705446	158	237	4	16	79	0.2025317
NODE_40655_length_503_cov_2.705446	211	291	0	4	80	0.0500000
NODE_40655_length_503_cov_2.705446	211	291	2	6	80	0.0750000
NODE_40655_length_503_cov_2.705446	211	291	4	41	80	0.5125000
NODE_40655_length_503_cov_2.705446	211	291	5	2	80	0.0250000
NODE_40655_length_503_cov_2.705446	211	291	7	10	80	0.1250000
NODE_40655_length_503_cov_2.705446	211	291	8	17	80	0.2125000
NODE_40656_length_503_cov_2.705446	251	331	1	1	80	0.0125000
NODE_40656_length_503_cov_2.705446	251	331	2	16	80	0.2000000
NODE_40656_length_503_cov_2.705446	251	331	3	48	80	0.6000000
NODE_40656_length_503_cov_2.705446	251	331	5	15	80	0.1875000
NODE_40656_length_503_cov_2.705446	251	321	1	1	70	0.0142857
NODE_40656_length_503_cov_2.705446	251	321	2	6	70	0.0857143
NODE_40656_length_503_cov_2.705446	251	321	3	48	70	0.6857143
NODE_40656_length_503_cov_2.705446	251	321	5	15	70	0.2142857
NODE_40656_length_503_cov_2.705446	330	384	0	27	54	0.5000000
NODE_40656_length_503_cov_2.705446	330	384	2	27	54	0.5000000
NODE_40656_length_503_cov_2.705446	338	384	0	27	46	0.5869565
NODE_40656_length_503_cov_2.705446	338	384	2	19	46	0.4130435
NODE_40664_length_503_cov_2.584158	95	163	0	2	68	0.0294118
NODE_40664_length_503_cov_2.584158	95	163	2	27	68	0.3970588
NODE_40664_length_503_cov_2.584158	95	163	6	39	68	0.5735294
NODE_40857_length_502_cov_45.292804	353	433	2	5	80	0.0625000
NODE_40857_length_502_cov_45.292804	353	433	4	5	80	0.0625000
NODE_40857_length_502_cov_45.292804	353	433	5	4	80	0.0500000
NODE_40857_length_502_cov_45.292804	353	433	7	6	80	0.0750000
NODE_40857_length_502_cov_45.292804	353	433	9	7	80	0.0875000
NODE_40857_length_502_cov_45.292804	353	433	11	1	80	0.0125000
NODE_40857_length_502_cov_45.292804	353	433	15	12	80	0.1500000
NODE_40857_length_502_cov_45.292804	353	433	17	36	80	0.4500000
NODE_40857_length_502_cov_45.292804	353	433	19	4	80	0.0500000
NODE_40864_length_502_cov_5.980149	305	381	3	5	76	0.0657895
NODE_40864_length_502_cov_5.980149	305	381	4	2	76	0.0263158
NODE_40864_length_502_cov_5.980149	305	381	6	25	76	0.3289474
NODE_40864_length_502_cov_5.980149	305	381	10	41	76	0.5394737
NODE_40864_length_502_cov_5.980149	305	381	12	3	76	0.0394737
NODE_41070_length_501_cov_208.708955	288	350	0	62	62	1.0000000
NODE_41070_length_501_cov_208.708955	327	413	0	86	86	1.0000000
NODE_41071_length_501_cov_29.126866	23	103	0	80	80	1.0000000
NODE_41071_length_501_cov_29.126866	76	156	0	80	80	1.0000000
NODE_41072_length_501_cov_23.736318	85	165	0	9	80	0.1125000
NODE_41072_length_501_cov_23.736318	85	165	4	71	80	0.8875000
NODE_41072_length_501_cov_23.736318	138	218	0	36	80	0.4500000
NODE_41072_length_501_cov_23.736318	138	218	4	44	80	0.5500000
NODE_41075_length_501_cov_7.820896	270	350	4	33	80	0.4125000
NODE_41075_length_501_cov_7.820896	270	350	8	2	80	0.0250000
NODE_41075_length_501_cov_7.820896	270	350	10	14	80	0.1750000
NODE_41075_length_501_cov_7.820896	270	350	11	10	80	0.1250000
NODE_41075_length_501_cov_7.820896	270	350	12	21	80	0.2625000
NODE_41075_length_501_cov_7.820896	323	403	2	17	80	0.2125000
NODE_41075_length_501_cov_7.820896	323	403	4	33	80	0.4125000
NODE_41075_length_501_cov_7.820896	323	403	6	18	80	0.2250000
NODE_41075_length_501_cov_7.820896	323	403	8	12	80	0.1500000
NODE_41080_length_501_cov_6.437811	309	389	0	37	80	0.4625000
NODE_41080_length_501_cov_6.437811	309	389	2	43	80	0.5375000
NODE_41097_length_501_cov_3.656716	289	312	0	23	23	1.0000000
NODE_41097_length_501_cov_3.656716	355	420	2	33	65	0.5076923
NODE_41097_length_501_cov_3.656716	355	420	4	32	65	0.4923077
NODE_41103_length_501_cov_3.477612	329	409	4	32	80	0.4000000
NODE_41103_length_501_cov_3.477612	329	409	6	48	80	0.6000000
NODE_41109_length_501_cov_3.134328	266	345	0	79	79	1.0000000
NODE_41308_length_500_cov_77.895262	456	500	1	3	44	0.0681818
NODE_41308_length_500_cov_77.895262	456	500	2	9	44	0.2045455
NODE_41308_length_500_cov_77.895262	456	500	4	12	44	0.2727273
NODE_41308_length_500_cov_77.895262	456	500	6	20	44	0.4545455
NODE_41309_length_500_cov_35.805486	326	406	2	25	80	0.3125000
NODE_41309_length_500_cov_35.805486	326	406	4	38	80	0.4750000
NODE_41309_length_500_cov_35.805486	326	406	5	2	80	0.0250000
NODE_41309_length_500_cov_35.805486	326	406	6	15	80	0.1875000
NODE_41309_length_500_cov_35.805486	379	459	0	19	80	0.2375000
NODE_41309_length_500_cov_35.805486	379	459	4	61	80	0.7625000
NODE_41310_length_500_cov_13.084788	160	221	0	60	61	0.9836066
NODE_41310_length_500_cov_13.084788	160	221	2	1	61	0.0163934
NODE_41311_length_500_cov_12.650873	215	295	0	68	80	0.8500000
NODE_41311_length_500_cov_12.650873	215	295	2	12	80	0.1500000
NODE_41311_length_500_cov_12.650873	268	348	0	15	80	0.1875000
NODE_41311_length_500_cov_12.650873	268	348	2	52	80	0.6500000
NODE_41311_length_500_cov_12.650873	268	348	4	13	80	0.1625000
NODE_41312_length_500_cov_12.009975	203	268	10	8	65	0.1230769
NODE_41312_length_500_cov_12.009975	203	268	12	57	65	0.8769231
NODE_41312_length_500_cov_12.009975	241	321	10	4	80	0.0500000
NODE_41312_length_500_cov_12.009975	241	321	12	76	80	0.9500000
NODE_41325_length_500_cov_4.653367	224	295	0	71	71	1.0000000
NODE_41415_length_500_cov_1.650873	355	435	0	80	80	1.0000000
NODE_41415_length_500_cov_1.650873	408	488	0	80	80	1.0000000
NODE_41462_length_500_cov_1.231920	169	212	0	43	43	1.0000000
NODE_41542_length_499_cov_358.730000	425	492	10	1	67	0.0149254
NODE_41542_length_499_cov_358.730000	425	492	16	2	67	0.0298507
NODE_41542_length_499_cov_358.730000	425	492	18	1	67	0.0149254
NODE_41542_length_499_cov_358.730000	425	492	20	4	67	0.0597015
NODE_41542_length_499_cov_358.730000	425	492	26	3	67	0.0447761
NODE_41542_length_499_cov_358.730000	425	492	28	1	67	0.0149254
NODE_41542_length_499_cov_358.730000	425	492	29	1	67	0.0149254
NODE_41542_length_499_cov_358.730000	425	492	30	2	67	0.0298507
NODE_41542_length_499_cov_358.730000	425	492	32	3	67	0.0447761
NODE_41542_length_499_cov_358.730000	425	492	36	4	67	0.0597015
NODE_41542_length_499_cov_358.730000	425	492	40	3	67	0.0447761
NODE_41542_length_499_cov_358.730000	425	492	44	4	67	0.0597015
NODE_41542_length_499_cov_358.730000	425	492	50	2	67	0.0298507
NODE_41542_length_499_cov_358.730000	425	492	52	4	67	0.0597015
NODE_41542_length_499_cov_358.730000	425	492	58	2	67	0.0298507
NODE_41542_length_499_cov_358.730000	425	492	60	5	67	0.0746269
NODE_41542_length_499_cov_358.730000	425	492	64	8	67	0.1194030
NODE_41542_length_499_cov_358.730000	425	492	65	2	67	0.0298507
NODE_41542_length_499_cov_358.730000	425	492	67	2	67	0.0298507
NODE_41542_length_499_cov_358.730000	425	492	71	3	67	0.0447761
NODE_41542_length_499_cov_358.730000	425	492	75	6	67	0.0895522
NODE_41542_length_499_cov_358.730000	425	492	77	4	67	0.0597015
NODE_41543_length_499_cov_21.135000	52	132	0	80	80	1.0000000
NODE_41543_length_499_cov_21.135000	105	185	0	80	80	1.0000000
NODE_41544_length_499_cov_11.917500	50	130	0	80	80	1.0000000
NODE_41544_length_499_cov_11.917500	103	183	0	80	80	1.0000000
NODE_41549_length_499_cov_5.007500	0	54	0	54	54	1.0000000
NODE_41563_length_499_cov_3.482500	307	336	13	4	29	0.1379310
NODE_41563_length_499_cov_3.482500	307	336	15	6	29	0.2068966
NODE_41563_length_499_cov_3.482500	307	336	17	9	29	0.3103448
NODE_41563_length_499_cov_3.482500	307	336	19	9	29	0.3103448
NODE_41563_length_499_cov_3.482500	307	336	20	1	29	0.0344828
NODE_41594_length_499_cov_2.420000	198	247	0	49	49	1.0000000
NODE_41662_length_499_cov_1.445000	311	372	0	61	61	1.0000000
NODE_41770_length_498_cov_31.704261	12	92	0	80	80	1.0000000
NODE_41770_length_498_cov_31.704261	65	145	0	80	80	1.0000000
NODE_41775_length_498_cov_7.002506	256	336	2	5	80	0.0625000
NODE_41775_length_498_cov_7.002506	256	336	4	54	80	0.6750000
NODE_41775_length_498_cov_7.002506	256	336	6	21	80	0.2625000
NODE_41780_length_498_cov_5.759398	217	247	0	30	30	1.0000000
NODE_41814_length_498_cov_3.075188	225	262	19	20	37	0.5405405
NODE_41814_length_498_cov_3.075188	225	262	21	8	37	0.2162162
NODE_41814_length_498_cov_3.075188	225	262	23	5	37	0.1351351
NODE_41814_length_498_cov_3.075188	225	262	27	4	37	0.1081081
NODE_41814_length_498_cov_3.075188	246	324	21	7	78	0.0897436
NODE_41814_length_498_cov_3.075188	246	324	23	5	78	0.0641026
NODE_41814_length_498_cov_3.075188	246	324	27	4	78	0.0512821
NODE_41814_length_498_cov_3.075188	246	324	36	1	78	0.0128205
NODE_41814_length_498_cov_3.075188	246	324	38	1	78	0.0128205
NODE_41814_length_498_cov_3.075188	246	324	39	14	78	0.1794872
NODE_41814_length_498_cov_3.075188	246	324	40	2	78	0.0256410
NODE_41814_length_498_cov_3.075188	246	324	41	6	78	0.0769231
NODE_41814_length_498_cov_3.075188	246	324	43	1	78	0.0128205
NODE_41814_length_498_cov_3.075188	246	324	44	5	78	0.0641026
NODE_41814_length_498_cov_3.075188	246	324	46	18	78	0.2307692
NODE_41814_length_498_cov_3.075188	246	324	48	14	78	0.1794872
NODE_42016_length_497_cov_44.105528	169	249	0	80	80	1.0000000
NODE_42016_length_497_cov_44.105528	222	302	0	80	80	1.0000000
NODE_42017_length_497_cov_10.145729	85	165	0	17	80	0.2125000
NODE_42017_length_497_cov_10.145729	85	165	2	63	80	0.7875000
NODE_42017_length_497_cov_10.145729	138	226	0	78	88	0.8863636
NODE_42017_length_497_cov_10.145729	138	226	2	10	88	0.1136364
NODE_42024_length_497_cov_6.618090	231	304	0	49	73	0.6712329
NODE_42024_length_497_cov_6.618090	231	304	2	24	73	0.3287671
NODE_42024_length_497_cov_6.618090	284	364	0	80	80	1.0000000
NODE_42065_length_497_cov_2.889447	109	189	0	37	80	0.4625000
NODE_42065_length_497_cov_2.889447	109	189	2	43	80	0.5375000
NODE_42065_length_497_cov_2.889447	162	242	0	30	80	0.3750000
NODE_42065_length_497_cov_2.889447	162	242	2	50	80	0.6250000
NODE_42071_length_497_cov_2.623116	302	368	0	19	66	0.2878788
NODE_42071_length_497_cov_2.623116	302	368	2	13	66	0.1969697
NODE_42071_length_497_cov_2.623116	302	368	4	34	66	0.5151515
NODE_42071_length_497_cov_2.623116	355	406	0	51	51	1.0000000
NODE_42100_length_497_cov_1.909548	106	186	3	4	80	0.0500000
NODE_42100_length_497_cov_1.909548	106	186	5	1	80	0.0125000
NODE_42100_length_497_cov_1.909548	106	186	7	1	80	0.0125000
NODE_42100_length_497_cov_1.909548	106	186	8	3	80	0.0375000
NODE_42100_length_497_cov_1.909548	106	186	12	4	80	0.0500000
NODE_42100_length_497_cov_1.909548	106	186	14	5	80	0.0625000
NODE_42100_length_497_cov_1.909548	106	186	16	6	80	0.0750000
NODE_42100_length_497_cov_1.909548	106	186	21	6	80	0.0750000
NODE_42100_length_497_cov_1.909548	106	186	24	2	80	0.0250000
NODE_42100_length_497_cov_1.909548	106	186	28	7	80	0.0875000
NODE_42100_length_497_cov_1.909548	106	186	29	7	80	0.0875000
NODE_42100_length_497_cov_1.909548	106	186	31	1	80	0.0125000
NODE_42100_length_497_cov_1.909548	106	186	33	3	80	0.0375000
NODE_42100_length_497_cov_1.909548	106	186	34	1	80	0.0125000
NODE_42100_length_497_cov_1.909548	106	186	38	3	80	0.0375000
NODE_42100_length_497_cov_1.909548	106	186	39	2	80	0.0250000
NODE_42100_length_497_cov_1.909548	106	186	42	24	80	0.3000000
NODE_42100_length_497_cov_1.909548	159	240	38	4	81	0.0493827
NODE_42100_length_497_cov_1.909548	159	240	39	2	81	0.0246914
NODE_42100_length_497_cov_1.909548	159	240	40	3	81	0.0370370
NODE_42100_length_497_cov_1.909548	159	240	42	27	81	0.3333333
NODE_42100_length_497_cov_1.909548	159	240	44	1	81	0.0123457
NODE_42100_length_497_cov_1.909548	159	240	45	8	81	0.0987654
NODE_42100_length_497_cov_1.909548	159	240	46	1	81	0.0123457
NODE_42100_length_497_cov_1.909548	159	240	48	1	81	0.0123457
NODE_42100_length_497_cov_1.909548	159	240	52	2	81	0.0246914
NODE_42100_length_497_cov_1.909548	159	240	54	1	81	0.0123457
NODE_42100_length_497_cov_1.909548	159	240	60	1	81	0.0123457
NODE_42100_length_497_cov_1.909548	159	240	64	1	81	0.0123457
NODE_42100_length_497_cov_1.909548	159	240	65	1	81	0.0123457
NODE_42100_length_497_cov_1.909548	159	240	70	1	81	0.0123457
NODE_42100_length_497_cov_1.909548	159	240	72	1	81	0.0123457
NODE_42100_length_497_cov_1.909548	159	240	77	2	81	0.0246914
NODE_42100_length_497_cov_1.909548	159	240	78	1	81	0.0123457
NODE_42100_length_497_cov_1.909548	159	240	79	1	81	0.0123457
NODE_42100_length_497_cov_1.909548	159	240	81	1	81	0.0123457
NODE_42100_length_497_cov_1.909548	159	240	90	1	81	0.0123457
NODE_42100_length_497_cov_1.909548	159	240	92	2	81	0.0246914
NODE_42100_length_497_cov_1.909548	159	240	100	1	81	0.0123457
NODE_42100_length_497_cov_1.909548	159	240	102	2	81	0.0246914
NODE_42100_length_497_cov_1.909548	159	240	106	2	81	0.0246914
NODE_42100_length_497_cov_1.909548	159	240	108	10	81	0.1234568
NODE_42100_length_497_cov_1.909548	159	240	110	3	81	0.0370370
NODE_42100_length_497_cov_1.909548	262	324	28	2	62	0.0322581
NODE_42100_length_497_cov_1.909548	262	324	30	2	62	0.0322581
NODE_42100_length_497_cov_1.909548	262	324	32	1	62	0.0161290
NODE_42100_length_497_cov_1.909548	262	324	36	1	62	0.0161290
NODE_42100_length_497_cov_1.909548	262	324	42	3	62	0.0483871
NODE_42100_length_497_cov_1.909548	262	324	44	1	62	0.0161290
NODE_42100_length_497_cov_1.909548	262	324	52	1	62	0.0161290
NODE_42100_length_497_cov_1.909548	262	324	56	1	62	0.0161290
NODE_42100_length_497_cov_1.909548	262	324	59	1	62	0.0161290
NODE_42100_length_497_cov_1.909548	262	324	62	1	62	0.0161290
NODE_42100_length_497_cov_1.909548	262	324	74	1	62	0.0161290
NODE_42100_length_497_cov_1.909548	262	324	84	3	62	0.0483871
NODE_42100_length_497_cov_1.909548	262	324	85	3	62	0.0483871
NODE_42100_length_497_cov_1.909548	262	324	87	2	62	0.0322581
NODE_42100_length_497_cov_1.909548	262	324	88	1	62	0.0161290
NODE_42100_length_497_cov_1.909548	262	324	89	1	62	0.0161290
NODE_42100_length_497_cov_1.909548	262	324	90	12	62	0.1935484
NODE_42100_length_497_cov_1.909548	262	324	91	1	62	0.0161290
NODE_42100_length_497_cov_1.909548	262	324	92	1	62	0.0161290
NODE_42100_length_497_cov_1.909548	262	324	93	5	62	0.0806452
NODE_42100_length_497_cov_1.909548	262	324	94	13	62	0.2096774
NODE_42100_length_497_cov_1.909548	262	324	98	5	62	0.0806452
NODE_42131_length_497_cov_1.500000	259	339	0	80	80	1.0000000
NODE_42136_length_497_cov_1.404523	211	263	0	52	52	1.0000000
NODE_42279_length_496_cov_5.619647	239	269	0	30	30	1.0000000
NODE_42281_length_496_cov_5.392947	103	168	4	49	65	0.7538462
NODE_42281_length_496_cov_5.392947	103	168	6	1	65	0.0153846
NODE_42281_length_496_cov_5.392947	103	168	8	15	65	0.2307692
NODE_42281_length_496_cov_5.392947	141	221	2	28	80	0.3500000
NODE_42281_length_496_cov_5.392947	141	221	4	26	80	0.3250000
NODE_42281_length_496_cov_5.392947	141	221	6	26	80	0.3250000
NODE_42281_length_496_cov_5.392947	217	295	0	29	78	0.3717949
NODE_42281_length_496_cov_5.392947	217	295	2	49	78	0.6282051
NODE_42281_length_496_cov_5.392947	270	295	0	25	25	1.0000000
NODE_42287_length_496_cov_4.397985	388	467	0	3	79	0.0379747
NODE_42287_length_496_cov_4.397985	388	467	2	1	79	0.0126582
NODE_42287_length_496_cov_4.397985	388	467	4	75	79	0.9493671
NODE_42288_length_496_cov_4.193955	235	315	6	2	80	0.0250000
NODE_42288_length_496_cov_4.193955	235	315	8	5	80	0.0625000
NODE_42288_length_496_cov_4.193955	235	315	12	10	80	0.1250000
NODE_42288_length_496_cov_4.193955	235	315	14	4	80	0.0500000
NODE_42288_length_496_cov_4.193955	235	315	16	12	80	0.1500000
NODE_42288_length_496_cov_4.193955	235	315	18	47	80	0.5875000
NODE_42297_length_496_cov_3.531486	192	273	8	4	81	0.0493827
NODE_42297_length_496_cov_3.531486	192	273	9	1	81	0.0123457
NODE_42297_length_496_cov_3.531486	192	273	11	8	81	0.0987654
NODE_42297_length_496_cov_3.531486	192	273	12	13	81	0.1604938
NODE_42297_length_496_cov_3.531486	192	273	14	55	81	0.6790124
NODE_42297_length_496_cov_3.531486	245	325	6	42	80	0.5250000
NODE_42297_length_496_cov_3.531486	245	325	10	10	80	0.1250000
NODE_42297_length_496_cov_3.531486	245	325	12	13	80	0.1625000
NODE_42297_length_496_cov_3.531486	245	325	14	15	80	0.1875000
NODE_42298_length_496_cov_3.377834	252	332	0	80	80	1.0000000
NODE_42298_length_496_cov_3.377834	305	383	0	78	78	1.0000000
NODE_42316_length_496_cov_2.659950	203	251	0	48	48	1.0000000
NODE_42328_length_496_cov_2.445844	95	165	0	70	70	1.0000000
NODE_42328_length_496_cov_2.445844	148	228	0	45	80	0.5625000
NODE_42328_length_496_cov_2.445844	148	228	2	35	80	0.4375000
NODE_42333_length_496_cov_2.214106	299	359	8	60	60	1.0000000
NODE_42415_length_496_cov_1.395466	273	317	0	3	44	0.0681818
NODE_42415_length_496_cov_1.395466	273	317	2	41	44	0.9318182
NODE_42461_length_496_cov_0.979849	214	294	4	8	80	0.1000000
NODE_42461_length_496_cov_0.979849	214	294	6	21	80	0.2625000
NODE_42461_length_496_cov_0.979849	214	294	10	16	80	0.2000000
NODE_42461_length_496_cov_0.979849	214	294	12	35	80	0.4375000
NODE_42525_length_495_cov_34.888889	209	264	0	55	55	1.0000000
NODE_42526_length_495_cov_12.800505	268	348	2	32	80	0.4000000
NODE_42526_length_495_cov_12.800505	268	348	4	48	80	0.6000000
NODE_42526_length_495_cov_12.800505	321	401	0	26	80	0.3250000
NODE_42526_length_495_cov_12.800505	321	401	2	51	80	0.6375000
NODE_42526_length_495_cov_12.800505	321	401	4	3	80	0.0375000
NODE_42529_length_495_cov_7.080808	386	416	0	30	30	1.0000000
NODE_42548_length_495_cov_3.868687	218	298	6	6	80	0.0750000
NODE_42548_length_495_cov_3.868687	218	298	8	4	80	0.0500000
NODE_42548_length_495_cov_3.868687	218	298	10	1	80	0.0125000
NODE_42548_length_495_cov_3.868687	218	298	12	11	80	0.1375000
NODE_42548_length_495_cov_3.868687	218	298	14	6	80	0.0750000
NODE_42548_length_495_cov_3.868687	218	298	18	50	80	0.6250000
NODE_42548_length_495_cov_3.868687	218	298	20	2	80	0.0250000
NODE_42736_length_495_cov_0.792929	274	309	2	35	35	1.0000000
NODE_42773_length_494_cov_20.096203	182	262	0	22	80	0.2750000
NODE_42773_length_494_cov_20.096203	182	262	4	40	80	0.5000000
NODE_42773_length_494_cov_20.096203	182	262	6	18	80	0.2250000
NODE_42773_length_494_cov_20.096203	235	315	0	8	80	0.1000000
NODE_42773_length_494_cov_20.096203	235	315	2	6	80	0.0750000
NODE_42773_length_494_cov_20.096203	235	315	4	9	80	0.1125000
NODE_42773_length_494_cov_20.096203	235	315	6	57	80	0.7125000
NODE_42778_length_494_cov_7.498734	187	240	2	35	53	0.6603774
NODE_42778_length_494_cov_7.498734	187	240	4	18	53	0.3396226
NODE_42788_length_494_cov_4.283544	255	332	0	25	77	0.3246753
NODE_42788_length_494_cov_4.283544	255	332	9	52	77	0.6753247
NODE_42804_length_494_cov_3.496203	209	276	0	67	67	1.0000000
NODE_42812_length_494_cov_3.032911	385	432	0	2	47	0.0425532
NODE_42812_length_494_cov_3.032911	385	432	2	28	47	0.5957447
NODE_42812_length_494_cov_3.032911	385	432	4	5	47	0.1063830
NODE_42812_length_494_cov_3.032911	385	432	6	10	47	0.2127660
NODE_42812_length_494_cov_3.032911	385	432	7	2	47	0.0425532
NODE_42816_length_494_cov_2.908861	189	269	2	5	80	0.0625000
NODE_42816_length_494_cov_2.908861	189	269	4	3	80	0.0375000
NODE_42816_length_494_cov_2.908861	189	269	11	1	80	0.0125000
NODE_42816_length_494_cov_2.908861	189	269	12	71	80	0.8875000
NODE_42822_length_494_cov_2.777215	145	188	0	43	43	1.0000000
NODE_42834_length_494_cov_2.531646	371	430	2	59	59	1.0000000
NODE_42834_length_494_cov_2.531646	428	494	0	62	66	0.9393939
NODE_42834_length_494_cov_2.531646	428	494	2	4	66	0.0606061
NODE_43021_length_493_cov_34.946701	140	220	0	80	80	1.0000000
NODE_43021_length_493_cov_34.946701	193	265	0	72	72	1.0000000
NODE_43022_length_493_cov_12.451777	173	253	0	80	80	1.0000000
NODE_43022_length_493_cov_12.451777	226	306	0	38	80	0.4750000
NODE_43022_length_493_cov_12.451777	226	306	2	15	80	0.1875000
NODE_43022_length_493_cov_12.451777	226	306	4	27	80	0.3375000
NODE_43025_length_493_cov_8.540609	116	146	16	2	30	0.0666667
NODE_43025_length_493_cov_8.540609	116	146	22	1	30	0.0333333
NODE_43025_length_493_cov_8.540609	116	146	26	3	30	0.1000000
NODE_43025_length_493_cov_8.540609	116	146	30	1	30	0.0333333
NODE_43025_length_493_cov_8.540609	116	146	35	1	30	0.0333333
NODE_43025_length_493_cov_8.540609	116	146	40	1	30	0.0333333
NODE_43025_length_493_cov_8.540609	116	146	42	1	30	0.0333333
NODE_43025_length_493_cov_8.540609	116	146	48	1	30	0.0333333
NODE_43025_length_493_cov_8.540609	116	146	54	1	30	0.0333333
NODE_43025_length_493_cov_8.540609	116	146	56	1	30	0.0333333
NODE_43025_length_493_cov_8.540609	116	146	59	1	30	0.0333333
NODE_43025_length_493_cov_8.540609	116	146	65	3	30	0.1000000
NODE_43025_length_493_cov_8.540609	116	146	66	1	30	0.0333333
NODE_43025_length_493_cov_8.540609	116	146	67	1	30	0.0333333
NODE_43025_length_493_cov_8.540609	116	146	73	1	30	0.0333333
NODE_43025_length_493_cov_8.540609	116	146	74	2	30	0.0666667
NODE_43025_length_493_cov_8.540609	116	146	76	2	30	0.0666667
NODE_43025_length_493_cov_8.540609	116	146	78	1	30	0.0333333
NODE_43025_length_493_cov_8.540609	116	146	80	3	30	0.1000000
NODE_43025_length_493_cov_8.540609	116	146	81	1	30	0.0333333
NODE_43025_length_493_cov_8.540609	116	146	82	1	30	0.0333333
NODE_43025_length_493_cov_8.540609	119	199	26	3	80	0.0375000
NODE_43025_length_493_cov_8.540609	119	199	30	1	80	0.0125000
NODE_43025_length_493_cov_8.540609	119	199	35	1	80	0.0125000
NODE_43025_length_493_cov_8.540609	119	199	40	1	80	0.0125000
NODE_43025_length_493_cov_8.540609	119	199	42	1	80	0.0125000
NODE_43025_length_493_cov_8.540609	119	199	48	1	80	0.0125000
NODE_43025_length_493_cov_8.540609	119	199	54	1	80	0.0125000
NODE_43025_length_493_cov_8.540609	119	199	56	1	80	0.0125000
NODE_43025_length_493_cov_8.540609	119	199	59	1	80	0.0125000
NODE_43025_length_493_cov_8.540609	119	199	65	3	80	0.0375000
NODE_43025_length_493_cov_8.540609	119	199	66	1	80	0.0125000
NODE_43025_length_493_cov_8.540609	119	199	67	1	80	0.0125000
NODE_43025_length_493_cov_8.540609	119	199	73	1	80	0.0125000
NODE_43025_length_493_cov_8.540609	119	199	74	2	80	0.0250000
NODE_43025_length_493_cov_8.540609	119	199	76	2	80	0.0250000
NODE_43025_length_493_cov_8.540609	119	199	78	1	80	0.0125000
NODE_43025_length_493_cov_8.540609	119	199	80	3	80	0.0375000
NODE_43025_length_493_cov_8.540609	119	199	81	1	80	0.0125000
NODE_43025_length_493_cov_8.540609	119	199	82	4	80	0.0500000
NODE_43025_length_493_cov_8.540609	119	199	83	2	80	0.0250000
NODE_43025_length_493_cov_8.540609	119	199	84	1	80	0.0125000
NODE_43025_length_493_cov_8.540609	119	199	86	3	80	0.0375000
NODE_43025_length_493_cov_8.540609	119	199	87	1	80	0.0125000
NODE_43025_length_493_cov_8.540609	119	199	88	1	80	0.0125000
NODE_43025_length_493_cov_8.540609	119	199	96	1	80	0.0125000
NODE_43025_length_493_cov_8.540609	119	199	97	1	80	0.0125000
NODE_43025_length_493_cov_8.540609	119	199	103	1	80	0.0125000
NODE_43025_length_493_cov_8.540609	119	199	105	1	80	0.0125000
NODE_43025_length_493_cov_8.540609	119	199	107	1	80	0.0125000
NODE_43025_length_493_cov_8.540609	119	199	110	1	80	0.0125000
NODE_43025_length_493_cov_8.540609	119	199	112	1	80	0.0125000
NODE_43025_length_493_cov_8.540609	119	199	116	5	80	0.0625000
NODE_43025_length_493_cov_8.540609	119	199	120	3	80	0.0375000
NODE_43025_length_493_cov_8.540609	119	199	122	5	80	0.0625000
NODE_43025_length_493_cov_8.540609	119	199	132	1	80	0.0125000
NODE_43025_length_493_cov_8.540609	119	199	134	2	80	0.0250000
NODE_43025_length_493_cov_8.540609	119	199	135	4	80	0.0500000
NODE_43025_length_493_cov_8.540609	119	199	136	3	80	0.0375000
NODE_43025_length_493_cov_8.540609	119	199	139	1	80	0.0125000
NODE_43025_length_493_cov_8.540609	119	199	141	3	80	0.0375000
NODE_43025_length_493_cov_8.540609	119	199	143	4	80	0.0500000
NODE_43025_length_493_cov_8.540609	119	199	145	4	80	0.0500000
NODE_43031_length_493_cov_6.144670	300	380	0	80	80	1.0000000
NODE_43031_length_493_cov_6.144670	353	433	0	80	80	1.0000000
NODE_43046_length_493_cov_3.840102	178	258	0	80	80	1.0000000
NODE_43046_length_493_cov_3.840102	231	311	0	80	80	1.0000000
NODE_43125_length_493_cov_1.588832	126	206	0	80	80	1.0000000
NODE_43125_length_493_cov_1.588832	179	259	0	80	80	1.0000000
NODE_43261_length_492_cov_5.488550	117	197	2	11	80	0.1375000
NODE_43261_length_492_cov_5.488550	117	197	4	69	80	0.8625000
NODE_43261_length_492_cov_5.488550	170	250	0	25	80	0.3125000
NODE_43261_length_492_cov_5.488550	170	250	2	39	80	0.4875000
NODE_43261_length_492_cov_5.488550	170	250	4	16	80	0.2000000
NODE_43270_length_492_cov_4.445293	158	234	0	40	76	0.5263158
NODE_43270_length_492_cov_4.445293	158	234	2	36	76	0.4736842
NODE_43270_length_492_cov_4.445293	207	285	0	78	78	1.0000000
NODE_43273_length_492_cov_4.244275	272	315	0	13	43	0.3023256
NODE_43273_length_492_cov_4.244275	272	315	2	30	43	0.6976744
NODE_43293_length_492_cov_3.297710	113	193	7	1	80	0.0125000
NODE_43293_length_492_cov_3.297710	113	193	8	79	80	0.9875000
NODE_43528_length_491_cov_17.196429	138	218	0	80	80	1.0000000
NODE_43528_length_491_cov_17.196429	191	271	0	80	80	1.0000000
NODE_43529_length_491_cov_17.193878	77	157	0	80	80	1.0000000
NODE_43529_length_491_cov_17.193878	130	210	0	80	80	1.0000000
NODE_43535_length_491_cov_5.505102	215	284	0	13	69	0.1884058
NODE_43535_length_491_cov_5.505102	215	284	2	7	69	0.1014493
NODE_43535_length_491_cov_5.505102	215	284	6	34	69	0.4927536
NODE_43535_length_491_cov_5.505102	215	284	8	15	69	0.2173913
NODE_43535_length_491_cov_5.505102	215	295	0	13	80	0.1625000
NODE_43535_length_491_cov_5.505102	215	295	2	7	80	0.0875000
NODE_43535_length_491_cov_5.505102	215	295	6	45	80	0.5625000
NODE_43535_length_491_cov_5.505102	215	295	8	15	80	0.1875000
NODE_43535_length_491_cov_5.505102	268	348	6	43	80	0.5375000
NODE_43535_length_491_cov_5.505102	268	348	8	37	80	0.4625000
NODE_43536_length_491_cov_5.477041	169	222	0	53	53	1.0000000
NODE_43546_length_491_cov_4.176020	383	449	0	1	66	0.0151515
NODE_43546_length_491_cov_4.176020	383	449	4	9	66	0.1363636
NODE_43546_length_491_cov_4.176020	383	449	6	56	66	0.8484849
NODE_43546_length_491_cov_4.176020	422	476	2	19	54	0.3518519
NODE_43546_length_491_cov_4.176020	422	476	4	12	54	0.2222222
NODE_43546_length_491_cov_4.176020	422	476	6	23	54	0.4259259
NODE_43570_length_491_cov_2.887755	348	428	0	80	80	1.0000000
NODE_43570_length_491_cov_2.887755	401	472	0	71	71	1.0000000
NODE_43575_length_491_cov_2.693878	239	316	0	4	77	0.0519481
NODE_43575_length_491_cov_2.693878	239	316	2	73	77	0.9480519
NODE_43744_length_490_cov_10.058824	192	272	0	4	80	0.0500000
NODE_43744_length_490_cov_10.058824	192	272	2	76	80	0.9500000
NODE_43744_length_490_cov_10.058824	245	325	0	57	80	0.7125000
NODE_43744_length_490_cov_10.058824	245	325	2	23	80	0.2875000
NODE_43748_length_490_cov_6.652174	304	363	0	59	59	1.0000000
NODE_43816_length_490_cov_2.212276	241	300	0	4	59	0.0677966
NODE_43816_length_490_cov_2.212276	241	300	2	55	59	0.9322034
NODE_43816_length_490_cov_2.212276	280	358	2	78	78	1.0000000
NODE_43886_length_490_cov_1.360614	97	159	4	49	62	0.7903226
NODE_43886_length_490_cov_1.360614	97	159	6	13	62	0.2096774
NODE_43886_length_490_cov_1.360614	132	212	2	15	80	0.1875000
NODE_43886_length_490_cov_1.360614	132	212	3	1	80	0.0125000
NODE_43886_length_490_cov_1.360614	132	212	4	43	80	0.5375000
NODE_43886_length_490_cov_1.360614	132	212	6	21	80	0.2625000
NODE_43993_length_489_cov_55.992308	50	130	0	80	80	1.0000000
NODE_43993_length_489_cov_55.992308	103	183	0	80	80	1.0000000
NODE_43993_length_489_cov_55.992308	179	259	0	80	80	1.0000000
NODE_43993_length_489_cov_55.992308	232	312	0	80	80	1.0000000
NODE_43994_length_489_cov_31.707692	299	384	2	3	85	0.0352941
NODE_43994_length_489_cov_31.707692	299	384	4	11	85	0.1294118
NODE_43994_length_489_cov_31.707692	299	384	6	27	85	0.3176471
NODE_43994_length_489_cov_31.707692	299	384	8	26	85	0.3058824
NODE_43994_length_489_cov_31.707692	299	384	10	18	85	0.2117647
NODE_43994_length_489_cov_31.707692	299	384	2	3	85	0.0352941
NODE_43994_length_489_cov_31.707692	299	384	4	11	85	0.1294118
NODE_43994_length_489_cov_31.707692	299	384	6	27	85	0.3176471
NODE_43994_length_489_cov_31.707692	299	384	8	26	85	0.3058824
NODE_43994_length_489_cov_31.707692	299	384	10	18	85	0.2117647
NODE_43996_length_489_cov_13.661538	227	307	2	38	80	0.4750000
NODE_43996_length_489_cov_13.661538	227	307	4	42	80	0.5250000
NODE_43996_length_489_cov_13.661538	280	358	0	49	78	0.6282051
NODE_43996_length_489_cov_13.661538	280	358	2	29	78	0.3717949
NODE_43997_length_489_cov_12.017949	214	294	0	80	80	1.0000000
NODE_43997_length_489_cov_12.017949	267	347	0	80	80	1.0000000
NODE_43998_length_489_cov_10.774359	262	304	4	4	42	0.0952381
NODE_43998_length_489_cov_10.774359	262	304	6	36	42	0.8571429
NODE_43998_length_489_cov_10.774359	262	304	7	2	42	0.0476190
NODE_44001_length_489_cov_8.094872	141	221	4	80	80	1.0000000
NODE_44001_length_489_cov_8.094872	194	247	4	53	53	1.0000000
NODE_44007_length_489_cov_5.284615	176	256	0	49	80	0.6125000
NODE_44007_length_489_cov_5.284615	176	256	2	31	80	0.3875000
NODE_44007_length_489_cov_5.284615	229	309	2	80	80	1.0000000
NODE_44096_length_489_cov_1.646154	234	278	1	42	44	0.9545454
NODE_44096_length_489_cov_1.646154	234	278	3	2	44	0.0454545
NODE_44105_length_489_cov_1.574359	351	391	2	40	40	1.0000000
NODE_44105_length_489_cov_1.574359	351	383	2	32	32	1.0000000
NODE_44105_length_489_cov_1.574359	365	445	0	9	80	0.1125000
NODE_44105_length_489_cov_1.574359	365	445	2	71	80	0.8875000
NODE_44105_length_489_cov_1.574359	365	445	0	9	80	0.1125000
NODE_44105_length_489_cov_1.574359	365	445	2	71	80	0.8875000
NODE_44105_length_489_cov_1.574359	366	445	0	9	79	0.1139240
NODE_44105_length_489_cov_1.574359	366	445	2	70	79	0.8860760
NODE_44231_length_488_cov_15.406170	235	313	0	78	78	1.0000000
NODE_44231_length_488_cov_15.406170	286	367	0	81	81	1.0000000
NODE_44234_length_488_cov_8.416452	210	290	0	80	80	1.0000000
NODE_44234_length_488_cov_8.416452	263	343	0	80	80	1.0000000
NODE_44240_length_488_cov_6.084833	254	302	6	37	48	0.7708333
NODE_44240_length_488_cov_6.084833	254	302	8	11	48	0.2291667
NODE_44243_length_488_cov_5.434447	210	279	0	69	69	1.0000000
NODE_44243_length_488_cov_5.434447	265	300	0	35	35	1.0000000
NODE_44263_length_488_cov_3.431877	212	248	0	36	36	1.0000000
NODE_44264_length_488_cov_3.424165	320	367	0	38	47	0.8085107
NODE_44264_length_488_cov_3.424165	320	367	2	9	47	0.1914894
NODE_44264_length_488_cov_3.424165	320	378	0	38	58	0.6551724
NODE_44264_length_488_cov_3.424165	320	378	2	20	58	0.3448276
NODE_44264_length_488_cov_3.424165	351	393	0	7	42	0.1666667
NODE_44264_length_488_cov_3.424165	351	393	2	35	42	0.8333333
NODE_44264_length_488_cov_3.424165	360	395	2	35	35	1.0000000
NODE_44274_length_488_cov_2.850900	276	356	0	14	80	0.1750000
NODE_44274_length_488_cov_2.850900	276	356	2	66	80	0.8250000
NODE_44376_length_488_cov_1.562982	31	67	0	36	36	1.0000000
NODE_44496_length_487_cov_7.028351	278	358	17	5	80	0.0625000
NODE_44496_length_487_cov_7.028351	278	358	18	2	80	0.0250000
NODE_44496_length_487_cov_7.028351	278	358	19	1	80	0.0125000
NODE_44496_length_487_cov_7.028351	278	358	20	1	80	0.0125000
NODE_44496_length_487_cov_7.028351	278	358	28	20	80	0.2500000
NODE_44496_length_487_cov_7.028351	278	358	30	51	80	0.6375000
NODE_44498_length_487_cov_6.804124	242	313	6	64	71	0.9014084
NODE_44498_length_487_cov_6.804124	242	313	8	7	71	0.0985916
NODE_44498_length_487_cov_6.804124	286	366	0	33	80	0.4125000
NODE_44498_length_487_cov_6.804124	286	366	3	9	80	0.1125000
NODE_44498_length_487_cov_6.804124	286	366	6	38	80	0.4750000
NODE_44500_length_487_cov_5.917526	140	220	0	80	80	1.0000000
NODE_44500_length_487_cov_5.917526	193	273	0	80	80	1.0000000
NODE_44520_length_487_cov_3.296392	235	315	0	35	80	0.4375000
NODE_44520_length_487_cov_3.296392	235	315	2	11	80	0.1375000
NODE_44520_length_487_cov_3.296392	235	315	4	4	80	0.0500000
NODE_44520_length_487_cov_3.296392	235	315	8	5	80	0.0625000
NODE_44520_length_487_cov_3.296392	235	315	10	25	80	0.3125000
NODE_44521_length_487_cov_3.237113	301	363	0	62	62	1.0000000
NODE_44525_length_487_cov_3.074742	214	294	0	13	80	0.1625000
NODE_44525_length_487_cov_3.074742	214	294	2	4	80	0.0500000
NODE_44525_length_487_cov_3.074742	214	294	4	18	80	0.2250000
NODE_44525_length_487_cov_3.074742	214	294	8	11	80	0.1375000
NODE_44525_length_487_cov_3.074742	214	294	10	5	80	0.0625000
NODE_44525_length_487_cov_3.074742	214	294	12	6	80	0.0750000
NODE_44525_length_487_cov_3.074742	214	294	14	4	80	0.0500000
NODE_44525_length_487_cov_3.074742	214	294	16	19	80	0.2375000
NODE_44723_length_486_cov_6.609819	206	286	0	50	80	0.6250000
NODE_44723_length_486_cov_6.609819	206	286	8	30	80	0.3750000
NODE_44728_length_486_cov_5.428941	147	227	0	21	80	0.2625000
NODE_44728_length_486_cov_5.428941	147	227	2	59	80	0.7375000
NODE_44754_length_486_cov_3.072351	131	211	0	23	80	0.2875000
NODE_44754_length_486_cov_3.072351	131	211	4	3	80	0.0375000
NODE_44754_length_486_cov_3.072351	131	211	6	54	80	0.6750000
NODE_44754_length_486_cov_3.072351	190	235	0	45	45	1.0000000
NODE_44769_length_486_cov_2.581395	156	236	0	80	80	1.0000000
NODE_44769_length_486_cov_2.581395	209	289	0	80	80	1.0000000
NODE_44781_length_486_cov_2.343669	189	230	0	41	41	1.0000000
NODE_44781_length_486_cov_2.343669	242	306	0	64	64	1.0000000
NODE_44959_length_485_cov_29.505181	270	350	0	80	80	1.0000000
NODE_44959_length_485_cov_29.505181	323	403	0	80	80	1.0000000
NODE_44959_length_485_cov_29.505181	399	479	0	80	80	1.0000000
NODE_44960_length_485_cov_10.450777	67	153	0	86	86	1.0000000
NODE_44960_length_485_cov_10.450777	133	206	0	73	73	1.0000000
NODE_44965_length_485_cov_5.922280	196	273	0	44	77	0.5714286
NODE_44965_length_485_cov_5.922280	196	273	2	14	77	0.1818182
NODE_44965_length_485_cov_5.922280	196	273	4	2	77	0.0259740
NODE_44965_length_485_cov_5.922280	196	273	6	13	77	0.1688312
NODE_44965_length_485_cov_5.922280	196	273	7	4	77	0.0519481
NODE_44965_length_485_cov_5.922280	246	326	0	80	80	1.0000000
NODE_44966_length_485_cov_5.818653	279	359	0	80	80	1.0000000
NODE_44966_length_485_cov_5.818653	332	412	0	80	80	1.0000000
NODE_44968_length_485_cov_5.670984	321	396	0	33	75	0.4400000
NODE_44968_length_485_cov_5.670984	321	396	2	42	75	0.5600000
NODE_44992_length_485_cov_3.518135	162	210	0	48	48	1.0000000
NODE_45005_length_485_cov_2.790155	193	253	0	60	60	1.0000000
NODE_45021_length_485_cov_2.427461	170	249	0	79	79	1.0000000
NODE_45100_length_485_cov_1.264249	232	251	0	19	19	1.0000000
NODE_45193_length_484_cov_33.384416	92	172	2	42	80	0.5250000
NODE_45193_length_484_cov_33.384416	92	172	6	38	80	0.4750000
NODE_45193_length_484_cov_33.384416	145	225	0	7	80	0.0875000
NODE_45193_length_484_cov_33.384416	145	225	4	17	80	0.2125000
NODE_45193_length_484_cov_33.384416	145	225	6	56	80	0.7000000
NODE_45195_length_484_cov_9.111688	136	216	0	80	80	1.0000000
NODE_45195_length_484_cov_9.111688	189	270	0	81	81	1.0000000
NODE_45196_length_484_cov_8.353247	165	244	0	79	79	1.0000000
NODE_45196_length_484_cov_8.353247	217	297	0	80	80	1.0000000
NODE_45197_length_484_cov_8.119481	108	188	2	80	80	1.0000000
NODE_45197_length_484_cov_8.119481	161	241	0	8	80	0.1000000
NODE_45197_length_484_cov_8.119481	161	241	2	72	80	0.9000000
NODE_45200_length_484_cov_7.703896	208	288	0	21	80	0.2625000
NODE_45200_length_484_cov_7.703896	208	288	2	5	80	0.0625000
NODE_45200_length_484_cov_7.703896	208	288	8	54	80	0.6750000
NODE_45200_length_484_cov_7.703896	261	341	0	13	80	0.1625000
NODE_45200_length_484_cov_7.703896	261	341	6	14	80	0.1750000
NODE_45200_length_484_cov_7.703896	261	341	8	53	80	0.6625000
NODE_45202_length_484_cov_7.153247	230	292	0	20	62	0.3225806
NODE_45202_length_484_cov_7.153247	230	292	1	12	62	0.1935484
NODE_45202_length_484_cov_7.153247	230	292	2	30	62	0.4838710
NODE_45204_length_484_cov_6.594805	221	301	0	80	80	1.0000000
NODE_45204_length_484_cov_6.594805	274	354	0	80	80	1.0000000
NODE_45218_length_484_cov_4.044156	267	347	0	14	80	0.1750000
NODE_45218_length_484_cov_4.044156	267	347	2	16	80	0.2000000
NODE_45218_length_484_cov_4.044156	267	347	4	12	80	0.1500000
NODE_45218_length_484_cov_4.044156	267	347	6	38	80	0.4750000
NODE_45218_length_484_cov_4.044156	342	396	2	10	54	0.1851852
NODE_45218_length_484_cov_4.044156	342	396	3	1	54	0.0185185
NODE_45218_length_484_cov_4.044156	342	396	4	28	54	0.5185185
NODE_45218_length_484_cov_4.044156	342	396	5	1	54	0.0185185
NODE_45218_length_484_cov_4.044156	342	396	6	14	54	0.2592593
NODE_45225_length_484_cov_3.787013	287	331	2	27	44	0.6136364
NODE_45225_length_484_cov_3.787013	287	331	4	17	44	0.3863636
NODE_45225_length_484_cov_3.787013	307	386	0	43	79	0.5443038
NODE_45225_length_484_cov_3.787013	307	386	2	36	79	0.4556962
NODE_45225_length_484_cov_3.787013	317	386	0	43	69	0.6231884
NODE_45225_length_484_cov_3.787013	317	386	2	26	69	0.3768116
NODE_45276_length_484_cov_2.254545	79	132	2	3	53	0.0566038
NODE_45276_length_484_cov_2.254545	79	132	4	50	53	0.9433962
NODE_45352_length_484_cov_1.322078	429	477	0	48	48	1.0000000
NODE_45353_length_484_cov_1.314286	431	472	0	41	41	1.0000000
NODE_45459_length_483_cov_40.815104	396	473	0	77	77	1.0000000
NODE_45459_length_483_cov_40.815104	396	473	0	77	77	1.0000000
NODE_45473_length_483_cov_5.289062	124	185	0	61	61	1.0000000
NODE_45494_length_483_cov_4.114583	226	306	2	80	80	1.0000000
NODE_45494_length_483_cov_4.114583	226	305	2	79	79	1.0000000
NODE_45494_length_483_cov_4.114583	226	306	2	80	80	1.0000000
NODE_45494_length_483_cov_4.114583	226	306	2	80	80	1.0000000
NODE_45494_length_483_cov_4.114583	279	359	0	31	80	0.3875000
NODE_45494_length_483_cov_4.114583	279	359	2	49	80	0.6125000
NODE_45494_length_483_cov_4.114583	279	325	2	46	46	1.0000000
NODE_45494_length_483_cov_4.114583	297	323	2	26	26	1.0000000
NODE_45495_length_483_cov_4.046875	68	117	0	49	49	1.0000000
NODE_45495_length_483_cov_4.046875	184	250	0	66	66	1.0000000
NODE_45635_length_483_cov_1.205729	249	291	2	42	42	1.0000000
NODE_45725_length_482_cov_37.900783	72	152	4	7	80	0.0875000
NODE_45725_length_482_cov_37.900783	72	152	6	19	80	0.2375000
NODE_45725_length_482_cov_37.900783	72	152	8	43	80	0.5375000
NODE_45725_length_482_cov_37.900783	72	152	10	11	80	0.1375000
NODE_45725_length_482_cov_37.900783	125	205	0	23	80	0.2875000
NODE_45725_length_482_cov_37.900783	125	205	2	30	80	0.3750000
NODE_45725_length_482_cov_37.900783	125	205	6	19	80	0.2375000
NODE_45725_length_482_cov_37.900783	125	205	10	8	80	0.1000000
NODE_45728_length_482_cov_10.545692	233	297	0	64	64	1.0000000
NODE_45729_length_482_cov_9.342037	281	333	0	52	52	1.0000000
NODE_45730_length_482_cov_8.190601	247	311	16	18	64	0.2812500
NODE_45730_length_482_cov_8.190601	247	311	18	2	64	0.0312500
NODE_45730_length_482_cov_8.190601	247	311	20	6	64	0.0937500
NODE_45730_length_482_cov_8.190601	247	311	21	13	64	0.2031250
NODE_45730_length_482_cov_8.190601	247	311	23	15	64	0.2343750
NODE_45730_length_482_cov_8.190601	247	311	25	10	64	0.1562500
NODE_45730_length_482_cov_8.190601	284	355	12	23	71	0.3239437
NODE_45730_length_482_cov_8.190601	284	355	14	18	71	0.2535211
NODE_45730_length_482_cov_8.190601	284	355	16	21	71	0.2957746
NODE_45730_length_482_cov_8.190601	284	355	18	2	71	0.0281690
NODE_45730_length_482_cov_8.190601	284	355	20	6	71	0.0845070
NODE_45730_length_482_cov_8.190601	284	355	21	1	71	0.0140845
NODE_45734_length_482_cov_6.002611	112	192	0	80	80	1.0000000
NODE_45734_length_482_cov_6.002611	165	245	0	80	80	1.0000000
NODE_45735_length_482_cov_5.953003	315	395	0	80	80	1.0000000
NODE_45735_length_482_cov_5.953003	368	441	0	73	73	1.0000000
NODE_45748_length_482_cov_4.530026	20	85	0	65	65	1.0000000
NODE_45759_length_482_cov_3.791123	278	358	0	80	80	1.0000000
NODE_45759_length_482_cov_3.791123	331	411	0	80	80	1.0000000
NODE_45842_length_482_cov_1.647520	382	446	0	63	64	0.9843750
NODE_45842_length_482_cov_1.647520	382	446	2	1	64	0.0156250
NODE_45842_length_482_cov_1.647520	435	482	0	47	47	1.0000000
NODE_45994_length_481_cov_50.623037	154	234	0	80	80	1.0000000
NODE_45994_length_481_cov_50.623037	207	287	0	80	80	1.0000000
NODE_45995_length_481_cov_30.939791	149	198	0	49	49	1.0000000
NODE_45995_length_481_cov_30.939791	171	235	0	64	64	1.0000000
NODE_45995_length_481_cov_30.939791	171	235	0	64	64	1.0000000
NODE_45996_length_481_cov_30.183246	0	41	0	41	41	1.0000000
NODE_45996_length_481_cov_30.183246	0	39	0	39	39	1.0000000
NODE_45996_length_481_cov_30.183246	0	44	0	44	44	1.0000000
NODE_45996_length_481_cov_30.183246	0	44	0	44	44	1.0000000
NODE_45996_length_481_cov_30.183246	0	44	0	44	44	1.0000000
NODE_45996_length_481_cov_30.183246	0	44	0	44	44	1.0000000
NODE_45996_length_481_cov_30.183246	17	97	0	80	80	1.0000000
NODE_45996_length_481_cov_30.183246	17	97	0	80	80	1.0000000
NODE_45996_length_481_cov_30.183246	17	97	0	80	80	1.0000000
NODE_45996_length_481_cov_30.183246	17	97	0	80	80	1.0000000
NODE_45996_length_481_cov_30.183246	17	97	0	80	80	1.0000000
NODE_45996_length_481_cov_30.183246	17	97	0	80	80	1.0000000
NODE_45997_length_481_cov_12.709424	250	330	30	3	80	0.0375000
NODE_45997_length_481_cov_12.709424	250	330	34	6	80	0.0750000
NODE_45997_length_481_cov_12.709424	250	330	35	1	80	0.0125000
NODE_45997_length_481_cov_12.709424	250	330	36	9	80	0.1125000
NODE_45997_length_481_cov_12.709424	250	330	38	1	80	0.0125000
NODE_45997_length_481_cov_12.709424	250	330	42	1	80	0.0125000
NODE_45997_length_481_cov_12.709424	250	330	44	59	80	0.7375000
NODE_45997_length_481_cov_12.709424	303	383	8	1	80	0.0125000
NODE_45997_length_481_cov_12.709424	303	383	9	2	80	0.0250000
NODE_45997_length_481_cov_12.709424	303	383	10	4	80	0.0500000
NODE_45997_length_481_cov_12.709424	303	383	12	4	80	0.0500000
NODE_45997_length_481_cov_12.709424	303	383	14	2	80	0.0250000
NODE_45997_length_481_cov_12.709424	303	383	23	5	80	0.0625000
NODE_45997_length_481_cov_12.709424	303	383	24	5	80	0.0625000
NODE_45997_length_481_cov_12.709424	303	383	39	1	80	0.0125000
NODE_45997_length_481_cov_12.709424	303	383	40	2	80	0.0250000
NODE_45997_length_481_cov_12.709424	303	383	44	36	80	0.4500000
NODE_45997_length_481_cov_12.709424	303	383	46	1	80	0.0125000
NODE_45997_length_481_cov_12.709424	303	383	50	13	80	0.1625000
NODE_45997_length_481_cov_12.709424	303	383	52	4	80	0.0500000
NODE_46037_length_481_cov_3.002618	197	277	0	80	80	1.0000000
NODE_46064_length_481_cov_2.261780	271	351	4	1	80	0.0125000
NODE_46064_length_481_cov_2.261780	271	351	8	2	80	0.0250000
NODE_46064_length_481_cov_2.261780	271	351	10	27	80	0.3375000
NODE_46064_length_481_cov_2.261780	271	351	12	39	80	0.4875000
NODE_46064_length_481_cov_2.261780	271	351	14	11	80	0.1375000
NODE_46256_length_480_cov_22.346457	318	398	4	23	80	0.2875000
NODE_46256_length_480_cov_22.346457	318	398	8	43	80	0.5375000
NODE_46256_length_480_cov_22.346457	318	398	12	14	80	0.1750000
NODE_46256_length_480_cov_22.346457	371	451	0	25	80	0.3125000
NODE_46256_length_480_cov_22.346457	371	451	4	51	80	0.6375000
NODE_46256_length_480_cov_22.346457	371	451	8	4	80	0.0500000
NODE_46257_length_480_cov_16.488189	252	332	0	80	80	1.0000000
NODE_46257_length_480_cov_16.488189	305	385	0	80	80	1.0000000
NODE_46258_length_480_cov_12.874016	164	234	0	70	70	1.0000000
NODE_46258_length_480_cov_12.874016	207	273	0	66	66	1.0000000
NODE_46260_length_480_cov_11.879265	170	250	0	80	80	1.0000000
NODE_46260_length_480_cov_11.879265	223	303	0	80	80	1.0000000
NODE_46261_length_480_cov_8.774278	114	143	0	17	29	0.5862069
NODE_46261_length_480_cov_8.774278	114	143	2	12	29	0.4137931
NODE_46261_length_480_cov_8.774278	165	245	2	10	80	0.1250000
NODE_46261_length_480_cov_8.774278	165	245	6	1	80	0.0125000
NODE_46261_length_480_cov_8.774278	165	245	8	4	80	0.0500000
NODE_46261_length_480_cov_8.774278	165	245	14	3	80	0.0375000
NODE_46261_length_480_cov_8.774278	165	245	16	23	80	0.2875000
NODE_46261_length_480_cov_8.774278	165	245	18	39	80	0.4875000
NODE_46261_length_480_cov_8.774278	218	298	0	18	80	0.2250000
NODE_46261_length_480_cov_8.774278	218	298	4	4	80	0.0500000
NODE_46261_length_480_cov_8.774278	218	298	14	34	80	0.4250000
NODE_46261_length_480_cov_8.774278	218	298	16	23	80	0.2875000
NODE_46261_length_480_cov_8.774278	218	298	18	1	80	0.0125000
NODE_46261_length_480_cov_8.774278	385	428	0	43	43	1.0000000
NODE_46271_length_480_cov_5.671916	231	302	0	71	71	1.0000000
NODE_46283_length_480_cov_4.354331	126	187	0	7	61	0.1147541
NODE_46283_length_480_cov_4.354331	126	187	1	1	61	0.0163934
NODE_46283_length_480_cov_4.354331	126	187	2	4	61	0.0655738
NODE_46283_length_480_cov_4.354331	126	187	4	9	61	0.1475410
NODE_46283_length_480_cov_4.354331	126	187	6	40	61	0.6557377
NODE_46283_length_480_cov_4.354331	218	298	8	36	80	0.4500000
NODE_46283_length_480_cov_4.354331	218	298	10	15	80	0.1875000
NODE_46283_length_480_cov_4.354331	218	298	12	29	80	0.3625000
NODE_46445_length_480_cov_1.152231	142	216	0	61	74	0.8243243
NODE_46445_length_480_cov_1.152231	142	216	2	13	74	0.1756757
NODE_46470_length_480_cov_0.973753	31	71	0	11	40	0.2750000
NODE_46470_length_480_cov_0.973753	31	71	2	1	40	0.0250000
NODE_46470_length_480_cov_0.973753	31	71	6	24	40	0.6000000
NODE_46470_length_480_cov_0.973753	31	71	7	1	40	0.0250000
NODE_46470_length_480_cov_0.973753	31	71	8	3	40	0.0750000
NODE_46533_length_479_cov_28.205263	308	388	0	44	80	0.5500000
NODE_46533_length_479_cov_28.205263	308	388	2	36	80	0.4500000
NODE_46533_length_479_cov_28.205263	361	441	0	80	80	1.0000000
NODE_46534_length_479_cov_23.944737	189	269	4	27	80	0.3375000
NODE_46534_length_479_cov_23.944737	189	269	5	41	80	0.5125000
NODE_46534_length_479_cov_23.944737	189	269	6	12	80	0.1500000
NODE_46534_length_479_cov_23.944737	242	322	0	34	80	0.4250000
NODE_46534_length_479_cov_23.944737	242	322	4	46	80	0.5750000
NODE_46554_length_479_cov_4.942105	283	363	4	19	80	0.2375000
NODE_46554_length_479_cov_4.942105	283	363	6	22	80	0.2750000
NODE_46554_length_479_cov_4.942105	283	363	8	28	80	0.3500000
NODE_46554_length_479_cov_4.942105	283	363	10	11	80	0.1375000
NODE_46554_length_479_cov_4.942105	336	416	2	47	80	0.5875000
NODE_46554_length_479_cov_4.942105	336	416	4	25	80	0.3125000
NODE_46554_length_479_cov_4.942105	336	416	6	8	80	0.1000000
NODE_46574_length_479_cov_3.494737	217	279	0	62	62	1.0000000
NODE_46574_length_479_cov_3.494737	272	332	0	60	60	1.0000000
NODE_46611_length_479_cov_2.281579	219	265	2	14	46	0.3043478
NODE_46611_length_479_cov_2.281579	219	265	3	3	46	0.0652174
NODE_46611_length_479_cov_2.281579	219	265	5	4	46	0.0869565
NODE_46611_length_479_cov_2.281579	219	265	7	5	46	0.1086956
NODE_46611_length_479_cov_2.281579	219	265	11	9	46	0.1956522
NODE_46611_length_479_cov_2.281579	219	265	13	3	46	0.0652174
NODE_46611_length_479_cov_2.281579	219	265	17	7	46	0.1521739
NODE_46611_length_479_cov_2.281579	219	265	19	1	46	0.0217391
NODE_46638_length_479_cov_1.839474	376	431	3	2	55	0.0363636
NODE_46638_length_479_cov_1.839474	376	431	8	14	55	0.2545455
NODE_46638_length_479_cov_1.839474	376	431	11	18	55	0.3272727
NODE_46638_length_479_cov_1.839474	376	431	12	12	55	0.2181818
NODE_46638_length_479_cov_1.839474	376	431	13	9	55	0.1636364
NODE_46654_length_479_cov_1.710526	203	265	4	62	62	1.0000000
NODE_46654_length_479_cov_1.710526	248	318	0	20	70	0.2857143
NODE_46654_length_479_cov_1.710526	248	318	2	12	70	0.1714286
NODE_46654_length_479_cov_1.710526	248	318	4	38	70	0.5428572
NODE_46828_length_478_cov_336.139842	153	233	165	1	80	0.0125000
NODE_46828_length_478_cov_336.139842	153	233	167	1	80	0.0125000
NODE_46828_length_478_cov_336.139842	153	233	173	1	80	0.0125000
NODE_46828_length_478_cov_336.139842	153	233	177	1	80	0.0125000
NODE_46828_length_478_cov_336.139842	153	233	187	1	80	0.0125000
NODE_46828_length_478_cov_336.139842	153	233	191	2	80	0.0250000
NODE_46828_length_478_cov_336.139842	153	233	195	1	80	0.0125000
NODE_46828_length_478_cov_336.139842	153	233	197	1	80	0.0125000
NODE_46828_length_478_cov_336.139842	153	233	201	1	80	0.0125000
NODE_46828_length_478_cov_336.139842	153	233	205	1	80	0.0125000
NODE_46828_length_478_cov_336.139842	153	233	211	1	80	0.0125000
NODE_46828_length_478_cov_336.139842	153	233	215	1	80	0.0125000
NODE_46828_length_478_cov_336.139842	153	233	217	2	80	0.0250000
NODE_46828_length_478_cov_336.139842	153	233	221	1	80	0.0125000
NODE_46828_length_478_cov_336.139842	153	233	223	2	80	0.0250000
NODE_46828_length_478_cov_336.139842	153	233	225	1	80	0.0125000
NODE_46828_length_478_cov_336.139842	153	233	235	1	80	0.0125000
NODE_46828_length_478_cov_336.139842	153	233	237	1	80	0.0125000
NODE_46828_length_478_cov_336.139842	153	233	241	1	80	0.0125000
NODE_46828_length_478_cov_336.139842	153	233	243	1	80	0.0125000
NODE_46828_length_478_cov_336.139842	153	233	245	2	80	0.0250000
NODE_46828_length_478_cov_336.139842	153	233	247	3	80	0.0375000
NODE_46828_length_478_cov_336.139842	153	233	257	2	80	0.0250000
NODE_46828_length_478_cov_336.139842	153	233	264	5	80	0.0625000
NODE_46828_length_478_cov_336.139842	153	233	266	2	80	0.0250000
NODE_46828_length_478_cov_336.139842	153	233	267	1	80	0.0125000
NODE_46828_length_478_cov_336.139842	153	233	269	3	80	0.0375000
NODE_46828_length_478_cov_336.139842	153	233	271	1	80	0.0125000
NODE_46828_length_478_cov_336.139842	153	233	273	2	80	0.0250000
NODE_46828_length_478_cov_336.139842	153	233	276	1	80	0.0125000
NODE_46828_length_478_cov_336.139842	153	233	277	1	80	0.0125000
NODE_46828_length_478_cov_336.139842	153	233	279	2	80	0.0250000
NODE_46828_length_478_cov_336.139842	153	233	281	1	80	0.0125000
NODE_46828_length_478_cov_336.139842	153	233	284	1	80	0.0125000
NODE_46828_length_478_cov_336.139842	153	233	288	1	80	0.0125000
NODE_46828_length_478_cov_336.139842	153	233	294	1	80	0.0125000
NODE_46828_length_478_cov_336.139842	153	233	297	1	80	0.0125000
NODE_46828_length_478_cov_336.139842	153	233	305	1	80	0.0125000
NODE_46828_length_478_cov_336.139842	153	233	322	2	80	0.0250000
NODE_46828_length_478_cov_336.139842	153	233	324	5	80	0.0625000
NODE_46828_length_478_cov_336.139842	153	233	326	7	80	0.0875000
NODE_46828_length_478_cov_336.139842	153	233	328	7	80	0.0875000
NODE_46828_length_478_cov_336.139842	153	233	329	1	80	0.0125000
NODE_46828_length_478_cov_336.139842	153	233	330	1	80	0.0125000
NODE_46828_length_478_cov_336.139842	153	233	333	1	80	0.0125000
NODE_46828_length_478_cov_336.139842	153	233	337	2	80	0.0250000
NODE_46828_length_478_cov_336.139842	206	286	232	2	80	0.0250000
NODE_46828_length_478_cov_336.139842	206	286	233	1	80	0.0125000
NODE_46828_length_478_cov_336.139842	206	286	235	2	80	0.0250000
NODE_46828_length_478_cov_336.139842	206	286	236	1	80	0.0125000
NODE_46828_length_478_cov_336.139842	206	286	238	2	80	0.0250000
NODE_46828_length_478_cov_336.139842	206	286	239	3	80	0.0375000
NODE_46828_length_478_cov_336.139842	206	286	244	1	80	0.0125000
NODE_46828_length_478_cov_336.139842	206	286	246	1	80	0.0125000
NODE_46828_length_478_cov_336.139842	206	286	247	1	80	0.0125000
NODE_46828_length_478_cov_336.139842	206	286	253	2	80	0.0250000
NODE_46828_length_478_cov_336.139842	206	286	256	1	80	0.0125000
NODE_46828_length_478_cov_336.139842	206	286	257	2	80	0.0250000
NODE_46828_length_478_cov_336.139842	206	286	259	1	80	0.0125000
NODE_46828_length_478_cov_336.139842	206	286	265	1	80	0.0125000
NODE_46828_length_478_cov_336.139842	206	286	267	1	80	0.0125000
NODE_46828_length_478_cov_336.139842	206	286	268	1	80	0.0125000
NODE_46828_length_478_cov_336.139842	206	286	272	1	80	0.0125000
NODE_46828_length_478_cov_336.139842	206	286	278	1	80	0.0125000
NODE_46828_length_478_cov_336.139842	206	286	280	1	80	0.0125000
NODE_46828_length_478_cov_336.139842	206	286	283	1	80	0.0125000
NODE_46828_length_478_cov_336.139842	206	286	292	1	80	0.0125000
NODE_46828_length_478_cov_336.139842	206	286	294	1	80	0.0125000
NODE_46828_length_478_cov_336.139842	206	286	304	1	80	0.0125000
NODE_46828_length_478_cov_336.139842	206	286	305	1	80	0.0125000
NODE_46828_length_478_cov_336.139842	206	286	306	1	80	0.0125000
NODE_46828_length_478_cov_336.139842	206	286	307	2	80	0.0250000
NODE_46828_length_478_cov_336.139842	206	286	309	5	80	0.0625000
NODE_46828_length_478_cov_336.139842	206	286	313	1	80	0.0125000
NODE_46828_length_478_cov_336.139842	206	286	317	4	80	0.0500000
NODE_46828_length_478_cov_336.139842	206	286	318	1	80	0.0125000
NODE_46828_length_478_cov_336.139842	206	286	320	2	80	0.0250000
NODE_46828_length_478_cov_336.139842	206	286	322	2	80	0.0250000
NODE_46828_length_478_cov_336.139842	206	286	323	2	80	0.0250000
NODE_46828_length_478_cov_336.139842	206	286	324	5	80	0.0625000
NODE_46828_length_478_cov_336.139842	206	286	326	8	80	0.1000000
NODE_46828_length_478_cov_336.139842	206	286	328	7	80	0.0875000
NODE_46828_length_478_cov_336.139842	206	286	329	1	80	0.0125000
NODE_46828_length_478_cov_336.139842	206	286	330	1	80	0.0125000
NODE_46828_length_478_cov_336.139842	206	286	333	1	80	0.0125000
NODE_46828_length_478_cov_336.139842	206	286	335	2	80	0.0250000
NODE_46828_length_478_cov_336.139842	206	286	337	4	80	0.0500000
NODE_46846_length_478_cov_4.448549	150	230	0	80	80	1.0000000
NODE_46846_length_478_cov_4.448549	203	284	0	81	81	1.0000000
NODE_46874_length_478_cov_2.627968	228	278	0	45	50	0.9000000
NODE_46874_length_478_cov_2.627968	228	278	2	5	50	0.1000000
NODE_47128_length_477_cov_36.230159	225	305	0	80	80	1.0000000
NODE_47128_length_477_cov_36.230159	278	358	0	80	80	1.0000000
NODE_47129_length_477_cov_33.111111	307	387	18	32	80	0.4000000
NODE_47129_length_477_cov_33.111111	307	387	22	48	80	0.6000000
NODE_47129_length_477_cov_33.111111	360	440	0	27	80	0.3375000
NODE_47129_length_477_cov_33.111111	360	440	18	53	80	0.6625000
NODE_47133_length_477_cov_11.235450	119	199	0	80	80	1.0000000
NODE_47133_length_477_cov_11.235450	172	247	0	75	75	1.0000000
NODE_47135_length_477_cov_9.359788	221	301	0	26	80	0.3250000
NODE_47135_length_477_cov_9.359788	221	301	2	18	80	0.2250000
NODE_47135_length_477_cov_9.359788	221	301	4	36	80	0.4500000
NODE_47135_length_477_cov_9.359788	274	354	2	7	80	0.0875000
NODE_47135_length_477_cov_9.359788	274	354	4	73	80	0.9125000
NODE_47139_length_477_cov_7.436508	230	304	15	10	74	0.1351351
NODE_47139_length_477_cov_7.436508	230	304	19	12	74	0.1621622
NODE_47139_length_477_cov_7.436508	230	304	20	2	74	0.0270270
NODE_47139_length_477_cov_7.436508	230	304	21	8	74	0.1081081
NODE_47139_length_477_cov_7.436508	230	304	32	1	74	0.0135135
NODE_47139_length_477_cov_7.436508	230	304	44	3	74	0.0405405
NODE_47139_length_477_cov_7.436508	230	304	48	8	74	0.1081081
NODE_47139_length_477_cov_7.436508	230	304	50	30	74	0.4054054
NODE_47140_length_477_cov_7.433862	43	123	0	80	80	1.0000000
NODE_47140_length_477_cov_7.433862	96	176	0	80	80	1.0000000
NODE_47143_length_477_cov_6.846561	163	243	0	80	80	1.0000000
NODE_47143_length_477_cov_6.846561	216	296	0	80	80	1.0000000
NODE_47147_length_477_cov_5.677249	150	228	0	78	78	1.0000000
NODE_47148_length_477_cov_5.084656	227	288	0	10	61	0.1639344
NODE_47148_length_477_cov_5.084656	227	288	2	51	61	0.8360656
NODE_47253_length_477_cov_1.629630	115	171	2	52	56	0.9285714
NODE_47253_length_477_cov_1.629630	115	171	4	4	56	0.0714286
NODE_47253_length_477_cov_1.629630	167	224	2	57	57	1.0000000
NODE_47375_length_477_cov_0.859788	445	477	0	32	32	1.0000000
NODE_47427_length_476_cov_7.533156	221	301	0	80	80	1.0000000
NODE_47427_length_476_cov_7.533156	274	354	0	80	80	1.0000000
NODE_47529_length_476_cov_1.618037	385	444	0	7	59	0.1186441
NODE_47529_length_476_cov_1.618037	385	444	1	6	59	0.1016949
NODE_47529_length_476_cov_1.618037	385	444	2	5	59	0.0847458
NODE_47529_length_476_cov_1.618037	385	444	6	28	59	0.4745763
NODE_47529_length_476_cov_1.618037	385	444	7	2	59	0.0338983
NODE_47529_length_476_cov_1.618037	385	444	8	11	59	0.1864407
NODE_47601_length_476_cov_1.129973	15	34	0	19	19	1.0000000
NODE_47620_length_476_cov_1.037135	180	243	0	63	63	1.0000000
NODE_47620_length_476_cov_1.037135	237	296	0	13	59	0.2203390
NODE_47620_length_476_cov_1.037135	237	296	2	3	59	0.0508475
NODE_47620_length_476_cov_1.037135	237	296	5	27	59	0.4576271
NODE_47620_length_476_cov_1.037135	237	296	6	1	59	0.0169492
NODE_47620_length_476_cov_1.037135	237	296	7	15	59	0.2542373
NODE_47693_length_475_cov_34.460106	270	350	0	80	80	1.0000000
NODE_47693_length_475_cov_34.460106	323	403	0	80	80	1.0000000
NODE_47694_length_475_cov_30.087766	273	353	6	45	80	0.5625000
NODE_47694_length_475_cov_30.087766	273	353	8	7	80	0.0875000
NODE_47694_length_475_cov_30.087766	273	353	12	28	80	0.3500000
NODE_47694_length_475_cov_30.087766	326	406	4	11	80	0.1375000
NODE_47694_length_475_cov_30.087766	326	406	6	54	80	0.6750000
NODE_47694_length_475_cov_30.087766	326	406	12	15	80	0.1875000
NODE_47695_length_475_cov_10.247340	42	122	0	1	80	0.0125000
NODE_47695_length_475_cov_10.247340	42	122	2	79	80	0.9875000
NODE_47701_length_475_cov_8.393617	9	89	0	80	80	1.0000000
NODE_47701_length_475_cov_8.393617	62	142	0	80	80	1.0000000
NODE_47828_length_475_cov_1.531915	272	352	0	3	80	0.0375000
NODE_47828_length_475_cov_1.531915	272	352	2	77	80	0.9625000
NODE_47839_length_475_cov_1.457447	50	93	0	43	43	1.0000000
NODE_47979_length_474_cov_49.453333	392	472	41	2	80	0.0250000
NODE_47979_length_474_cov_49.453333	392	472	42	1	80	0.0125000
NODE_47979_length_474_cov_49.453333	392	472	47	2	80	0.0250000
NODE_47979_length_474_cov_49.453333	392	472	50	1	80	0.0125000
NODE_47979_length_474_cov_49.453333	392	472	53	1	80	0.0125000
NODE_47979_length_474_cov_49.453333	392	472	63	1	80	0.0125000
NODE_47979_length_474_cov_49.453333	392	472	64	1	80	0.0125000
NODE_47979_length_474_cov_49.453333	392	472	71	1	80	0.0125000
NODE_47979_length_474_cov_49.453333	392	472	73	1	80	0.0125000
NODE_47979_length_474_cov_49.453333	392	472	82	1	80	0.0125000
NODE_47979_length_474_cov_49.453333	392	472	85	1	80	0.0125000
NODE_47979_length_474_cov_49.453333	392	472	92	1	80	0.0125000
NODE_47979_length_474_cov_49.453333	392	472	95	1	80	0.0125000
NODE_47979_length_474_cov_49.453333	392	472	103	2	80	0.0250000
NODE_47979_length_474_cov_49.453333	392	472	121	2	80	0.0250000
NODE_47979_length_474_cov_49.453333	392	472	124	1	80	0.0125000
NODE_47979_length_474_cov_49.453333	392	472	126	2	80	0.0250000
NODE_47979_length_474_cov_49.453333	392	472	130	1	80	0.0125000
NODE_47979_length_474_cov_49.453333	392	472	131	1	80	0.0125000
NODE_47979_length_474_cov_49.453333	392	472	133	2	80	0.0250000
NODE_47979_length_474_cov_49.453333	392	472	141	2	80	0.0250000
NODE_47979_length_474_cov_49.453333	392	472	145	1	80	0.0125000
NODE_47979_length_474_cov_49.453333	392	472	146	1	80	0.0125000
NODE_47979_length_474_cov_49.453333	392	472	148	1	80	0.0125000
NODE_47979_length_474_cov_49.453333	392	472	157	2	80	0.0250000
NODE_47979_length_474_cov_49.453333	392	472	159	1	80	0.0125000
NODE_47979_length_474_cov_49.453333	392	472	166	1	80	0.0125000
NODE_47979_length_474_cov_49.453333	392	472	169	1	80	0.0125000
NODE_47979_length_474_cov_49.453333	392	472	172	2	80	0.0250000
NODE_47979_length_474_cov_49.453333	392	472	176	1	80	0.0125000
NODE_47979_length_474_cov_49.453333	392	472	180	1	80	0.0125000
NODE_47979_length_474_cov_49.453333	392	472	181	1	80	0.0125000
NODE_47979_length_474_cov_49.453333	392	472	185	1	80	0.0125000
NODE_47979_length_474_cov_49.453333	392	472	188	1	80	0.0125000
NODE_47979_length_474_cov_49.453333	392	472	190	1	80	0.0125000
NODE_47979_length_474_cov_49.453333	392	472	194	1	80	0.0125000
NODE_47979_length_474_cov_49.453333	392	472	199	1	80	0.0125000
NODE_47979_length_474_cov_49.453333	392	472	204	1	80	0.0125000
NODE_47979_length_474_cov_49.453333	392	472	206	1	80	0.0125000
NODE_47979_length_474_cov_49.453333	392	472	214	1	80	0.0125000
NODE_47979_length_474_cov_49.453333	392	472	217	1	80	0.0125000
NODE_47979_length_474_cov_49.453333	392	472	223	1	80	0.0125000
NODE_47979_length_474_cov_49.453333	392	472	231	1	80	0.0125000
NODE_47979_length_474_cov_49.453333	392	472	233	1	80	0.0125000
NODE_47979_length_474_cov_49.453333	392	472	239	1	80	0.0125000
NODE_47979_length_474_cov_49.453333	392	472	242	1	80	0.0125000
NODE_47979_length_474_cov_49.453333	392	472	246	2	80	0.0250000
NODE_47979_length_474_cov_49.453333	392	472	247	1	80	0.0125000
NODE_47979_length_474_cov_49.453333	392	472	248	1	80	0.0125000
NODE_47979_length_474_cov_49.453333	392	472	253	1	80	0.0125000
NODE_47979_length_474_cov_49.453333	392	472	257	1	80	0.0125000
NODE_47979_length_474_cov_49.453333	392	472	263	2	80	0.0250000
NODE_47979_length_474_cov_49.453333	392	472	265	1	80	0.0125000
NODE_47979_length_474_cov_49.453333	392	472	270	1	80	0.0125000
NODE_47979_length_474_cov_49.453333	392	472	273	1	80	0.0125000
NODE_47979_length_474_cov_49.453333	392	472	277	1	80	0.0125000
NODE_47979_length_474_cov_49.453333	392	472	278	1	80	0.0125000
NODE_47979_length_474_cov_49.453333	392	472	286	1	80	0.0125000
NODE_47979_length_474_cov_49.453333	392	472	298	1	80	0.0125000
NODE_47979_length_474_cov_49.453333	392	472	310	1	80	0.0125000
NODE_47979_length_474_cov_49.453333	392	472	313	1	80	0.0125000
NODE_47979_length_474_cov_49.453333	392	472	316	1	80	0.0125000
NODE_47979_length_474_cov_49.453333	392	472	317	1	80	0.0125000
NODE_47979_length_474_cov_49.453333	392	472	322	1	80	0.0125000
NODE_47979_length_474_cov_49.453333	392	472	331	1	80	0.0125000
NODE_47979_length_474_cov_49.453333	392	472	336	1	80	0.0125000
NODE_47979_length_474_cov_49.453333	392	472	344	1	80	0.0125000
NODE_47979_length_474_cov_49.453333	392	472	346	1	80	0.0125000
NODE_47979_length_474_cov_49.453333	392	472	349	1	80	0.0125000
NODE_47979_length_474_cov_49.453333	445	474	33	1	29	0.0344828
NODE_47979_length_474_cov_49.453333	445	474	35	1	29	0.0344828
NODE_47979_length_474_cov_49.453333	445	474	41	2	29	0.0689655
NODE_47979_length_474_cov_49.453333	445	474	42	1	29	0.0344828
NODE_47979_length_474_cov_49.453333	445	474	47	2	29	0.0689655
NODE_47979_length_474_cov_49.453333	445	474	50	1	29	0.0344828
NODE_47979_length_474_cov_49.453333	445	474	53	1	29	0.0344828
NODE_47979_length_474_cov_49.453333	445	474	63	1	29	0.0344828
NODE_47979_length_474_cov_49.453333	445	474	64	1	29	0.0344828
NODE_47979_length_474_cov_49.453333	445	474	71	1	29	0.0344828
NODE_47979_length_474_cov_49.453333	445	474	73	1	29	0.0344828
NODE_47979_length_474_cov_49.453333	445	474	82	1	29	0.0344828
NODE_47979_length_474_cov_49.453333	445	474	85	1	29	0.0344828
NODE_47979_length_474_cov_49.453333	445	474	92	1	29	0.0344828
NODE_47979_length_474_cov_49.453333	445	474	95	1	29	0.0344828
NODE_47979_length_474_cov_49.453333	445	474	103	2	29	0.0689655
NODE_47979_length_474_cov_49.453333	445	474	121	2	29	0.0689655
NODE_47979_length_474_cov_49.453333	445	474	124	1	29	0.0344828
NODE_47979_length_474_cov_49.453333	445	474	126	2	29	0.0689655
NODE_47979_length_474_cov_49.453333	445	474	130	1	29	0.0344828
NODE_47979_length_474_cov_49.453333	445	474	131	1	29	0.0344828
NODE_47979_length_474_cov_49.453333	445	474	133	2	29	0.0689655
NODE_47979_length_474_cov_49.453333	445	474	141	1	29	0.0344828
NODE_47981_length_474_cov_24.930667	287	367	0	32	80	0.4000000
NODE_47981_length_474_cov_24.930667	287	367	2	48	80	0.6000000
NODE_47981_length_474_cov_24.930667	340	420	0	80	80	1.0000000
NODE_47982_length_474_cov_15.952000	258	338	2	80	80	1.0000000
NODE_47982_length_474_cov_15.952000	311	391	0	35	80	0.4375000
NODE_47982_length_474_cov_15.952000	311	391	2	45	80	0.5625000
NODE_48003_length_474_cov_3.986667	172	252	4	7	80	0.0875000
NODE_48003_length_474_cov_3.986667	172	252	8	4	80	0.0500000
NODE_48003_length_474_cov_3.986667	172	252	10	1	80	0.0125000
NODE_48003_length_474_cov_3.986667	172	252	14	7	80	0.0875000
NODE_48003_length_474_cov_3.986667	172	252	16	1	80	0.0125000
NODE_48003_length_474_cov_3.986667	172	252	18	2	80	0.0250000
NODE_48003_length_474_cov_3.986667	172	252	20	5	80	0.0625000
NODE_48003_length_474_cov_3.986667	172	252	22	11	80	0.1375000
NODE_48003_length_474_cov_3.986667	172	252	24	16	80	0.2000000
NODE_48003_length_474_cov_3.986667	172	252	26	26	80	0.3250000
NODE_48015_length_474_cov_3.496000	163	243	14	40	80	0.5000000
NODE_48015_length_474_cov_3.496000	163	243	16	8	80	0.1000000
NODE_48015_length_474_cov_3.496000	163	243	17	10	80	0.1250000
NODE_48015_length_474_cov_3.496000	163	243	18	12	80	0.1500000
NODE_48015_length_474_cov_3.496000	163	243	19	8	80	0.1000000
NODE_48015_length_474_cov_3.496000	163	243	20	2	80	0.0250000
NODE_48038_length_474_cov_2.784000	259	300	0	41	41	1.0000000
NODE_48116_length_474_cov_1.538667	41	62	0	21	21	1.0000000
NODE_48181_length_474_cov_1.085333	0	50	0	50	50	1.0000000
NODE_48184_length_474_cov_1.056000	95	133	0	38	38	1.0000000
NODE_48266_length_473_cov_82.374332	123	203	10	27	80	0.3375000
NODE_48266_length_473_cov_82.374332	123	203	19	17	80	0.2125000
NODE_48266_length_473_cov_82.374332	123	203	20	1	80	0.0125000
NODE_48266_length_473_cov_82.374332	123	203	21	2	80	0.0250000
NODE_48266_length_473_cov_82.374332	123	203	22	33	80	0.4125000
NODE_48266_length_473_cov_82.374332	176	256	0	23	80	0.2875000
NODE_48266_length_473_cov_82.374332	176	256	10	35	80	0.4375000
NODE_48266_length_473_cov_82.374332	176	256	19	17	80	0.2125000
NODE_48266_length_473_cov_82.374332	176	256	20	1	80	0.0125000
NODE_48266_length_473_cov_82.374332	176	256	21	2	80	0.0250000
NODE_48266_length_473_cov_82.374332	176	256	22	2	80	0.0250000
NODE_48267_length_473_cov_54.882353	199	279	0	80	80	1.0000000
NODE_48267_length_473_cov_54.882353	252	332	0	80	80	1.0000000
NODE_48268_length_473_cov_48.997326	119	194	12	2	75	0.0266667
NODE_48268_length_473_cov_48.997326	119	194	14	7	75	0.0933333
NODE_48268_length_473_cov_48.997326	119	194	18	4	75	0.0533333
NODE_48268_length_473_cov_48.997326	119	194	21	4	75	0.0533333
NODE_48268_length_473_cov_48.997326	119	194	22	6	75	0.0800000
NODE_48268_length_473_cov_48.997326	119	194	28	10	75	0.1333333
NODE_48268_length_473_cov_48.997326	119	194	29	2	75	0.0266667
NODE_48268_length_473_cov_48.997326	119	194	30	9	75	0.1200000
NODE_48268_length_473_cov_48.997326	119	194	31	6	75	0.0800000
NODE_48268_length_473_cov_48.997326	119	194	32	21	75	0.2800000
NODE_48268_length_473_cov_48.997326	119	194	33	4	75	0.0533333
NODE_48268_length_473_cov_48.997326	119	194	12	2	75	0.0266667
NODE_48268_length_473_cov_48.997326	119	194	14	7	75	0.0933333
NODE_48268_length_473_cov_48.997326	119	194	18	4	75	0.0533333
NODE_48268_length_473_cov_48.997326	119	194	21	4	75	0.0533333
NODE_48268_length_473_cov_48.997326	119	194	22	6	75	0.0800000
NODE_48268_length_473_cov_48.997326	119	194	28	10	75	0.1333333
NODE_48268_length_473_cov_48.997326	119	194	29	2	75	0.0266667
NODE_48268_length_473_cov_48.997326	119	194	30	9	75	0.1200000
NODE_48268_length_473_cov_48.997326	119	194	31	6	75	0.0800000
NODE_48268_length_473_cov_48.997326	119	194	32	21	75	0.2800000
NODE_48268_length_473_cov_48.997326	119	194	33	4	75	0.0533333
NODE_48268_length_473_cov_48.997326	167	247	1	9	80	0.1125000
NODE_48268_length_473_cov_48.997326	167	247	2	7	80	0.0875000
NODE_48268_length_473_cov_48.997326	167	247	4	23	80	0.2875000
NODE_48268_length_473_cov_48.997326	167	247	8	1	80	0.0125000
NODE_48268_length_473_cov_48.997326	167	247	10	13	80	0.1625000
NODE_48268_length_473_cov_48.997326	167	247	12	2	80	0.0250000
NODE_48268_length_473_cov_48.997326	167	247	14	7	80	0.0875000
NODE_48268_length_473_cov_48.997326	167	247	18	4	80	0.0500000
NODE_48268_length_473_cov_48.997326	167	247	21	4	80	0.0500000
NODE_48268_length_473_cov_48.997326	167	247	22	6	80	0.0750000
NODE_48268_length_473_cov_48.997326	167	247	29	2	80	0.0250000
NODE_48268_length_473_cov_48.997326	167	247	30	2	80	0.0250000
NODE_48269_length_473_cov_30.679144	174	254	2	28	80	0.3500000
NODE_48269_length_473_cov_30.679144	174	254	6	31	80	0.3875000
NODE_48269_length_473_cov_30.679144	174	254	8	2	80	0.0250000
NODE_48269_length_473_cov_30.679144	174	254	10	10	80	0.1250000
NODE_48269_length_473_cov_30.679144	174	254	12	9	80	0.1125000
NODE_48269_length_473_cov_30.679144	226	307	2	22	81	0.2716049
NODE_48269_length_473_cov_30.679144	226	307	4	14	81	0.1728395
NODE_48269_length_473_cov_30.679144	226	307	6	45	81	0.5555556
NODE_48269_length_473_cov_30.679144	227	307	2	21	80	0.2625000
NODE_48269_length_473_cov_30.679144	227	307	4	14	80	0.1750000
NODE_48269_length_473_cov_30.679144	227	307	6	45	80	0.5625000
NODE_48270_length_473_cov_24.967914	295	370	0	75	75	1.0000000
NODE_48270_length_473_cov_24.967914	343	423	0	80	80	1.0000000
NODE_48271_length_473_cov_18.540107	168	248	8	17	80	0.2125000
NODE_48271_length_473_cov_18.540107	168	248	10	63	80	0.7875000
NODE_48271_length_473_cov_18.540107	221	301	4	15	80	0.1875000
NODE_48271_length_473_cov_18.540107	221	301	7	21	80	0.2625000
NODE_48271_length_473_cov_18.540107	221	301	8	18	80	0.2250000
NODE_48271_length_473_cov_18.540107	221	301	9	2	80	0.0250000
NODE_48271_length_473_cov_18.540107	221	301	10	16	80	0.2000000
NODE_48271_length_473_cov_18.540107	221	301	12	8	80	0.1000000
NODE_48272_length_473_cov_15.871658	143	223	0	80	80	1.0000000
NODE_48272_length_473_cov_15.871658	196	276	0	80	80	1.0000000
NODE_48291_length_473_cov_4.363636	160	240	0	80	80	1.0000000
NODE_48291_length_473_cov_4.363636	213	293	0	80	80	1.0000000
NODE_48320_length_473_cov_2.959893	199	267	0	12	68	0.1764706
NODE_48320_length_473_cov_2.959893	199	267	2	56	68	0.8235294
NODE_48325_length_473_cov_2.804813	207	269	0	62	62	1.0000000
NODE_48350_length_473_cov_2.251337	48	128	1	23	80	0.2875000
NODE_48350_length_473_cov_2.251337	48	128	2	29	80	0.3625000
NODE_48350_length_473_cov_2.251337	48	128	4	24	80	0.3000000
NODE_48350_length_473_cov_2.251337	48	128	8	4	80	0.0500000
NODE_48350_length_473_cov_2.251337	101	181	4	23	80	0.2875000
NODE_48350_length_473_cov_2.251337	101	181	6	7	80	0.0875000
NODE_48350_length_473_cov_2.251337	101	181	7	3	80	0.0375000
NODE_48350_length_473_cov_2.251337	101	181	8	47	80	0.5875000
NODE_48568_length_472_cov_50.077748	1	81	5	1	80	0.0125000
NODE_48568_length_472_cov_50.077748	1	81	14	1	80	0.0125000
NODE_48568_length_472_cov_50.077748	1	81	16	1	80	0.0125000
NODE_48568_length_472_cov_50.077748	1	81	17	6	80	0.0750000
NODE_48568_length_472_cov_50.077748	1	81	21	11	80	0.1375000
NODE_48568_length_472_cov_50.077748	1	81	24	21	80	0.2625000
NODE_48568_length_472_cov_50.077748	1	81	28	6	80	0.0750000
NODE_48568_length_472_cov_50.077748	1	81	34	1	80	0.0125000
NODE_48568_length_472_cov_50.077748	1	81	41	1	80	0.0125000
NODE_48568_length_472_cov_50.077748	1	81	42	2	80	0.0250000
NODE_48568_length_472_cov_50.077748	1	81	44	2	80	0.0250000
NODE_48568_length_472_cov_50.077748	1	81	46	10	80	0.1250000
NODE_48568_length_472_cov_50.077748	1	81	48	4	80	0.0500000
NODE_48568_length_472_cov_50.077748	1	81	49	4	80	0.0500000
NODE_48568_length_472_cov_50.077748	1	81	50	9	80	0.1125000
NODE_48568_length_472_cov_50.077748	1	81	5	1	80	0.0125000
NODE_48568_length_472_cov_50.077748	1	81	14	1	80	0.0125000
NODE_48568_length_472_cov_50.077748	1	81	16	1	80	0.0125000
NODE_48568_length_472_cov_50.077748	1	81	17	6	80	0.0750000
NODE_48568_length_472_cov_50.077748	1	81	21	11	80	0.1375000
NODE_48568_length_472_cov_50.077748	1	81	24	21	80	0.2625000
NODE_48568_length_472_cov_50.077748	1	81	28	6	80	0.0750000
NODE_48568_length_472_cov_50.077748	1	81	34	1	80	0.0125000
NODE_48568_length_472_cov_50.077748	1	81	41	1	80	0.0125000
NODE_48568_length_472_cov_50.077748	1	81	42	2	80	0.0250000
NODE_48568_length_472_cov_50.077748	1	81	44	2	80	0.0250000
NODE_48568_length_472_cov_50.077748	1	81	46	10	80	0.1250000
NODE_48568_length_472_cov_50.077748	1	81	48	4	80	0.0500000
NODE_48568_length_472_cov_50.077748	1	81	49	4	80	0.0500000
NODE_48568_length_472_cov_50.077748	1	81	50	9	80	0.1125000
NODE_48568_length_472_cov_50.077748	1	81	5	1	80	0.0125000
NODE_48568_length_472_cov_50.077748	1	81	14	1	80	0.0125000
NODE_48568_length_472_cov_50.077748	1	81	16	1	80	0.0125000
NODE_48568_length_472_cov_50.077748	1	81	17	6	80	0.0750000
NODE_48568_length_472_cov_50.077748	1	81	21	11	80	0.1375000
NODE_48568_length_472_cov_50.077748	1	81	24	21	80	0.2625000
NODE_48568_length_472_cov_50.077748	1	81	28	6	80	0.0750000
NODE_48568_length_472_cov_50.077748	1	81	34	1	80	0.0125000
NODE_48568_length_472_cov_50.077748	1	81	41	1	80	0.0125000
NODE_48568_length_472_cov_50.077748	1	81	42	2	80	0.0250000
NODE_48568_length_472_cov_50.077748	1	81	44	2	80	0.0250000
NODE_48568_length_472_cov_50.077748	1	81	46	10	80	0.1250000
NODE_48568_length_472_cov_50.077748	1	81	48	4	80	0.0500000
NODE_48568_length_472_cov_50.077748	1	81	49	4	80	0.0500000
NODE_48568_length_472_cov_50.077748	1	81	50	9	80	0.1125000
NODE_48568_length_472_cov_50.077748	1	81	5	1	80	0.0125000
NODE_48568_length_472_cov_50.077748	1	81	14	1	80	0.0125000
NODE_48568_length_472_cov_50.077748	1	81	16	1	80	0.0125000
NODE_48568_length_472_cov_50.077748	1	81	17	6	80	0.0750000
NODE_48568_length_472_cov_50.077748	1	81	21	11	80	0.1375000
NODE_48568_length_472_cov_50.077748	1	81	24	21	80	0.2625000
NODE_48568_length_472_cov_50.077748	1	81	28	6	80	0.0750000
NODE_48568_length_472_cov_50.077748	1	81	34	1	80	0.0125000
NODE_48568_length_472_cov_50.077748	1	81	41	1	80	0.0125000
NODE_48568_length_472_cov_50.077748	1	81	42	2	80	0.0250000
NODE_48568_length_472_cov_50.077748	1	81	44	2	80	0.0250000
NODE_48568_length_472_cov_50.077748	1	81	46	10	80	0.1250000
NODE_48568_length_472_cov_50.077748	1	81	48	4	80	0.0500000
NODE_48568_length_472_cov_50.077748	1	81	49	4	80	0.0500000
NODE_48568_length_472_cov_50.077748	1	81	50	9	80	0.1125000
NODE_48568_length_472_cov_50.077748	1	81	5	1	80	0.0125000
NODE_48568_length_472_cov_50.077748	1	81	14	1	80	0.0125000
NODE_48568_length_472_cov_50.077748	1	81	16	1	80	0.0125000
NODE_48568_length_472_cov_50.077748	1	81	17	6	80	0.0750000
NODE_48568_length_472_cov_50.077748	1	81	21	11	80	0.1375000
NODE_48568_length_472_cov_50.077748	1	81	24	21	80	0.2625000
NODE_48568_length_472_cov_50.077748	1	81	28	6	80	0.0750000
NODE_48568_length_472_cov_50.077748	1	81	34	1	80	0.0125000
NODE_48568_length_472_cov_50.077748	1	81	41	1	80	0.0125000
NODE_48568_length_472_cov_50.077748	1	81	42	2	80	0.0250000
NODE_48568_length_472_cov_50.077748	1	81	44	2	80	0.0250000
NODE_48568_length_472_cov_50.077748	1	81	46	10	80	0.1250000
NODE_48568_length_472_cov_50.077748	1	81	48	4	80	0.0500000
NODE_48568_length_472_cov_50.077748	1	81	49	4	80	0.0500000
NODE_48568_length_472_cov_50.077748	1	81	50	9	80	0.1125000
NODE_48568_length_472_cov_50.077748	10	81	21	11	71	0.1549296
NODE_48568_length_472_cov_50.077748	10	81	24	21	71	0.2957746
NODE_48568_length_472_cov_50.077748	10	81	28	6	71	0.0845070
NODE_48568_length_472_cov_50.077748	10	81	34	1	71	0.0140845
NODE_48568_length_472_cov_50.077748	10	81	41	1	71	0.0140845
NODE_48568_length_472_cov_50.077748	10	81	42	2	71	0.0281690
NODE_48568_length_472_cov_50.077748	10	81	44	2	71	0.0281690
NODE_48568_length_472_cov_50.077748	10	81	46	10	71	0.1408451
NODE_48568_length_472_cov_50.077748	10	81	48	4	71	0.0563380
NODE_48568_length_472_cov_50.077748	10	81	49	4	71	0.0563380
NODE_48568_length_472_cov_50.077748	10	81	50	9	71	0.1267606
NODE_48568_length_472_cov_50.077748	54	131	38	8	77	0.1038961
NODE_48568_length_472_cov_50.077748	54	131	45	1	77	0.0129870
NODE_48568_length_472_cov_50.077748	54	131	46	11	77	0.1428571
NODE_48568_length_472_cov_50.077748	54	131	48	4	77	0.0519481
NODE_48568_length_472_cov_50.077748	54	131	49	4	77	0.0519481
NODE_48568_length_472_cov_50.077748	54	131	50	30	77	0.3896104
NODE_48568_length_472_cov_50.077748	54	131	52	19	77	0.2467532
NODE_48568_length_472_cov_50.077748	54	131	38	8	77	0.1038961
NODE_48568_length_472_cov_50.077748	54	131	45	1	77	0.0129870
NODE_48568_length_472_cov_50.077748	54	131	46	11	77	0.1428571
NODE_48568_length_472_cov_50.077748	54	131	48	4	77	0.0519481
NODE_48568_length_472_cov_50.077748	54	131	49	4	77	0.0519481
NODE_48568_length_472_cov_50.077748	54	131	50	30	77	0.3896104
NODE_48568_length_472_cov_50.077748	54	131	52	19	77	0.2467532
NODE_48568_length_472_cov_50.077748	54	131	38	8	77	0.1038961
NODE_48568_length_472_cov_50.077748	54	131	45	1	77	0.0129870
NODE_48568_length_472_cov_50.077748	54	131	46	11	77	0.1428571
NODE_48568_length_472_cov_50.077748	54	131	48	4	77	0.0519481
NODE_48568_length_472_cov_50.077748	54	131	49	4	77	0.0519481
NODE_48568_length_472_cov_50.077748	54	131	50	30	77	0.3896104
NODE_48568_length_472_cov_50.077748	54	131	52	19	77	0.2467532
NODE_48568_length_472_cov_50.077748	130	204	4	12	74	0.1621622
NODE_48568_length_472_cov_50.077748	130	204	8	1	74	0.0135135
NODE_48568_length_472_cov_50.077748	130	204	10	3	74	0.0405405
NODE_48568_length_472_cov_50.077748	130	204	15	1	74	0.0135135
NODE_48568_length_472_cov_50.077748	130	204	17	11	74	0.1486486
NODE_48568_length_472_cov_50.077748	130	204	18	4	74	0.0540541
NODE_48568_length_472_cov_50.077748	130	204	20	7	74	0.0945946
NODE_48568_length_472_cov_50.077748	130	204	21	4	74	0.0540541
NODE_48568_length_472_cov_50.077748	130	204	29	5	74	0.0675676
NODE_48568_length_472_cov_50.077748	130	204	31	5	74	0.0675676
NODE_48568_length_472_cov_50.077748	130	204	35	6	74	0.0810811
NODE_48568_length_472_cov_50.077748	130	204	38	15	74	0.2027027
NODE_48569_length_472_cov_10.469169	294	374	0	80	80	1.0000000
NODE_48569_length_472_cov_10.469169	347	427	0	80	80	1.0000000
NODE_48570_length_472_cov_10.195710	143	223	0	46	80	0.5750000
NODE_48570_length_472_cov_10.195710	143	223	2	34	80	0.4250000
NODE_48570_length_472_cov_10.195710	196	276	0	16	80	0.2000000
NODE_48570_length_472_cov_10.195710	196	276	2	64	80	0.8000000
NODE_48593_length_472_cov_4.375335	165	245	0	80	80	1.0000000
NODE_48593_length_472_cov_4.375335	218	251	0	33	33	1.0000000
NODE_48614_length_472_cov_3.495979	305	349	0	44	44	1.0000000
NODE_48620_length_472_cov_3.093834	220	295	0	75	75	1.0000000
NODE_48638_length_472_cov_2.592493	431	471	0	40	40	1.0000000
NODE_48745_length_472_cov_1.294906	43	98	0	40	55	0.7272727
NODE_48745_length_472_cov_1.294906	43	98	2	15	55	0.2727273
NODE_48745_length_472_cov_1.294906	71	151	0	13	80	0.1625000
NODE_48745_length_472_cov_1.294906	71	151	2	67	80	0.8375000
NODE_48768_length_472_cov_1.211796	106	126	2	17	20	0.8500000
NODE_48768_length_472_cov_1.211796	106	126	4	3	20	0.1500000
NODE_48873_length_471_cov_39.319892	119	193	0	69	74	0.9324324
NODE_48873_length_471_cov_39.319892	119	193	2	3	74	0.0405405
NODE_48873_length_471_cov_39.319892	119	193	6	1	74	0.0135135
NODE_48873_length_471_cov_39.319892	119	193	64	1	74	0.0135135
NODE_48874_length_471_cov_24.279570	185	265	0	55	80	0.6875000
NODE_48874_length_471_cov_24.279570	185	265	2	25	80	0.3125000
NODE_48874_length_471_cov_24.279570	238	318	0	2	80	0.0250000
NODE_48874_length_471_cov_24.279570	238	318	2	78	80	0.9750000
NODE_48875_length_471_cov_19.669355	83	163	8	2	80	0.0250000
NODE_48875_length_471_cov_19.669355	83	163	11	3	80	0.0375000
NODE_48875_length_471_cov_19.669355	83	163	14	47	80	0.5875000
NODE_48875_length_471_cov_19.669355	83	163	15	8	80	0.1000000
NODE_48875_length_471_cov_19.669355	83	163	20	20	80	0.2500000
NODE_48875_length_471_cov_19.669355	136	216	10	34	80	0.4250000
NODE_48875_length_471_cov_19.669355	136	216	11	19	80	0.2375000
NODE_48875_length_471_cov_19.669355	136	216	13	2	80	0.0250000
NODE_48875_length_471_cov_19.669355	136	216	14	1	80	0.0125000
NODE_48875_length_471_cov_19.669355	136	216	15	8	80	0.1000000
NODE_48875_length_471_cov_19.669355	136	216	20	16	80	0.2000000
NODE_48876_length_471_cov_14.387097	198	278	0	80	80	1.0000000
NODE_48876_length_471_cov_14.387097	251	331	0	80	80	1.0000000
NODE_48881_length_471_cov_6.948925	186	213	0	27	27	1.0000000
NODE_48881_length_471_cov_6.948925	204	284	0	80	80	1.0000000
NODE_48881_length_471_cov_6.948925	244	275	0	31	31	1.0000000
NODE_48881_length_471_cov_6.948925	257	337	0	80	80	1.0000000
NODE_48881_length_471_cov_6.948925	268	337	0	69	69	1.0000000
NODE_48902_length_471_cov_3.803763	83	162	0	79	79	1.0000000
NODE_48902_length_471_cov_3.803763	135	215	0	80	80	1.0000000
NODE_48924_length_471_cov_2.954301	284	315	17	9	31	0.2903226
NODE_48924_length_471_cov_2.954301	284	315	19	11	31	0.3548387
NODE_48924_length_471_cov_2.954301	284	315	20	1	31	0.0322581
NODE_48924_length_471_cov_2.954301	284	315	22	10	31	0.3225806
NODE_48957_length_471_cov_2.287634	133	200	2	17	67	0.2537313
NODE_48957_length_471_cov_2.287634	133	200	4	12	67	0.1791045
NODE_48957_length_471_cov_2.287634	133	200	6	8	67	0.1194030
NODE_48957_length_471_cov_2.287634	133	200	8	2	67	0.0298507
NODE_48957_length_471_cov_2.287634	133	200	10	28	67	0.4179105
NODE_49186_length_470_cov_57.078167	184	264	0	63	80	0.7875000
NODE_49186_length_470_cov_57.078167	184	264	2	17	80	0.2125000
NODE_49186_length_470_cov_57.078167	237	317	0	10	80	0.1250000
NODE_49186_length_470_cov_57.078167	237	317	2	26	80	0.3250000
NODE_49186_length_470_cov_57.078167	237	317	4	21	80	0.2625000
NODE_49186_length_470_cov_57.078167	237	317	9	23	80	0.2875000
NODE_49186_length_470_cov_57.078167	313	393	7	2	80	0.0250000
NODE_49186_length_470_cov_57.078167	313	393	9	6	80	0.0750000
NODE_49186_length_470_cov_57.078167	313	393	10	1	80	0.0125000
NODE_49186_length_470_cov_57.078167	313	393	11	2	80	0.0250000
NODE_49186_length_470_cov_57.078167	313	393	16	3	80	0.0375000
NODE_49186_length_470_cov_57.078167	313	393	18	1	80	0.0125000
NODE_49186_length_470_cov_57.078167	313	393	19	5	80	0.0625000
NODE_49186_length_470_cov_57.078167	313	393	27	5	80	0.0625000
NODE_49186_length_470_cov_57.078167	313	393	29	1	80	0.0125000
NODE_49186_length_470_cov_57.078167	313	393	30	1	80	0.0125000
NODE_49186_length_470_cov_57.078167	313	393	33	1	80	0.0125000
NODE_49186_length_470_cov_57.078167	313	393	34	13	80	0.1625000
NODE_49186_length_470_cov_57.078167	313	393	35	12	80	0.1500000
NODE_49186_length_470_cov_57.078167	313	393	36	19	80	0.2375000
NODE_49186_length_470_cov_57.078167	313	393	38	8	80	0.1000000
NODE_49186_length_470_cov_57.078167	366	446	24	2	80	0.0250000
NODE_49186_length_470_cov_57.078167	366	446	29	28	80	0.3500000
NODE_49186_length_470_cov_57.078167	366	446	30	1	80	0.0125000
NODE_49186_length_470_cov_57.078167	366	446	31	2	80	0.0250000
NODE_49186_length_470_cov_57.078167	366	446	33	1	80	0.0125000
NODE_49186_length_470_cov_57.078167	366	446	35	31	80	0.3875000
NODE_49186_length_470_cov_57.078167	366	446	36	15	80	0.1875000
NODE_49187_length_470_cov_34.035040	228	308	0	80	80	1.0000000
NODE_49187_length_470_cov_34.035040	281	361	0	80	80	1.0000000
NODE_49187_length_470_cov_34.035040	357	437	0	80	80	1.0000000
NODE_49187_length_470_cov_34.035040	410	470	0	60	60	1.0000000
NODE_49188_length_470_cov_15.539084	142	222	0	80	80	1.0000000
NODE_49188_length_470_cov_15.539084	195	275	0	80	80	1.0000000
NODE_49193_length_470_cov_6.070081	272	330	77	1	58	0.0172414
NODE_49193_length_470_cov_6.070081	272	330	78	4	58	0.0689655
NODE_49193_length_470_cov_6.070081	272	330	79	4	58	0.0689655
NODE_49193_length_470_cov_6.070081	272	330	81	1	58	0.0172414
NODE_49193_length_470_cov_6.070081	272	330	84	2	58	0.0344828
NODE_49193_length_470_cov_6.070081	272	330	88	3	58	0.0517241
NODE_49193_length_470_cov_6.070081	272	330	89	2	58	0.0344828
NODE_49193_length_470_cov_6.070081	272	330	90	1	58	0.0172414
NODE_49193_length_470_cov_6.070081	272	330	93	1	58	0.0172414
NODE_49193_length_470_cov_6.070081	272	330	94	1	58	0.0172414
NODE_49193_length_470_cov_6.070081	272	330	96	1	58	0.0172414
NODE_49193_length_470_cov_6.070081	272	330	98	3	58	0.0517241
NODE_49193_length_470_cov_6.070081	272	330	100	1	58	0.0172414
NODE_49193_length_470_cov_6.070081	272	330	103	7	58	0.1206897
NODE_49193_length_470_cov_6.070081	272	330	107	2	58	0.0344828
NODE_49193_length_470_cov_6.070081	272	330	109	2	58	0.0344828
NODE_49193_length_470_cov_6.070081	272	330	111	1	58	0.0172414
NODE_49193_length_470_cov_6.070081	272	330	115	1	58	0.0172414
NODE_49193_length_470_cov_6.070081	272	330	121	3	58	0.0517241
NODE_49193_length_470_cov_6.070081	272	330	123	2	58	0.0344828
NODE_49193_length_470_cov_6.070081	272	330	128	2	58	0.0344828
NODE_49193_length_470_cov_6.070081	272	330	129	3	58	0.0517241
NODE_49193_length_470_cov_6.070081	272	330	130	3	58	0.0517241
NODE_49193_length_470_cov_6.070081	272	330	131	2	58	0.0344828
NODE_49193_length_470_cov_6.070081	272	330	132	5	58	0.0862069
NODE_49193_length_470_cov_6.070081	325	383	10	1	58	0.0172414
NODE_49193_length_470_cov_6.070081	325	383	12	2	58	0.0344828
NODE_49193_length_470_cov_6.070081	325	383	15	2	58	0.0344828
NODE_49193_length_470_cov_6.070081	325	383	19	3	58	0.0517241
NODE_49193_length_470_cov_6.070081	325	383	21	3	58	0.0517241
NODE_49193_length_470_cov_6.070081	325	383	25	3	58	0.0517241
NODE_49193_length_470_cov_6.070081	325	383	27	5	58	0.0862069
NODE_49193_length_470_cov_6.070081	325	383	29	1	58	0.0172414
NODE_49193_length_470_cov_6.070081	325	383	30	2	58	0.0344828
NODE_49193_length_470_cov_6.070081	325	383	32	3	58	0.0517241
NODE_49193_length_470_cov_6.070081	325	383	39	3	58	0.0517241
NODE_49193_length_470_cov_6.070081	325	383	41	1	58	0.0172414
NODE_49193_length_470_cov_6.070081	325	383	47	1	58	0.0172414
NODE_49193_length_470_cov_6.070081	325	383	48	1	58	0.0172414
NODE_49193_length_470_cov_6.070081	325	383	59	1	58	0.0172414
NODE_49193_length_470_cov_6.070081	325	383	62	1	58	0.0172414
NODE_49193_length_470_cov_6.070081	325	383	65	2	58	0.0344828
NODE_49193_length_470_cov_6.070081	325	383	67	2	58	0.0344828
NODE_49193_length_470_cov_6.070081	325	383	70	2	58	0.0344828
NODE_49193_length_470_cov_6.070081	325	383	71	3	58	0.0517241
NODE_49193_length_470_cov_6.070081	325	383	73	10	58	0.1724138
NODE_49193_length_470_cov_6.070081	325	383	77	2	58	0.0344828
NODE_49193_length_470_cov_6.070081	325	383	78	4	58	0.0689655
NODE_49215_length_470_cov_3.735849	194	251	0	57	57	1.0000000
NODE_49260_length_470_cov_2.363881	403	422	4	19	19	1.0000000
NODE_49260_length_470_cov_2.363881	403	422	4	19	19	1.0000000
NODE_49389_length_470_cov_1.142857	414	470	0	18	56	0.3214286
NODE_49389_length_470_cov_1.142857	414	470	2	4	56	0.0714286
NODE_49389_length_470_cov_1.142857	414	470	4	7	56	0.1250000
NODE_49389_length_470_cov_1.142857	414	470	6	6	56	0.1071429
NODE_49389_length_470_cov_1.142857	414	470	11	21	56	0.3750000
NODE_49502_length_469_cov_221.024324	150	228	265	1	78	0.0128205
NODE_49502_length_469_cov_221.024324	150	228	281	1	78	0.0128205
NODE_49502_length_469_cov_221.024324	150	228	295	1	78	0.0128205
NODE_49502_length_469_cov_221.024324	150	228	299	2	78	0.0256410
NODE_49502_length_469_cov_221.024324	150	228	309	2	78	0.0256410
NODE_49502_length_469_cov_221.024324	150	228	311	1	78	0.0128205
NODE_49502_length_469_cov_221.024324	150	228	318	2	78	0.0256410
NODE_49502_length_469_cov_221.024324	150	228	320	1	78	0.0128205
NODE_49502_length_469_cov_221.024324	150	228	324	2	78	0.0256410
NODE_49502_length_469_cov_221.024324	150	228	326	4	78	0.0512821
NODE_49502_length_469_cov_221.024324	150	228	327	1	78	0.0128205
NODE_49502_length_469_cov_221.024324	150	228	332	1	78	0.0128205
NODE_49502_length_469_cov_221.024324	150	228	333	6	78	0.0769231
NODE_49502_length_469_cov_221.024324	150	228	334	1	78	0.0128205
NODE_49502_length_469_cov_221.024324	150	228	335	3	78	0.0384615
NODE_49502_length_469_cov_221.024324	150	228	336	5	78	0.0641026
NODE_49502_length_469_cov_221.024324	150	228	338	3	78	0.0384615
NODE_49502_length_469_cov_221.024324	150	228	339	2	78	0.0256410
NODE_49502_length_469_cov_221.024324	150	228	340	2	78	0.0256410
NODE_49502_length_469_cov_221.024324	150	228	341	1	78	0.0128205
NODE_49502_length_469_cov_221.024324	150	228	342	2	78	0.0256410
NODE_49502_length_469_cov_221.024324	150	228	347	1	78	0.0128205
NODE_49502_length_469_cov_221.024324	150	228	348	1	78	0.0128205
NODE_49502_length_469_cov_221.024324	150	228	351	1	78	0.0128205
NODE_49502_length_469_cov_221.024324	150	228	353	1	78	0.0128205
NODE_49502_length_469_cov_221.024324	150	228	354	1	78	0.0128205
NODE_49502_length_469_cov_221.024324	150	228	355	7	78	0.0897436
NODE_49502_length_469_cov_221.024324	150	228	359	1	78	0.0128205
NODE_49502_length_469_cov_221.024324	150	228	363	4	78	0.0512821
NODE_49502_length_469_cov_221.024324	150	228	367	1	78	0.0128205
NODE_49502_length_469_cov_221.024324	150	228	368	3	78	0.0384615
NODE_49502_length_469_cov_221.024324	150	228	369	1	78	0.0128205
NODE_49502_length_469_cov_221.024324	150	228	371	1	78	0.0128205
NODE_49502_length_469_cov_221.024324	150	228	372	2	78	0.0256410
NODE_49502_length_469_cov_221.024324	150	228	374	5	78	0.0641026
NODE_49502_length_469_cov_221.024324	150	228	375	2	78	0.0256410
NODE_49502_length_469_cov_221.024324	150	228	382	1	78	0.0128205
NODE_49502_length_469_cov_221.024324	150	228	383	1	78	0.0128205
NODE_49502_length_469_cov_221.024324	150	228	265	1	78	0.0128205
NODE_49502_length_469_cov_221.024324	150	228	281	1	78	0.0128205
NODE_49502_length_469_cov_221.024324	150	228	295	1	78	0.0128205
NODE_49502_length_469_cov_221.024324	150	228	299	2	78	0.0256410
NODE_49502_length_469_cov_221.024324	150	228	309	2	78	0.0256410
NODE_49502_length_469_cov_221.024324	150	228	311	1	78	0.0128205
NODE_49502_length_469_cov_221.024324	150	228	318	2	78	0.0256410
NODE_49502_length_469_cov_221.024324	150	228	320	1	78	0.0128205
NODE_49502_length_469_cov_221.024324	150	228	324	2	78	0.0256410
NODE_49502_length_469_cov_221.024324	150	228	326	4	78	0.0512821
NODE_49502_length_469_cov_221.024324	150	228	327	1	78	0.0128205
NODE_49502_length_469_cov_221.024324	150	228	332	1	78	0.0128205
NODE_49502_length_469_cov_221.024324	150	228	333	6	78	0.0769231
NODE_49502_length_469_cov_221.024324	150	228	334	1	78	0.0128205
NODE_49502_length_469_cov_221.024324	150	228	335	3	78	0.0384615
NODE_49502_length_469_cov_221.024324	150	228	336	5	78	0.0641026
NODE_49502_length_469_cov_221.024324	150	228	338	3	78	0.0384615
NODE_49502_length_469_cov_221.024324	150	228	339	2	78	0.0256410
NODE_49502_length_469_cov_221.024324	150	228	340	2	78	0.0256410
NODE_49502_length_469_cov_221.024324	150	228	341	1	78	0.0128205
NODE_49502_length_469_cov_221.024324	150	228	342	2	78	0.0256410
NODE_49502_length_469_cov_221.024324	150	228	347	1	78	0.0128205
NODE_49502_length_469_cov_221.024324	150	228	348	1	78	0.0128205
NODE_49502_length_469_cov_221.024324	150	228	351	1	78	0.0128205
NODE_49502_length_469_cov_221.024324	150	228	353	1	78	0.0128205
NODE_49502_length_469_cov_221.024324	150	228	354	1	78	0.0128205
NODE_49502_length_469_cov_221.024324	150	228	355	7	78	0.0897436
NODE_49502_length_469_cov_221.024324	150	228	359	1	78	0.0128205
NODE_49502_length_469_cov_221.024324	150	228	363	4	78	0.0512821
NODE_49502_length_469_cov_221.024324	150	228	367	1	78	0.0128205
NODE_49502_length_469_cov_221.024324	150	228	368	3	78	0.0384615
NODE_49502_length_469_cov_221.024324	150	228	369	1	78	0.0128205
NODE_49502_length_469_cov_221.024324	150	228	371	1	78	0.0128205
NODE_49502_length_469_cov_221.024324	150	228	372	2	78	0.0256410
NODE_49502_length_469_cov_221.024324	150	228	374	5	78	0.0641026
NODE_49502_length_469_cov_221.024324	150	228	375	2	78	0.0256410
NODE_49502_length_469_cov_221.024324	150	228	382	1	78	0.0128205
NODE_49502_length_469_cov_221.024324	150	228	383	1	78	0.0128205
NODE_49502_length_469_cov_221.024324	150	219	318	1	69	0.0144928
NODE_49502_length_469_cov_221.024324	150	219	320	1	69	0.0144928
NODE_49502_length_469_cov_221.024324	150	219	324	2	69	0.0289855
NODE_49502_length_469_cov_221.024324	150	219	326	4	69	0.0579710
NODE_49502_length_469_cov_221.024324	150	219	327	1	69	0.0144928
NODE_49502_length_469_cov_221.024324	150	219	332	1	69	0.0144928
NODE_49502_length_469_cov_221.024324	150	219	333	6	69	0.0869565
NODE_49502_length_469_cov_221.024324	150	219	334	1	69	0.0144928
NODE_49502_length_469_cov_221.024324	150	219	335	3	69	0.0434783
NODE_49502_length_469_cov_221.024324	150	219	336	5	69	0.0724638
NODE_49502_length_469_cov_221.024324	150	219	338	3	69	0.0434783
NODE_49502_length_469_cov_221.024324	150	219	339	2	69	0.0289855
NODE_49502_length_469_cov_221.024324	150	219	340	2	69	0.0289855
NODE_49502_length_469_cov_221.024324	150	219	341	1	69	0.0144928
NODE_49502_length_469_cov_221.024324	150	219	342	2	69	0.0289855
NODE_49502_length_469_cov_221.024324	150	219	347	1	69	0.0144928
NODE_49502_length_469_cov_221.024324	150	219	348	1	69	0.0144928
NODE_49502_length_469_cov_221.024324	150	219	351	1	69	0.0144928
NODE_49502_length_469_cov_221.024324	150	219	353	1	69	0.0144928
NODE_49502_length_469_cov_221.024324	150	219	354	1	69	0.0144928
NODE_49502_length_469_cov_221.024324	150	219	355	7	69	0.1014493
NODE_49502_length_469_cov_221.024324	150	219	359	1	69	0.0144928
NODE_49502_length_469_cov_221.024324	150	219	363	4	69	0.0579710
NODE_49502_length_469_cov_221.024324	150	219	367	1	69	0.0144928
NODE_49502_length_469_cov_221.024324	150	219	368	3	69	0.0434783
NODE_49502_length_469_cov_221.024324	150	219	369	1	69	0.0144928
NODE_49502_length_469_cov_221.024324	150	219	371	1	69	0.0144928
NODE_49502_length_469_cov_221.024324	150	219	372	2	69	0.0289855
NODE_49502_length_469_cov_221.024324	150	219	374	5	69	0.0724638
NODE_49502_length_469_cov_221.024324	150	219	375	2	69	0.0289855
NODE_49502_length_469_cov_221.024324	150	219	382	1	69	0.0144928
NODE_49502_length_469_cov_221.024324	150	219	383	1	69	0.0144928
NODE_49557_length_469_cov_2.686486	263	343	0	80	80	1.0000000
NODE_49561_length_469_cov_2.521622	237	289	0	33	52	0.6346154
NODE_49561_length_469_cov_2.521622	237	289	2	19	52	0.3653846
NODE_49579_length_469_cov_2.224324	279	331	2	7	52	0.1346154
NODE_49579_length_469_cov_2.224324	279	331	4	45	52	0.8653846
NODE_49796_length_468_cov_8.043360	190	250	0	24	60	0.4000000
NODE_49796_length_468_cov_8.043360	190	250	4	11	60	0.1833333
NODE_49796_length_468_cov_8.043360	190	250	6	5	60	0.0833333
NODE_49796_length_468_cov_8.043360	190	250	10	20	60	0.3333333
NODE_49796_length_468_cov_8.043360	223	303	4	2	80	0.0250000
NODE_49796_length_468_cov_8.043360	223	303	6	5	80	0.0625000
NODE_49796_length_468_cov_8.043360	223	303	8	13	80	0.1625000
NODE_49796_length_468_cov_8.043360	223	303	10	60	80	0.7500000
NODE_49800_length_468_cov_6.046070	152	232	0	80	80	1.0000000
NODE_49800_length_468_cov_6.046070	205	285	0	80	80	1.0000000
NODE_49801_length_468_cov_5.997290	81	161	0	44	80	0.5500000
NODE_49801_length_468_cov_5.997290	81	161	2	36	80	0.4500000
NODE_49801_length_468_cov_5.997290	134	214	0	44	80	0.5500000
NODE_49801_length_468_cov_5.997290	134	214	1	14	80	0.1750000
NODE_49801_length_468_cov_5.997290	134	214	3	22	80	0.2750000
NODE_49801_length_468_cov_5.997290	210	270	3	13	60	0.2166667
NODE_49801_length_468_cov_5.997290	210	270	4	15	60	0.2500000
NODE_49801_length_468_cov_5.997290	210	270	6	20	60	0.3333333
NODE_49801_length_468_cov_5.997290	210	270	8	12	60	0.2000000
NODE_49803_length_468_cov_5.872629	133	201	10	33	68	0.4852941
NODE_49803_length_468_cov_5.872629	133	201	11	2	68	0.0294118
NODE_49803_length_468_cov_5.872629	133	201	12	14	68	0.2058824
NODE_49803_length_468_cov_5.872629	133	201	14	5	68	0.0735294
NODE_49803_length_468_cov_5.872629	133	201	16	14	68	0.2058824
NODE_49807_length_468_cov_5.384824	305	356	0	10	51	0.1960784
NODE_49807_length_468_cov_5.384824	305	356	2	2	51	0.0392157
NODE_49807_length_468_cov_5.384824	305	356	4	39	51	0.7647059
NODE_49894_length_468_cov_2.067751	45	96	2	51	51	1.0000000
NODE_49913_length_468_cov_1.891599	4	63	0	59	59	1.0000000
NODE_49928_length_468_cov_1.758808	140	218	0	78	78	1.0000000
NODE_49928_length_468_cov_1.758808	191	257	0	66	66	1.0000000
NODE_49974_length_468_cov_1.390244	291	310	2	16	19	0.8421053
NODE_49974_length_468_cov_1.390244	291	310	6	3	19	0.1578947
NODE_49974_length_468_cov_1.390244	369	405	1	6	36	0.1666667
NODE_49974_length_468_cov_1.390244	369	405	2	18	36	0.5000000
NODE_49974_length_468_cov_1.390244	369	405	3	12	36	0.3333333
NODE_50133_length_467_cov_14.100543	176	256	0	13	80	0.1625000
NODE_50133_length_467_cov_14.100543	176	256	2	67	80	0.8375000
NODE_50134_length_467_cov_11.902174	193	236	0	43	43	1.0000000
NODE_50135_length_467_cov_10.875000	226	306	0	80	80	1.0000000
NODE_50135_length_467_cov_10.875000	279	359	0	80	80	1.0000000
NODE_50144_length_467_cov_6.625000	206	275	7	8	69	0.1159420
NODE_50144_length_467_cov_6.625000	206	275	8	14	69	0.2028985
NODE_50144_length_467_cov_6.625000	206	275	11	47	69	0.6811594
NODE_50144_length_467_cov_6.625000	257	328	2	6	71	0.0845070
NODE_50144_length_467_cov_6.625000	257	328	5	23	71	0.3239437
NODE_50144_length_467_cov_6.625000	257	328	6	2	71	0.0281690
NODE_50144_length_467_cov_6.625000	257	328	7	7	71	0.0985916
NODE_50144_length_467_cov_6.625000	257	328	9	14	71	0.1971831
NODE_50144_length_467_cov_6.625000	257	328	11	19	71	0.2676056
NODE_50197_length_467_cov_2.709239	247	327	0	1	80	0.0125000
NODE_50197_length_467_cov_2.709239	247	327	1	79	80	0.9875000
NODE_50215_length_467_cov_2.296196	284	329	0	45	45	1.0000000
NODE_50238_length_467_cov_2.027174	218	269	0	51	51	1.0000000
NODE_50252_length_467_cov_1.836957	55	118	0	2	63	0.0317460
NODE_50252_length_467_cov_1.836957	55	118	2	61	63	0.9682540
NODE_50267_length_467_cov_1.603261	92	141	0	5	49	0.1020408
NODE_50267_length_467_cov_1.603261	92	141	4	40	49	0.8163266
NODE_50267_length_467_cov_1.603261	92	141	6	4	49	0.0816327
NODE_50283_length_467_cov_1.426630	135	183	0	1	48	0.0208333
NODE_50283_length_467_cov_1.426630	135	183	2	47	48	0.9791667
NODE_50447_length_466_cov_42.839237	0	47	0	47	47	1.0000000
NODE_50447_length_466_cov_42.839237	20	100	0	80	80	1.0000000
NODE_50447_length_466_cov_42.839237	96	176	0	26	80	0.3250000
NODE_50447_length_466_cov_42.839237	96	176	2	54	80	0.6750000
NODE_50447_length_466_cov_42.839237	149	229	0	28	80	0.3500000
NODE_50447_length_466_cov_42.839237	149	229	2	52	80	0.6500000
NODE_50448_length_466_cov_36.901907	85	165	4	80	80	1.0000000
NODE_50448_length_466_cov_36.901907	138	218	0	49	80	0.6125000
NODE_50448_length_466_cov_36.901907	138	218	4	31	80	0.3875000
NODE_50448_length_466_cov_36.901907	214	294	0	80	80	1.0000000
NODE_50448_length_466_cov_36.901907	267	347	0	80	80	1.0000000
NODE_50457_length_466_cov_5.122616	275	316	2	13	41	0.3170732
NODE_50457_length_466_cov_5.122616	275	316	9	1	41	0.0243902
NODE_50457_length_466_cov_5.122616	275	316	10	21	41	0.5121951
NODE_50457_length_466_cov_5.122616	275	316	12	6	41	0.1463415
NODE_50457_length_466_cov_5.122616	276	316	2	13	40	0.3250000
NODE_50457_length_466_cov_5.122616	276	316	9	1	40	0.0250000
NODE_50457_length_466_cov_5.122616	276	316	10	21	40	0.5250000
NODE_50457_length_466_cov_5.122616	276	316	12	5	40	0.1250000
NODE_50457_length_466_cov_5.122616	289	338	0	11	49	0.2244898
NODE_50457_length_466_cov_5.122616	289	338	2	24	49	0.4897959
NODE_50457_length_466_cov_5.122616	289	338	9	1	49	0.0204082
NODE_50457_length_466_cov_5.122616	289	338	10	13	49	0.2653061
NODE_50515_length_466_cov_2.602180	9	90	0	15	81	0.1851852
NODE_50515_length_466_cov_2.602180	9	90	2	15	81	0.1851852
NODE_50515_length_466_cov_2.602180	9	90	4	4	81	0.0493827
NODE_50515_length_466_cov_2.602180	9	90	6	17	81	0.2098765
NODE_50515_length_466_cov_2.602180	9	90	8	30	81	0.3703704
NODE_50515_length_466_cov_2.602180	312	341	4	29	29	1.0000000
NODE_50549_length_466_cov_2.108992	130	182	4	14	52	0.2692308
NODE_50549_length_466_cov_2.108992	130	182	6	5	52	0.0961538
NODE_50549_length_466_cov_2.108992	130	182	7	33	52	0.6346154
NODE_50562_length_466_cov_1.980926	183	265	0	35	82	0.4268293
NODE_50562_length_466_cov_1.980926	183	265	2	47	82	0.5731707
NODE_50787_length_465_cov_13.019126	170	250	0	19	80	0.2375000
NODE_50787_length_465_cov_13.019126	170	250	6	39	80	0.4875000
NODE_50787_length_465_cov_13.019126	170	250	8	22	80	0.2750000
NODE_50787_length_465_cov_13.019126	223	301	2	2	78	0.0256410
NODE_50787_length_465_cov_13.019126	223	301	6	5	78	0.0641026
NODE_50787_length_465_cov_13.019126	223	301	8	71	78	0.9102564
NODE_50799_length_465_cov_5.363388	316	393	0	77	77	1.0000000
NODE_50800_length_465_cov_4.898907	376	406	0	30	30	1.0000000
NODE_50869_length_465_cov_2.366120	147	227	0	80	80	1.0000000
NODE_50869_length_465_cov_2.366120	200	271	0	71	71	1.0000000
NODE_50911_length_465_cov_1.737705	338	383	2	45	45	1.0000000
NODE_51100_length_464_cov_8.473973	209	289	0	35	80	0.4375000
NODE_51100_length_464_cov_8.473973	209	289	2	36	80	0.4500000
NODE_51100_length_464_cov_8.473973	209	289	4	9	80	0.1125000
NODE_51100_length_464_cov_8.473973	262	342	2	19	80	0.2375000
NODE_51100_length_464_cov_8.473973	262	342	4	61	80	0.7625000
NODE_51148_length_464_cov_2.528767	136	199	6	63	63	1.0000000
NODE_51167_length_464_cov_2.134247	130	203	0	66	73	0.9041096
NODE_51167_length_464_cov_2.134247	130	203	2	7	73	0.0958904
NODE_51186_length_464_cov_1.901370	58	138	0	1	80	0.0125000
NODE_51186_length_464_cov_1.901370	58	138	4	39	80	0.4875000
NODE_51186_length_464_cov_1.901370	58	138	6	30	80	0.3750000
NODE_51186_length_464_cov_1.901370	58	138	7	10	80	0.1250000
NODE_51203_length_464_cov_1.706849	186	265	0	79	79	1.0000000
NODE_51377_length_463_cov_64.420330	375	455	0	23	80	0.2875000
NODE_51377_length_463_cov_64.420330	375	455	6	33	80	0.4125000
NODE_51377_length_463_cov_64.420330	375	455	11	14	80	0.1750000
NODE_51377_length_463_cov_64.420330	375	455	16	10	80	0.1250000
NODE_51377_length_463_cov_64.420330	375	455	0	23	80	0.2875000
NODE_51377_length_463_cov_64.420330	375	455	6	33	80	0.4125000
NODE_51377_length_463_cov_64.420330	375	455	11	14	80	0.1750000
NODE_51377_length_463_cov_64.420330	375	455	16	10	80	0.1250000
NODE_51377_length_463_cov_64.420330	375	455	0	23	80	0.2875000
NODE_51377_length_463_cov_64.420330	375	455	6	33	80	0.4125000
NODE_51377_length_463_cov_64.420330	375	455	11	14	80	0.1750000
NODE_51377_length_463_cov_64.420330	375	455	16	10	80	0.1250000
NODE_51377_length_463_cov_64.420330	375	455	0	23	80	0.2875000
NODE_51377_length_463_cov_64.420330	375	455	6	33	80	0.4125000
NODE_51377_length_463_cov_64.420330	375	455	11	14	80	0.1750000
NODE_51377_length_463_cov_64.420330	375	455	16	10	80	0.1250000
NODE_51377_length_463_cov_64.420330	375	455	0	23	80	0.2875000
NODE_51377_length_463_cov_64.420330	375	455	6	33	80	0.4125000
NODE_51377_length_463_cov_64.420330	375	455	11	14	80	0.1750000
NODE_51377_length_463_cov_64.420330	375	455	16	10	80	0.1250000
NODE_51378_length_463_cov_49.673077	0	71	0	58	71	0.8169014
NODE_51378_length_463_cov_49.673077	0	71	4	13	71	0.1830986
NODE_51378_length_463_cov_49.673077	44	121	0	14	77	0.1818182
NODE_51378_length_463_cov_49.673077	44	121	4	63	77	0.8181818
NODE_51379_length_463_cov_41.005495	8	88	0	56	80	0.7000000
NODE_51379_length_463_cov_41.005495	8	88	2	24	80	0.3000000
NODE_51379_length_463_cov_41.005495	61	141	0	33	80	0.4125000
NODE_51379_length_463_cov_41.005495	61	141	2	47	80	0.5875000
NODE_51380_length_463_cov_30.626374	318	398	0	37	80	0.4625000
NODE_51380_length_463_cov_30.626374	318	398	2	43	80	0.5375000
NODE_51380_length_463_cov_30.626374	371	451	0	9	80	0.1125000
NODE_51380_length_463_cov_30.626374	371	451	1	1	80	0.0125000
NODE_51380_length_463_cov_30.626374	371	451	2	70	80	0.8750000
NODE_51381_length_463_cov_27.475275	211	291	0	80	80	1.0000000
NODE_51381_length_463_cov_27.475275	264	344	0	80	80	1.0000000
NODE_51383_length_463_cov_11.211538	304	377	0	73	73	1.0000000
NODE_51383_length_463_cov_11.211538	350	430	0	80	80	1.0000000
NODE_51391_length_463_cov_5.711538	181	261	0	80	80	1.0000000
NODE_51391_length_463_cov_5.711538	234	314	0	80	80	1.0000000
NODE_51399_length_463_cov_4.398352	119	169	2	50	50	1.0000000
NODE_51402_length_463_cov_4.186813	175	233	6	6	58	0.1034483
NODE_51402_length_463_cov_4.186813	175	233	14	3	58	0.0517241
NODE_51402_length_463_cov_4.186813	175	233	18	49	58	0.8448276
NODE_51402_length_463_cov_4.186813	206	251	16	17	45	0.3777778
NODE_51402_length_463_cov_4.186813	206	251	18	28	45	0.6222222
NODE_51408_length_463_cov_3.846154	235	268	10	11	33	0.3333333
NODE_51408_length_463_cov_3.846154	235	268	12	12	33	0.3636364
NODE_51408_length_463_cov_3.846154	235	268	14	10	33	0.3030303
NODE_51421_length_463_cov_3.063187	193	248	0	55	55	1.0000000
NODE_51421_length_463_cov_3.063187	222	301	0	79	79	1.0000000
NODE_51680_length_462_cov_21.876033	93	173	0	5	80	0.0625000
NODE_51680_length_462_cov_21.876033	93	173	1	55	80	0.6875000
NODE_51680_length_462_cov_21.876033	93	173	2	20	80	0.2500000
NODE_51680_length_462_cov_21.876033	146	226	0	58	80	0.7250000
NODE_51680_length_462_cov_21.876033	146	226	1	22	80	0.2750000
NODE_51687_length_462_cov_5.033058	93	154	0	61	61	1.0000000
NODE_51687_length_462_cov_5.033058	159	209	0	50	50	1.0000000
NODE_51699_length_462_cov_4.101928	168	246	0	78	78	1.0000000
NODE_51699_length_462_cov_4.101928	184	208	0	24	24	1.0000000
NODE_51699_length_462_cov_4.101928	219	299	0	80	80	1.0000000
NODE_51708_length_462_cov_3.630854	149	194	0	28	45	0.6222222
NODE_51708_length_462_cov_3.630854	149	194	1	1	45	0.0222222
NODE_51708_length_462_cov_3.630854	149	194	2	16	45	0.3555556
NODE_51720_length_462_cov_3.079890	103	147	0	44	44	1.0000000
NODE_51735_length_462_cov_2.677686	78	118	0	40	40	1.0000000
NODE_51763_length_462_cov_2.209366	18	58	0	40	40	1.0000000
NODE_51817_length_462_cov_1.570248	68	113	0	45	45	1.0000000
NODE_51995_length_461_cov_35.116022	0	79	0	79	79	1.0000000
NODE_51995_length_461_cov_35.116022	52	132	0	80	80	1.0000000
NODE_51996_length_461_cov_11.124309	77	157	0	80	80	1.0000000
NODE_51996_length_461_cov_11.124309	130	210	0	80	80	1.0000000
NODE_52010_length_461_cov_5.361878	246	322	4	72	76	0.9473684
NODE_52010_length_461_cov_5.361878	246	322	6	4	76	0.0526316
NODE_52018_length_461_cov_4.472376	268	333	0	65	65	1.0000000
NODE_52021_length_461_cov_4.168508	159	234	0	75	75	1.0000000
NODE_52047_length_461_cov_2.892265	233	312	0	12	79	0.1518987
NODE_52047_length_461_cov_2.892265	233	312	4	23	79	0.2911392
NODE_52047_length_461_cov_2.892265	233	312	6	31	79	0.3924051
NODE_52047_length_461_cov_2.892265	233	312	8	13	79	0.1645570
NODE_52073_length_461_cov_2.392265	186	223	0	37	37	1.0000000
NODE_52154_length_461_cov_1.389503	283	349	2	66	66	1.0000000
NODE_52292_length_460_cov_172.986150	0	68	44	1	68	0.0147059
NODE_52292_length_460_cov_172.986150	0	68	48	1	68	0.0147059
NODE_52292_length_460_cov_172.986150	0	68	58	1	68	0.0147059
NODE_52292_length_460_cov_172.986150	0	68	74	1	68	0.0147059
NODE_52292_length_460_cov_172.986150	0	68	77	1	68	0.0147059
NODE_52292_length_460_cov_172.986150	0	68	85	1	68	0.0147059
NODE_52292_length_460_cov_172.986150	0	68	98	1	68	0.0147059
NODE_52292_length_460_cov_172.986150	0	68	101	1	68	0.0147059
NODE_52292_length_460_cov_172.986150	0	68	114	1	68	0.0147059
NODE_52292_length_460_cov_172.986150	0	68	127	1	68	0.0147059
NODE_52292_length_460_cov_172.986150	0	68	131	1	68	0.0147059
NODE_52292_length_460_cov_172.986150	0	68	145	1	68	0.0147059
NODE_52292_length_460_cov_172.986150	0	68	169	1	68	0.0147059
NODE_52292_length_460_cov_172.986150	0	68	194	1	68	0.0147059
NODE_52292_length_460_cov_172.986150	0	68	205	1	68	0.0147059
NODE_52292_length_460_cov_172.986150	0	68	211	1	68	0.0147059
NODE_52292_length_460_cov_172.986150	0	68	228	1	68	0.0147059
NODE_52292_length_460_cov_172.986150	0	68	267	1	68	0.0147059
NODE_52292_length_460_cov_172.986150	0	68	283	1	68	0.0147059
NODE_52292_length_460_cov_172.986150	0	68	317	1	68	0.0147059
NODE_52292_length_460_cov_172.986150	0	68	357	1	68	0.0147059
NODE_52292_length_460_cov_172.986150	0	68	367	1	68	0.0147059
NODE_52292_length_460_cov_172.986150	0	68	376	1	68	0.0147059
NODE_52292_length_460_cov_172.986150	0	68	421	1	68	0.0147059
NODE_52292_length_460_cov_172.986150	0	68	462	1	68	0.0147059
NODE_52292_length_460_cov_172.986150	0	68	471	1	68	0.0147059
NODE_52292_length_460_cov_172.986150	0	68	478	1	68	0.0147059
NODE_52292_length_460_cov_172.986150	0	68	492	1	68	0.0147059
NODE_52292_length_460_cov_172.986150	0	68	497	1	68	0.0147059
NODE_52292_length_460_cov_172.986150	0	68	499	2	68	0.0294118
NODE_52292_length_460_cov_172.986150	0	68	517	1	68	0.0147059
NODE_52292_length_460_cov_172.986150	0	68	522	1	68	0.0147059
NODE_52292_length_460_cov_172.986150	0	68	525	1	68	0.0147059
NODE_52292_length_460_cov_172.986150	0	68	535	1	68	0.0147059
NODE_52292_length_460_cov_172.986150	0	68	537	2	68	0.0294118
NODE_52292_length_460_cov_172.986150	0	68	557	1	68	0.0147059
NODE_52292_length_460_cov_172.986150	0	68	559	1	68	0.0147059
NODE_52292_length_460_cov_172.986150	0	68	561	1	68	0.0147059
NODE_52292_length_460_cov_172.986150	0	68	572	1	68	0.0147059
NODE_52292_length_460_cov_172.986150	0	68	573	1	68	0.0147059
NODE_52292_length_460_cov_172.986150	0	68	592	1	68	0.0147059
NODE_52292_length_460_cov_172.986150	0	68	597	1	68	0.0147059
NODE_52292_length_460_cov_172.986150	0	68	605	1	68	0.0147059
NODE_52292_length_460_cov_172.986150	0	68	612	1	68	0.0147059
NODE_52292_length_460_cov_172.986150	0	68	628	1	68	0.0147059
NODE_52292_length_460_cov_172.986150	0	68	633	1	68	0.0147059
NODE_52292_length_460_cov_172.986150	0	68	642	1	68	0.0147059
NODE_52292_length_460_cov_172.986150	0	68	653	1	68	0.0147059
NODE_52292_length_460_cov_172.986150	0	68	664	1	68	0.0147059
NODE_52292_length_460_cov_172.986150	0	68	672	1	68	0.0147059
NODE_52292_length_460_cov_172.986150	0	68	683	1	68	0.0147059
NODE_52292_length_460_cov_172.986150	0	68	685	1	68	0.0147059
NODE_52292_length_460_cov_172.986150	0	68	706	1	68	0.0147059
NODE_52292_length_460_cov_172.986150	0	68	713	1	68	0.0147059
NODE_52292_length_460_cov_172.986150	0	68	717	1	68	0.0147059
NODE_52292_length_460_cov_172.986150	0	68	725	1	68	0.0147059
NODE_52292_length_460_cov_172.986150	0	68	727	1	68	0.0147059
NODE_52292_length_460_cov_172.986150	0	68	732	1	68	0.0147059
NODE_52292_length_460_cov_172.986150	0	68	734	1	68	0.0147059
NODE_52292_length_460_cov_172.986150	0	68	738	1	68	0.0147059
NODE_52292_length_460_cov_172.986150	0	68	745	1	68	0.0147059
NODE_52292_length_460_cov_172.986150	0	68	753	1	68	0.0147059
NODE_52292_length_460_cov_172.986150	0	68	754	2	68	0.0294118
NODE_52292_length_460_cov_172.986150	0	68	758	1	68	0.0147059
NODE_52292_length_460_cov_172.986150	0	68	763	1	68	0.0147059
NODE_52292_length_460_cov_172.986150	41	121	573	1	80	0.0125000
NODE_52292_length_460_cov_172.986150	41	121	592	1	80	0.0125000
NODE_52292_length_460_cov_172.986150	41	121	597	1	80	0.0125000
NODE_52292_length_460_cov_172.986150	41	121	605	1	80	0.0125000
NODE_52292_length_460_cov_172.986150	41	121	612	1	80	0.0125000
NODE_52292_length_460_cov_172.986150	41	121	628	1	80	0.0125000
NODE_52292_length_460_cov_172.986150	41	121	633	1	80	0.0125000
NODE_52292_length_460_cov_172.986150	41	121	642	1	80	0.0125000
NODE_52292_length_460_cov_172.986150	41	121	653	1	80	0.0125000
NODE_52292_length_460_cov_172.986150	41	121	664	1	80	0.0125000
NODE_52292_length_460_cov_172.986150	41	121	672	1	80	0.0125000
NODE_52292_length_460_cov_172.986150	41	121	683	1	80	0.0125000
NODE_52292_length_460_cov_172.986150	41	121	685	1	80	0.0125000
NODE_52292_length_460_cov_172.986150	41	121	706	1	80	0.0125000
NODE_52292_length_460_cov_172.986150	41	121	713	1	80	0.0125000
NODE_52292_length_460_cov_172.986150	41	121	717	1	80	0.0125000
NODE_52292_length_460_cov_172.986150	41	121	725	1	80	0.0125000
NODE_52292_length_460_cov_172.986150	41	121	727	1	80	0.0125000
NODE_52292_length_460_cov_172.986150	41	121	732	1	80	0.0125000
NODE_52292_length_460_cov_172.986150	41	121	734	1	80	0.0125000
NODE_52292_length_460_cov_172.986150	41	121	738	1	80	0.0125000
NODE_52292_length_460_cov_172.986150	41	121	745	1	80	0.0125000
NODE_52292_length_460_cov_172.986150	41	121	753	1	80	0.0125000
NODE_52292_length_460_cov_172.986150	41	121	754	2	80	0.0250000
NODE_52292_length_460_cov_172.986150	41	121	758	1	80	0.0125000
NODE_52292_length_460_cov_172.986150	41	121	763	2	80	0.0250000
NODE_52292_length_460_cov_172.986150	41	121	765	1	80	0.0125000
NODE_52292_length_460_cov_172.986150	41	121	771	1	80	0.0125000
NODE_52292_length_460_cov_172.986150	41	121	777	1	80	0.0125000
NODE_52292_length_460_cov_172.986150	41	121	778	1	80	0.0125000
NODE_52292_length_460_cov_172.986150	41	121	780	1	80	0.0125000
NODE_52292_length_460_cov_172.986150	41	121	783	2	80	0.0250000
NODE_52292_length_460_cov_172.986150	41	121	788	1	80	0.0125000
NODE_52292_length_460_cov_172.986150	41	121	791	1	80	0.0125000
NODE_52292_length_460_cov_172.986150	41	121	793	1	80	0.0125000
NODE_52292_length_460_cov_172.986150	41	121	795	1	80	0.0125000
NODE_52292_length_460_cov_172.986150	41	121	799	1	80	0.0125000
NODE_52292_length_460_cov_172.986150	41	121	815	1	80	0.0125000
NODE_52292_length_460_cov_172.986150	41	121	818	1	80	0.0125000
NODE_52292_length_460_cov_172.986150	41	121	824	1	80	0.0125000
NODE_52292_length_460_cov_172.986150	41	121	837	1	80	0.0125000
NODE_52292_length_460_cov_172.986150	41	121	842	1	80	0.0125000
NODE_52292_length_460_cov_172.986150	41	121	844	1	80	0.0125000
NODE_52292_length_460_cov_172.986150	41	121	846	1	80	0.0125000
NODE_52292_length_460_cov_172.986150	41	121	850	1	80	0.0125000
NODE_52292_length_460_cov_172.986150	41	121	855	1	80	0.0125000
NODE_52292_length_460_cov_172.986150	41	121	857	1	80	0.0125000
NODE_52292_length_460_cov_172.986150	41	121	863	1	80	0.0125000
NODE_52292_length_460_cov_172.986150	41	121	869	1	80	0.0125000
NODE_52292_length_460_cov_172.986150	41	121	885	1	80	0.0125000
NODE_52292_length_460_cov_172.986150	41	121	891	1	80	0.0125000
NODE_52292_length_460_cov_172.986150	41	121	892	1	80	0.0125000
NODE_52292_length_460_cov_172.986150	41	121	894	1	80	0.0125000
NODE_52292_length_460_cov_172.986150	41	121	895	1	80	0.0125000
NODE_52292_length_460_cov_172.986150	41	121	896	1	80	0.0125000
NODE_52292_length_460_cov_172.986150	41	121	899	2	80	0.0250000
NODE_52292_length_460_cov_172.986150	41	121	901	2	80	0.0250000
NODE_52292_length_460_cov_172.986150	41	121	903	2	80	0.0250000
NODE_52292_length_460_cov_172.986150	41	121	904	2	80	0.0250000
NODE_52292_length_460_cov_172.986150	41	121	905	1	80	0.0125000
NODE_52292_length_460_cov_172.986150	41	121	909	1	80	0.0125000
NODE_52292_length_460_cov_172.986150	41	121	911	4	80	0.0500000
NODE_52292_length_460_cov_172.986150	41	121	912	1	80	0.0125000
NODE_52292_length_460_cov_172.986150	41	121	914	1	80	0.0125000
NODE_52292_length_460_cov_172.986150	41	121	915	1	80	0.0125000
NODE_52292_length_460_cov_172.986150	41	121	922	1	80	0.0125000
NODE_52292_length_460_cov_172.986150	41	121	924	1	80	0.0125000
NODE_52292_length_460_cov_172.986150	41	121	932	1	80	0.0125000
NODE_52292_length_460_cov_172.986150	41	121	934	2	80	0.0250000
NODE_52293_length_460_cov_62.512465	9	48	8	8	39	0.2051282
NODE_52293_length_460_cov_62.512465	9	48	11	3	39	0.0769231
NODE_52293_length_460_cov_62.512465	9	48	13	4	39	0.1025641
NODE_52293_length_460_cov_62.512465	9	48	15	5	39	0.1282051
NODE_52293_length_460_cov_62.512465	9	48	16	2	39	0.0512821
NODE_52293_length_460_cov_62.512465	9	48	17	8	39	0.2051282
NODE_52293_length_460_cov_62.512465	9	48	18	5	39	0.1282051
NODE_52293_length_460_cov_62.512465	9	48	19	4	39	0.1025641
NODE_52294_length_460_cov_33.146814	0	47	0	47	47	1.0000000
NODE_52294_length_460_cov_33.146814	43	115	0	72	72	1.0000000
NODE_52294_length_460_cov_33.146814	96	165	0	69	69	1.0000000
NODE_52295_length_460_cov_26.049861	0	63	0	5	63	0.0793651
NODE_52295_length_460_cov_26.049861	0	63	2	16	63	0.2539683
NODE_52295_length_460_cov_26.049861	0	63	6	14	63	0.2222222
NODE_52295_length_460_cov_26.049861	0	63	8	11	63	0.1746032
NODE_52295_length_460_cov_26.049861	0	63	10	1	63	0.0158730
NODE_52295_length_460_cov_26.049861	0	63	12	1	63	0.0158730
NODE_52295_length_460_cov_26.049861	0	63	22	15	63	0.2380952
NODE_52296_length_460_cov_25.709141	246	326	0	80	80	1.0000000
NODE_52296_length_460_cov_25.709141	299	379	0	80	80	1.0000000
NODE_52297_length_460_cov_11.063712	273	353	0	80	80	1.0000000
NODE_52297_length_460_cov_11.063712	326	406	0	80	80	1.0000000
NODE_52303_length_460_cov_7.285319	172	250	0	78	78	1.0000000
NODE_52312_length_460_cov_5.163435	120	200	0	23	80	0.2875000
NODE_52312_length_460_cov_5.163435	120	200	1	14	80	0.1750000
NODE_52312_length_460_cov_5.163435	120	200	2	43	80	0.5375000
NODE_52312_length_460_cov_5.163435	173	253	2	80	80	1.0000000
NODE_52333_length_460_cov_3.457064	150	230	0	80	80	1.0000000
NODE_52333_length_460_cov_3.457064	203	246	0	43	43	1.0000000
NODE_52339_length_460_cov_3.027701	167	230	0	63	63	1.0000000
NODE_52347_length_460_cov_2.819945	195	266	0	14	71	0.1971831
NODE_52347_length_460_cov_2.819945	195	266	2	7	71	0.0985916
NODE_52347_length_460_cov_2.819945	195	266	4	2	71	0.0281690
NODE_52347_length_460_cov_2.819945	195	266	6	48	71	0.6760563
NODE_52358_length_460_cov_2.626039	223	277	2	54	54	1.0000000
NODE_52612_length_459_cov_34.927778	165	239	0	10	74	0.1351351
NODE_52612_length_459_cov_34.927778	165	239	2	64	74	0.8648649
NODE_52612_length_459_cov_34.927778	212	292	0	35	80	0.4375000
NODE_52612_length_459_cov_34.927778	212	292	2	45	80	0.5625000
NODE_52617_length_459_cov_7.261111	143	189	0	10	46	0.2173913
NODE_52617_length_459_cov_7.261111	143	189	4	26	46	0.5652174
NODE_52617_length_459_cov_7.261111	143	189	8	10	46	0.2173913
NODE_52617_length_459_cov_7.261111	162	242	4	25	80	0.3125000
NODE_52617_length_459_cov_7.261111	162	242	8	55	80	0.6875000
NODE_52635_length_459_cov_4.127778	153	233	8	80	80	1.0000000
NODE_52685_length_459_cov_2.158333	219	285	0	66	66	1.0000000
NODE_52685_length_459_cov_2.158333	283	342	0	59	59	1.0000000
NODE_52704_length_459_cov_1.722222	280	353	0	66	73	0.9041096
NODE_52704_length_459_cov_1.722222	280	353	2	7	73	0.0958904
NODE_52920_length_458_cov_71.047354	0	51	0	51	51	1.0000000
NODE_52920_length_458_cov_71.047354	24	104	0	80	80	1.0000000
NODE_52920_length_458_cov_71.047354	100	180	0	46	80	0.5750000
NODE_52920_length_458_cov_71.047354	100	180	2	34	80	0.4250000
NODE_52920_length_458_cov_71.047354	153	233	0	11	80	0.1375000
NODE_52920_length_458_cov_71.047354	153	233	2	69	80	0.8625000
NODE_52921_length_458_cov_47.966574	151	231	0	80	80	1.0000000
NODE_52921_length_458_cov_47.966574	204	284	0	78	80	0.9750000
NODE_52921_length_458_cov_47.966574	204	284	2	2	80	0.0250000
NODE_52921_length_458_cov_47.966574	280	360	0	2	80	0.0250000
NODE_52921_length_458_cov_47.966574	280	360	2	78	80	0.9750000
NODE_52921_length_458_cov_47.966574	333	413	0	31	80	0.3875000
NODE_52921_length_458_cov_47.966574	333	413	2	49	80	0.6125000
NODE_52924_length_458_cov_9.935933	267	347	4	25	80	0.3125000
NODE_52924_length_458_cov_9.935933	267	347	6	14	80	0.1750000
NODE_52924_length_458_cov_9.935933	267	347	8	41	80	0.5125000
NODE_52924_length_458_cov_9.935933	320	400	0	18	80	0.2250000
NODE_52924_length_458_cov_9.935933	320	400	4	3	80	0.0375000
NODE_52924_length_458_cov_9.935933	320	400	6	24	80	0.3000000
NODE_52924_length_458_cov_9.935933	320	400	8	35	80	0.4375000
NODE_52929_length_458_cov_7.598886	87	167	0	80	80	1.0000000
NODE_52967_length_458_cov_3.061281	62	91	4	29	29	1.0000000
NODE_52967_length_458_cov_3.061281	185	224	0	8	39	0.2051282
NODE_52967_length_458_cov_3.061281	185	224	2	3	39	0.0769231
NODE_52967_length_458_cov_3.061281	185	224	4	28	39	0.7179487
NODE_52992_length_458_cov_2.454039	210	251	8	41	41	1.0000000
NODE_53107_length_458_cov_1.139276	242	289	4	5	47	0.1063830
NODE_53107_length_458_cov_1.139276	242	289	6	27	47	0.5744681
NODE_53107_length_458_cov_1.139276	242	289	8	15	47	0.3191489
NODE_53107_length_458_cov_1.139276	262	328	4	37	66	0.5606061
NODE_53107_length_458_cov_1.139276	262	328	6	13	66	0.1969697
NODE_53107_length_458_cov_1.139276	262	328	8	16	66	0.2424242
NODE_53205_length_457_cov_20.754190	123	203	0	19	80	0.2375000
NODE_53205_length_457_cov_20.754190	123	203	2	61	80	0.7625000
NODE_53205_length_457_cov_20.754190	176	256	2	34	80	0.4250000
NODE_53205_length_457_cov_20.754190	176	256	4	46	80	0.5750000
NODE_53207_length_457_cov_13.918994	218	298	0	80	80	1.0000000
NODE_53207_length_457_cov_13.918994	218	298	0	80	80	1.0000000
NODE_53207_length_457_cov_13.918994	218	298	0	80	80	1.0000000
NODE_53207_length_457_cov_13.918994	218	298	0	80	80	1.0000000
NODE_53207_length_457_cov_13.918994	271	320	0	49	49	1.0000000
NODE_53207_length_457_cov_13.918994	271	320	0	49	49	1.0000000
NODE_53207_length_457_cov_13.918994	271	320	0	49	49	1.0000000
NODE_53216_length_457_cov_6.050279	264	326	2	62	62	1.0000000
NODE_53220_length_457_cov_5.078212	71	149	0	78	78	1.0000000
NODE_53220_length_457_cov_5.078212	122	202	0	80	80	1.0000000
NODE_53225_length_457_cov_4.530726	193	273	0	30	80	0.3750000
NODE_53225_length_457_cov_4.530726	193	273	2	22	80	0.2750000
NODE_53225_length_457_cov_4.530726	193	273	4	28	80	0.3500000
NODE_53225_length_457_cov_4.530726	246	315	2	8	69	0.1159420
NODE_53225_length_457_cov_4.530726	246	315	4	61	69	0.8840580
NODE_53230_length_457_cov_3.986034	192	272	0	80	80	1.0000000
NODE_53267_length_457_cov_2.636872	117	197	0	42	80	0.5250000
NODE_53267_length_457_cov_2.636872	117	197	2	38	80	0.4750000
NODE_53462_length_457_cov_0.916201	108	188	0	80	80	1.0000000
NODE_53462_length_457_cov_0.916201	108	188	0	80	80	1.0000000
NODE_53462_length_457_cov_0.916201	161	241	0	80	80	1.0000000
NODE_53462_length_457_cov_0.916201	161	241	0	80	80	1.0000000
NODE_53512_length_456_cov_34.731092	0	63	0	63	63	1.0000000
NODE_53512_length_456_cov_34.731092	36	116	0	80	80	1.0000000
NODE_53512_length_456_cov_34.731092	112	194	0	82	82	1.0000000
NODE_53532_length_456_cov_4.582633	269	349	0	80	80	1.0000000
NODE_53533_length_456_cov_4.554622	124	206	0	82	82	1.0000000
NODE_53533_length_456_cov_4.554622	179	263	0	38	84	0.4523810
NODE_53533_length_456_cov_4.554622	179	263	2	46	84	0.5476190
NODE_53546_length_456_cov_3.669468	123	186	2	9	63	0.1428571
NODE_53546_length_456_cov_3.669468	123	186	6	54	63	0.8571429
NODE_53566_length_456_cov_2.921569	302	362	0	57	60	0.9500000
NODE_53566_length_456_cov_2.921569	302	362	2	3	60	0.0500000
NODE_53859_length_455_cov_113.589888	137	220	2	24	83	0.2891566
NODE_53859_length_455_cov_113.589888	137	220	4	5	83	0.0602410
NODE_53859_length_455_cov_113.589888	137	220	6	4	83	0.0481928
NODE_53859_length_455_cov_113.589888	137	220	8	12	83	0.1445783
NODE_53859_length_455_cov_113.589888	137	220	10	38	83	0.4578313
NODE_53859_length_455_cov_113.589888	198	268	0	46	70	0.6571429
NODE_53859_length_455_cov_113.589888	198	268	2	24	70	0.3428572
NODE_53859_length_455_cov_113.589888	269	348	0	45	79	0.5696203
NODE_53859_length_455_cov_113.589888	269	348	6	34	79	0.4303797
NODE_53859_length_455_cov_113.589888	321	401	6	80	80	1.0000000
NODE_53860_length_455_cov_52.941011	260	340	0	64	80	0.8000000
NODE_53860_length_455_cov_52.941011	260	340	2	16	80	0.2000000
NODE_53860_length_455_cov_52.941011	313	393	0	80	80	1.0000000
NODE_53863_length_455_cov_8.584270	250	302	0	52	52	1.0000000
NODE_53863_length_455_cov_8.584270	275	355	0	80	80	1.0000000
NODE_53864_length_455_cov_8.084270	146	226	0	21	80	0.2625000
NODE_53864_length_455_cov_8.084270	146	226	4	4	80	0.0500000
NODE_53864_length_455_cov_8.084270	146	226	8	1	80	0.0125000
NODE_53864_length_455_cov_8.084270	146	226	10	1	80	0.0125000
NODE_53864_length_455_cov_8.084270	146	226	14	1	80	0.0125000
NODE_53864_length_455_cov_8.084270	146	226	18	8	80	0.1000000
NODE_53864_length_455_cov_8.084270	146	226	20	44	80	0.5500000
NODE_53864_length_455_cov_8.084270	199	279	0	74	80	0.9250000
NODE_53864_length_455_cov_8.084270	199	279	4	4	80	0.0500000
NODE_53864_length_455_cov_8.084270	199	279	8	1	80	0.0125000
NODE_53864_length_455_cov_8.084270	199	279	10	1	80	0.0125000
NODE_53870_length_455_cov_6.022472	122	203	0	9	81	0.1111111
NODE_53870_length_455_cov_6.022472	122	203	3	10	81	0.1234568
NODE_53870_length_455_cov_6.022472	122	203	6	5	81	0.0617284
NODE_53870_length_455_cov_6.022472	122	203	7	10	81	0.1234568
NODE_53870_length_455_cov_6.022472	122	203	9	4	81	0.0493827
NODE_53870_length_455_cov_6.022472	122	203	13	36	81	0.4444444
NODE_53870_length_455_cov_6.022472	122	203	15	4	81	0.0493827
NODE_53870_length_455_cov_6.022472	122	203	16	3	81	0.0370370
NODE_53872_length_455_cov_5.140449	181	232	0	8	51	0.1568628
NODE_53872_length_455_cov_5.140449	181	232	3	3	51	0.0588235
NODE_53872_length_455_cov_5.140449	181	232	4	40	51	0.7843137
NODE_54512_length_453_cov_29.528249	44	124	0	80	80	1.0000000
NODE_54512_length_453_cov_29.528249	97	177	0	80	80	1.0000000
NODE_54512_length_453_cov_29.528249	173	253	0	80	80	1.0000000
NODE_54512_length_453_cov_29.528249	226	301	0	75	75	1.0000000
NODE_54513_length_453_cov_11.146893	95	140	0	45	45	1.0000000
NODE_54513_length_453_cov_11.146893	146	220	0	64	74	0.8648649
NODE_54513_length_453_cov_11.146893	146	220	2	10	74	0.1351351
NODE_54517_length_453_cov_7.709040	194	252	0	8	58	0.1379310
NODE_54517_length_453_cov_7.709040	194	252	4	7	58	0.1206897
NODE_54517_length_453_cov_7.709040	194	252	6	43	58	0.7413793
NODE_54518_length_453_cov_7.440678	250	319	0	51	69	0.7391304
NODE_54518_length_453_cov_7.440678	250	319	2	18	69	0.2608696
NODE_54533_length_453_cov_4.282486	190	270	0	80	80	1.0000000
NODE_54533_length_453_cov_4.282486	243	283	0	40	40	1.0000000
NODE_54566_length_453_cov_2.836158	186	266	2	80	80	1.0000000
NODE_54566_length_453_cov_2.836158	239	319	0	51	80	0.6375000
NODE_54566_length_453_cov_2.836158	239	319	2	29	80	0.3625000
NODE_54592_length_453_cov_2.048023	139	174	3	5	35	0.1428571
NODE_54592_length_453_cov_2.048023	139	174	4	7	35	0.2000000
NODE_54592_length_453_cov_2.048023	139	174	5	5	35	0.1428571
NODE_54592_length_453_cov_2.048023	139	174	7	7	35	0.2000000
NODE_54592_length_453_cov_2.048023	139	174	8	6	35	0.1714286
NODE_54592_length_453_cov_2.048023	139	174	10	5	35	0.1428571
NODE_54600_length_453_cov_2.002825	78	98	0	20	20	1.0000000
NODE_54767_length_453_cov_0.774011	174	195	0	21	21	1.0000000
NODE_54822_length_452_cov_36.028329	0	72	0	6	72	0.0833333
NODE_54822_length_452_cov_36.028329	0	72	2	4	72	0.0555556
NODE_54822_length_452_cov_36.028329	0	72	4	37	72	0.5138889
NODE_54822_length_452_cov_36.028329	0	72	7	4	72	0.0555556
NODE_54822_length_452_cov_36.028329	0	72	8	21	72	0.2916667
NODE_54822_length_452_cov_36.028329	0	72	0	6	72	0.0833333
NODE_54822_length_452_cov_36.028329	0	72	2	4	72	0.0555556
NODE_54822_length_452_cov_36.028329	0	72	4	37	72	0.5138889
NODE_54822_length_452_cov_36.028329	0	72	7	4	72	0.0555556
NODE_54822_length_452_cov_36.028329	0	72	8	21	72	0.2916667
NODE_54822_length_452_cov_36.028329	45	99	4	2	54	0.0370370
NODE_54822_length_452_cov_36.028329	45	99	7	4	54	0.0740741
NODE_54822_length_452_cov_36.028329	45	99	8	48	54	0.8888889
NODE_54822_length_452_cov_36.028329	45	125	4	7	80	0.0875000
NODE_54822_length_452_cov_36.028329	45	125	7	4	80	0.0500000
NODE_54822_length_452_cov_36.028329	45	125	8	69	80	0.8625000
NODE_54823_length_452_cov_17.424929	29	109	0	80	80	1.0000000
NODE_54823_length_452_cov_17.424929	82	162	0	80	80	1.0000000
NODE_54844_length_452_cov_4.317280	141	200	2	19	59	0.3220339
NODE_54844_length_452_cov_4.317280	141	200	4	40	59	0.6779661
NODE_54886_length_452_cov_2.634561	262	338	0	76	76	1.0000000
NODE_55146_length_451_cov_37.090909	230	310	0	54	80	0.6750000
NODE_55146_length_451_cov_37.090909	230	310	2	25	80	0.3125000
NODE_55146_length_451_cov_37.090909	230	310	4	1	80	0.0125000
NODE_55146_length_451_cov_37.090909	283	363	0	1	80	0.0125000
NODE_55146_length_451_cov_37.090909	283	363	2	25	80	0.3125000
NODE_55146_length_451_cov_37.090909	283	363	4	54	80	0.6750000
NODE_55147_length_451_cov_16.517045	205	286	1	23	81	0.2839506
NODE_55147_length_451_cov_16.517045	205	286	2	58	81	0.7160494
NODE_55147_length_451_cov_16.517045	259	339	0	51	80	0.6375000
NODE_55147_length_451_cov_16.517045	259	339	1	25	80	0.3125000
NODE_55147_length_451_cov_16.517045	259	339	2	4	80	0.0500000
NODE_55148_length_451_cov_13.153409	182	262	0	80	80	1.0000000
NODE_55148_length_451_cov_13.153409	235	315	0	80	80	1.0000000
NODE_55149_length_451_cov_11.926136	141	221	6	5	80	0.0625000
NODE_55149_length_451_cov_11.926136	141	221	8	16	80	0.2000000
NODE_55149_length_451_cov_11.926136	141	221	12	45	80	0.5625000
NODE_55149_length_451_cov_11.926136	141	221	14	14	80	0.1750000
NODE_55149_length_451_cov_11.926136	331	411	2	9	80	0.1125000
NODE_55149_length_451_cov_11.926136	331	411	4	15	80	0.1875000
NODE_55149_length_451_cov_11.926136	331	411	6	3	80	0.0375000
NODE_55149_length_451_cov_11.926136	331	411	8	50	80	0.6250000
NODE_55149_length_451_cov_11.926136	331	411	12	3	80	0.0375000
NODE_55154_length_451_cov_7.102273	81	143	0	62	62	1.0000000
NODE_55161_length_451_cov_5.610795	1	31	0	30	30	1.0000000
NODE_55161_length_451_cov_5.610795	60	90	0	30	30	1.0000000
NODE_55166_length_451_cov_5.065341	219	285	0	19	66	0.2878788
NODE_55166_length_451_cov_5.065341	219	285	2	9	66	0.1363636
NODE_55166_length_451_cov_5.065341	219	285	4	11	66	0.1666667
NODE_55166_length_451_cov_5.065341	219	285	6	27	66	0.4090909
NODE_55166_length_451_cov_5.065341	272	322	0	50	50	1.0000000
NODE_55184_length_451_cov_3.696023	253	332	8	4	79	0.0506329
NODE_55184_length_451_cov_3.696023	253	332	10	6	79	0.0759494
NODE_55184_length_451_cov_3.696023	253	332	12	5	79	0.0632911
NODE_55184_length_451_cov_3.696023	253	332	14	21	79	0.2658228
NODE_55184_length_451_cov_3.696023	253	332	16	9	79	0.1139240
NODE_55184_length_451_cov_3.696023	253	332	20	7	79	0.0886076
NODE_55184_length_451_cov_3.696023	253	332	22	2	79	0.0253165
NODE_55184_length_451_cov_3.696023	253	332	24	5	79	0.0632911
NODE_55184_length_451_cov_3.696023	253	332	26	2	79	0.0253165
NODE_55184_length_451_cov_3.696023	253	332	28	3	79	0.0379747
NODE_55184_length_451_cov_3.696023	253	332	30	15	79	0.1898734
NODE_55188_length_451_cov_3.406250	176	247	16	8	71	0.1126761
NODE_55188_length_451_cov_3.406250	176	247	18	7	71	0.0985916
NODE_55188_length_451_cov_3.406250	176	247	19	3	71	0.0422535
NODE_55188_length_451_cov_3.406250	176	247	20	30	71	0.4225352
NODE_55188_length_451_cov_3.406250	176	247	21	9	71	0.1267606
NODE_55188_length_451_cov_3.406250	176	247	22	14	71	0.1971831
NODE_55188_length_451_cov_3.406250	220	300	4	22	80	0.2750000
NODE_55188_length_451_cov_3.406250	220	300	8	3	80	0.0375000
NODE_55188_length_451_cov_3.406250	220	300	10	1	80	0.0125000
NODE_55188_length_451_cov_3.406250	220	300	11	2	80	0.0250000
NODE_55188_length_451_cov_3.406250	220	300	13	6	80	0.0750000
NODE_55188_length_451_cov_3.406250	220	300	15	3	80	0.0375000
NODE_55188_length_451_cov_3.406250	220	300	20	20	80	0.2500000
NODE_55188_length_451_cov_3.406250	220	300	22	16	80	0.2000000
NODE_55188_length_451_cov_3.406250	220	300	24	7	80	0.0875000
NODE_55198_length_451_cov_3.025568	72	148	0	16	76	0.2105263
NODE_55198_length_451_cov_3.025568	72	148	2	41	76	0.5394737
NODE_55198_length_451_cov_3.025568	72	148	4	19	76	0.2500000
NODE_55213_length_451_cov_2.607955	84	143	0	59	59	1.0000000
NODE_55213_length_451_cov_2.607955	257	326	0	69	69	1.0000000
NODE_55234_length_451_cov_2.125000	156	224	0	68	68	1.0000000
NODE_55436_length_450_cov_105.723647	317	386	4	69	69	1.0000000
NODE_55438_length_450_cov_27.982906	98	120	0	22	22	1.0000000
NODE_55438_length_450_cov_27.982906	225	305	0	80	80	1.0000000
NODE_55438_length_450_cov_27.982906	278	358	0	80	80	1.0000000
NODE_55459_length_450_cov_3.991453	220	290	0	70	70	1.0000000
NODE_55459_length_450_cov_3.991453	223	290	0	67	67	1.0000000
NODE_55459_length_450_cov_3.991453	268	348	0	80	80	1.0000000
NODE_55459_length_450_cov_3.991453	268	348	0	80	80	1.0000000
NODE_55459_length_450_cov_3.991453	278	348	0	70	70	1.0000000
NODE_55459_length_450_cov_3.991453	344	363	0	19	19	1.0000000
NODE_55466_length_450_cov_3.717949	107	177	0	70	70	1.0000000
NODE_55483_length_450_cov_3.162393	99	157	2	58	58	1.0000000
NODE_55550_length_450_cov_1.857550	114	172	4	15	58	0.2586207
NODE_55550_length_450_cov_1.857550	114	172	6	5	58	0.0862069
NODE_55550_length_450_cov_1.857550	114	172	8	22	58	0.3793103
NODE_55550_length_450_cov_1.857550	114	172	10	16	58	0.2758621
NODE_55560_length_450_cov_1.749288	321	376	0	55	55	1.0000000
NODE_55565_length_450_cov_1.723647	101	161	16	17	60	0.2833333
NODE_55565_length_450_cov_1.723647	101	161	20	2	60	0.0333333
NODE_55565_length_450_cov_1.723647	101	161	23	3	60	0.0500000
NODE_55565_length_450_cov_1.723647	101	161	26	3	60	0.0500000
NODE_55565_length_450_cov_1.723647	101	161	28	1	60	0.0166667
NODE_55565_length_450_cov_1.723647	101	161	30	3	60	0.0500000
NODE_55565_length_450_cov_1.723647	101	161	34	5	60	0.0833333
NODE_55565_length_450_cov_1.723647	101	161	36	24	60	0.4000000
NODE_55565_length_450_cov_1.723647	101	161	38	2	60	0.0333333
NODE_55685_length_450_cov_1.017094	116	196	2	6	80	0.0750000
NODE_55685_length_450_cov_1.017094	116	196	4	25	80	0.3125000
NODE_55685_length_450_cov_1.017094	116	196	6	49	80	0.6125000
NODE_55761_length_449_cov_46.882857	237	317	0	80	80	1.0000000
NODE_55761_length_449_cov_46.882857	290	370	0	80	80	1.0000000
NODE_55762_length_449_cov_36.031429	238	318	0	80	80	1.0000000
NODE_55762_length_449_cov_36.031429	291	371	0	80	80	1.0000000
NODE_55783_length_449_cov_4.594286	137	184	2	10	47	0.2127660
NODE_55783_length_449_cov_4.594286	137	184	6	8	47	0.1702128
NODE_55783_length_449_cov_4.594286	137	184	8	29	47	0.6170213
NODE_55794_length_449_cov_3.797143	204	284	2	2	80	0.0250000
NODE_55794_length_449_cov_3.797143	204	284	3	39	80	0.4875000
NODE_55794_length_449_cov_3.797143	204	284	4	15	80	0.1875000
NODE_55794_length_449_cov_3.797143	204	284	6	17	80	0.2125000
NODE_55794_length_449_cov_3.797143	204	284	8	7	80	0.0875000
NODE_55844_length_449_cov_2.445714	346	376	0	9	30	0.3000000
NODE_55844_length_449_cov_2.445714	346	376	2	21	30	0.7000000
NODE_56144_length_448_cov_44.664756	126	206	0	80	80	1.0000000
NODE_56144_length_448_cov_44.664756	179	259	0	80	80	1.0000000
NODE_56145_length_448_cov_36.148997	195	275	0	80	80	1.0000000
NODE_56145_length_448_cov_36.148997	248	328	0	80	80	1.0000000
NODE_56145_length_448_cov_36.148997	324	404	0	10	80	0.1250000
NODE_56145_length_448_cov_36.148997	324	404	3	1	80	0.0125000
NODE_56145_length_448_cov_36.148997	324	404	4	69	80	0.8625000
NODE_56145_length_448_cov_36.148997	377	448	0	20	71	0.2816902
NODE_56145_length_448_cov_36.148997	377	448	3	1	71	0.0140845
NODE_56145_length_448_cov_36.148997	377	448	4	50	71	0.7042254
NODE_56146_length_448_cov_31.816619	43	123	0	3	80	0.0375000
NODE_56146_length_448_cov_31.816619	43	123	1	46	80	0.5750000
NODE_56146_length_448_cov_31.816619	43	123	2	31	80	0.3875000
NODE_56151_length_448_cov_6.779370	197	277	0	33	80	0.4125000
NODE_56151_length_448_cov_6.779370	197	277	4	47	80	0.5875000
NODE_56151_length_448_cov_6.779370	250	313	0	6	63	0.0952381
NODE_56151_length_448_cov_6.779370	250	313	4	57	63	0.9047619
NODE_56180_length_448_cov_3.664756	148	189	4	41	41	1.0000000
NODE_56189_length_448_cov_3.108883	242	324	0	10	82	0.1219512
NODE_56189_length_448_cov_3.108883	242	324	2	56	82	0.6829268
NODE_56189_length_448_cov_3.108883	242	324	4	16	82	0.1951219
NODE_56233_length_448_cov_2.263610	292	360	0	68	68	1.0000000
NODE_56518_length_447_cov_10.505747	205	234	0	29	29	1.0000000
NODE_56518_length_447_cov_10.505747	267	326	0	59	59	1.0000000
NODE_56518_length_447_cov_10.505747	299	379	0	80	80	1.0000000
NODE_56527_length_447_cov_5.767241	176	256	0	2	80	0.0250000
NODE_56527_length_447_cov_5.767241	176	256	6	13	80	0.1625000
NODE_56527_length_447_cov_5.767241	176	256	8	65	80	0.8125000
NODE_56527_length_447_cov_5.767241	229	309	0	55	80	0.6875000
NODE_56527_length_447_cov_5.767241	229	309	6	13	80	0.1625000
NODE_56527_length_447_cov_5.767241	229	309	8	12	80	0.1500000
NODE_56539_length_447_cov_4.583333	265	289	0	10	24	0.4166667
NODE_56539_length_447_cov_4.583333	265	289	1	14	24	0.5833333
NODE_56545_length_447_cov_4.037356	58	138	0	50	80	0.6250000
NODE_56545_length_447_cov_4.037356	58	138	2	30	80	0.3750000
NODE_56545_length_447_cov_4.037356	111	191	0	80	80	1.0000000
NODE_56890_length_446_cov_42.527378	239	310	8	8	71	0.1126761
NODE_56890_length_446_cov_42.527378	239	310	10	1	71	0.0140845
NODE_56890_length_446_cov_42.527378	239	310	12	23	71	0.3239437
NODE_56890_length_446_cov_42.527378	239	310	16	1	71	0.0140845
NODE_56890_length_446_cov_42.527378	239	310	26	2	71	0.0281690
NODE_56890_length_446_cov_42.527378	239	310	28	23	71	0.3239437
NODE_56890_length_446_cov_42.527378	239	310	32	3	71	0.0422535
NODE_56890_length_446_cov_42.527378	239	310	38	4	71	0.0563380
NODE_56890_length_446_cov_42.527378	239	310	42	6	71	0.0845070
NODE_56890_length_446_cov_42.527378	359	433	4	2	74	0.0270270
NODE_56890_length_446_cov_42.527378	359	433	8	5	74	0.0675676
NODE_56890_length_446_cov_42.527378	359	433	13	1	74	0.0135135
NODE_56890_length_446_cov_42.527378	359	433	17	1	74	0.0135135
NODE_56890_length_446_cov_42.527378	359	433	22	2	74	0.0270270
NODE_56890_length_446_cov_42.527378	359	433	28	1	74	0.0135135
NODE_56890_length_446_cov_42.527378	359	433	29	1	74	0.0135135
NODE_56890_length_446_cov_42.527378	359	433	30	11	74	0.1486486
NODE_56890_length_446_cov_42.527378	359	433	32	12	74	0.1621622
NODE_56890_length_446_cov_42.527378	359	433	35	1	74	0.0135135
NODE_56890_length_446_cov_42.527378	359	433	36	2	74	0.0270270
NODE_56890_length_446_cov_42.527378	359	433	38	35	74	0.4729730
NODE_56891_length_446_cov_12.749280	92	172	4	8	80	0.1000000
NODE_56891_length_446_cov_12.749280	92	172	6	12	80	0.1500000
NODE_56891_length_446_cov_12.749280	92	172	8	21	80	0.2625000
NODE_56891_length_446_cov_12.749280	92	172	10	39	80	0.4875000
NODE_56891_length_446_cov_12.749280	145	225	2	4	80	0.0500000
NODE_56891_length_446_cov_12.749280	145	225	4	14	80	0.1750000
NODE_56891_length_446_cov_12.749280	145	225	6	14	80	0.1750000
NODE_56891_length_446_cov_12.749280	145	225	8	20	80	0.2500000
NODE_56891_length_446_cov_12.749280	145	225	10	28	80	0.3500000
NODE_56896_length_446_cov_6.902017	175	217	0	42	42	1.0000000
NODE_56902_length_446_cov_5.930836	165	245	0	80	80	1.0000000
NODE_56902_length_446_cov_5.930836	165	245	0	80	80	1.0000000
NODE_56902_length_446_cov_5.930836	165	235	0	70	70	1.0000000
NODE_56902_length_446_cov_5.930836	218	298	0	80	80	1.0000000
NODE_56902_length_446_cov_5.930836	218	297	0	79	79	1.0000000
NODE_56919_length_446_cov_3.896254	215	274	2	22	59	0.3728814
NODE_56919_length_446_cov_3.896254	215	274	3	3	59	0.0508475
NODE_56919_length_446_cov_3.896254	215	274	4	34	59	0.5762712
NODE_56934_length_446_cov_3.282421	130	168	0	38	38	1.0000000
NODE_56952_length_446_cov_2.775216	337	417	0	8	80	0.1000000
NODE_56952_length_446_cov_2.775216	337	417	2	15	80	0.1875000
NODE_56952_length_446_cov_2.775216	337	417	4	57	80	0.7125000
NODE_56995_length_446_cov_2.161383	17	97	0	80	80	1.0000000
NODE_57022_length_446_cov_1.907781	196	225	0	13	29	0.4482759
NODE_57022_length_446_cov_1.907781	196	225	2	16	29	0.5517241
NODE_57277_length_445_cov_75.572254	108	188	0	80	80	1.0000000
NODE_57277_length_445_cov_75.572254	161	241	0	80	80	1.0000000
NODE_57277_length_445_cov_75.572254	237	317	0	80	80	1.0000000
NODE_57277_length_445_cov_75.572254	290	370	0	80	80	1.0000000
NODE_57278_length_445_cov_33.973988	83	163	0	38	80	0.4750000
NODE_57278_length_445_cov_33.973988	83	163	7	1	80	0.0125000
NODE_57278_length_445_cov_33.973988	83	163	8	41	80	0.5125000
NODE_57278_length_445_cov_33.973988	136	216	8	80	80	1.0000000
NODE_57280_length_445_cov_9.323699	78	148	0	70	70	1.0000000
NODE_57280_length_445_cov_9.323699	121	201	0	80	80	1.0000000
NODE_57284_length_445_cov_6.439306	210	282	0	45	72	0.6250000
NODE_57284_length_445_cov_6.439306	210	282	2	27	72	0.3750000
NODE_57286_length_445_cov_5.479769	115	184	0	49	69	0.7101449
NODE_57286_length_445_cov_5.479769	115	184	2	20	69	0.2898551
NODE_57286_length_445_cov_5.479769	157	237	0	7	80	0.0875000
NODE_57286_length_445_cov_5.479769	157	237	2	73	80	0.9125000
NODE_57286_length_445_cov_5.479769	233	309	0	7	76	0.0921053
NODE_57286_length_445_cov_5.479769	233	309	2	69	76	0.9078947
NODE_57286_length_445_cov_5.479769	286	309	0	7	23	0.3043478
NODE_57286_length_445_cov_5.479769	286	309	2	16	23	0.6956522
NODE_57345_length_445_cov_2.843931	124	199	0	11	75	0.1466667
NODE_57345_length_445_cov_2.843931	124	199	2	41	75	0.5466667
NODE_57345_length_445_cov_2.843931	124	199	4	23	75	0.3066667
NODE_57352_length_445_cov_2.682081	202	248	3	2	46	0.0434783
NODE_57352_length_445_cov_2.682081	202	248	4	4	46	0.0869565
NODE_57352_length_445_cov_2.682081	202	248	6	40	46	0.8695652
NODE_57400_length_445_cov_1.884393	252	332	2	15	80	0.1875000
NODE_57400_length_445_cov_1.884393	252	332	4	65	80	0.8125000
NODE_57409_length_445_cov_1.783237	132	203	0	19	71	0.2676056
NODE_57409_length_445_cov_1.783237	132	203	2	52	71	0.7323943
NODE_57409_length_445_cov_1.783237	256	331	0	75	75	1.0000000
NODE_57409_length_445_cov_1.783237	256	278	0	22	22	1.0000000
NODE_57644_length_444_cov_34.075362	243	323	0	80	80	1.0000000
NODE_57644_length_444_cov_34.075362	296	376	0	80	80	1.0000000
NODE_57645_length_444_cov_22.524638	98	178	0	80	80	1.0000000
NODE_57645_length_444_cov_22.524638	151	231	0	27	80	0.3375000
NODE_57645_length_444_cov_22.524638	151	231	2	53	80	0.6625000
NODE_57646_length_444_cov_16.544928	263	343	0	80	80	1.0000000
NODE_57646_length_444_cov_16.544928	316	396	0	80	80	1.0000000
NODE_57647_length_444_cov_12.684058	293	373	2	19	80	0.2375000
NODE_57647_length_444_cov_12.684058	293	373	3	1	80	0.0125000
NODE_57647_length_444_cov_12.684058	293	373	4	60	80	0.7500000
NODE_57647_length_444_cov_12.684058	346	426	0	16	80	0.2000000
NODE_57647_length_444_cov_12.684058	346	426	2	2	80	0.0250000
NODE_57647_length_444_cov_12.684058	346	426	3	1	80	0.0125000
NODE_57647_length_444_cov_12.684058	346	426	4	61	80	0.7625000
NODE_57649_length_444_cov_9.284058	176	256	0	80	80	1.0000000
NODE_57649_length_444_cov_9.284058	229	309	0	80	80	1.0000000
NODE_57666_length_444_cov_5.159420	170	241	0	71	71	1.0000000
NODE_57668_length_444_cov_5.060870	201	245	0	44	44	1.0000000
NODE_57668_length_444_cov_5.060870	218	298	0	80	80	1.0000000
NODE_57717_length_444_cov_2.744928	73	136	2	63	63	1.0000000
NODE_57770_length_444_cov_2.028986	46	113	32	2	67	0.0298507
NODE_57770_length_444_cov_2.028986	46	113	34	1	67	0.0149254
NODE_57770_length_444_cov_2.028986	46	113	42	3	67	0.0447761
NODE_57770_length_444_cov_2.028986	46	113	46	1	67	0.0149254
NODE_57770_length_444_cov_2.028986	46	113	48	1	67	0.0149254
NODE_57770_length_444_cov_2.028986	46	113	55	1	67	0.0149254
NODE_57770_length_444_cov_2.028986	46	113	57	1	67	0.0149254
NODE_57770_length_444_cov_2.028986	46	113	62	1	67	0.0149254
NODE_57770_length_444_cov_2.028986	46	113	72	1	67	0.0149254
NODE_57770_length_444_cov_2.028986	46	113	74	1	67	0.0149254
NODE_57770_length_444_cov_2.028986	46	113	76	1	67	0.0149254
NODE_57770_length_444_cov_2.028986	46	113	90	3	67	0.0447761
NODE_57770_length_444_cov_2.028986	46	113	98	1	67	0.0149254
NODE_57770_length_444_cov_2.028986	46	113	101	1	67	0.0149254
NODE_57770_length_444_cov_2.028986	46	113	102	1	67	0.0149254
NODE_57770_length_444_cov_2.028986	46	113	104	2	67	0.0298507
NODE_57770_length_444_cov_2.028986	46	113	108	1	67	0.0149254
NODE_57770_length_444_cov_2.028986	46	113	110	1	67	0.0149254
NODE_57770_length_444_cov_2.028986	46	113	112	1	67	0.0149254
NODE_57770_length_444_cov_2.028986	46	113	116	1	67	0.0149254
NODE_57770_length_444_cov_2.028986	46	113	118	1	67	0.0149254
NODE_57770_length_444_cov_2.028986	46	113	120	2	67	0.0298507
NODE_57770_length_444_cov_2.028986	46	113	124	2	67	0.0298507
NODE_57770_length_444_cov_2.028986	46	113	126	1	67	0.0149254
NODE_57770_length_444_cov_2.028986	46	113	128	2	67	0.0298507
NODE_57770_length_444_cov_2.028986	46	113	130	1	67	0.0149254
NODE_57770_length_444_cov_2.028986	46	113	134	1	67	0.0149254
NODE_57770_length_444_cov_2.028986	46	113	136	1	67	0.0149254
NODE_57770_length_444_cov_2.028986	46	113	138	1	67	0.0149254
NODE_57770_length_444_cov_2.028986	46	113	145	1	67	0.0149254
NODE_57770_length_444_cov_2.028986	46	113	149	1	67	0.0149254
NODE_57770_length_444_cov_2.028986	46	113	151	1	67	0.0149254
NODE_57770_length_444_cov_2.028986	46	113	153	2	67	0.0298507
NODE_57770_length_444_cov_2.028986	46	113	159	2	67	0.0298507
NODE_57770_length_444_cov_2.028986	46	113	161	1	67	0.0149254
NODE_57770_length_444_cov_2.028986	46	113	163	1	67	0.0149254
NODE_57770_length_444_cov_2.028986	46	113	165	6	67	0.0895522
NODE_57770_length_444_cov_2.028986	46	113	171	1	67	0.0149254
NODE_57770_length_444_cov_2.028986	46	113	173	2	67	0.0298507
NODE_57770_length_444_cov_2.028986	46	113	175	3	67	0.0447761
NODE_57770_length_444_cov_2.028986	46	113	177	3	67	0.0447761
NODE_57770_length_444_cov_2.028986	46	113	179	1	67	0.0149254
NODE_57770_length_444_cov_2.028986	46	113	182	4	67	0.0597015
NODE_57770_length_444_cov_2.028986	86	166	107	1	80	0.0125000
NODE_57770_length_444_cov_2.028986	86	166	123	2	80	0.0250000
NODE_57770_length_444_cov_2.028986	86	166	127	1	80	0.0125000
NODE_57770_length_444_cov_2.028986	86	166	128	1	80	0.0125000
NODE_57770_length_444_cov_2.028986	86	166	130	1	80	0.0125000
NODE_57770_length_444_cov_2.028986	86	166	132	2	80	0.0250000
NODE_57770_length_444_cov_2.028986	86	166	139	1	80	0.0125000
NODE_57770_length_444_cov_2.028986	86	166	141	1	80	0.0125000
NODE_57770_length_444_cov_2.028986	86	166	143	1	80	0.0125000
NODE_57770_length_444_cov_2.028986	86	166	145	1	80	0.0125000
NODE_57770_length_444_cov_2.028986	86	166	147	1	80	0.0125000
NODE_57770_length_444_cov_2.028986	86	166	151	1	80	0.0125000
NODE_57770_length_444_cov_2.028986	86	166	152	1	80	0.0125000
NODE_57770_length_444_cov_2.028986	86	166	153	2	80	0.0250000
NODE_57770_length_444_cov_2.028986	86	166	159	2	80	0.0250000
NODE_57770_length_444_cov_2.028986	86	166	160	1	80	0.0125000
NODE_57770_length_444_cov_2.028986	86	166	161	1	80	0.0125000
NODE_57770_length_444_cov_2.028986	86	166	163	1	80	0.0125000
NODE_57770_length_444_cov_2.028986	86	166	164	1	80	0.0125000
NODE_57770_length_444_cov_2.028986	86	166	165	7	80	0.0875000
NODE_57770_length_444_cov_2.028986	86	166	166	1	80	0.0125000
NODE_57770_length_444_cov_2.028986	86	166	171	1	80	0.0125000
NODE_57770_length_444_cov_2.028986	86	166	173	2	80	0.0250000
NODE_57770_length_444_cov_2.028986	86	166	174	1	80	0.0125000
NODE_57770_length_444_cov_2.028986	86	166	175	3	80	0.0375000
NODE_57770_length_444_cov_2.028986	86	166	176	3	80	0.0375000
NODE_57770_length_444_cov_2.028986	86	166	177	3	80	0.0375000
NODE_57770_length_444_cov_2.028986	86	166	178	2	80	0.0250000
NODE_57770_length_444_cov_2.028986	86	166	179	1	80	0.0125000
NODE_57770_length_444_cov_2.028986	86	166	180	5	80	0.0625000
NODE_57770_length_444_cov_2.028986	86	166	182	6	80	0.0750000
NODE_57770_length_444_cov_2.028986	86	166	183	1	80	0.0125000
NODE_57770_length_444_cov_2.028986	86	166	184	4	80	0.0500000
NODE_57770_length_444_cov_2.028986	86	166	185	1	80	0.0125000
NODE_57770_length_444_cov_2.028986	86	166	186	3	80	0.0375000
NODE_57770_length_444_cov_2.028986	86	166	187	1	80	0.0125000
NODE_57770_length_444_cov_2.028986	86	166	188	9	80	0.1125000
NODE_57770_length_444_cov_2.028986	86	166	190	2	80	0.0250000
NODE_57770_length_444_cov_2.028986	86	166	192	1	80	0.0125000
NODE_57873_length_444_cov_1.234783	335	407	0	72	72	1.0000000
NODE_57892_length_444_cov_1.173913	7	87	2	80	80	1.0000000
NODE_58026_length_443_cov_71.284884	209	289	14	3	80	0.0375000
NODE_58026_length_443_cov_71.284884	209	289	15	2	80	0.0250000
NODE_58026_length_443_cov_71.284884	209	289	16	8	80	0.1000000
NODE_58026_length_443_cov_71.284884	209	289	18	8	80	0.1000000
NODE_58026_length_443_cov_71.284884	209	289	23	1	80	0.0125000
NODE_58026_length_443_cov_71.284884	209	289	24	11	80	0.1375000
NODE_58026_length_443_cov_71.284884	209	289	26	1	80	0.0125000
NODE_58026_length_443_cov_71.284884	209	289	32	10	80	0.1250000
NODE_58026_length_443_cov_71.284884	209	289	34	36	80	0.4500000
NODE_58026_length_443_cov_71.284884	262	342	2	3	80	0.0375000
NODE_58026_length_443_cov_71.284884	262	342	16	20	80	0.2500000
NODE_58026_length_443_cov_71.284884	262	342	24	1	80	0.0125000
NODE_58026_length_443_cov_71.284884	262	342	26	3	80	0.0375000
NODE_58026_length_443_cov_71.284884	262	342	29	9	80	0.1125000
NODE_58026_length_443_cov_71.284884	262	342	31	9	80	0.1125000
NODE_58026_length_443_cov_71.284884	262	342	32	11	80	0.1375000
NODE_58026_length_443_cov_71.284884	262	342	34	24	80	0.3000000
NODE_58026_length_443_cov_71.284884	338	418	0	57	80	0.7125000
NODE_58026_length_443_cov_71.284884	338	418	2	22	80	0.2750000
NODE_58026_length_443_cov_71.284884	338	418	16	1	80	0.0125000
NODE_58026_length_443_cov_71.284884	391	443	0	52	52	1.0000000
NODE_58027_length_443_cov_68.973837	314	394	0	16	80	0.2000000
NODE_58027_length_443_cov_68.973837	314	394	2	64	80	0.8000000
NODE_58027_length_443_cov_68.973837	367	443	0	38	76	0.5000000
NODE_58027_length_443_cov_68.973837	367	443	2	38	76	0.5000000
NODE_58028_length_443_cov_61.116279	34	114	0	26	80	0.3250000
NODE_58028_length_443_cov_61.116279	34	114	6	54	80	0.6750000
NODE_58028_length_443_cov_61.116279	87	167	6	80	80	1.0000000
NODE_58041_length_443_cov_4.895349	127	207	2	52	80	0.6500000
NODE_58041_length_443_cov_4.895349	127	207	9	10	80	0.1250000
NODE_58041_length_443_cov_4.895349	127	207	10	18	80	0.2250000
NODE_58086_length_443_cov_2.581395	121	195	2	65	74	0.8783784
NODE_58086_length_443_cov_2.581395	121	195	4	9	74	0.1216216
NODE_58088_length_443_cov_2.508721	297	347	0	50	50	1.0000000
NODE_58088_length_443_cov_2.508721	320	395	0	75	75	1.0000000
NODE_58091_length_443_cov_2.456395	114	192	4	2	78	0.0256410
NODE_58091_length_443_cov_2.456395	114	192	6	76	78	0.9743590
NODE_58091_length_443_cov_2.456395	118	141	6	23	23	1.0000000
NODE_58237_length_443_cov_1.151163	144	224	0	3	80	0.0375000
NODE_58237_length_443_cov_1.151163	144	224	2	9	80	0.1125000
NODE_58237_length_443_cov_1.151163	144	224	8	10	80	0.1250000
NODE_58237_length_443_cov_1.151163	144	224	14	58	80	0.7250000
NODE_58321_length_443_cov_0.715116	52	104	0	52	52	1.0000000
NODE_58321_length_443_cov_0.715116	105	146	0	41	41	1.0000000
NODE_58346_length_442_cov_42.956268	290	375	0	13	85	0.1529412
NODE_58346_length_442_cov_42.956268	290	375	6	6	85	0.0705882
NODE_58346_length_442_cov_42.956268	290	375	8	2	85	0.0235294
NODE_58346_length_442_cov_42.956268	290	375	10	1	85	0.0117647
NODE_58346_length_442_cov_42.956268	290	375	14	5	85	0.0588235
NODE_58346_length_442_cov_42.956268	290	375	20	1	85	0.0117647
NODE_58346_length_442_cov_42.956268	290	375	23	4	85	0.0470588
NODE_58346_length_442_cov_42.956268	290	375	25	13	85	0.1529412
NODE_58346_length_442_cov_42.956268	290	375	26	7	85	0.0823529
NODE_58346_length_442_cov_42.956268	290	375	27	3	85	0.0352941
NODE_58346_length_442_cov_42.956268	290	375	28	30	85	0.3529412
NODE_58346_length_442_cov_42.956268	290	375	0	13	85	0.1529412
NODE_58346_length_442_cov_42.956268	290	375	6	6	85	0.0705882
NODE_58346_length_442_cov_42.956268	290	375	8	2	85	0.0235294
NODE_58346_length_442_cov_42.956268	290	375	10	1	85	0.0117647
NODE_58346_length_442_cov_42.956268	290	375	14	5	85	0.0588235
NODE_58346_length_442_cov_42.956268	290	375	20	1	85	0.0117647
NODE_58346_length_442_cov_42.956268	290	375	23	4	85	0.0470588
NODE_58346_length_442_cov_42.956268	290	375	25	13	85	0.1529412
NODE_58346_length_442_cov_42.956268	290	375	26	7	85	0.0823529
NODE_58346_length_442_cov_42.956268	290	375	27	3	85	0.0352941
NODE_58346_length_442_cov_42.956268	290	375	28	30	85	0.3529412
NODE_58347_length_442_cov_24.093294	225	305	0	80	80	1.0000000
NODE_58347_length_442_cov_24.093294	278	358	0	32	80	0.4000000
NODE_58347_length_442_cov_24.093294	278	358	2	48	80	0.6000000
NODE_58348_length_442_cov_8.956268	173	192	0	19	19	1.0000000
NODE_58361_length_442_cov_5.052478	213	293	0	80	80	1.0000000
NODE_58361_length_442_cov_5.052478	266	346	0	80	80	1.0000000
NODE_58376_length_442_cov_3.871720	297	372	6	2	75	0.0266667
NODE_58376_length_442_cov_3.871720	297	372	10	2	75	0.0266667
NODE_58376_length_442_cov_3.871720	297	372	16	36	75	0.4800000
NODE_58376_length_442_cov_3.871720	297	372	17	35	75	0.4666667
NODE_58376_length_442_cov_3.871720	360	413	0	2	53	0.0377358
NODE_58376_length_442_cov_3.871720	360	413	2	2	53	0.0377358
NODE_58376_length_442_cov_3.871720	360	413	3	2	53	0.0377358
NODE_58376_length_442_cov_3.871720	360	413	5	2	53	0.0377358
NODE_58376_length_442_cov_3.871720	360	413	7	6	53	0.1132075
NODE_58376_length_442_cov_3.871720	360	413	8	11	53	0.2075472
NODE_58376_length_442_cov_3.871720	360	413	12	2	53	0.0377358
NODE_58376_length_442_cov_3.871720	360	413	17	26	53	0.4905660
NODE_58378_length_442_cov_3.804665	211	244	0	30	33	0.9090909
NODE_58378_length_442_cov_3.804665	211	244	4	2	33	0.0606061
NODE_58378_length_442_cov_3.804665	211	244	12	1	33	0.0303030
NODE_58405_length_442_cov_3.206997	149	217	6	14	68	0.2058824
NODE_58405_length_442_cov_3.206997	149	217	11	13	68	0.1911765
NODE_58405_length_442_cov_3.206997	149	217	12	41	68	0.6029412
NODE_58438_length_442_cov_2.434402	203	274	4	68	71	0.9577465
NODE_58438_length_442_cov_2.434402	203	274	6	1	71	0.0140845
NODE_58438_length_442_cov_2.434402	203	274	8	2	71	0.0281690
NODE_58438_length_442_cov_2.434402	247	327	4	24	80	0.3000000
NODE_58438_length_442_cov_2.434402	247	327	6	14	80	0.1750000
NODE_58438_length_442_cov_2.434402	247	327	8	42	80	0.5250000
NODE_58503_length_442_cov_1.746356	95	161	0	30	66	0.4545455
NODE_58503_length_442_cov_1.746356	95	161	2	36	66	0.5454546
NODE_58503_length_442_cov_1.746356	95	122	0	27	27	1.0000000
NODE_58759_length_441_cov_21.877193	28	108	0	80	80	1.0000000
NODE_58759_length_441_cov_21.877193	81	161	0	29	80	0.3625000
NODE_58759_length_441_cov_21.877193	81	161	4	51	80	0.6375000
NODE_58760_length_441_cov_13.546784	152	232	0	44	80	0.5500000
NODE_58760_length_441_cov_13.546784	152	232	2	36	80	0.4500000
NODE_58760_length_441_cov_13.546784	205	285	0	10	80	0.1250000
NODE_58760_length_441_cov_13.546784	205	285	2	70	80	0.8750000
NODE_58771_length_441_cov_5.710526	200	280	0	80	80	1.0000000
NODE_58771_length_441_cov_5.710526	253	333	0	80	80	1.0000000
NODE_58817_length_441_cov_3.096491	240	324	0	48	84	0.5714286
NODE_58817_length_441_cov_3.096491	240	324	2	5	84	0.0595238
NODE_58817_length_441_cov_3.096491	240	324	4	15	84	0.1785714
NODE_58817_length_441_cov_3.096491	240	324	6	4	84	0.0476190
NODE_58817_length_441_cov_3.096491	240	324	8	12	84	0.1428571
NODE_58820_length_441_cov_3.023392	105	163	0	35	58	0.6034483
NODE_58820_length_441_cov_3.023392	105	163	4	23	58	0.3965517
NODE_58852_length_441_cov_2.438596	19	99	0	52	80	0.6500000
NODE_58852_length_441_cov_2.438596	19	99	2	28	80	0.3500000
NODE_58852_length_441_cov_2.438596	72	126	2	54	54	1.0000000
NODE_58970_length_441_cov_1.435673	105	156	0	51	51	1.0000000
NODE_59142_length_440_cov_43.131965	122	202	2	30	80	0.3750000
NODE_59142_length_440_cov_43.131965	122	202	4	3	80	0.0375000
NODE_59142_length_440_cov_43.131965	122	202	6	47	80	0.5875000
NODE_59142_length_440_cov_43.131965	175	255	0	5	80	0.0625000
NODE_59142_length_440_cov_43.131965	175	255	2	9	80	0.1125000
NODE_59142_length_440_cov_43.131965	175	255	4	3	80	0.0375000
NODE_59142_length_440_cov_43.131965	175	255	6	63	80	0.7875000
NODE_59142_length_440_cov_43.131965	251	331	0	65	80	0.8125000
NODE_59142_length_440_cov_43.131965	251	331	6	15	80	0.1875000
NODE_59142_length_440_cov_43.131965	304	384	0	12	80	0.1500000
NODE_59142_length_440_cov_43.131965	304	384	6	68	80	0.8500000
NODE_59143_length_440_cov_42.929619	116	196	0	13	80	0.1625000
NODE_59143_length_440_cov_42.929619	116	196	8	67	80	0.8375000
NODE_59143_length_440_cov_42.929619	169	249	0	66	80	0.8250000
NODE_59143_length_440_cov_42.929619	169	249	8	14	80	0.1750000
NODE_59147_length_440_cov_8.164223	45	125	0	80	80	1.0000000
NODE_59147_length_440_cov_8.164223	98	178	0	80	80	1.0000000
NODE_59157_length_440_cov_5.193548	146	210	3	4	64	0.0625000
NODE_59157_length_440_cov_5.193548	146	210	5	17	64	0.2656250
NODE_59157_length_440_cov_5.193548	146	210	14	32	64	0.5000000
NODE_59157_length_440_cov_5.193548	146	210	15	4	64	0.0625000
NODE_59157_length_440_cov_5.193548	146	210	16	7	64	0.1093750
NODE_59157_length_440_cov_5.193548	146	210	3	4	64	0.0625000
NODE_59157_length_440_cov_5.193548	146	210	5	17	64	0.2656250
NODE_59157_length_440_cov_5.193548	146	210	14	32	64	0.5000000
NODE_59157_length_440_cov_5.193548	146	210	15	4	64	0.0625000
NODE_59157_length_440_cov_5.193548	146	210	16	7	64	0.1093750
NODE_59157_length_440_cov_5.193548	146	210	3	4	64	0.0625000
NODE_59157_length_440_cov_5.193548	146	210	5	17	64	0.2656250
NODE_59157_length_440_cov_5.193548	146	210	14	32	64	0.5000000
NODE_59157_length_440_cov_5.193548	146	210	15	4	64	0.0625000
NODE_59157_length_440_cov_5.193548	146	210	16	7	64	0.1093750
NODE_59164_length_440_cov_4.595308	153	233	4	80	80	1.0000000
NODE_59164_length_440_cov_4.595308	153	180	4	27	27	1.0000000
NODE_59188_length_440_cov_3.431085	84	150	6	17	66	0.2575758
NODE_59188_length_440_cov_3.431085	84	150	8	8	66	0.1212121
NODE_59188_length_440_cov_3.431085	84	150	10	12	66	0.1818182
NODE_59188_length_440_cov_3.431085	84	150	12	29	66	0.4393939
NODE_59191_length_440_cov_3.331378	139	195	2	18	56	0.3214286
NODE_59191_length_440_cov_3.331378	139	195	4	38	56	0.6785714
NODE_59517_length_439_cov_76.552941	0	68	0	68	68	1.0000000
NODE_59517_length_439_cov_76.552941	0	68	0	68	68	1.0000000
NODE_59517_length_439_cov_76.552941	0	68	0	68	68	1.0000000
NODE_59517_length_439_cov_76.552941	1	68	0	67	67	1.0000000
NODE_59517_length_439_cov_76.552941	64	144	0	80	80	1.0000000
NODE_59517_length_439_cov_76.552941	64	144	0	80	80	1.0000000
NODE_59517_length_439_cov_76.552941	117	197	0	80	80	1.0000000
NODE_59517_length_439_cov_76.552941	117	195	0	78	78	1.0000000
NODE_59533_length_439_cov_4.408824	174	238	0	64	64	1.0000000
NODE_59536_length_439_cov_4.255882	258	318	0	10	60	0.1666667
NODE_59536_length_439_cov_4.255882	258	318	2	50	60	0.8333333
NODE_59560_length_439_cov_3.011765	57	128	42	21	71	0.2957746
NODE_59560_length_439_cov_3.011765	57	128	44	12	71	0.1690141
NODE_59560_length_439_cov_3.011765	57	128	45	22	71	0.3098592
NODE_59560_length_439_cov_3.011765	57	128	46	16	71	0.2253521
NODE_59560_length_439_cov_3.011765	101	140	33	1	39	0.0256410
NODE_59560_length_439_cov_3.011765	101	140	34	1	39	0.0256410
NODE_59560_length_439_cov_3.011765	101	140	38	3	39	0.0769231
NODE_59560_length_439_cov_3.011765	101	140	40	1	39	0.0256410
NODE_59560_length_439_cov_3.011765	101	140	42	4	39	0.1025641
NODE_59560_length_439_cov_3.011765	101	140	44	3	39	0.0769231
NODE_59560_length_439_cov_3.011765	101	140	45	10	39	0.2564103
NODE_59560_length_439_cov_3.011765	101	140	46	16	39	0.4102564
NODE_59592_length_439_cov_2.252941	227	269	0	16	42	0.3809524
NODE_59592_length_439_cov_2.252941	227	269	2	15	42	0.3571429
NODE_59592_length_439_cov_2.252941	227	269	4	11	42	0.2619048
NODE_59599_length_439_cov_2.135294	116	179	0	29	63	0.4603175
NODE_59599_length_439_cov_2.135294	116	179	2	34	63	0.5396826
NODE_59617_length_439_cov_1.929412	388	439	0	51	51	1.0000000
NODE_59897_length_438_cov_29.952802	196	276	0	80	80	1.0000000
NODE_59897_length_438_cov_29.952802	249	329	0	80	80	1.0000000
NODE_59898_length_438_cov_16.330383	225	305	2	37	80	0.4625000
NODE_59898_length_438_cov_16.330383	225	305	6	16	80	0.2000000
NODE_59898_length_438_cov_16.330383	225	305	8	27	80	0.3375000
NODE_59898_length_438_cov_16.330383	278	358	6	8	80	0.1000000
NODE_59898_length_438_cov_16.330383	278	358	8	72	80	0.9000000
NODE_59899_length_438_cov_15.436578	74	154	0	80	80	1.0000000
NODE_59899_length_438_cov_15.436578	127	207	0	80	80	1.0000000
NODE_59901_length_438_cov_9.306785	256	309	0	53	53	1.0000000
NODE_59901_length_438_cov_9.306785	282	327	0	45	45	1.0000000
NODE_59916_length_438_cov_4.808260	46	133	0	55	87	0.6321839
NODE_59916_length_438_cov_4.808260	46	133	2	32	87	0.3678161
NODE_59916_length_438_cov_4.808260	106	186	2	32	80	0.4000000
NODE_59916_length_438_cov_4.808260	106	186	4	17	80	0.2125000
NODE_59916_length_438_cov_4.808260	106	186	6	31	80	0.3875000
NODE_59920_length_438_cov_4.622419	135	184	6	8	49	0.1632653
NODE_59920_length_438_cov_4.622419	135	184	8	41	49	0.8367347
NODE_59936_length_438_cov_3.651917	86	166	0	80	80	1.0000000
NODE_59936_length_438_cov_3.651917	139	219	0	80	80	1.0000000
NODE_59952_length_438_cov_3.109145	215	273	1	4	58	0.0689655
NODE_59952_length_438_cov_3.109145	215	273	2	5	58	0.0862069
NODE_59952_length_438_cov_3.109145	215	273	3	12	58	0.2068966
NODE_59952_length_438_cov_3.109145	215	273	4	37	58	0.6379310
NODE_59957_length_438_cov_3.005900	175	258	0	76	83	0.9156626
NODE_59957_length_438_cov_3.005900	175	258	6	7	83	0.0843373
NODE_60317_length_437_cov_57.260355	272	352	0	80	80	1.0000000
NODE_60317_length_437_cov_57.260355	325	405	0	80	80	1.0000000
NODE_60318_length_437_cov_40.964497	0	73	0	73	73	1.0000000
NODE_60318_length_437_cov_40.964497	46	126	0	80	80	1.0000000
NODE_60319_length_437_cov_30.843195	140	220	0	80	80	1.0000000
NODE_60319_length_437_cov_30.843195	193	273	0	80	80	1.0000000
NODE_60320_length_437_cov_14.736686	164	244	0	80	80	1.0000000
NODE_60320_length_437_cov_14.736686	217	297	0	80	80	1.0000000
NODE_60331_length_437_cov_6.032544	249	320	0	71	71	1.0000000
NODE_60332_length_437_cov_6.020710	272	352	0	3	80	0.0375000
NODE_60332_length_437_cov_6.020710	272	352	2	77	80	0.9625000
NODE_60332_length_437_cov_6.020710	325	405	0	47	80	0.5875000
NODE_60332_length_437_cov_6.020710	325	405	2	33	80	0.4125000
NODE_60336_length_437_cov_5.526627	129	209	0	80	80	1.0000000
NODE_60336_length_437_cov_5.526627	182	262	0	80	80	1.0000000
NODE_60348_length_437_cov_4.505917	247	327	0	80	80	1.0000000
NODE_60361_length_437_cov_3.470414	204	259	0	55	55	1.0000000
NODE_60369_length_437_cov_3.301775	95	149	0	6	54	0.1111111
NODE_60369_length_437_cov_3.301775	95	149	2	7	54	0.1296296
NODE_60369_length_437_cov_3.301775	95	149	4	41	54	0.7592593
NODE_60381_length_437_cov_2.911243	91	171	0	45	80	0.5625000
NODE_60381_length_437_cov_2.911243	91	171	2	35	80	0.4375000
NODE_60400_length_437_cov_2.650888	190	239	0	49	49	1.0000000
NODE_60400_length_437_cov_2.650888	212	292	0	31	80	0.3875000
NODE_60400_length_437_cov_2.650888	212	292	2	22	80	0.2750000
NODE_60400_length_437_cov_2.650888	212	292	6	18	80	0.2250000
NODE_60400_length_437_cov_2.650888	212	292	8	9	80	0.1125000
NODE_60411_length_437_cov_2.514793	292	333	2	41	41	1.0000000
NODE_60509_length_437_cov_1.473373	252	324	0	2	72	0.0277778
NODE_60509_length_437_cov_1.473373	252	324	2	15	72	0.2083333
NODE_60509_length_437_cov_1.473373	252	324	4	55	72	0.7638889
NODE_60709_length_436_cov_125.940653	204	284	1	7	80	0.0875000
NODE_60709_length_436_cov_125.940653	204	284	2	21	80	0.2625000
NODE_60709_length_436_cov_125.940653	204	284	4	5	80	0.0625000
NODE_60709_length_436_cov_125.940653	204	284	6	1	80	0.0125000
NODE_60709_length_436_cov_125.940653	204	284	7	4	80	0.0500000
NODE_60709_length_436_cov_125.940653	204	284	8	7	80	0.0875000
NODE_60709_length_436_cov_125.940653	204	284	10	8	80	0.1000000
NODE_60709_length_436_cov_125.940653	204	284	12	16	80	0.2000000
NODE_60709_length_436_cov_125.940653	204	284	14	2	80	0.0250000
NODE_60709_length_436_cov_125.940653	204	284	16	2	80	0.0250000
NODE_60709_length_436_cov_125.940653	204	284	18	3	80	0.0375000
NODE_60709_length_436_cov_125.940653	204	284	20	4	80	0.0500000
NODE_60709_length_436_cov_125.940653	255	301	0	3	46	0.0652174
NODE_60709_length_436_cov_125.940653	255	301	1	21	46	0.4565217
NODE_60709_length_436_cov_125.940653	255	301	2	21	46	0.4565217
NODE_60709_length_436_cov_125.940653	255	301	4	1	46	0.0217391
NODE_60709_length_436_cov_125.940653	257	337	0	39	80	0.4875000
NODE_60709_length_436_cov_125.940653	257	337	1	21	80	0.2625000
NODE_60709_length_436_cov_125.940653	257	337	2	20	80	0.2500000
NODE_60709_length_436_cov_125.940653	333	413	0	80	80	1.0000000
NODE_60709_length_436_cov_125.940653	386	436	0	50	50	1.0000000
NODE_60712_length_436_cov_45.459941	166	246	0	80	80	1.0000000
NODE_60712_length_436_cov_45.459941	219	299	0	80	80	1.0000000
NODE_60712_length_436_cov_45.459941	295	375	0	80	80	1.0000000
NODE_60712_length_436_cov_45.459941	348	428	0	80	80	1.0000000
NODE_60713_length_436_cov_10.560831	74	154	0	80	80	1.0000000
NODE_60713_length_436_cov_10.560831	127	207	0	80	80	1.0000000
NODE_60716_length_436_cov_8.317507	51	127	0	76	76	1.0000000
NODE_60716_length_436_cov_8.317507	104	182	0	78	78	1.0000000
NODE_60760_length_436_cov_3.109792	153	205	0	52	52	1.0000000
NODE_60786_length_436_cov_2.551929	182	258	0	76	76	1.0000000
NODE_60786_length_436_cov_2.551929	235	315	0	49	80	0.6125000
NODE_60786_length_436_cov_2.551929	235	315	2	21	80	0.2625000
NODE_60786_length_436_cov_2.551929	235	315	4	10	80	0.1250000
NODE_60934_length_436_cov_1.207715	105	181	0	76	76	1.0000000
NODE_61088_length_435_cov_17.401786	55	135	0	80	80	1.0000000
NODE_61088_length_435_cov_17.401786	108	188	0	80	80	1.0000000
NODE_61094_length_435_cov_6.910714	113	193	2	2	80	0.0250000
NODE_61094_length_435_cov_6.910714	113	193	4	4	80	0.0500000
NODE_61094_length_435_cov_6.910714	113	193	8	74	80	0.9250000
NODE_61094_length_435_cov_6.910714	147	194	2	3	47	0.0638298
NODE_61094_length_435_cov_6.910714	147	194	4	4	47	0.0851064
NODE_61094_length_435_cov_6.910714	147	194	8	40	47	0.8510638
NODE_61094_length_435_cov_6.910714	149	184	8	35	35	1.0000000
NODE_61094_length_435_cov_6.910714	151	193	2	2	42	0.0476190
NODE_61094_length_435_cov_6.910714	151	193	4	4	42	0.0952381
NODE_61094_length_435_cov_6.910714	151	193	8	36	42	0.8571429
NODE_61094_length_435_cov_6.910714	166	251	0	57	85	0.6705883
NODE_61094_length_435_cov_6.910714	166	251	2	3	85	0.0352941
NODE_61094_length_435_cov_6.910714	166	251	4	4	85	0.0470588
NODE_61094_length_435_cov_6.910714	166	251	8	21	85	0.2470588
NODE_61094_length_435_cov_6.910714	167	251	0	57	84	0.6785714
NODE_61094_length_435_cov_6.910714	167	251	2	3	84	0.0357143
NODE_61094_length_435_cov_6.910714	167	251	4	4	84	0.0476190
NODE_61094_length_435_cov_6.910714	167	251	8	20	84	0.2380952
NODE_61102_length_435_cov_5.630952	159	217	0	58	58	1.0000000
NODE_61102_length_435_cov_5.630952	190	270	0	36	80	0.4500000
NODE_61102_length_435_cov_5.630952	190	270	3	44	80	0.5500000
NODE_61112_length_435_cov_4.601190	271	309	0	38	38	1.0000000
NODE_61112_length_435_cov_4.601190	282	344	0	38	62	0.6129032
NODE_61112_length_435_cov_4.601190	282	344	2	8	62	0.1290323
NODE_61112_length_435_cov_4.601190	282	344	4	16	62	0.2580645
NODE_61122_length_435_cov_3.770833	209	240	0	31	31	1.0000000
NODE_61137_length_435_cov_2.836310	113	194	14	16	81	0.1975309
NODE_61137_length_435_cov_2.836310	113	194	17	8	81	0.0987654
NODE_61137_length_435_cov_2.836310	113	194	18	41	81	0.5061728
NODE_61137_length_435_cov_2.836310	113	194	19	8	81	0.0987654
NODE_61137_length_435_cov_2.836310	113	194	20	8	81	0.0987654
NODE_61357_length_435_cov_0.988095	286	322	0	36	36	1.0000000
NODE_61451_length_434_cov_136.483582	0	58	38	1	58	0.0172414
NODE_61451_length_434_cov_136.483582	0	58	43	1	58	0.0172414
NODE_61451_length_434_cov_136.483582	0	58	54	1	58	0.0172414
NODE_61451_length_434_cov_136.483582	0	58	71	2	58	0.0344828
NODE_61451_length_434_cov_136.483582	0	58	77	1	58	0.0172414
NODE_61451_length_434_cov_136.483582	0	58	83	1	58	0.0172414
NODE_61451_length_434_cov_136.483582	0	58	85	1	58	0.0172414
NODE_61451_length_434_cov_136.483582	0	58	113	1	58	0.0172414
NODE_61451_length_434_cov_136.483582	0	58	115	1	58	0.0172414
NODE_61451_length_434_cov_136.483582	0	58	117	1	58	0.0172414
NODE_61451_length_434_cov_136.483582	0	58	144	1	58	0.0172414
NODE_61451_length_434_cov_136.483582	0	58	145	1	58	0.0172414
NODE_61451_length_434_cov_136.483582	0	58	155	1	58	0.0172414
NODE_61451_length_434_cov_136.483582	0	58	163	1	58	0.0172414
NODE_61451_length_434_cov_136.483582	0	58	164	1	58	0.0172414
NODE_61451_length_434_cov_136.483582	0	58	176	1	58	0.0172414
NODE_61451_length_434_cov_136.483582	0	58	180	1	58	0.0172414
NODE_61451_length_434_cov_136.483582	0	58	184	1	58	0.0172414
NODE_61451_length_434_cov_136.483582	0	58	188	1	58	0.0172414
NODE_61451_length_434_cov_136.483582	0	58	192	1	58	0.0172414
NODE_61451_length_434_cov_136.483582	0	58	196	1	58	0.0172414
NODE_61451_length_434_cov_136.483582	0	58	207	1	58	0.0172414
NODE_61451_length_434_cov_136.483582	0	58	216	2	58	0.0344828
NODE_61451_length_434_cov_136.483582	0	58	222	1	58	0.0172414
NODE_61451_length_434_cov_136.483582	0	58	230	1	58	0.0172414
NODE_61451_length_434_cov_136.483582	0	58	240	1	58	0.0172414
NODE_61451_length_434_cov_136.483582	0	58	244	1	58	0.0172414
NODE_61451_length_434_cov_136.483582	0	58	252	1	58	0.0172414
NODE_61451_length_434_cov_136.483582	0	58	255	1	58	0.0172414
NODE_61451_length_434_cov_136.483582	0	58	260	1	58	0.0172414
NODE_61451_length_434_cov_136.483582	0	58	273	1	58	0.0172414
NODE_61451_length_434_cov_136.483582	0	58	274	1	58	0.0172414
NODE_61451_length_434_cov_136.483582	0	58	277	6	58	0.1034483
NODE_61451_length_434_cov_136.483582	0	58	279	3	58	0.0517241
NODE_61451_length_434_cov_136.483582	0	58	283	2	58	0.0344828
NODE_61451_length_434_cov_136.483582	0	58	285	1	58	0.0172414
NODE_61451_length_434_cov_136.483582	0	58	289	7	58	0.1206897
NODE_61451_length_434_cov_136.483582	0	58	293	1	58	0.0172414
NODE_61451_length_434_cov_136.483582	0	58	295	1	58	0.0172414
NODE_61451_length_434_cov_136.483582	0	58	297	3	58	0.0517241
NODE_61451_length_434_cov_136.483582	31	111	260	1	80	0.0125000
NODE_61451_length_434_cov_136.483582	31	111	273	1	80	0.0125000
NODE_61451_length_434_cov_136.483582	31	111	274	1	80	0.0125000
NODE_61451_length_434_cov_136.483582	31	111	277	6	80	0.0750000
NODE_61451_length_434_cov_136.483582	31	111	279	3	80	0.0375000
NODE_61451_length_434_cov_136.483582	31	111	283	2	80	0.0250000
NODE_61451_length_434_cov_136.483582	31	111	285	1	80	0.0125000
NODE_61451_length_434_cov_136.483582	31	111	289	7	80	0.0875000
NODE_61451_length_434_cov_136.483582	31	111	293	1	80	0.0125000
NODE_61451_length_434_cov_136.483582	31	111	295	1	80	0.0125000
NODE_61451_length_434_cov_136.483582	31	111	297	4	80	0.0500000
NODE_61451_length_434_cov_136.483582	31	111	298	1	80	0.0125000
NODE_61451_length_434_cov_136.483582	31	111	300	2	80	0.0250000
NODE_61451_length_434_cov_136.483582	31	111	303	2	80	0.0250000
NODE_61451_length_434_cov_136.483582	31	111	311	3	80	0.0375000
NODE_61451_length_434_cov_136.483582	31	111	314	1	80	0.0125000
NODE_61451_length_434_cov_136.483582	31	111	319	2	80	0.0250000
NODE_61451_length_434_cov_136.483582	31	111	321	2	80	0.0250000
NODE_61451_length_434_cov_136.483582	31	111	323	1	80	0.0125000
NODE_61451_length_434_cov_136.483582	31	111	325	3	80	0.0375000
NODE_61451_length_434_cov_136.483582	31	111	328	1	80	0.0125000
NODE_61451_length_434_cov_136.483582	31	111	332	1	80	0.0125000
NODE_61451_length_434_cov_136.483582	31	111	344	2	80	0.0250000
NODE_61451_length_434_cov_136.483582	31	111	346	1	80	0.0125000
NODE_61451_length_434_cov_136.483582	31	111	348	1	80	0.0125000
NODE_61451_length_434_cov_136.483582	31	111	349	3	80	0.0375000
NODE_61451_length_434_cov_136.483582	31	111	353	1	80	0.0125000
NODE_61451_length_434_cov_136.483582	31	111	355	1	80	0.0125000
NODE_61451_length_434_cov_136.483582	31	111	361	1	80	0.0125000
NODE_61451_length_434_cov_136.483582	31	111	362	1	80	0.0125000
NODE_61451_length_434_cov_136.483582	31	111	364	1	80	0.0125000
NODE_61451_length_434_cov_136.483582	31	111	367	3	80	0.0375000
NODE_61451_length_434_cov_136.483582	31	111	369	1	80	0.0125000
NODE_61451_length_434_cov_136.483582	31	111	371	1	80	0.0125000
NODE_61451_length_434_cov_136.483582	31	111	376	1	80	0.0125000
NODE_61451_length_434_cov_136.483582	31	111	380	1	80	0.0125000
NODE_61451_length_434_cov_136.483582	31	111	381	1	80	0.0125000
NODE_61451_length_434_cov_136.483582	31	111	382	1	80	0.0125000
NODE_61451_length_434_cov_136.483582	31	111	386	5	80	0.0625000
NODE_61451_length_434_cov_136.483582	31	111	388	1	80	0.0125000
NODE_61451_length_434_cov_136.483582	31	111	389	2	80	0.0250000
NODE_61451_length_434_cov_136.483582	31	111	396	1	80	0.0125000
NODE_61451_length_434_cov_136.483582	31	111	397	1	80	0.0125000
NODE_61451_length_434_cov_136.483582	31	111	398	1	80	0.0125000
NODE_61451_length_434_cov_136.483582	31	111	401	1	80	0.0125000
NODE_61452_length_434_cov_43.214925	291	366	0	75	75	1.0000000
NODE_61452_length_434_cov_43.214925	344	424	0	80	80	1.0000000
NODE_61452_length_434_cov_43.214925	344	424	0	80	80	1.0000000
NODE_61453_length_434_cov_22.373134	80	160	0	79	80	0.9875000
NODE_61453_length_434_cov_22.373134	80	160	2	1	80	0.0125000
NODE_61453_length_434_cov_22.373134	133	213	0	26	80	0.3250000
NODE_61453_length_434_cov_22.373134	133	213	2	54	80	0.6750000
NODE_61455_length_434_cov_11.549254	74	145	0	71	71	1.0000000
NODE_61455_length_434_cov_11.549254	118	198	0	80	80	1.0000000
NODE_61477_length_434_cov_4.125373	191	233	4	42	42	1.0000000
NODE_61477_length_434_cov_4.125373	200	235	4	35	35	1.0000000
NODE_61497_length_434_cov_3.104478	191	263	2	9	72	0.1250000
NODE_61497_length_434_cov_3.104478	191	263	4	63	72	0.8750000
NODE_61528_length_434_cov_2.197015	129	168	0	5	39	0.1282051
NODE_61528_length_434_cov_2.197015	129	168	2	34	39	0.8717949
NODE_61563_length_434_cov_1.883582	88	133	2	39	45	0.8666667
NODE_61563_length_434_cov_1.883582	88	133	6	6	45	0.1333333
NODE_61563_length_434_cov_1.883582	141	182	6	40	41	0.9756098
NODE_61563_length_434_cov_1.883582	141	182	8	1	41	0.0243902
NODE_61603_length_434_cov_1.626866	163	243	10	8	80	0.1000000
NODE_61603_length_434_cov_1.626866	163	243	12	3	80	0.0375000
NODE_61603_length_434_cov_1.626866	163	243	14	30	80	0.3750000
NODE_61603_length_434_cov_1.626866	163	243	16	39	80	0.4875000
NODE_61676_length_434_cov_1.220896	118	198	144	1	80	0.0125000
NODE_61676_length_434_cov_1.220896	118	198	150	4	80	0.0500000
NODE_61676_length_434_cov_1.220896	118	198	151	1	80	0.0125000
NODE_61676_length_434_cov_1.220896	118	198	153	2	80	0.0250000
NODE_61676_length_434_cov_1.220896	118	198	167	1	80	0.0125000
NODE_61676_length_434_cov_1.220896	118	198	170	1	80	0.0125000
NODE_61676_length_434_cov_1.220896	118	198	176	1	80	0.0125000
NODE_61676_length_434_cov_1.220896	118	198	179	1	80	0.0125000
NODE_61676_length_434_cov_1.220896	118	198	184	1	80	0.0125000
NODE_61676_length_434_cov_1.220896	118	198	188	3	80	0.0375000
NODE_61676_length_434_cov_1.220896	118	198	192	1	80	0.0125000
NODE_61676_length_434_cov_1.220896	118	198	200	1	80	0.0125000
NODE_61676_length_434_cov_1.220896	118	198	206	1	80	0.0125000
NODE_61676_length_434_cov_1.220896	118	198	208	1	80	0.0125000
NODE_61676_length_434_cov_1.220896	118	198	214	2	80	0.0250000
NODE_61676_length_434_cov_1.220896	118	198	222	1	80	0.0125000
NODE_61676_length_434_cov_1.220896	118	198	225	1	80	0.0125000
NODE_61676_length_434_cov_1.220896	118	198	229	3	80	0.0375000
NODE_61676_length_434_cov_1.220896	118	198	231	1	80	0.0125000
NODE_61676_length_434_cov_1.220896	118	198	233	1	80	0.0125000
NODE_61676_length_434_cov_1.220896	118	198	234	1	80	0.0125000
NODE_61676_length_434_cov_1.220896	118	198	235	1	80	0.0125000
NODE_61676_length_434_cov_1.220896	118	198	238	1	80	0.0125000
NODE_61676_length_434_cov_1.220896	118	198	239	1	80	0.0125000
NODE_61676_length_434_cov_1.220896	118	198	240	3	80	0.0375000
NODE_61676_length_434_cov_1.220896	118	198	241	1	80	0.0125000
NODE_61676_length_434_cov_1.220896	118	198	242	3	80	0.0375000
NODE_61676_length_434_cov_1.220896	118	198	243	2	80	0.0250000
NODE_61676_length_434_cov_1.220896	118	198	244	7	80	0.0875000
NODE_61676_length_434_cov_1.220896	118	198	247	2	80	0.0250000
NODE_61676_length_434_cov_1.220896	118	198	248	6	80	0.0750000
NODE_61676_length_434_cov_1.220896	118	198	249	1	80	0.0125000
NODE_61676_length_434_cov_1.220896	118	198	250	3	80	0.0375000
NODE_61676_length_434_cov_1.220896	118	198	251	1	80	0.0125000
NODE_61676_length_434_cov_1.220896	118	198	252	5	80	0.0625000
NODE_61676_length_434_cov_1.220896	118	198	253	3	80	0.0375000
NODE_61676_length_434_cov_1.220896	118	198	254	8	80	0.1000000
NODE_61676_length_434_cov_1.220896	118	198	255	1	80	0.0125000
NODE_61676_length_434_cov_1.220896	118	198	256	1	80	0.0125000
NODE_61727_length_434_cov_1.002985	245	286	14	1	41	0.0243902
NODE_61727_length_434_cov_1.002985	245	286	16	32	41	0.7804878
NODE_61727_length_434_cov_1.002985	245	286	18	8	41	0.1951219
NODE_61727_length_434_cov_1.002985	258	339	8	5	81	0.0617284
NODE_61727_length_434_cov_1.002985	258	339	10	1	81	0.0123457
NODE_61727_length_434_cov_1.002985	258	339	14	12	81	0.1481481
NODE_61727_length_434_cov_1.002985	258	339	15	2	81	0.0246914
NODE_61727_length_434_cov_1.002985	258	339	16	60	81	0.7407407
NODE_61727_length_434_cov_1.002985	258	339	18	1	81	0.0123457
NODE_61826_length_433_cov_51.392216	2	82	0	53	80	0.6625000
NODE_61826_length_433_cov_51.392216	2	82	2	26	80	0.3250000
NODE_61826_length_433_cov_51.392216	2	82	4	1	80	0.0125000
NODE_61826_length_433_cov_51.392216	55	135	2	47	80	0.5875000
NODE_61826_length_433_cov_51.392216	55	135	4	33	80	0.4125000
NODE_61826_length_433_cov_51.392216	131	213	0	35	82	0.4268293
NODE_61826_length_433_cov_51.392216	131	213	2	47	82	0.5731707
NODE_61826_length_433_cov_51.392216	189	266	0	77	77	1.0000000
NODE_61827_length_433_cov_46.344311	248	328	0	73	80	0.9125000
NODE_61827_length_433_cov_46.344311	248	328	2	7	80	0.0875000
NODE_61827_length_433_cov_46.344311	301	381	0	20	80	0.2500000
NODE_61827_length_433_cov_46.344311	301	381	2	60	80	0.7500000
NODE_61828_length_433_cov_41.808383	92	172	0	80	80	1.0000000
NODE_61828_length_433_cov_41.808383	145	225	0	80	80	1.0000000
NODE_61835_length_433_cov_6.227545	157	237	0	80	80	1.0000000
NODE_61836_length_433_cov_6.080838	164	244	2	9	80	0.1125000
NODE_61836_length_433_cov_6.080838	164	244	4	43	80	0.5375000
NODE_61836_length_433_cov_6.080838	164	244	6	28	80	0.3500000
NODE_61838_length_433_cov_5.547904	10	80	0	34	70	0.4857143
NODE_61838_length_433_cov_5.547904	10	80	2	36	70	0.5142857
NODE_61838_length_433_cov_5.547904	51	133	2	33	82	0.4024390
NODE_61838_length_433_cov_5.547904	51	133	4	49	82	0.5975610
NODE_61839_length_433_cov_5.476048	81	141	0	60	60	1.0000000
NODE_61855_length_433_cov_3.907186	77	107	0	30	30	1.0000000
NODE_61862_length_433_cov_3.595808	231	316	0	74	85	0.8705882
NODE_61862_length_433_cov_3.595808	231	316	2	11	85	0.1294118
NODE_61864_length_433_cov_3.526946	107	178	0	10	71	0.1408451
NODE_61864_length_433_cov_3.526946	107	178	2	61	71	0.8591549
NODE_61931_length_433_cov_2.137725	123	203	0	80	80	1.0000000
NODE_62258_length_432_cov_17.540541	150	230	0	80	80	1.0000000
NODE_62258_length_432_cov_17.540541	203	288	0	85	85	1.0000000
NODE_62264_length_432_cov_6.555556	52	82	8	30	30	1.0000000
NODE_62268_length_432_cov_5.720721	77	157	0	80	80	1.0000000
NODE_62268_length_432_cov_5.720721	130	202	0	72	72	1.0000000
NODE_62269_length_432_cov_5.387387	65	95	0	30	30	1.0000000
NODE_62270_length_432_cov_5.345345	271	324	2	46	53	0.8679245
NODE_62270_length_432_cov_5.345345	271	324	4	7	53	0.1320755
NODE_62293_length_432_cov_3.678679	78	121	0	1	43	0.0232558
NODE_62293_length_432_cov_3.678679	78	121	2	5	43	0.1162791
NODE_62293_length_432_cov_3.678679	78	121	4	33	43	0.7674419
NODE_62293_length_432_cov_3.678679	78	121	6	4	43	0.0930233
NODE_62304_length_432_cov_3.246246	87	128	4	6	41	0.1463415
NODE_62304_length_432_cov_3.246246	87	128	6	2	41	0.0487805
NODE_62304_length_432_cov_3.246246	87	128	8	11	41	0.2682927
NODE_62304_length_432_cov_3.246246	87	128	10	4	41	0.0975610
NODE_62304_length_432_cov_3.246246	87	128	12	5	41	0.1219512
NODE_62304_length_432_cov_3.246246	87	128	14	1	41	0.0243902
NODE_62304_length_432_cov_3.246246	87	128	16	7	41	0.1707317
NODE_62304_length_432_cov_3.246246	87	128	18	1	41	0.0243902
NODE_62304_length_432_cov_3.246246	87	128	20	1	41	0.0243902
NODE_62304_length_432_cov_3.246246	87	128	22	2	41	0.0487805
NODE_62304_length_432_cov_3.246246	87	128	26	1	41	0.0243902
NODE_62304_length_432_cov_3.246246	101	167	8	5	66	0.0757576
NODE_62304_length_432_cov_3.246246	101	167	10	4	66	0.0606061
NODE_62304_length_432_cov_3.246246	101	167	12	5	66	0.0757576
NODE_62304_length_432_cov_3.246246	101	167	14	1	66	0.0151515
NODE_62304_length_432_cov_3.246246	101	167	16	7	66	0.1060606
NODE_62304_length_432_cov_3.246246	101	167	18	1	66	0.0151515
NODE_62304_length_432_cov_3.246246	101	167	20	1	66	0.0151515
NODE_62304_length_432_cov_3.246246	101	167	22	2	66	0.0303030
NODE_62304_length_432_cov_3.246246	101	167	26	2	66	0.0303030
NODE_62304_length_432_cov_3.246246	101	167	35	3	66	0.0454545
NODE_62304_length_432_cov_3.246246	101	167	37	8	66	0.1212121
NODE_62304_length_432_cov_3.246246	101	167	39	1	66	0.0151515
NODE_62304_length_432_cov_3.246246	101	167	41	18	66	0.2727273
NODE_62304_length_432_cov_3.246246	101	167	43	8	66	0.1212121
NODE_62396_length_432_cov_1.762763	4	71	0	29	67	0.4328358
NODE_62396_length_432_cov_1.762763	4	71	2	38	67	0.5671642
NODE_62544_length_432_cov_1.027027	44	68	0	24	24	1.0000000
NODE_62650_length_431_cov_35.355422	202	284	0	82	82	1.0000000
NODE_62650_length_431_cov_35.355422	257	333	0	76	76	1.0000000
NODE_62652_length_431_cov_11.207831	185	265	0	80	80	1.0000000
NODE_62652_length_431_cov_11.207831	238	318	0	80	80	1.0000000
NODE_62657_length_431_cov_7.018072	110	190	0	80	80	1.0000000
NODE_62657_length_431_cov_7.018072	163	243	0	63	80	0.7875000
NODE_62657_length_431_cov_7.018072	163	243	2	17	80	0.2125000
NODE_62661_length_431_cov_6.292169	123	203	0	80	80	1.0000000
NODE_62668_length_431_cov_5.608434	170	241	0	71	71	1.0000000
NODE_62681_length_431_cov_4.250000	146	216	2	41	70	0.5857143
NODE_62681_length_431_cov_4.250000	146	216	4	26	70	0.3714286
NODE_62681_length_431_cov_4.250000	146	216	6	3	70	0.0428571
NODE_62684_length_431_cov_3.993976	210	290	0	80	80	1.0000000
NODE_62794_length_431_cov_1.695783	76	156	14	4	80	0.0500000
NODE_62794_length_431_cov_1.695783	76	156	15	4	80	0.0500000
NODE_62794_length_431_cov_1.695783	76	156	17	2	80	0.0250000
NODE_62794_length_431_cov_1.695783	76	156	19	4	80	0.0500000
NODE_62794_length_431_cov_1.695783	76	156	23	3	80	0.0375000
NODE_62794_length_431_cov_1.695783	76	156	24	4	80	0.0500000
NODE_62794_length_431_cov_1.695783	76	156	28	3	80	0.0375000
NODE_62794_length_431_cov_1.695783	76	156	29	4	80	0.0500000
NODE_62794_length_431_cov_1.695783	76	156	30	2	80	0.0250000
NODE_62794_length_431_cov_1.695783	76	156	31	14	80	0.1750000
NODE_62794_length_431_cov_1.695783	76	156	32	7	80	0.0875000
NODE_62794_length_431_cov_1.695783	76	156	33	15	80	0.1875000
NODE_62794_length_431_cov_1.695783	76	156	34	14	80	0.1750000
NODE_62794_length_431_cov_1.695783	129	199	16	8	70	0.1142857
NODE_62794_length_431_cov_1.695783	129	199	18	4	70	0.0571429
NODE_62794_length_431_cov_1.695783	129	199	20	1	70	0.0142857
NODE_62794_length_431_cov_1.695783	129	199	22	14	70	0.2000000
NODE_62794_length_431_cov_1.695783	129	199	26	8	70	0.1142857
NODE_62794_length_431_cov_1.695783	129	199	28	7	70	0.1000000
NODE_62794_length_431_cov_1.695783	129	199	30	6	70	0.0857143
NODE_62794_length_431_cov_1.695783	129	199	32	7	70	0.1000000
NODE_62794_length_431_cov_1.695783	129	199	33	1	70	0.0142857
NODE_62794_length_431_cov_1.695783	129	199	34	14	70	0.2000000
NODE_63043_length_430_cov_49.791541	319	399	144	1	80	0.0125000
NODE_63043_length_430_cov_49.791541	319	399	150	1	80	0.0125000
NODE_63043_length_430_cov_49.791541	319	399	152	1	80	0.0125000
NODE_63043_length_430_cov_49.791541	319	399	161	1	80	0.0125000
NODE_63043_length_430_cov_49.791541	319	399	163	4	80	0.0500000
NODE_63043_length_430_cov_49.791541	319	399	167	1	80	0.0125000
NODE_63043_length_430_cov_49.791541	319	399	173	4	80	0.0500000
NODE_63043_length_430_cov_49.791541	319	399	179	1	80	0.0125000
NODE_63043_length_430_cov_49.791541	319	399	182	1	80	0.0125000
NODE_63043_length_430_cov_49.791541	319	399	186	1	80	0.0125000
NODE_63043_length_430_cov_49.791541	319	399	190	1	80	0.0125000
NODE_63043_length_430_cov_49.791541	319	399	192	1	80	0.0125000
NODE_63043_length_430_cov_49.791541	319	399	194	1	80	0.0125000
NODE_63043_length_430_cov_49.791541	319	399	200	1	80	0.0125000
NODE_63043_length_430_cov_49.791541	319	399	203	1	80	0.0125000
NODE_63043_length_430_cov_49.791541	319	399	205	1	80	0.0125000
NODE_63043_length_430_cov_49.791541	319	399	209	1	80	0.0125000
NODE_63043_length_430_cov_49.791541	319	399	214	1	80	0.0125000
NODE_63043_length_430_cov_49.791541	319	399	216	2	80	0.0250000
NODE_63043_length_430_cov_49.791541	319	399	218	1	80	0.0125000
NODE_63043_length_430_cov_49.791541	319	399	223	1	80	0.0125000
NODE_63043_length_430_cov_49.791541	319	399	231	2	80	0.0250000
NODE_63043_length_430_cov_49.791541	319	399	237	1	80	0.0125000
NODE_63043_length_430_cov_49.791541	319	399	241	1	80	0.0125000
NODE_63043_length_430_cov_49.791541	319	399	247	1	80	0.0125000
NODE_63043_length_430_cov_49.791541	319	399	248	1	80	0.0125000
NODE_63043_length_430_cov_49.791541	319	399	252	1	80	0.0125000
NODE_63043_length_430_cov_49.791541	319	399	258	1	80	0.0125000
NODE_63043_length_430_cov_49.791541	319	399	264	1	80	0.0125000
NODE_63043_length_430_cov_49.791541	319	399	272	1	80	0.0125000
NODE_63043_length_430_cov_49.791541	319	399	275	1	80	0.0125000
NODE_63043_length_430_cov_49.791541	319	399	277	2	80	0.0250000
NODE_63043_length_430_cov_49.791541	319	399	279	1	80	0.0125000
NODE_63043_length_430_cov_49.791541	319	399	281	1	80	0.0125000
NODE_63043_length_430_cov_49.791541	319	399	282	1	80	0.0125000
NODE_63043_length_430_cov_49.791541	319	399	292	2	80	0.0250000
NODE_63043_length_430_cov_49.791541	319	399	294	1	80	0.0125000
NODE_63043_length_430_cov_49.791541	319	399	302	1	80	0.0125000
NODE_63043_length_430_cov_49.791541	319	399	304	1	80	0.0125000
NODE_63043_length_430_cov_49.791541	319	399	307	4	80	0.0500000
NODE_63043_length_430_cov_49.791541	319	399	309	1	80	0.0125000
NODE_63043_length_430_cov_49.791541	319	399	311	1	80	0.0125000
NODE_63043_length_430_cov_49.791541	319	399	312	1	80	0.0125000
NODE_63043_length_430_cov_49.791541	319	399	316	1	80	0.0125000
NODE_63043_length_430_cov_49.791541	319	399	317	2	80	0.0250000
NODE_63043_length_430_cov_49.791541	319	399	327	1	80	0.0125000
NODE_63043_length_430_cov_49.791541	319	399	331	1	80	0.0125000
NODE_63043_length_430_cov_49.791541	319	399	333	1	80	0.0125000
NODE_63043_length_430_cov_49.791541	319	399	339	2	80	0.0250000
NODE_63043_length_430_cov_49.791541	319	399	340	1	80	0.0125000
NODE_63043_length_430_cov_49.791541	319	399	346	1	80	0.0125000
NODE_63043_length_430_cov_49.791541	319	399	350	3	80	0.0375000
NODE_63043_length_430_cov_49.791541	319	399	356	1	80	0.0125000
NODE_63043_length_430_cov_49.791541	319	399	358	5	80	0.0625000
NODE_63043_length_430_cov_49.791541	319	399	360	1	80	0.0125000
NODE_63043_length_430_cov_49.791541	319	399	366	1	80	0.0125000
NODE_63043_length_430_cov_49.791541	319	399	373	2	80	0.0250000
NODE_63043_length_430_cov_49.791541	319	399	375	1	80	0.0125000
NODE_63043_length_430_cov_49.791541	372	430	35	1	58	0.0172414
NODE_63043_length_430_cov_49.791541	372	430	38	1	58	0.0172414
NODE_63043_length_430_cov_49.791541	372	430	47	1	58	0.0172414
NODE_63043_length_430_cov_49.791541	372	430	57	5	58	0.0862069
NODE_63043_length_430_cov_49.791541	372	430	63	1	58	0.0172414
NODE_63043_length_430_cov_49.791541	372	430	72	1	58	0.0172414
NODE_63043_length_430_cov_49.791541	372	430	74	1	58	0.0172414
NODE_63043_length_430_cov_49.791541	372	430	87	1	58	0.0172414
NODE_63043_length_430_cov_49.791541	372	430	91	1	58	0.0172414
NODE_63043_length_430_cov_49.791541	372	430	95	1	58	0.0172414
NODE_63043_length_430_cov_49.791541	372	430	101	1	58	0.0172414
NODE_63043_length_430_cov_49.791541	372	430	103	2	58	0.0344828
NODE_63043_length_430_cov_49.791541	372	430	109	1	58	0.0172414
NODE_63043_length_430_cov_49.791541	372	430	112	3	58	0.0517241
NODE_63043_length_430_cov_49.791541	372	430	118	1	58	0.0172414
NODE_63043_length_430_cov_49.791541	372	430	123	1	58	0.0172414
NODE_63043_length_430_cov_49.791541	372	430	125	1	58	0.0172414
NODE_63043_length_430_cov_49.791541	372	430	129	3	58	0.0517241
NODE_63043_length_430_cov_49.791541	372	430	133	1	58	0.0172414
NODE_63043_length_430_cov_49.791541	372	430	137	1	58	0.0172414
NODE_63043_length_430_cov_49.791541	372	430	140	1	58	0.0172414
NODE_63043_length_430_cov_49.791541	372	430	142	1	58	0.0172414
NODE_63043_length_430_cov_49.791541	372	430	144	1	58	0.0172414
NODE_63043_length_430_cov_49.791541	372	430	150	1	58	0.0172414
NODE_63043_length_430_cov_49.791541	372	430	152	1	58	0.0172414
NODE_63043_length_430_cov_49.791541	372	430	161	1	58	0.0172414
NODE_63043_length_430_cov_49.791541	372	430	163	4	58	0.0689655
NODE_63043_length_430_cov_49.791541	372	430	167	1	58	0.0172414
NODE_63043_length_430_cov_49.791541	372	430	173	4	58	0.0689655
NODE_63043_length_430_cov_49.791541	372	430	179	1	58	0.0172414
NODE_63043_length_430_cov_49.791541	372	430	182	1	58	0.0172414
NODE_63043_length_430_cov_49.791541	372	430	186	1	58	0.0172414
NODE_63043_length_430_cov_49.791541	372	430	190	1	58	0.0172414
NODE_63043_length_430_cov_49.791541	372	430	192	1	58	0.0172414
NODE_63043_length_430_cov_49.791541	372	430	194	1	58	0.0172414
NODE_63043_length_430_cov_49.791541	372	430	200	1	58	0.0172414
NODE_63043_length_430_cov_49.791541	372	430	203	1	58	0.0172414
NODE_63043_length_430_cov_49.791541	372	430	205	1	58	0.0172414
NODE_63043_length_430_cov_49.791541	372	430	209	1	58	0.0172414
NODE_63043_length_430_cov_49.791541	372	430	214	1	58	0.0172414
NODE_63043_length_430_cov_49.791541	372	430	216	2	58	0.0344828
NODE_63043_length_430_cov_49.791541	372	430	218	1	58	0.0172414
NODE_63044_length_430_cov_44.365559	109	189	0	56	80	0.7000000
NODE_63044_length_430_cov_44.365559	109	189	2	24	80	0.3000000
NODE_63044_length_430_cov_44.365559	162	242	0	3	80	0.0375000
NODE_63044_length_430_cov_44.365559	162	242	2	77	80	0.9625000
NODE_63045_length_430_cov_16.746224	92	172	6	80	80	1.0000000
NODE_63045_length_430_cov_16.746224	145	225	0	34	80	0.4250000
NODE_63045_length_430_cov_16.746224	145	225	6	46	80	0.5750000
NODE_63048_length_430_cov_7.737160	180	263	0	22	83	0.2650602
NODE_63048_length_430_cov_7.737160	180	263	6	61	83	0.7349398
NODE_63050_length_430_cov_6.163142	135	197	0	62	62	1.0000000
NODE_63051_length_430_cov_5.873112	7	90	0	83	83	1.0000000
NODE_63051_length_430_cov_5.873112	60	126	0	31	66	0.4696970
NODE_63051_length_430_cov_5.873112	60	126	2	35	66	0.5303030
NODE_63066_length_430_cov_4.323263	18	90	0	11	72	0.1527778
NODE_63066_length_430_cov_4.323263	18	90	2	61	72	0.8472222
NODE_63161_length_430_cov_1.945619	153	233	0	80	80	1.0000000
NODE_63401_length_430_cov_0.664653	391	430	0	39	39	1.0000000
NODE_63437_length_429_cov_10.424242	78	158	0	42	80	0.5250000
NODE_63437_length_429_cov_10.424242	78	158	2	38	80	0.4750000
NODE_63437_length_429_cov_10.424242	207	287	4	80	80	1.0000000
NODE_63437_length_429_cov_10.424242	260	340	0	38	80	0.4750000
NODE_63437_length_429_cov_10.424242	260	340	4	42	80	0.5250000
NODE_63439_length_429_cov_8.957576	213	293	0	80	80	1.0000000
NODE_63439_length_429_cov_8.957576	266	346	0	80	80	1.0000000
NODE_63441_length_429_cov_6.772727	337	366	0	29	29	1.0000000
NODE_63485_length_429_cov_3.003030	173	251	8	78	78	1.0000000
NODE_63516_length_429_cov_2.433333	220	300	0	2	80	0.0250000
NODE_63516_length_429_cov_2.433333	220	300	2	78	80	0.9750000
NODE_63519_length_429_cov_2.360606	24	85	0	61	61	1.0000000
NODE_63527_length_429_cov_2.224242	115	195	0	80	80	1.0000000
NODE_63547_length_429_cov_2.051515	114	143	6	29	29	1.0000000
NODE_63547_length_429_cov_2.051515	286	348	6	11	62	0.1774193
NODE_63547_length_429_cov_2.051515	286	348	8	4	62	0.0645161
NODE_63547_length_429_cov_2.051515	286	348	10	7	62	0.1129032
NODE_63547_length_429_cov_2.051515	286	348	12	6	62	0.0967742
NODE_63547_length_429_cov_2.051515	286	348	14	34	62	0.5483871
NODE_63864_length_428_cov_40.449848	217	297	0	80	80	1.0000000
NODE_63864_length_428_cov_40.449848	270	350	0	80	80	1.0000000
NODE_63864_length_428_cov_40.449848	346	426	0	80	80	1.0000000
NODE_63865_length_428_cov_31.066869	249	325	4	5	76	0.0657895
NODE_63865_length_428_cov_31.066869	249	325	6	15	76	0.1973684
NODE_63865_length_428_cov_31.066869	249	325	8	22	76	0.2894737
NODE_63865_length_428_cov_31.066869	249	325	10	34	76	0.4473684
NODE_63865_length_428_cov_31.066869	297	378	6	19	81	0.2345679
NODE_63865_length_428_cov_31.066869	297	378	8	16	81	0.1975309
NODE_63865_length_428_cov_31.066869	297	378	10	46	81	0.5679013
NODE_63866_length_428_cov_11.799392	62	142	0	80	80	1.0000000
NODE_63866_length_428_cov_11.799392	115	195	0	80	80	1.0000000
NODE_63867_length_428_cov_10.595745	227	307	0	80	80	1.0000000
NODE_63870_length_428_cov_6.784195	344	374	0	30	30	1.0000000
NODE_63871_length_428_cov_6.768997	131	194	2	6	63	0.0952381
NODE_63871_length_428_cov_6.768997	131	194	4	1	63	0.0158730
NODE_63871_length_428_cov_6.768997	131	194	6	3	63	0.0476190
NODE_63871_length_428_cov_6.768997	131	194	8	10	63	0.1587302
NODE_63871_length_428_cov_6.768997	131	194	11	2	63	0.0317460
NODE_63871_length_428_cov_6.768997	131	194	12	41	63	0.6507937
NODE_63895_length_428_cov_4.206687	224	304	0	80	80	1.0000000
NODE_63905_length_428_cov_3.525836	168	236	0	68	68	1.0000000
NODE_63905_length_428_cov_3.525836	209	244	0	35	35	1.0000000
NODE_63959_length_428_cov_2.322188	1	42	0	7	41	0.1707317
NODE_63959_length_428_cov_2.322188	1	42	2	34	41	0.8292683
NODE_63977_length_428_cov_2.124620	228	308	0	80	80	1.0000000
NODE_64011_length_428_cov_1.848024	178	260	0	82	82	1.0000000
NODE_64027_length_428_cov_1.772036	187	255	2	27	68	0.3970588
NODE_64027_length_428_cov_1.772036	187	255	4	41	68	0.6029412
NODE_64245_length_428_cov_0.790274	275	308	0	33	33	1.0000000
NODE_64245_length_428_cov_0.790274	276	302	0	26	26	1.0000000
NODE_64310_length_427_cov_29.628049	312	392	6	80	80	1.0000000
NODE_64310_length_427_cov_29.628049	365	427	0	18	62	0.2903226
NODE_64310_length_427_cov_29.628049	365	427	6	44	62	0.7096774
NODE_64310_length_427_cov_29.628049	365	427	0	18	62	0.2903226
NODE_64310_length_427_cov_29.628049	365	427	6	44	62	0.7096774
NODE_64312_length_427_cov_9.371951	184	239	3	3	55	0.0545455
NODE_64312_length_427_cov_9.371951	184	239	9	2	55	0.0363636
NODE_64312_length_427_cov_9.371951	184	239	15	3	55	0.0545455
NODE_64312_length_427_cov_9.371951	184	239	16	1	55	0.0181818
NODE_64312_length_427_cov_9.371951	184	239	18	4	55	0.0727273
NODE_64312_length_427_cov_9.371951	184	239	22	16	55	0.2909091
NODE_64312_length_427_cov_9.371951	184	239	24	26	55	0.4727273
NODE_64313_length_427_cov_9.359756	11	82	0	71	71	1.0000000
NODE_64313_length_427_cov_9.359756	70	149	0	79	79	1.0000000
NODE_64313_length_427_cov_9.359756	145	225	0	80	80	1.0000000
NODE_64313_length_427_cov_9.359756	198	278	0	80	80	1.0000000
NODE_64321_length_427_cov_5.929878	405	424	0	19	19	1.0000000
NODE_64324_length_427_cov_5.088415	257	332	0	75	75	1.0000000
NODE_64345_length_427_cov_3.884146	212	260	0	48	48	1.0000000
NODE_64383_length_427_cov_2.765244	312	363	0	51	51	1.0000000
NODE_64409_length_427_cov_2.362805	142	177	6	35	35	1.0000000
NODE_64537_length_427_cov_1.359756	56	139	0	37	83	0.4457831
NODE_64537_length_427_cov_1.359756	56	139	2	46	83	0.5542169
NODE_64728_length_426_cov_21.837920	178	258	0	25	80	0.3125000
NODE_64728_length_426_cov_21.837920	178	258	2	55	80	0.6875000
NODE_64729_length_426_cov_16.850153	76	156	0	80	80	1.0000000
NODE_64729_length_426_cov_16.850153	129	209	0	80	80	1.0000000
NODE_64731_length_426_cov_9.033639	152	232	0	80	80	1.0000000
NODE_64731_length_426_cov_9.033639	205	285	0	80	80	1.0000000
NODE_64734_length_426_cov_8.314985	133	213	0	80	80	1.0000000
NODE_64734_length_426_cov_8.314985	186	266	0	80	80	1.0000000
NODE_64735_length_426_cov_8.278287	132	212	0	80	80	1.0000000
NODE_64735_length_426_cov_8.278287	185	265	0	80	80	1.0000000
NODE_64752_length_426_cov_4.926606	116	196	0	80	80	1.0000000
NODE_64754_length_426_cov_4.743119	119	199	0	8	80	0.1000000
NODE_64754_length_426_cov_4.743119	119	199	3	20	80	0.2500000
NODE_64754_length_426_cov_4.743119	119	199	4	35	80	0.4375000
NODE_64754_length_426_cov_4.743119	119	199	5	17	80	0.2125000
NODE_64754_length_426_cov_4.743119	172	252	2	37	80	0.4625000
NODE_64754_length_426_cov_4.743119	172	252	3	10	80	0.1250000
NODE_64754_length_426_cov_4.743119	172	252	5	33	80	0.4125000
NODE_64833_length_426_cov_2.278287	92	132	0	40	40	1.0000000
NODE_64833_length_426_cov_2.278287	139	205	0	19	66	0.2878788
NODE_64833_length_426_cov_2.278287	139	205	2	47	66	0.7121212
NODE_64865_length_426_cov_1.896024	80	154	0	74	74	1.0000000
NODE_64948_length_426_cov_1.397554	240	290	2	50	50	1.0000000
NODE_65135_length_426_cov_0.602446	127	158	0	31	31	1.0000000
NODE_65152_length_425_cov_63.938650	0	61	0	61	61	1.0000000
NODE_65152_length_425_cov_63.938650	34	114	0	36	80	0.4500000
NODE_65152_length_425_cov_63.938650	34	114	2	44	80	0.5500000
NODE_65164_length_425_cov_4.877301	171	229	20	11	58	0.1896552
NODE_65164_length_425_cov_4.877301	171	229	22	9	58	0.1551724
NODE_65164_length_425_cov_4.877301	171	229	24	8	58	0.1379310
NODE_65164_length_425_cov_4.877301	171	229	26	3	58	0.0517241
NODE_65164_length_425_cov_4.877301	171	229	28	2	58	0.0344828
NODE_65164_length_425_cov_4.877301	171	229	32	8	58	0.1379310
NODE_65164_length_425_cov_4.877301	171	229	34	17	58	0.2931035
NODE_65165_length_425_cov_4.822086	295	377	0	29	82	0.3536585
NODE_65165_length_425_cov_4.822086	295	377	2	35	82	0.4268293
NODE_65165_length_425_cov_4.822086	295	377	6	15	82	0.1829268
NODE_65165_length_425_cov_4.822086	295	377	8	3	82	0.0365854
NODE_65218_length_425_cov_2.809816	38	118	4	5	80	0.0625000
NODE_65218_length_425_cov_2.809816	38	118	6	32	80	0.4000000
NODE_65218_length_425_cov_2.809816	38	118	8	43	80	0.5375000
NODE_65278_length_425_cov_1.935583	93	138	12	9	45	0.2000000
NODE_65278_length_425_cov_1.935583	93	138	14	36	45	0.8000000
NODE_65278_length_425_cov_1.935583	170	225	0	13	55	0.2363636
NODE_65278_length_425_cov_1.935583	170	225	7	9	55	0.1636364
NODE_65278_length_425_cov_1.935583	170	225	9	26	55	0.4727273
NODE_65278_length_425_cov_1.935583	170	225	10	7	55	0.1272727
NODE_65278_length_425_cov_1.935583	312	355	6	11	43	0.2558140
NODE_65278_length_425_cov_1.935583	312	355	8	2	43	0.0465116
NODE_65278_length_425_cov_1.935583	312	355	10	13	43	0.3023256
NODE_65278_length_425_cov_1.935583	312	355	12	17	43	0.3953488
NODE_65565_length_425_cov_0.628834	104	131	0	27	27	1.0000000
NODE_65602_length_424_cov_5.295385	224	270	4	46	46	1.0000000
NODE_65634_length_424_cov_3.255385	266	329	0	1	63	0.0158730
NODE_65634_length_424_cov_3.255385	266	329	2	62	63	0.9841270
NODE_65669_length_424_cov_2.578462	403	422	0	18	19	0.9473684
NODE_65669_length_424_cov_2.578462	403	422	4	1	19	0.0526316
NODE_65670_length_424_cov_2.578462	122	144	0	22	22	1.0000000
NODE_66111_length_423_cov_2.728395	150	229	0	27	79	0.3417721
NODE_66111_length_423_cov_2.728395	150	229	2	15	79	0.1898734
NODE_66111_length_423_cov_2.728395	150	229	4	12	79	0.1518987
NODE_66111_length_423_cov_2.728395	150	229	6	25	79	0.3164557
NODE_66181_length_423_cov_1.879630	94	142	0	48	48	1.0000000
NODE_66222_length_423_cov_1.580247	128	208	0	10	80	0.1250000
NODE_66222_length_423_cov_1.580247	128	208	2	70	80	0.8750000
NODE_66258_length_423_cov_1.410494	206	286	0	80	80	1.0000000
NODE_66459_length_422_cov_12.021672	201	236	3	35	35	1.0000000
NODE_66459_length_422_cov_12.021672	247	289	4	5	42	0.1190476
NODE_66459_length_422_cov_12.021672	247	289	5	37	42	0.8809524
NODE_66460_length_422_cov_10.712074	62	140	0	78	78	1.0000000
NODE_66460_length_422_cov_10.712074	115	195	0	80	80	1.0000000
NODE_66468_length_422_cov_6.281734	37	117	0	57	80	0.7125000
NODE_66468_length_422_cov_6.281734	37	117	2	23	80	0.2875000
NODE_66468_length_422_cov_6.281734	90	170	0	4	80	0.0500000
NODE_66468_length_422_cov_6.281734	90	170	2	76	80	0.9500000
NODE_66474_length_422_cov_5.266254	176	256	0	80	80	1.0000000
NODE_66485_length_422_cov_4.148607	159	224	0	65	65	1.0000000
NODE_66485_length_422_cov_4.148607	197	277	0	80	80	1.0000000
NODE_66488_length_422_cov_4.003096	146	226	0	80	80	1.0000000
NODE_66488_length_422_cov_4.003096	199	279	0	61	80	0.7625000
NODE_66488_length_422_cov_4.003096	199	279	2	2	80	0.0250000
NODE_66488_length_422_cov_4.003096	199	279	4	1	80	0.0125000
NODE_66488_length_422_cov_4.003096	199	279	6	16	80	0.2000000
NODE_66512_length_422_cov_3.130031	93	173	0	80	80	1.0000000
NODE_66512_length_422_cov_3.130031	146	226	0	80	80	1.0000000
NODE_66515_length_422_cov_3.077399	291	359	18	3	68	0.0441176
NODE_66515_length_422_cov_3.077399	291	359	20	1	68	0.0147059
NODE_66515_length_422_cov_3.077399	291	359	22	1	68	0.0147059
NODE_66515_length_422_cov_3.077399	291	359	23	3	68	0.0441176
NODE_66515_length_422_cov_3.077399	291	359	28	7	68	0.1029412
NODE_66515_length_422_cov_3.077399	291	359	30	2	68	0.0294118
NODE_66515_length_422_cov_3.077399	291	359	32	18	68	0.2647059
NODE_66515_length_422_cov_3.077399	291	359	34	16	68	0.2352941
NODE_66515_length_422_cov_3.077399	291	359	36	5	68	0.0735294
NODE_66515_length_422_cov_3.077399	291	359	37	1	68	0.0147059
NODE_66515_length_422_cov_3.077399	291	359	39	1	68	0.0147059
NODE_66515_length_422_cov_3.077399	291	359	40	1	68	0.0147059
NODE_66515_length_422_cov_3.077399	291	359	42	5	68	0.0735294
NODE_66515_length_422_cov_3.077399	291	359	44	3	68	0.0441176
NODE_66515_length_422_cov_3.077399	291	359	46	1	68	0.0147059
NODE_66550_length_422_cov_2.191950	5	24	0	19	19	1.0000000
NODE_66560_length_422_cov_2.108359	97	177	0	46	80	0.5750000
NODE_66560_length_422_cov_2.108359	97	177	1	1	80	0.0125000
NODE_66560_length_422_cov_2.108359	97	177	2	13	80	0.1625000
NODE_66560_length_422_cov_2.108359	97	177	4	1	80	0.0125000
NODE_66560_length_422_cov_2.108359	97	177	8	1	80	0.0125000
NODE_66560_length_422_cov_2.108359	97	177	10	3	80	0.0375000
NODE_66560_length_422_cov_2.108359	97	177	12	2	80	0.0250000
NODE_66560_length_422_cov_2.108359	97	177	14	13	80	0.1625000
NODE_66560_length_422_cov_2.108359	150	189	0	26	39	0.6666667
NODE_66560_length_422_cov_2.108359	150	189	1	13	39	0.3333333
NODE_66560_length_422_cov_2.108359	249	289	18	3	40	0.0750000
NODE_66560_length_422_cov_2.108359	249	289	20	2	40	0.0500000
NODE_66560_length_422_cov_2.108359	249	289	23	6	40	0.1500000
NODE_66560_length_422_cov_2.108359	249	289	25	4	40	0.1000000
NODE_66560_length_422_cov_2.108359	249	289	26	5	40	0.1250000
NODE_66560_length_422_cov_2.108359	249	289	28	1	40	0.0250000
NODE_66560_length_422_cov_2.108359	249	289	30	13	40	0.3250000
NODE_66560_length_422_cov_2.108359	249	289	32	1	40	0.0250000
NODE_66560_length_422_cov_2.108359	249	289	34	2	40	0.0500000
NODE_66560_length_422_cov_2.108359	249	289	36	1	40	0.0250000
NODE_66560_length_422_cov_2.108359	249	289	40	2	40	0.0500000
NODE_66806_length_422_cov_0.845201	2	76	0	74	74	1.0000000
NODE_66869_length_421_cov_10.664596	178	256	0	78	78	1.0000000
NODE_66869_length_421_cov_10.664596	229	309	0	80	80	1.0000000
NODE_66874_length_421_cov_7.552795	325	407	0	80	82	0.9756098
NODE_66874_length_421_cov_7.552795	325	407	20	2	82	0.0243902
NODE_66874_length_421_cov_7.552795	380	421	0	41	41	1.0000000
NODE_66875_length_421_cov_7.431677	96	118	0	22	22	1.0000000
NODE_66883_length_421_cov_5.279503	245	310	0	65	65	1.0000000
NODE_66884_length_421_cov_5.158385	68	145	0	77	77	1.0000000
NODE_66897_length_421_cov_4.114907	221	287	0	66	66	1.0000000
NODE_66898_length_421_cov_4.102484	202	277	0	75	75	1.0000000
NODE_66899_length_421_cov_4.040373	192	272	0	80	80	1.0000000
NODE_66899_length_421_cov_4.040373	245	314	0	69	69	1.0000000
NODE_66923_length_421_cov_3.319876	0	57	0	57	57	1.0000000
NODE_66955_length_421_cov_2.708075	95	118	0	23	23	1.0000000
NODE_66955_length_421_cov_2.708075	109	189	0	80	80	1.0000000
NODE_66955_length_421_cov_2.708075	248	300	0	52	52	1.0000000
NODE_67073_length_421_cov_1.559006	240	309	0	11	69	0.1594203
NODE_67073_length_421_cov_1.559006	240	309	2	58	69	0.8405797
NODE_67073_length_421_cov_1.559006	240	310	0	12	70	0.1714286
NODE_67073_length_421_cov_1.559006	240	310	2	58	70	0.8285714
NODE_67077_length_421_cov_1.537267	305	383	0	26	78	0.3333333
NODE_67077_length_421_cov_1.537267	305	383	2	52	78	0.6666667
NODE_67098_length_421_cov_1.413043	254	303	0	49	49	1.0000000
NODE_67283_length_421_cov_0.633540	132	156	0	24	24	1.0000000
NODE_67317_length_420_cov_80.766355	90	170	0	45	80	0.5625000
NODE_67317_length_420_cov_80.766355	90	170	7	1	80	0.0125000
NODE_67317_length_420_cov_80.766355	90	170	9	9	80	0.1125000
NODE_67317_length_420_cov_80.766355	90	170	10	22	80	0.2750000
NODE_67317_length_420_cov_80.766355	90	170	16	3	80	0.0375000
NODE_67317_length_420_cov_80.766355	143	223	9	2	80	0.0250000
NODE_67317_length_420_cov_80.766355	143	223	10	22	80	0.2750000
NODE_67317_length_420_cov_80.766355	143	223	16	56	80	0.7000000
NODE_67319_length_420_cov_51.473520	171	250	0	79	79	1.0000000
NODE_67319_length_420_cov_51.473520	223	307	0	84	84	1.0000000
NODE_67319_length_420_cov_51.473520	303	383	0	80	80	1.0000000
NODE_67319_length_420_cov_51.473520	356	420	0	64	64	1.0000000
NODE_67330_length_420_cov_5.071651	230	310	4	7	80	0.0875000
NODE_67330_length_420_cov_5.071651	230	310	7	21	80	0.2625000
NODE_67330_length_420_cov_5.071651	230	310	8	30	80	0.3750000
NODE_67330_length_420_cov_5.071651	230	310	9	22	80	0.2750000
NODE_67334_length_420_cov_4.775701	177	221	0	44	44	1.0000000
NODE_67345_length_420_cov_4.037383	161	240	0	32	79	0.4050633
NODE_67345_length_420_cov_4.037383	161	240	2	10	79	0.1265823
NODE_67345_length_420_cov_4.037383	161	240	4	37	79	0.4683544
NODE_67358_length_420_cov_3.657321	291	373	0	82	82	1.0000000
NODE_67398_length_420_cov_2.542056	96	176	0	80	80	1.0000000
NODE_67398_length_420_cov_2.542056	148	202	0	54	54	1.0000000
NODE_67398_length_420_cov_2.542056	149	195	0	46	46	1.0000000
NODE_67414_length_420_cov_2.323988	89	108	2	19	19	1.0000000
NODE_67506_length_420_cov_1.641745	277	312	0	35	35	1.0000000
NODE_67547_length_420_cov_1.429907	15	68	2	9	53	0.1698113
NODE_67547_length_420_cov_1.429907	15	68	4	7	53	0.1320755
NODE_67547_length_420_cov_1.429907	15	68	6	2	53	0.0377358
NODE_67547_length_420_cov_1.429907	15	68	8	2	53	0.0377358
NODE_67547_length_420_cov_1.429907	15	68	12	5	53	0.0943396
NODE_67547_length_420_cov_1.429907	15	68	14	1	53	0.0188679
NODE_67547_length_420_cov_1.429907	15	68	18	9	53	0.1698113
NODE_67547_length_420_cov_1.429907	15	68	20	18	53	0.3396226
NODE_67547_length_420_cov_1.429907	69	111	18	28	42	0.6666667
NODE_67547_length_420_cov_1.429907	69	111	20	9	42	0.2142857
NODE_67547_length_420_cov_1.429907	69	111	24	5	42	0.1190476
NODE_67770_length_419_cov_491.015625	0	67	4	5	67	0.0746269
NODE_67770_length_419_cov_491.015625	0	67	8	21	67	0.3134328
NODE_67770_length_419_cov_491.015625	0	67	10	11	67	0.1641791
NODE_67770_length_419_cov_491.015625	0	67	12	6	67	0.0895522
NODE_67770_length_419_cov_491.015625	0	67	14	10	67	0.1492537
NODE_67770_length_419_cov_491.015625	0	67	26	7	67	0.1044776
NODE_67770_length_419_cov_491.015625	0	67	28	1	67	0.0149254
NODE_67770_length_419_cov_491.015625	0	67	32	6	67	0.0895522
NODE_67770_length_419_cov_491.015625	0	67	4	5	67	0.0746269
NODE_67770_length_419_cov_491.015625	0	67	8	21	67	0.3134328
NODE_67770_length_419_cov_491.015625	0	67	10	11	67	0.1641791
NODE_67770_length_419_cov_491.015625	0	67	12	6	67	0.0895522
NODE_67770_length_419_cov_491.015625	0	67	14	10	67	0.1492537
NODE_67770_length_419_cov_491.015625	0	67	26	7	67	0.1044776
NODE_67770_length_419_cov_491.015625	0	67	28	1	67	0.0149254
NODE_67770_length_419_cov_491.015625	0	67	32	6	67	0.0895522
NODE_67770_length_419_cov_491.015625	0	67	4	5	67	0.0746269
NODE_67770_length_419_cov_491.015625	0	67	8	21	67	0.3134328
NODE_67770_length_419_cov_491.015625	0	67	10	11	67	0.1641791
NODE_67770_length_419_cov_491.015625	0	67	12	6	67	0.0895522
NODE_67770_length_419_cov_491.015625	0	67	14	10	67	0.1492537
NODE_67770_length_419_cov_491.015625	0	67	26	7	67	0.1044776
NODE_67770_length_419_cov_491.015625	0	67	28	1	67	0.0149254
NODE_67770_length_419_cov_491.015625	0	67	32	6	67	0.0895522
NODE_67770_length_419_cov_491.015625	0	67	4	5	67	0.0746269
NODE_67770_length_419_cov_491.015625	0	67	8	21	67	0.3134328
NODE_67770_length_419_cov_491.015625	0	67	10	11	67	0.1641791
NODE_67770_length_419_cov_491.015625	0	67	12	6	67	0.0895522
NODE_67770_length_419_cov_491.015625	0	67	14	10	67	0.1492537
NODE_67770_length_419_cov_491.015625	0	67	26	7	67	0.1044776
NODE_67770_length_419_cov_491.015625	0	67	28	1	67	0.0149254
NODE_67770_length_419_cov_491.015625	0	67	32	6	67	0.0895522
NODE_67770_length_419_cov_491.015625	63	143	32	9	80	0.1125000
NODE_67770_length_419_cov_491.015625	63	143	34	4	80	0.0500000
NODE_67770_length_419_cov_491.015625	63	143	41	3	80	0.0375000
NODE_67770_length_419_cov_491.015625	63	143	43	3	80	0.0375000
NODE_67770_length_419_cov_491.015625	63	143	51	3	80	0.0375000
NODE_67770_length_419_cov_491.015625	63	143	55	2	80	0.0250000
NODE_67770_length_419_cov_491.015625	63	143	56	7	80	0.0875000
NODE_67770_length_419_cov_491.015625	63	143	64	8	80	0.1000000
NODE_67770_length_419_cov_491.015625	63	143	66	1	80	0.0125000
NODE_67770_length_419_cov_491.015625	63	143	67	2	80	0.0250000
NODE_67770_length_419_cov_491.015625	63	143	69	4	80	0.0500000
NODE_67770_length_419_cov_491.015625	63	143	71	11	80	0.1375000
NODE_67770_length_419_cov_491.015625	63	143	76	1	80	0.0125000
NODE_67770_length_419_cov_491.015625	63	143	77	4	80	0.0500000
NODE_67770_length_419_cov_491.015625	63	143	78	1	80	0.0125000
NODE_67770_length_419_cov_491.015625	63	143	79	3	80	0.0375000
NODE_67770_length_419_cov_491.015625	63	143	80	3	80	0.0375000
NODE_67770_length_419_cov_491.015625	63	143	81	11	80	0.1375000
NODE_67770_length_419_cov_491.015625	63	143	32	9	80	0.1125000
NODE_67770_length_419_cov_491.015625	63	143	34	4	80	0.0500000
NODE_67770_length_419_cov_491.015625	63	143	41	3	80	0.0375000
NODE_67770_length_419_cov_491.015625	63	143	43	3	80	0.0375000
NODE_67770_length_419_cov_491.015625	63	143	51	3	80	0.0375000
NODE_67770_length_419_cov_491.015625	63	143	55	2	80	0.0250000
NODE_67770_length_419_cov_491.015625	63	143	56	7	80	0.0875000
NODE_67770_length_419_cov_491.015625	63	143	64	8	80	0.1000000
NODE_67770_length_419_cov_491.015625	63	143	66	1	80	0.0125000
NODE_67770_length_419_cov_491.015625	63	143	67	2	80	0.0250000
NODE_67770_length_419_cov_491.015625	63	143	69	4	80	0.0500000
NODE_67770_length_419_cov_491.015625	63	143	71	11	80	0.1375000
NODE_67770_length_419_cov_491.015625	63	143	76	1	80	0.0125000
NODE_67770_length_419_cov_491.015625	63	143	77	4	80	0.0500000
NODE_67770_length_419_cov_491.015625	63	143	78	1	80	0.0125000
NODE_67770_length_419_cov_491.015625	63	143	79	3	80	0.0375000
NODE_67770_length_419_cov_491.015625	63	143	80	3	80	0.0375000
NODE_67770_length_419_cov_491.015625	63	143	81	11	80	0.1375000
NODE_67770_length_419_cov_491.015625	63	143	32	9	80	0.1125000
NODE_67770_length_419_cov_491.015625	63	143	34	4	80	0.0500000
NODE_67770_length_419_cov_491.015625	63	143	41	3	80	0.0375000
NODE_67770_length_419_cov_491.015625	63	143	43	3	80	0.0375000
NODE_67770_length_419_cov_491.015625	63	143	51	3	80	0.0375000
NODE_67770_length_419_cov_491.015625	63	143	55	2	80	0.0250000
NODE_67770_length_419_cov_491.015625	63	143	56	7	80	0.0875000
NODE_67770_length_419_cov_491.015625	63	143	64	8	80	0.1000000
NODE_67770_length_419_cov_491.015625	63	143	66	1	80	0.0125000
NODE_67770_length_419_cov_491.015625	63	143	67	2	80	0.0250000
NODE_67770_length_419_cov_491.015625	63	143	69	4	80	0.0500000
NODE_67770_length_419_cov_491.015625	63	143	71	11	80	0.1375000
NODE_67770_length_419_cov_491.015625	63	143	76	1	80	0.0125000
NODE_67770_length_419_cov_491.015625	63	143	77	4	80	0.0500000
NODE_67770_length_419_cov_491.015625	63	143	78	1	80	0.0125000
NODE_67770_length_419_cov_491.015625	63	143	79	3	80	0.0375000
NODE_67770_length_419_cov_491.015625	63	143	80	3	80	0.0375000
NODE_67770_length_419_cov_491.015625	63	143	81	11	80	0.1375000
NODE_67770_length_419_cov_491.015625	116	196	45	2	80	0.0250000
NODE_67770_length_419_cov_491.015625	116	196	50	2	80	0.0250000
NODE_67770_length_419_cov_491.015625	116	196	51	8	80	0.1000000
NODE_67770_length_419_cov_491.015625	116	196	52	2	80	0.0250000
NODE_67770_length_419_cov_491.015625	116	196	54	1	80	0.0125000
NODE_67770_length_419_cov_491.015625	116	196	55	5	80	0.0625000
NODE_67770_length_419_cov_491.015625	116	196	59	4	80	0.0500000
NODE_67770_length_419_cov_491.015625	116	196	60	2	80	0.0250000
NODE_67770_length_419_cov_491.015625	116	196	61	20	80	0.2500000
NODE_67770_length_419_cov_491.015625	116	196	65	2	80	0.0250000
NODE_67770_length_419_cov_491.015625	116	196	71	4	80	0.0500000
NODE_67770_length_419_cov_491.015625	116	196	76	1	80	0.0125000
NODE_67770_length_419_cov_491.015625	116	196	77	4	80	0.0500000
NODE_67770_length_419_cov_491.015625	116	196	78	1	80	0.0125000
NODE_67770_length_419_cov_491.015625	116	196	79	3	80	0.0375000
NODE_67770_length_419_cov_491.015625	116	196	80	3	80	0.0375000
NODE_67770_length_419_cov_491.015625	116	196	81	16	80	0.2000000
NODE_67770_length_419_cov_491.015625	116	196	45	2	80	0.0250000
NODE_67770_length_419_cov_491.015625	116	196	50	2	80	0.0250000
NODE_67770_length_419_cov_491.015625	116	196	51	8	80	0.1000000
NODE_67770_length_419_cov_491.015625	116	196	52	2	80	0.0250000
NODE_67770_length_419_cov_491.015625	116	196	54	1	80	0.0125000
NODE_67770_length_419_cov_491.015625	116	196	55	5	80	0.0625000
NODE_67770_length_419_cov_491.015625	116	196	59	4	80	0.0500000
NODE_67770_length_419_cov_491.015625	116	196	60	2	80	0.0250000
NODE_67770_length_419_cov_491.015625	116	196	61	20	80	0.2500000
NODE_67770_length_419_cov_491.015625	116	196	65	2	80	0.0250000
NODE_67770_length_419_cov_491.015625	116	196	71	4	80	0.0500000
NODE_67770_length_419_cov_491.015625	116	196	76	1	80	0.0125000
NODE_67770_length_419_cov_491.015625	116	196	77	4	80	0.0500000
NODE_67770_length_419_cov_491.015625	116	196	78	1	80	0.0125000
NODE_67770_length_419_cov_491.015625	116	196	79	3	80	0.0375000
NODE_67770_length_419_cov_491.015625	116	196	80	3	80	0.0375000
NODE_67770_length_419_cov_491.015625	116	196	81	16	80	0.2000000
NODE_67770_length_419_cov_491.015625	116	196	45	2	80	0.0250000
NODE_67770_length_419_cov_491.015625	116	196	50	2	80	0.0250000
NODE_67770_length_419_cov_491.015625	116	196	51	8	80	0.1000000
NODE_67770_length_419_cov_491.015625	116	196	52	2	80	0.0250000
NODE_67770_length_419_cov_491.015625	116	196	54	1	80	0.0125000
NODE_67770_length_419_cov_491.015625	116	196	55	5	80	0.0625000
NODE_67770_length_419_cov_491.015625	116	196	59	4	80	0.0500000
NODE_67770_length_419_cov_491.015625	116	196	60	2	80	0.0250000
NODE_67770_length_419_cov_491.015625	116	196	61	20	80	0.2500000
NODE_67770_length_419_cov_491.015625	116	196	65	2	80	0.0250000
NODE_67770_length_419_cov_491.015625	116	196	71	4	80	0.0500000
NODE_67770_length_419_cov_491.015625	116	196	76	1	80	0.0125000
NODE_67770_length_419_cov_491.015625	116	196	77	4	80	0.0500000
NODE_67770_length_419_cov_491.015625	116	196	78	1	80	0.0125000
NODE_67770_length_419_cov_491.015625	116	196	79	3	80	0.0375000
NODE_67770_length_419_cov_491.015625	116	196	80	3	80	0.0375000
NODE_67770_length_419_cov_491.015625	116	196	81	16	80	0.2000000
NODE_67770_length_419_cov_491.015625	116	196	45	2	80	0.0250000
NODE_67770_length_419_cov_491.015625	116	196	50	2	80	0.0250000
NODE_67770_length_419_cov_491.015625	116	196	51	8	80	0.1000000
NODE_67770_length_419_cov_491.015625	116	196	52	2	80	0.0250000
NODE_67770_length_419_cov_491.015625	116	196	54	1	80	0.0125000
NODE_67770_length_419_cov_491.015625	116	196	55	5	80	0.0625000
NODE_67770_length_419_cov_491.015625	116	196	59	4	80	0.0500000
NODE_67770_length_419_cov_491.015625	116	196	60	2	80	0.0250000
NODE_67770_length_419_cov_491.015625	116	196	61	20	80	0.2500000
NODE_67770_length_419_cov_491.015625	116	196	65	2	80	0.0250000
NODE_67770_length_419_cov_491.015625	116	196	71	4	80	0.0500000
NODE_67770_length_419_cov_491.015625	116	196	76	1	80	0.0125000
NODE_67770_length_419_cov_491.015625	116	196	77	4	80	0.0500000
NODE_67770_length_419_cov_491.015625	116	196	78	1	80	0.0125000
NODE_67770_length_419_cov_491.015625	116	196	79	3	80	0.0375000
NODE_67770_length_419_cov_491.015625	116	196	80	3	80	0.0375000
NODE_67770_length_419_cov_491.015625	116	196	81	16	80	0.2000000
NODE_67770_length_419_cov_491.015625	116	196	45	2	80	0.0250000
NODE_67770_length_419_cov_491.015625	116	196	50	2	80	0.0250000
NODE_67770_length_419_cov_491.015625	116	196	51	8	80	0.1000000
NODE_67770_length_419_cov_491.015625	116	196	52	2	80	0.0250000
NODE_67770_length_419_cov_491.015625	116	196	54	1	80	0.0125000
NODE_67770_length_419_cov_491.015625	116	196	55	5	80	0.0625000
NODE_67770_length_419_cov_491.015625	116	196	59	4	80	0.0500000
NODE_67770_length_419_cov_491.015625	116	196	60	2	80	0.0250000
NODE_67770_length_419_cov_491.015625	116	196	61	20	80	0.2500000
NODE_67770_length_419_cov_491.015625	116	196	65	2	80	0.0250000
NODE_67770_length_419_cov_491.015625	116	196	71	4	80	0.0500000
NODE_67770_length_419_cov_491.015625	116	196	76	1	80	0.0125000
NODE_67770_length_419_cov_491.015625	116	196	77	4	80	0.0500000
NODE_67770_length_419_cov_491.015625	116	196	78	1	80	0.0125000
NODE_67770_length_419_cov_491.015625	116	196	79	3	80	0.0375000
NODE_67770_length_419_cov_491.015625	116	196	80	3	80	0.0375000
NODE_67770_length_419_cov_491.015625	116	196	81	16	80	0.2000000
NODE_67772_length_419_cov_31.725000	12	92	0	80	80	1.0000000
NODE_67772_length_419_cov_31.725000	65	145	0	80	80	1.0000000
NODE_67789_length_419_cov_4.862500	47	103	2	56	56	1.0000000
NODE_67789_length_419_cov_4.862500	258	327	8	56	69	0.8115942
NODE_67789_length_419_cov_4.862500	258	327	10	13	69	0.1884058
NODE_67789_length_419_cov_4.862500	284	328	8	31	44	0.7045454
NODE_67789_length_419_cov_4.862500	284	328	10	13	44	0.2954545
NODE_67803_length_419_cov_4.193750	215	262	0	3	47	0.0638298
NODE_67803_length_419_cov_4.193750	215	262	8	22	47	0.4680851
NODE_67803_length_419_cov_4.193750	215	262	12	22	47	0.4680851
NODE_67803_length_419_cov_4.193750	235	275	8	5	40	0.1250000
NODE_67803_length_419_cov_4.193750	235	275	12	35	40	0.8750000
NODE_67817_length_419_cov_3.696875	165	215	0	50	50	1.0000000
NODE_67854_length_419_cov_2.628125	234	314	0	56	80	0.7000000
NODE_67854_length_419_cov_2.628125	234	314	2	24	80	0.3000000
NODE_67856_length_419_cov_2.603125	154	196	2	42	42	1.0000000
NODE_67878_length_419_cov_2.350000	156	220	10	3	64	0.0468750
NODE_67878_length_419_cov_2.350000	156	220	11	5	64	0.0781250
NODE_67878_length_419_cov_2.350000	156	220	12	2	64	0.0312500
NODE_67878_length_419_cov_2.350000	156	220	16	15	64	0.2343750
NODE_67878_length_419_cov_2.350000	156	220	17	7	64	0.1093750
NODE_67878_length_419_cov_2.350000	156	220	18	17	64	0.2656250
NODE_67878_length_419_cov_2.350000	156	220	19	15	64	0.2343750
NODE_67961_length_419_cov_1.593750	339	358	2	19	19	1.0000000
NODE_68250_length_418_cov_63.059561	105	186	0	41	81	0.5061728
NODE_68250_length_418_cov_63.059561	105	186	2	14	81	0.1728395
NODE_68250_length_418_cov_63.059561	105	186	5	1	81	0.0123457
NODE_68250_length_418_cov_63.059561	105	186	6	11	81	0.1358025
NODE_68250_length_418_cov_63.059561	105	186	8	14	81	0.1728395
NODE_68250_length_418_cov_63.059561	159	239	2	1	80	0.0125000
NODE_68250_length_418_cov_63.059561	159	239	5	1	80	0.0125000
NODE_68250_length_418_cov_63.059561	159	239	6	16	80	0.2000000
NODE_68250_length_418_cov_63.059561	159	239	8	62	80	0.7750000
NODE_68251_length_418_cov_49.796238	325	405	18	2	80	0.0250000
NODE_68251_length_418_cov_49.796238	325	405	20	1	80	0.0125000
NODE_68251_length_418_cov_49.796238	325	405	22	3	80	0.0375000
NODE_68251_length_418_cov_49.796238	325	405	23	3	80	0.0375000
NODE_68251_length_418_cov_49.796238	325	405	25	3	80	0.0375000
NODE_68251_length_418_cov_49.796238	325	405	29	3	80	0.0375000
NODE_68251_length_418_cov_49.796238	325	405	31	2	80	0.0250000
NODE_68251_length_418_cov_49.796238	325	405	33	1	80	0.0125000
NODE_68251_length_418_cov_49.796238	325	405	37	1	80	0.0125000
NODE_68251_length_418_cov_49.796238	325	405	40	1	80	0.0125000
NODE_68251_length_418_cov_49.796238	325	405	44	1	80	0.0125000
NODE_68251_length_418_cov_49.796238	325	405	50	1	80	0.0125000
NODE_68251_length_418_cov_49.796238	325	405	55	2	80	0.0250000
NODE_68251_length_418_cov_49.796238	325	405	61	6	80	0.0750000
NODE_68251_length_418_cov_49.796238	325	405	63	4	80	0.0500000
NODE_68251_length_418_cov_49.796238	325	405	65	1	80	0.0125000
NODE_68251_length_418_cov_49.796238	325	405	71	6	80	0.0750000
NODE_68251_length_418_cov_49.796238	325	405	76	1	80	0.0125000
NODE_68251_length_418_cov_49.796238	325	405	82	3	80	0.0375000
NODE_68251_length_418_cov_49.796238	325	405	88	6	80	0.0750000
NODE_68251_length_418_cov_49.796238	325	405	90	1	80	0.0125000
NODE_68251_length_418_cov_49.796238	325	405	94	1	80	0.0125000
NODE_68251_length_418_cov_49.796238	325	405	96	1	80	0.0125000
NODE_68251_length_418_cov_49.796238	325	405	97	1	80	0.0125000
NODE_68251_length_418_cov_49.796238	325	405	106	1	80	0.0125000
NODE_68251_length_418_cov_49.796238	325	405	109	5	80	0.0625000
NODE_68251_length_418_cov_49.796238	325	405	110	2	80	0.0250000
NODE_68251_length_418_cov_49.796238	325	405	113	2	80	0.0250000
NODE_68251_length_418_cov_49.796238	325	405	115	3	80	0.0375000
NODE_68251_length_418_cov_49.796238	325	405	124	1	80	0.0125000
NODE_68251_length_418_cov_49.796238	325	405	131	1	80	0.0125000
NODE_68251_length_418_cov_49.796238	325	405	133	2	80	0.0250000
NODE_68251_length_418_cov_49.796238	325	405	136	1	80	0.0125000
NODE_68251_length_418_cov_49.796238	325	405	137	2	80	0.0250000
NODE_68251_length_418_cov_49.796238	325	405	145	2	80	0.0250000
NODE_68251_length_418_cov_49.796238	325	405	154	1	80	0.0125000
NODE_68251_length_418_cov_49.796238	325	405	160	2	80	0.0250000
NODE_68251_length_418_cov_49.796238	378	415	3	1	37	0.0270270
NODE_68251_length_418_cov_49.796238	378	415	7	1	37	0.0270270
NODE_68251_length_418_cov_49.796238	378	415	12	2	37	0.0540541
NODE_68251_length_418_cov_49.796238	378	415	18	8	37	0.2162162
NODE_68251_length_418_cov_49.796238	378	415	20	1	37	0.0270270
NODE_68251_length_418_cov_49.796238	378	415	22	3	37	0.0810811
NODE_68251_length_418_cov_49.796238	378	415	23	3	37	0.0810811
NODE_68251_length_418_cov_49.796238	378	415	25	3	37	0.0810811
NODE_68251_length_418_cov_49.796238	378	415	29	3	37	0.0810811
NODE_68251_length_418_cov_49.796238	378	415	31	2	37	0.0540541
NODE_68251_length_418_cov_49.796238	378	415	33	1	37	0.0270270
NODE_68251_length_418_cov_49.796238	378	415	37	1	37	0.0270270
NODE_68251_length_418_cov_49.796238	378	415	40	1	37	0.0270270
NODE_68251_length_418_cov_49.796238	378	415	44	1	37	0.0270270
NODE_68251_length_418_cov_49.796238	378	415	50	1	37	0.0270270
NODE_68251_length_418_cov_49.796238	378	415	55	2	37	0.0540541
NODE_68251_length_418_cov_49.796238	378	415	61	3	37	0.0810811
NODE_68252_length_418_cov_42.764890	119	196	0	6	77	0.0779221
NODE_68252_length_418_cov_42.764890	119	196	6	55	77	0.7142857
NODE_68252_length_418_cov_42.764890	119	196	12	1	77	0.0129870
NODE_68252_length_418_cov_42.764890	119	196	14	15	77	0.1948052
NODE_68252_length_418_cov_42.764890	172	250	6	8	78	0.1025641
NODE_68252_length_418_cov_42.764890	172	250	12	1	78	0.0128205
NODE_68252_length_418_cov_42.764890	172	250	14	69	78	0.8846154
NODE_68253_length_418_cov_23.830721	73	153	0	80	80	1.0000000
NODE_68253_length_418_cov_23.830721	126	200	0	74	74	1.0000000
NODE_68255_length_418_cov_7.216301	211	291	4	2	80	0.0250000
NODE_68255_length_418_cov_7.216301	211	291	6	9	80	0.1125000
NODE_68255_length_418_cov_7.216301	211	291	8	69	80	0.8625000
NODE_68265_length_418_cov_5.382445	134	215	0	81	81	1.0000000
NODE_68265_length_418_cov_5.382445	187	268	0	81	81	1.0000000
NODE_68275_length_418_cov_4.463950	191	272	2	81	81	1.0000000
NODE_68280_length_418_cov_4.216301	148	230	0	58	82	0.7073171
NODE_68280_length_418_cov_4.216301	148	230	2	24	82	0.2926829
NODE_68281_length_418_cov_4.065831	211	280	0	69	69	1.0000000
NODE_68284_length_418_cov_3.909091	95	175	5	9	80	0.1125000
NODE_68284_length_418_cov_3.909091	95	175	6	1	80	0.0125000
NODE_68284_length_418_cov_3.909091	95	175	7	3	80	0.0375000
NODE_68284_length_418_cov_3.909091	95	175	8	12	80	0.1500000
NODE_68284_length_418_cov_3.909091	95	175	9	1	80	0.0125000
NODE_68284_length_418_cov_3.909091	95	175	13	8	80	0.1000000
NODE_68284_length_418_cov_3.909091	95	175	17	1	80	0.0125000
NODE_68284_length_418_cov_3.909091	95	175	19	1	80	0.0125000
NODE_68284_length_418_cov_3.909091	95	175	21	1	80	0.0125000
NODE_68284_length_418_cov_3.909091	95	175	23	1	80	0.0125000
NODE_68284_length_418_cov_3.909091	95	175	27	1	80	0.0125000
NODE_68284_length_418_cov_3.909091	95	175	29	1	80	0.0125000
NODE_68284_length_418_cov_3.909091	95	175	31	8	80	0.1000000
NODE_68284_length_418_cov_3.909091	95	175	33	4	80	0.0500000
NODE_68284_length_418_cov_3.909091	95	175	35	7	80	0.0875000
NODE_68284_length_418_cov_3.909091	95	175	37	5	80	0.0625000
NODE_68284_length_418_cov_3.909091	95	175	39	5	80	0.0625000
NODE_68284_length_418_cov_3.909091	95	175	40	8	80	0.1000000
NODE_68284_length_418_cov_3.909091	95	175	41	3	80	0.0375000
NODE_68284_length_418_cov_3.909091	148	224	5	14	76	0.1842105
NODE_68284_length_418_cov_3.909091	148	224	6	3	76	0.0394737
NODE_68284_length_418_cov_3.909091	148	224	7	3	76	0.0394737
NODE_68284_length_418_cov_3.909091	148	224	8	19	76	0.2500000
NODE_68284_length_418_cov_3.909091	148	224	9	1	76	0.0131579
NODE_68284_length_418_cov_3.909091	148	224	10	10	76	0.1315790
NODE_68284_length_418_cov_3.909091	148	224	12	3	76	0.0394737
NODE_68284_length_418_cov_3.909091	148	224	13	1	76	0.0131579
NODE_68284_length_418_cov_3.909091	148	224	14	1	76	0.0131579
NODE_68284_length_418_cov_3.909091	148	224	16	2	76	0.0263158
NODE_68284_length_418_cov_3.909091	148	224	18	2	76	0.0263158
NODE_68284_length_418_cov_3.909091	148	224	20	3	76	0.0394737
NODE_68284_length_418_cov_3.909091	148	224	22	3	76	0.0394737
NODE_68284_length_418_cov_3.909091	148	224	24	5	76	0.0657895
NODE_68284_length_418_cov_3.909091	148	224	25	6	76	0.0789474
NODE_68288_length_418_cov_3.749216	181	247	8	32	66	0.4848485
NODE_68288_length_418_cov_3.749216	181	247	10	34	66	0.5151515
NODE_68289_length_418_cov_3.711599	249	313	0	64	64	1.0000000
NODE_68307_length_418_cov_3.012539	101	181	2	16	80	0.2000000
NODE_68307_length_418_cov_3.012539	101	181	4	64	80	0.8000000
NODE_68354_length_418_cov_2.376176	95	115	0	20	20	1.0000000
NODE_68436_length_418_cov_1.623824	47	128	0	81	81	1.0000000
NODE_68436_length_418_cov_1.623824	239	268	11	22	29	0.7586207
NODE_68436_length_418_cov_1.623824	239	268	13	7	29	0.2413793
NODE_68682_length_418_cov_0.626959	255	299	0	44	44	1.0000000
NODE_68708_length_417_cov_45.267296	212	292	0	80	80	1.0000000
NODE_68708_length_417_cov_45.267296	265	345	0	80	80	1.0000000
NODE_68708_length_417_cov_45.267296	341	417	0	76	76	1.0000000
NODE_68709_length_417_cov_36.006289	159	239	2	16	80	0.2000000
NODE_68709_length_417_cov_36.006289	159	239	4	48	80	0.6000000
NODE_68709_length_417_cov_36.006289	159	239	6	16	80	0.2000000
NODE_68711_length_417_cov_12.886792	193	273	0	80	80	1.0000000
NODE_68711_length_417_cov_12.886792	246	326	0	80	80	1.0000000
NODE_68717_length_417_cov_7.056604	210	271	0	61	61	1.0000000
NODE_68717_length_417_cov_7.056604	263	315	0	52	52	1.0000000
NODE_68718_length_417_cov_6.669811	194	264	2	3	70	0.0428571
NODE_68718_length_417_cov_6.669811	194	264	3	12	70	0.1714286
NODE_68718_length_417_cov_6.669811	194	264	4	23	70	0.3285714
NODE_68718_length_417_cov_6.669811	194	264	6	1	70	0.0142857
NODE_68718_length_417_cov_6.669811	194	264	9	7	70	0.1000000
NODE_68718_length_417_cov_6.669811	194	264	10	19	70	0.2714286
NODE_68718_length_417_cov_6.669811	194	264	11	5	70	0.0714286
NODE_68779_length_417_cov_2.795597	20	91	0	71	71	1.0000000
NODE_69163_length_416_cov_115.782334	174	259	22	3	85	0.0352941
NODE_69163_length_416_cov_115.782334	174	259	24	4	85	0.0470588
NODE_69163_length_416_cov_115.782334	174	259	28	1	85	0.0117647
NODE_69163_length_416_cov_115.782334	174	259	32	4	85	0.0470588
NODE_69163_length_416_cov_115.782334	174	259	37	1	85	0.0117647
NODE_69163_length_416_cov_115.782334	174	259	38	9	85	0.1058824
NODE_69163_length_416_cov_115.782334	174	259	39	4	85	0.0470588
NODE_69163_length_416_cov_115.782334	174	259	43	3	85	0.0352941
NODE_69163_length_416_cov_115.782334	174	259	52	2	85	0.0235294
NODE_69163_length_416_cov_115.782334	174	259	55	3	85	0.0352941
NODE_69163_length_416_cov_115.782334	174	259	61	5	85	0.0588235
NODE_69163_length_416_cov_115.782334	174	259	69	4	85	0.0470588
NODE_69163_length_416_cov_115.782334	174	259	70	2	85	0.0235294
NODE_69163_length_416_cov_115.782334	174	259	71	5	85	0.0588235
NODE_69163_length_416_cov_115.782334	174	259	75	1	85	0.0117647
NODE_69163_length_416_cov_115.782334	174	259	79	6	85	0.0705882
NODE_69163_length_416_cov_115.782334	174	259	81	6	85	0.0705882
NODE_69163_length_416_cov_115.782334	174	259	84	1	85	0.0117647
NODE_69163_length_416_cov_115.782334	174	259	85	2	85	0.0235294
NODE_69163_length_416_cov_115.782334	174	259	87	3	85	0.0352941
NODE_69163_length_416_cov_115.782334	174	259	89	3	85	0.0352941
NODE_69163_length_416_cov_115.782334	174	259	91	2	85	0.0235294
NODE_69163_length_416_cov_115.782334	174	259	95	7	85	0.0823529
NODE_69163_length_416_cov_115.782334	174	259	97	1	85	0.0117647
NODE_69163_length_416_cov_115.782334	174	259	111	3	85	0.0352941
NODE_69164_length_416_cov_70.678233	180	244	16	32	64	0.5000000
NODE_69164_length_416_cov_70.678233	180	244	17	2	64	0.0312500
NODE_69164_length_416_cov_70.678233	180	244	18	1	64	0.0156250
NODE_69164_length_416_cov_70.678233	180	244	20	29	64	0.4531250
NODE_69166_length_416_cov_39.933754	288	368	0	80	80	1.0000000
NODE_69166_length_416_cov_39.933754	341	416	0	75	75	1.0000000
NODE_69167_length_416_cov_37.334385	158	238	0	32	80	0.4000000
NODE_69167_length_416_cov_37.334385	158	238	2	48	80	0.6000000
NODE_69167_length_416_cov_37.334385	211	291	0	80	80	1.0000000
NODE_69167_length_416_cov_37.334385	287	367	0	80	80	1.0000000
NODE_69167_length_416_cov_37.334385	340	416	0	76	76	1.0000000
NODE_69179_length_416_cov_5.242902	89	169	0	80	80	1.0000000
NODE_69179_length_416_cov_5.242902	142	222	0	80	80	1.0000000
NODE_69184_length_416_cov_4.892744	79	145	0	65	66	0.9848485
NODE_69184_length_416_cov_4.892744	79	145	2	1	66	0.0151515
NODE_69184_length_416_cov_4.892744	194	272	0	40	78	0.5128205
NODE_69184_length_416_cov_4.892744	194	272	2	38	78	0.4871795
NODE_69184_length_416_cov_4.892744	247	272	0	25	25	1.0000000
NODE_69204_length_416_cov_3.886435	79	136	6	13	57	0.2280702
NODE_69204_length_416_cov_3.886435	79	136	8	9	57	0.1578947
NODE_69204_length_416_cov_3.886435	79	136	10	35	57	0.6140351
NODE_69279_length_416_cov_2.230284	10	90	0	9	80	0.1125000
NODE_69279_length_416_cov_2.230284	10	90	2	23	80	0.2875000
NODE_69279_length_416_cov_2.230284	10	90	4	23	80	0.2875000
NODE_69279_length_416_cov_2.230284	10	90	6	25	80	0.3125000
NODE_69399_length_416_cov_1.520505	198	244	6	11	46	0.2391304
NODE_69399_length_416_cov_1.520505	198	244	8	3	46	0.0652174
NODE_69399_length_416_cov_1.520505	198	244	10	1	46	0.0217391
NODE_69399_length_416_cov_1.520505	198	244	12	5	46	0.1086956
NODE_69399_length_416_cov_1.520505	198	244	14	2	46	0.0434783
NODE_69399_length_416_cov_1.520505	198	244	18	11	46	0.2391304
NODE_69399_length_416_cov_1.520505	198	244	20	1	46	0.0217391
NODE_69399_length_416_cov_1.520505	198	244	22	2	46	0.0434783
NODE_69399_length_416_cov_1.520505	198	244	23	10	46	0.2173913
NODE_69399_length_416_cov_1.520505	261	328	26	4	67	0.0597015
NODE_69399_length_416_cov_1.520505	261	328	28	38	67	0.5671642
NODE_69399_length_416_cov_1.520505	261	328	30	18	67	0.2686567
NODE_69399_length_416_cov_1.520505	261	328	32	7	67	0.1044776
NODE_69673_length_415_cov_35.924051	260	339	0	79	79	1.0000000
NODE_69673_length_415_cov_35.924051	316	392	0	76	76	1.0000000
NODE_69679_length_415_cov_6.376582	117	197	0	80	80	1.0000000
NODE_69679_length_415_cov_6.376582	254	334	2	47	80	0.5875000
NODE_69679_length_415_cov_6.376582	254	334	4	33	80	0.4125000
NODE_69774_length_415_cov_2.224684	144	224	10	1	80	0.0125000
NODE_69774_length_415_cov_2.224684	144	224	12	17	80	0.2125000
NODE_69774_length_415_cov_2.224684	144	224	14	15	80	0.1875000
NODE_69774_length_415_cov_2.224684	144	224	16	47	80	0.5875000
NODE_69795_length_415_cov_2.069620	207	273	2	55	66	0.8333333
NODE_69795_length_415_cov_2.069620	207	273	6	2	66	0.0303030
NODE_69795_length_415_cov_2.069620	207	273	8	9	66	0.1363636
NODE_69817_length_415_cov_1.832278	225	283	4	17	58	0.2931035
NODE_69817_length_415_cov_1.832278	225	283	6	6	58	0.1034483
NODE_69817_length_415_cov_1.832278	225	283	12	6	58	0.1034483
NODE_69817_length_415_cov_1.832278	225	283	14	1	58	0.0172414
NODE_69817_length_415_cov_1.832278	225	283	16	3	58	0.0517241
NODE_69817_length_415_cov_1.832278	225	283	18	2	58	0.0344828
NODE_69817_length_415_cov_1.832278	225	283	20	7	58	0.1206897
NODE_69817_length_415_cov_1.832278	225	283	22	4	58	0.0689655
NODE_69817_length_415_cov_1.832278	225	283	26	3	58	0.0517241
NODE_69817_length_415_cov_1.832278	225	283	30	5	58	0.0862069
NODE_69817_length_415_cov_1.832278	225	283	32	4	58	0.0689655
NODE_69845_length_415_cov_1.610759	90	170	18	2	80	0.0250000
NODE_69845_length_415_cov_1.610759	90	170	20	2	80	0.0250000
NODE_69845_length_415_cov_1.610759	90	170	26	14	80	0.1750000
NODE_69845_length_415_cov_1.610759	90	170	28	7	80	0.0875000
NODE_69845_length_415_cov_1.610759	90	170	34	2	80	0.0250000
NODE_69845_length_415_cov_1.610759	90	170	36	1	80	0.0125000
NODE_69845_length_415_cov_1.610759	90	170	38	6	80	0.0750000
NODE_69845_length_415_cov_1.610759	90	170	42	4	80	0.0500000
NODE_69845_length_415_cov_1.610759	90	170	44	3	80	0.0375000
NODE_69845_length_415_cov_1.610759	90	170	46	5	80	0.0625000
NODE_69845_length_415_cov_1.610759	90	170	48	34	80	0.4250000
NODE_69845_length_415_cov_1.610759	335	376	2	41	41	1.0000000
NODE_70175_length_414_cov_46.263492	0	49	0	49	49	1.0000000
NODE_70175_length_414_cov_46.263492	22	102	0	80	80	1.0000000
NODE_70183_length_414_cov_7.460317	167	247	0	80	80	1.0000000
NODE_70183_length_414_cov_7.460317	220	300	0	80	80	1.0000000
NODE_70192_length_414_cov_5.676190	54	134	0	80	80	1.0000000
NODE_70192_length_414_cov_5.676190	107	187	0	80	80	1.0000000
NODE_70222_length_414_cov_4.130159	257	303	0	44	46	0.9565217
NODE_70222_length_414_cov_4.130159	257	303	2	2	46	0.0434783
NODE_70222_length_414_cov_4.130159	276	356	0	80	80	1.0000000
NODE_70254_length_414_cov_2.996825	75	135	18	8	60	0.1333333
NODE_70254_length_414_cov_2.996825	75	135	20	24	60	0.4000000
NODE_70254_length_414_cov_2.996825	75	135	22	8	60	0.1333333
NODE_70254_length_414_cov_2.996825	75	135	24	1	60	0.0166667
NODE_70254_length_414_cov_2.996825	75	135	26	19	60	0.3166667
NODE_70271_length_414_cov_2.631746	68	145	0	77	77	1.0000000
NODE_70284_length_414_cov_2.473016	164	197	4	33	33	1.0000000
NODE_70284_length_414_cov_2.473016	170	255	2	37	85	0.4352941
NODE_70284_length_414_cov_2.473016	170	255	4	48	85	0.5647059
NODE_70305_length_414_cov_2.222222	185	260	0	10	75	0.1333333
NODE_70305_length_414_cov_2.222222	185	260	2	5	75	0.0666667
NODE_70305_length_414_cov_2.222222	185	260	8	1	75	0.0133333
NODE_70305_length_414_cov_2.222222	185	260	10	1	75	0.0133333
NODE_70305_length_414_cov_2.222222	185	260	14	5	75	0.0666667
NODE_70305_length_414_cov_2.222222	185	260	16	19	75	0.2533333
NODE_70305_length_414_cov_2.222222	185	260	18	20	75	0.2666667
NODE_70305_length_414_cov_2.222222	185	260	20	13	75	0.1733333
NODE_70305_length_414_cov_2.222222	185	260	22	1	75	0.0133333
NODE_70305_length_414_cov_2.222222	233	304	8	3	71	0.0422535
NODE_70305_length_414_cov_2.222222	233	304	12	2	71	0.0281690
NODE_70305_length_414_cov_2.222222	233	304	14	5	71	0.0704225
NODE_70305_length_414_cov_2.222222	233	304	16	1	71	0.0140845
NODE_70305_length_414_cov_2.222222	233	304	18	16	71	0.2253521
NODE_70305_length_414_cov_2.222222	233	304	20	14	71	0.1971831
NODE_70305_length_414_cov_2.222222	233	304	22	30	71	0.4225352
NODE_70307_length_414_cov_2.206349	88	163	2	22	75	0.2933333
NODE_70307_length_414_cov_2.206349	88	163	4	53	75	0.7066666
NODE_70326_length_414_cov_2.047619	298	349	0	51	51	1.0000000
NODE_70486_length_414_cov_1.177778	106	190	2	63	84	0.7500000
NODE_70486_length_414_cov_1.177778	106	190	4	21	84	0.2500000
NODE_70494_length_414_cov_1.155556	0	23	0	23	23	1.0000000
NODE_70690_length_413_cov_41.471338	35	115	0	80	80	1.0000000
NODE_70690_length_413_cov_41.471338	35	115	0	80	80	1.0000000
NODE_70690_length_413_cov_41.471338	88	168	0	80	80	1.0000000
NODE_70690_length_413_cov_41.471338	88	168	0	80	80	1.0000000
NODE_70691_length_413_cov_16.687898	222	302	0	80	80	1.0000000
NODE_70691_length_413_cov_16.687898	275	355	0	80	80	1.0000000
NODE_70699_length_413_cov_7.057325	170	250	2	4	80	0.0500000
NODE_70699_length_413_cov_7.057325	170	250	4	21	80	0.2625000
NODE_70699_length_413_cov_7.057325	170	250	6	55	80	0.6875000
NODE_70699_length_413_cov_7.057325	223	300	2	25	77	0.3246753
NODE_70699_length_413_cov_7.057325	223	300	4	23	77	0.2987013
NODE_70699_length_413_cov_7.057325	223	300	6	29	77	0.3766234
NODE_70703_length_413_cov_5.665605	125	182	0	24	57	0.4210526
NODE_70703_length_413_cov_5.665605	125	182	1	6	57	0.1052632
NODE_70703_length_413_cov_5.665605	125	182	2	27	57	0.4736842
NODE_70712_length_413_cov_4.754777	140	184	0	44	44	1.0000000
NODE_70743_length_413_cov_3.506369	113	193	4	1	80	0.0125000
NODE_70743_length_413_cov_3.506369	113	193	6	21	80	0.2625000
NODE_70743_length_413_cov_3.506369	113	193	8	58	80	0.7250000
NODE_70749_length_413_cov_3.235669	251	331	0	80	80	1.0000000
NODE_70749_length_413_cov_3.235669	304	356	0	52	52	1.0000000
NODE_70792_length_413_cov_2.484076	209	257	4	48	48	1.0000000
NODE_70835_length_413_cov_1.949045	224	296	0	72	72	1.0000000
NODE_71196_length_412_cov_9.996805	172	244	0	72	72	1.0000000
NODE_71218_length_412_cov_4.686901	112	167	0	55	55	1.0000000
NODE_71253_length_412_cov_3.204473	44	124	0	80	80	1.0000000
NODE_71276_length_412_cov_2.824281	225	305	0	80	80	1.0000000
NODE_71371_length_412_cov_1.782748	262	342	2	18	80	0.2250000
NODE_71371_length_412_cov_1.782748	262	342	6	62	80	0.7750000
NODE_71398_length_412_cov_1.603834	143	182	2	8	39	0.2051282
NODE_71398_length_412_cov_1.603834	143	182	6	2	39	0.0512821
NODE_71398_length_412_cov_1.603834	143	182	8	18	39	0.4615385
NODE_71398_length_412_cov_1.603834	143	182	10	4	39	0.1025641
NODE_71398_length_412_cov_1.603834	143	182	12	7	39	0.1794872
NODE_71665_length_411_cov_44.701923	4	72	2	27	68	0.3970588
NODE_71665_length_411_cov_44.701923	4	72	4	5	68	0.0735294
NODE_71665_length_411_cov_44.701923	4	72	12	18	68	0.2647059
NODE_71665_length_411_cov_44.701923	4	72	14	18	68	0.2647059
NODE_71665_length_411_cov_44.701923	35	116	4	1	81	0.0123457
NODE_71665_length_411_cov_44.701923	35	116	12	18	81	0.2222222
NODE_71665_length_411_cov_44.701923	35	116	14	62	81	0.7654321
NODE_71665_length_411_cov_44.701923	161	242	0	81	81	1.0000000
NODE_71665_length_411_cov_44.701923	293	374	2	81	81	1.0000000
NODE_71665_length_411_cov_44.701923	337	411	0	15	74	0.2027027
NODE_71665_length_411_cov_44.701923	337	411	2	59	74	0.7972973
NODE_71666_length_411_cov_43.144231	102	183	0	24	81	0.2962963
NODE_71666_length_411_cov_43.144231	102	183	2	57	81	0.7037037
NODE_71666_length_411_cov_43.144231	156	236	0	77	80	0.9625000
NODE_71666_length_411_cov_43.144231	156	236	2	3	80	0.0375000
NODE_71666_length_411_cov_43.144231	232	312	0	80	80	1.0000000
NODE_71666_length_411_cov_43.144231	285	365	0	80	80	1.0000000
NODE_71672_length_411_cov_8.471154	133	213	0	80	80	1.0000000
NODE_71672_length_411_cov_8.471154	186	266	0	35	80	0.4375000
NODE_71672_length_411_cov_8.471154	186	266	2	21	80	0.2625000
NODE_71672_length_411_cov_8.471154	186	266	3	1	80	0.0125000
NODE_71672_length_411_cov_8.471154	186	266	4	23	80	0.2875000
NODE_71673_length_411_cov_8.407051	133	220	8	6	87	0.0689655
NODE_71673_length_411_cov_8.407051	133	220	10	9	87	0.1034483
NODE_71673_length_411_cov_8.407051	133	220	12	2	87	0.0229885
NODE_71673_length_411_cov_8.407051	133	220	14	33	87	0.3793103
NODE_71673_length_411_cov_8.407051	133	220	16	37	87	0.4252874
NODE_71675_length_411_cov_6.455128	249	316	0	67	67	1.0000000
NODE_71675_length_411_cov_6.455128	292	344	0	42	52	0.8076923
NODE_71675_length_411_cov_6.455128	292	344	2	10	52	0.1923077
NODE_71687_length_411_cov_4.782051	98	178	2	44	80	0.5500000
NODE_71687_length_411_cov_4.782051	98	178	3	4	80	0.0500000
NODE_71687_length_411_cov_4.782051	98	178	4	21	80	0.2625000
NODE_71687_length_411_cov_4.782051	98	178	5	11	80	0.1375000
NODE_71687_length_411_cov_4.782051	151	228	2	77	77	1.0000000
NODE_71705_length_411_cov_3.698718	282	347	0	65	65	1.0000000
NODE_71713_length_411_cov_3.378205	88	148	6	4	60	0.0666667
NODE_71713_length_411_cov_3.378205	88	148	8	6	60	0.1000000
NODE_71713_length_411_cov_3.378205	88	148	10	20	60	0.3333333
NODE_71713_length_411_cov_3.378205	88	148	12	30	60	0.5000000
NODE_71714_length_411_cov_3.371795	145	225	2	3	80	0.0375000
NODE_71714_length_411_cov_3.371795	145	225	4	12	80	0.1500000
NODE_71714_length_411_cov_3.371795	145	225	6	8	80	0.1000000
NODE_71714_length_411_cov_3.371795	145	225	7	45	80	0.5625000
NODE_71714_length_411_cov_3.371795	145	225	9	12	80	0.1500000
NODE_71714_length_411_cov_3.371795	198	274	7	64	76	0.8421053
NODE_71714_length_411_cov_3.371795	198	274	9	12	76	0.1578947
NODE_72163_length_410_cov_49.331190	320	400	0	52	80	0.6500000
NODE_72163_length_410_cov_49.331190	320	400	4	28	80	0.3500000
NODE_72163_length_410_cov_49.331190	320	400	0	52	80	0.6500000
NODE_72163_length_410_cov_49.331190	320	400	4	28	80	0.3500000
NODE_72163_length_410_cov_49.331190	320	400	0	52	80	0.6500000
NODE_72163_length_410_cov_49.331190	320	400	4	28	80	0.3500000
NODE_72163_length_410_cov_49.331190	320	400	0	52	80	0.6500000
NODE_72163_length_410_cov_49.331190	320	400	4	28	80	0.3500000
NODE_72163_length_410_cov_49.331190	320	400	0	52	80	0.6500000
NODE_72163_length_410_cov_49.331190	320	400	4	28	80	0.3500000
NODE_72163_length_410_cov_49.331190	329	400	0	52	71	0.7323943
NODE_72163_length_410_cov_49.331190	329	400	4	19	71	0.2676056
NODE_72169_length_410_cov_6.797428	179	259	0	80	80	1.0000000
NODE_72169_length_410_cov_6.797428	232	312	0	80	80	1.0000000
NODE_72184_length_410_cov_5.102894	153	222	0	69	69	1.0000000
NODE_72186_length_410_cov_4.884244	101	179	0	48	78	0.6153846
NODE_72186_length_410_cov_4.884244	101	179	2	30	78	0.3846154
NODE_72187_length_410_cov_4.787781	287	344	2	57	57	1.0000000
NODE_72187_length_410_cov_4.787781	340	397	0	40	57	0.7017544
NODE_72187_length_410_cov_4.787781	340	397	2	17	57	0.2982456
NODE_72194_length_410_cov_4.591640	245	303	5	1	58	0.0172414
NODE_72194_length_410_cov_4.591640	245	303	7	2	58	0.0344828
NODE_72194_length_410_cov_4.591640	245	303	14	1	58	0.0172414
NODE_72194_length_410_cov_4.591640	245	303	16	1	58	0.0172414
NODE_72194_length_410_cov_4.591640	245	303	17	5	58	0.0862069
NODE_72194_length_410_cov_4.591640	245	303	19	5	58	0.0862069
NODE_72194_length_410_cov_4.591640	245	303	24	4	58	0.0689655
NODE_72194_length_410_cov_4.591640	245	303	28	1	58	0.0172414
NODE_72194_length_410_cov_4.591640	245	303	33	4	58	0.0689655
NODE_72194_length_410_cov_4.591640	245	303	35	2	58	0.0344828
NODE_72194_length_410_cov_4.591640	245	303	37	3	58	0.0517241
NODE_72194_length_410_cov_4.591640	245	303	38	2	58	0.0344828
NODE_72194_length_410_cov_4.591640	245	303	42	1	58	0.0172414
NODE_72194_length_410_cov_4.591640	245	303	44	1	58	0.0172414
NODE_72194_length_410_cov_4.591640	245	303	46	1	58	0.0172414
NODE_72194_length_410_cov_4.591640	245	303	52	1	58	0.0172414
NODE_72194_length_410_cov_4.591640	245	303	55	4	58	0.0689655
NODE_72194_length_410_cov_4.591640	245	303	56	4	58	0.0689655
NODE_72194_length_410_cov_4.591640	245	303	58	1	58	0.0172414
NODE_72194_length_410_cov_4.591640	245	303	62	6	58	0.1034483
NODE_72194_length_410_cov_4.591640	245	303	64	8	58	0.1379310
NODE_72194_length_410_cov_4.591640	298	356	44	2	58	0.0344828
NODE_72194_length_410_cov_4.591640	298	356	46	2	58	0.0344828
NODE_72194_length_410_cov_4.591640	298	356	48	1	58	0.0172414
NODE_72194_length_410_cov_4.591640	298	356	54	4	58	0.0689655
NODE_72194_length_410_cov_4.591640	298	356	56	2	58	0.0344828
NODE_72194_length_410_cov_4.591640	298	356	58	3	58	0.0517241
NODE_72194_length_410_cov_4.591640	298	356	60	7	58	0.1206897
NODE_72194_length_410_cov_4.591640	298	356	62	2	58	0.0344828
NODE_72194_length_410_cov_4.591640	298	356	64	35	58	0.6034483
NODE_72230_length_410_cov_3.215434	32	112	0	52	80	0.6500000
NODE_72230_length_410_cov_3.215434	32	112	2	28	80	0.3500000
NODE_72230_length_410_cov_3.215434	85	165	0	7	80	0.0875000
NODE_72230_length_410_cov_3.215434	85	165	2	73	80	0.9125000
NODE_72327_length_410_cov_1.913183	227	285	0	19	58	0.3275862
NODE_72327_length_410_cov_1.913183	227	285	2	13	58	0.2241379
NODE_72327_length_410_cov_1.913183	227	285	3	1	58	0.0172414
NODE_72327_length_410_cov_1.913183	227	285	4	25	58	0.4310345
NODE_72526_length_410_cov_1.038585	272	316	4	11	44	0.2500000
NODE_72526_length_410_cov_1.038585	272	316	6	19	44	0.4318182
NODE_72526_length_410_cov_1.038585	272	316	8	14	44	0.3181818
NODE_72688_length_409_cov_11.506452	56	136	0	80	80	1.0000000
NODE_72688_length_409_cov_11.506452	109	189	0	80	80	1.0000000
NODE_72689_length_409_cov_10.329032	131	186	0	55	55	1.0000000
NODE_72690_length_409_cov_9.625806	62	142	0	80	80	1.0000000
NODE_72690_length_409_cov_9.625806	115	195	0	80	80	1.0000000
NODE_72697_length_409_cov_6.867742	41	71	0	30	30	1.0000000
NODE_72730_length_409_cov_3.822581	103	158	4	17	55	0.3090909
NODE_72730_length_409_cov_3.822581	103	158	8	16	55	0.2909091
NODE_72730_length_409_cov_3.822581	103	158	10	22	55	0.4000000
NODE_72730_length_409_cov_3.822581	151	232	6	51	81	0.6296296
NODE_72730_length_409_cov_3.822581	151	232	8	30	81	0.3703704
NODE_72754_length_409_cov_2.987097	240	287	0	47	47	1.0000000
NODE_72951_length_409_cov_1.319355	49	131	2	82	82	1.0000000
NODE_72951_length_409_cov_1.319355	104	161	0	25	57	0.4385965
NODE_72951_length_409_cov_1.319355	104	161	2	32	57	0.5614035
NODE_73196_length_408_cov_8.585761	57	137	0	80	80	1.0000000
NODE_73196_length_408_cov_8.585761	110	190	0	80	80	1.0000000
NODE_73198_length_408_cov_6.948220	71	151	0	25	80	0.3125000
NODE_73198_length_408_cov_6.948220	71	151	2	55	80	0.6875000
NODE_73198_length_408_cov_6.948220	124	204	0	78	80	0.9750000
NODE_73198_length_408_cov_6.948220	124	204	2	2	80	0.0250000
NODE_73219_length_408_cov_3.957929	83	132	0	49	49	1.0000000
NODE_73226_length_408_cov_3.511327	40	97	4	57	57	1.0000000
NODE_73226_length_408_cov_3.511327	357	398	0	41	41	1.0000000
NODE_73262_length_408_cov_2.724919	128	180	0	24	52	0.4615385
NODE_73262_length_408_cov_2.724919	128	180	2	28	52	0.5384616
NODE_73269_length_408_cov_2.563107	164	241	0	51	77	0.6623377
NODE_73269_length_408_cov_2.563107	164	241	2	21	77	0.2727273
NODE_73269_length_408_cov_2.563107	164	241	10	1	77	0.0129870
NODE_73269_length_408_cov_2.563107	164	241	18	1	77	0.0129870
NODE_73269_length_408_cov_2.563107	164	241	24	3	77	0.0389610
NODE_73271_length_408_cov_2.456311	314	379	0	65	65	1.0000000
NODE_73271_length_408_cov_2.456311	352	408	0	56	56	1.0000000
NODE_73690_length_407_cov_6.191558	144	208	0	64	64	1.0000000
NODE_73698_length_407_cov_4.961039	212	291	0	9	79	0.1139240
NODE_73698_length_407_cov_4.961039	212	291	2	35	79	0.4430380
NODE_73698_length_407_cov_4.961039	212	291	4	2	79	0.0253165
NODE_73698_length_407_cov_4.961039	212	291	6	2	79	0.0253165
NODE_73698_length_407_cov_4.961039	212	291	8	31	79	0.3924051
NODE_73719_length_407_cov_3.681818	314	375	0	45	61	0.7377049
NODE_73719_length_407_cov_3.681818	314	375	2	16	61	0.2622951
NODE_73732_length_407_cov_3.344156	199	247	8	8	48	0.1666667
NODE_73732_length_407_cov_3.344156	199	247	10	28	48	0.5833333
NODE_73732_length_407_cov_3.344156	199	247	12	12	48	0.2500000
NODE_73736_length_407_cov_3.250000	142	223	12	2	81	0.0246914
NODE_73736_length_407_cov_3.250000	142	223	16	4	81	0.0493827
NODE_73736_length_407_cov_3.250000	142	223	18	5	81	0.0617284
NODE_73736_length_407_cov_3.250000	142	223	20	27	81	0.3333333
NODE_73736_length_407_cov_3.250000	142	223	22	43	81	0.5308642
NODE_73762_length_407_cov_2.594156	194	257	0	25	63	0.3968254
NODE_73762_length_407_cov_2.594156	194	257	2	6	63	0.0952381
NODE_73762_length_407_cov_2.594156	194	257	4	32	63	0.5079365
NODE_73769_length_407_cov_2.538961	34	114	2	8	80	0.1000000
NODE_73769_length_407_cov_2.538961	34	114	4	10	80	0.1250000
NODE_73769_length_407_cov_2.538961	34	114	6	62	80	0.7750000
NODE_73853_length_407_cov_1.737013	208	264	0	56	56	1.0000000
NODE_74200_length_406_cov_176.856678	200	271	104	1	71	0.0140845
NODE_74200_length_406_cov_176.856678	200	271	105	2	71	0.0281690
NODE_74200_length_406_cov_176.856678	200	271	107	4	71	0.0563380
NODE_74200_length_406_cov_176.856678	200	271	108	3	71	0.0422535
NODE_74200_length_406_cov_176.856678	200	271	109	3	71	0.0422535
NODE_74200_length_406_cov_176.856678	200	271	110	2	71	0.0281690
NODE_74200_length_406_cov_176.856678	200	271	111	3	71	0.0422535
NODE_74200_length_406_cov_176.856678	200	271	112	4	71	0.0563380
NODE_74200_length_406_cov_176.856678	200	271	118	4	71	0.0563380
NODE_74200_length_406_cov_176.856678	200	271	120	5	71	0.0704225
NODE_74200_length_406_cov_176.856678	200	271	121	3	71	0.0422535
NODE_74200_length_406_cov_176.856678	200	271	122	6	71	0.0845070
NODE_74200_length_406_cov_176.856678	200	271	123	3	71	0.0422535
NODE_74200_length_406_cov_176.856678	200	271	124	10	71	0.1408451
NODE_74200_length_406_cov_176.856678	200	271	125	5	71	0.0704225
NODE_74200_length_406_cov_176.856678	200	271	126	7	71	0.0985916
NODE_74200_length_406_cov_176.856678	200	271	127	4	71	0.0563380
NODE_74200_length_406_cov_176.856678	200	271	129	2	71	0.0281690
NODE_74200_length_406_cov_176.856678	244	321	67	2	77	0.0259740
NODE_74200_length_406_cov_176.856678	244	321	68	2	77	0.0259740
NODE_74200_length_406_cov_176.856678	244	321	73	3	77	0.0389610
NODE_74200_length_406_cov_176.856678	244	321	77	7	77	0.0909091
NODE_74200_length_406_cov_176.856678	244	321	78	3	77	0.0389610
NODE_74200_length_406_cov_176.856678	244	321	82	3	77	0.0389610
NODE_74200_length_406_cov_176.856678	244	321	84	2	77	0.0259740
NODE_74200_length_406_cov_176.856678	244	321	88	10	77	0.1298701
NODE_74200_length_406_cov_176.856678	244	321	90	2	77	0.0259740
NODE_74200_length_406_cov_176.856678	244	321	92	1	77	0.0129870
NODE_74200_length_406_cov_176.856678	244	321	94	1	77	0.0129870
NODE_74200_length_406_cov_176.856678	244	321	96	1	77	0.0129870
NODE_74200_length_406_cov_176.856678	244	321	98	2	77	0.0259740
NODE_74200_length_406_cov_176.856678	244	321	99	6	77	0.0779221
NODE_74200_length_406_cov_176.856678	244	321	100	4	77	0.0519481
NODE_74200_length_406_cov_176.856678	244	321	101	1	77	0.0129870
NODE_74200_length_406_cov_176.856678	244	321	104	1	77	0.0129870
NODE_74200_length_406_cov_176.856678	244	321	105	1	77	0.0129870
NODE_74200_length_406_cov_176.856678	244	321	107	4	77	0.0519481
NODE_74200_length_406_cov_176.856678	244	321	110	2	77	0.0259740
NODE_74200_length_406_cov_176.856678	244	321	111	3	77	0.0389610
NODE_74200_length_406_cov_176.856678	244	321	112	1	77	0.0129870
NODE_74200_length_406_cov_176.856678	244	321	118	1	77	0.0129870
NODE_74200_length_406_cov_176.856678	244	321	121	1	77	0.0129870
NODE_74200_length_406_cov_176.856678	244	321	122	2	77	0.0259740
NODE_74200_length_406_cov_176.856678	244	321	123	1	77	0.0129870
NODE_74200_length_406_cov_176.856678	244	321	124	1	77	0.0129870
NODE_74200_length_406_cov_176.856678	244	321	125	1	77	0.0129870
NODE_74200_length_406_cov_176.856678	244	321	126	3	77	0.0389610
NODE_74200_length_406_cov_176.856678	244	321	127	3	77	0.0389610
NODE_74200_length_406_cov_176.856678	244	321	129	2	77	0.0259740
NODE_74203_length_406_cov_37.723127	15	95	0	12	80	0.1500000
NODE_74203_length_406_cov_37.723127	15	95	2	24	80	0.3000000
NODE_74203_length_406_cov_37.723127	15	95	4	26	80	0.3250000
NODE_74203_length_406_cov_37.723127	15	95	6	12	80	0.1500000
NODE_74203_length_406_cov_37.723127	15	95	8	3	80	0.0375000
NODE_74203_length_406_cov_37.723127	15	95	10	1	80	0.0125000
NODE_74203_length_406_cov_37.723127	15	95	12	1	80	0.0125000
NODE_74203_length_406_cov_37.723127	15	95	24	1	80	0.0125000
NODE_74219_length_406_cov_4.960912	268	327	0	53	59	0.8983051
NODE_74219_length_406_cov_4.960912	268	327	2	6	59	0.1016949
NODE_74253_length_406_cov_3.087948	261	302	0	41	41	1.0000000
NODE_74284_length_406_cov_2.475570	220	270	0	50	50	1.0000000
NODE_74332_length_406_cov_1.986971	238	276	0	13	38	0.3421053
NODE_74332_length_406_cov_1.986971	238	276	2	25	38	0.6578947
NODE_74368_length_406_cov_1.778502	159	195	28	2	36	0.0555556
NODE_74368_length_406_cov_1.778502	159	195	29	6	36	0.1666667
NODE_74368_length_406_cov_1.778502	159	195	31	3	36	0.0833333
NODE_74368_length_406_cov_1.778502	159	195	33	5	36	0.1388889
NODE_74368_length_406_cov_1.778502	159	195	35	20	36	0.5555556
NODE_74368_length_406_cov_1.778502	234	294	16	5	60	0.0833333
NODE_74368_length_406_cov_1.778502	234	294	18	16	60	0.2666667
NODE_74368_length_406_cov_1.778502	234	294	20	5	60	0.0833333
NODE_74368_length_406_cov_1.778502	234	294	22	3	60	0.0500000
NODE_74368_length_406_cov_1.778502	234	294	23	1	60	0.0166667
NODE_74368_length_406_cov_1.778502	234	294	24	9	60	0.1500000
NODE_74368_length_406_cov_1.778502	234	294	25	1	60	0.0166667
NODE_74368_length_406_cov_1.778502	234	294	27	16	60	0.2666667
NODE_74368_length_406_cov_1.778502	234	294	29	1	60	0.0166667
NODE_74368_length_406_cov_1.778502	234	294	33	1	60	0.0166667
NODE_74368_length_406_cov_1.778502	234	294	34	2	60	0.0333333
NODE_74368_length_406_cov_1.778502	267	347	2	23	80	0.2875000
NODE_74368_length_406_cov_1.778502	267	347	4	9	80	0.1125000
NODE_74368_length_406_cov_1.778502	267	347	6	7	80	0.0875000
NODE_74368_length_406_cov_1.778502	267	347	8	1	80	0.0125000
NODE_74368_length_406_cov_1.778502	267	347	10	1	80	0.0125000
NODE_74368_length_406_cov_1.778502	267	347	14	7	80	0.0875000
NODE_74368_length_406_cov_1.778502	267	347	16	10	80	0.1250000
NODE_74368_length_406_cov_1.778502	267	347	18	16	80	0.2000000
NODE_74368_length_406_cov_1.778502	267	347	20	5	80	0.0625000
NODE_74368_length_406_cov_1.778502	267	347	22	1	80	0.0125000
NODE_74427_length_406_cov_1.495114	173	212	0	39	39	1.0000000
NODE_74476_length_406_cov_1.325733	367	398	0	31	31	1.0000000
NODE_74588_length_406_cov_0.934853	1	32	0	22	31	0.7096774
NODE_74588_length_406_cov_0.934853	1	32	2	9	31	0.2903226
NODE_74588_length_406_cov_0.934853	5	85	0	18	80	0.2250000
NODE_74588_length_406_cov_0.934853	5	85	2	62	80	0.7750000
NODE_74696_length_405_cov_5.107843	332	380	0	45	48	0.9375000
NODE_74696_length_405_cov_5.107843	332	380	2	3	48	0.0625000
NODE_74697_length_405_cov_4.915033	15	46	2	31	31	1.0000000
NODE_74727_length_405_cov_3.346405	195	240	8	45	45	1.0000000
NODE_74727_length_405_cov_3.346405	274	329	0	11	55	0.2000000
NODE_74727_length_405_cov_3.346405	274	329	2	11	55	0.2000000
NODE_74727_length_405_cov_3.346405	274	329	4	1	55	0.0181818
NODE_74727_length_405_cov_3.346405	274	329	8	32	55	0.5818182
NODE_74737_length_405_cov_3.124183	210	260	0	50	50	1.0000000
NODE_74737_length_405_cov_3.124183	240	286	0	46	46	1.0000000
NODE_74737_length_405_cov_3.124183	260	339	0	38	79	0.4810127
NODE_74737_length_405_cov_3.124183	260	339	2	41	79	0.5189874
NODE_74737_length_405_cov_3.124183	272	339	0	26	67	0.3880597
NODE_74737_length_405_cov_3.124183	272	339	2	41	67	0.6119403
NODE_74780_length_405_cov_2.503268	352	399	0	47	47	1.0000000
NODE_74787_length_405_cov_2.460784	0	73	0	9	73	0.1232877
NODE_74787_length_405_cov_2.460784	0	73	2	5	73	0.0684932
NODE_74787_length_405_cov_2.460784	0	73	4	6	73	0.0821918
NODE_74787_length_405_cov_2.460784	0	73	6	53	73	0.7260274
NODE_75145_length_405_cov_0.666667	207	268	0	61	61	1.0000000
NODE_75196_length_404_cov_40.937705	40	120	0	80	80	1.0000000
NODE_75196_length_404_cov_40.937705	93	173	0	80	80	1.0000000
NODE_75197_length_404_cov_32.940984	46	126	0	80	80	1.0000000
NODE_75197_length_404_cov_32.940984	99	179	0	80	80	1.0000000
NODE_75197_length_404_cov_32.940984	175	255	0	80	80	1.0000000
NODE_75197_length_404_cov_32.940984	228	308	0	80	80	1.0000000
NODE_75198_length_404_cov_11.731148	130	210	2	50	80	0.6250000
NODE_75198_length_404_cov_11.731148	130	210	4	30	80	0.3750000
NODE_75198_length_404_cov_11.731148	183	263	2	36	80	0.4500000
NODE_75198_length_404_cov_11.731148	183	263	4	44	80	0.5500000
NODE_75200_length_404_cov_9.170492	201	257	0	40	56	0.7142857
NODE_75200_length_404_cov_9.170492	201	257	2	16	56	0.2857143
NODE_75236_length_404_cov_3.613115	323	385	0	17	62	0.2741936
NODE_75236_length_404_cov_3.613115	323	385	1	5	62	0.0806452
NODE_75236_length_404_cov_3.613115	323	385	2	40	62	0.6451613
NODE_75259_length_404_cov_2.914754	181	261	0	40	80	0.5000000
NODE_75259_length_404_cov_2.914754	181	261	1	40	80	0.5000000
NODE_75345_length_404_cov_2.085246	245	325	0	80	80	1.0000000
NODE_75357_length_404_cov_1.993443	95	148	2	53	53	1.0000000
NODE_75399_length_404_cov_1.672131	32	106	0	74	74	1.0000000
NODE_75440_length_404_cov_1.498361	94	174	4	16	80	0.2000000
NODE_75440_length_404_cov_1.498361	94	174	6	3	80	0.0375000
NODE_75440_length_404_cov_1.498361	94	174	8	7	80	0.0875000
NODE_75440_length_404_cov_1.498361	94	174	10	10	80	0.1250000
NODE_75440_length_404_cov_1.498361	94	174	12	44	80	0.5500000
NODE_75446_length_404_cov_1.485246	234	282	2	48	48	1.0000000
NODE_75545_length_404_cov_1.121311	114	194	5	16	80	0.2000000
NODE_75545_length_404_cov_1.121311	114	194	7	36	80	0.4500000
NODE_75545_length_404_cov_1.121311	114	194	9	16	80	0.2000000
NODE_75545_length_404_cov_1.121311	114	194	13	12	80	0.1500000
NODE_75750_length_403_cov_7.325658	80	146	0	66	66	1.0000000
NODE_75750_length_403_cov_7.325658	165	234	0	69	69	1.0000000
NODE_75750_length_403_cov_7.325658	215	255	0	40	40	1.0000000
NODE_75751_length_403_cov_7.217105	207	284	0	77	77	1.0000000
NODE_75751_length_403_cov_7.217105	257	334	0	77	77	1.0000000
NODE_75752_length_403_cov_6.776316	192	250	4	2	58	0.0344828
NODE_75752_length_403_cov_6.776316	192	250	6	10	58	0.1724138
NODE_75752_length_403_cov_6.776316	192	250	7	3	58	0.0517241
NODE_75752_length_403_cov_6.776316	192	250	12	1	58	0.0172414
NODE_75752_length_403_cov_6.776316	192	250	13	17	58	0.2931035
NODE_75752_length_403_cov_6.776316	192	250	14	25	58	0.4310345
NODE_75788_length_403_cov_3.710526	327	373	0	4	46	0.0869565
NODE_75788_length_403_cov_3.710526	327	373	2	42	46	0.9130435
NODE_75788_length_403_cov_3.710526	346	403	0	34	57	0.5964912
NODE_75788_length_403_cov_3.710526	346	403	2	23	57	0.4035088
NODE_75793_length_403_cov_3.611842	283	363	8	12	80	0.1500000
NODE_75793_length_403_cov_3.611842	283	363	12	9	80	0.1125000
NODE_75793_length_403_cov_3.611842	283	363	14	11	80	0.1375000
NODE_75793_length_403_cov_3.611842	283	363	16	4	80	0.0500000
NODE_75793_length_403_cov_3.611842	283	363	19	13	80	0.1625000
NODE_75793_length_403_cov_3.611842	283	363	20	4	80	0.0500000
NODE_75793_length_403_cov_3.611842	283	363	21	6	80	0.0750000
NODE_75793_length_403_cov_3.611842	283	363	22	11	80	0.1375000
NODE_75793_length_403_cov_3.611842	283	363	24	10	80	0.1250000
NODE_75824_length_403_cov_2.822368	201	282	8	18	81	0.2222222
NODE_75824_length_403_cov_2.822368	201	282	12	26	81	0.3209876
NODE_75824_length_403_cov_2.822368	201	282	13	7	81	0.0864198
NODE_75824_length_403_cov_2.822368	201	282	14	23	81	0.2839506
NODE_75824_length_403_cov_2.822368	201	282	16	2	81	0.0246914
NODE_75824_length_403_cov_2.822368	201	282	18	5	81	0.0617284
NODE_75871_length_403_cov_2.082237	102	145	0	43	43	1.0000000
NODE_75908_length_403_cov_1.871711	130	166	0	36	36	1.0000000
NODE_75993_length_403_cov_1.398026	79	116	0	37	37	1.0000000
NODE_76029_length_403_cov_1.269737	82	111	0	29	29	1.0000000
NODE_76239_length_402_cov_6.293729	217	297	2	15	80	0.1875000
NODE_76239_length_402_cov_6.293729	217	297	4	7	80	0.0875000
NODE_76239_length_402_cov_6.293729	217	297	6	58	80	0.7250000
NODE_76239_length_402_cov_6.293729	270	350	0	14	80	0.1750000
NODE_76239_length_402_cov_6.293729	270	350	2	12	80	0.1500000
NODE_76239_length_402_cov_6.293729	270	350	3	9	80	0.1125000
NODE_76239_length_402_cov_6.293729	270	350	4	17	80	0.2125000
NODE_76239_length_402_cov_6.293729	270	350	6	28	80	0.3500000
NODE_76246_length_402_cov_5.227723	176	236	16	20	60	0.3333333
NODE_76246_length_402_cov_5.227723	176	236	18	40	60	0.6666667
NODE_76261_length_402_cov_4.356436	44	123	0	79	79	1.0000000
NODE_76261_length_402_cov_4.356436	119	199	0	30	80	0.3750000
NODE_76261_length_402_cov_4.356436	119	199	2	4	80	0.0500000
NODE_76261_length_402_cov_4.356436	119	199	4	15	80	0.1875000
NODE_76261_length_402_cov_4.356436	119	199	6	31	80	0.3875000
NODE_76261_length_402_cov_4.356436	172	252	6	33	80	0.4125000
NODE_76261_length_402_cov_4.356436	172	252	8	9	80	0.1125000
NODE_76261_length_402_cov_4.356436	172	252	12	5	80	0.0625000
NODE_76261_length_402_cov_4.356436	172	252	14	33	80	0.4125000
NODE_76276_length_402_cov_3.564356	197	257	0	17	60	0.2833333
NODE_76276_length_402_cov_3.564356	197	257	2	2	60	0.0333333
NODE_76276_length_402_cov_3.564356	197	257	6	6	60	0.1000000
NODE_76276_length_402_cov_3.564356	197	257	8	25	60	0.4166667
NODE_76276_length_402_cov_3.564356	197	257	10	4	60	0.0666667
NODE_76276_length_402_cov_3.564356	197	257	12	6	60	0.1000000
NODE_76276_length_402_cov_3.564356	230	310	8	17	80	0.2125000
NODE_76276_length_402_cov_3.564356	230	310	10	4	80	0.0500000
NODE_76276_length_402_cov_3.564356	230	310	12	59	80	0.7375000
NODE_76328_length_402_cov_2.633663	335	402	0	67	67	1.0000000
NODE_76336_length_402_cov_2.514851	82	162	4	10	80	0.1250000
NODE_76336_length_402_cov_2.514851	82	162	6	7	80	0.0875000
NODE_76336_length_402_cov_2.514851	82	162	8	10	80	0.1250000
NODE_76336_length_402_cov_2.514851	82	162	10	1	80	0.0125000
NODE_76336_length_402_cov_2.514851	82	162	12	3	80	0.0375000
NODE_76336_length_402_cov_2.514851	82	162	14	5	80	0.0625000
NODE_76336_length_402_cov_2.514851	82	162	18	4	80	0.0500000
NODE_76336_length_402_cov_2.514851	82	162	20	2	80	0.0250000
NODE_76336_length_402_cov_2.514851	82	162	24	2	80	0.0250000
NODE_76336_length_402_cov_2.514851	82	162	26	19	80	0.2375000
NODE_76336_length_402_cov_2.514851	82	162	28	17	80	0.2125000
NODE_76336_length_402_cov_2.514851	135	200	0	15	65	0.2307692
NODE_76336_length_402_cov_2.514851	135	200	2	3	65	0.0461538
NODE_76336_length_402_cov_2.514851	135	200	4	17	65	0.2615385
NODE_76336_length_402_cov_2.514851	135	200	6	20	65	0.3076923
NODE_76336_length_402_cov_2.514851	135	200	8	10	65	0.1538462
NODE_76380_length_402_cov_2.102310	114	165	2	31	51	0.6078432
NODE_76380_length_402_cov_2.102310	114	165	4	20	51	0.3921569
NODE_76380_length_402_cov_2.102310	138	195	2	24	57	0.4210526
NODE_76380_length_402_cov_2.102310	138	195	4	33	57	0.5789474
NODE_76560_length_402_cov_1.214521	0	33	0	33	33	1.0000000
NODE_76646_length_402_cov_1.000000	119	188	0	49	69	0.7101449
NODE_76646_length_402_cov_1.000000	119	188	2	20	69	0.2898551
NODE_76752_length_402_cov_0.663366	0	46	0	46	46	1.0000000
NODE_76780_length_401_cov_43.675497	285	343	8	58	58	1.0000000
NODE_76801_length_401_cov_4.377483	309	389	0	80	80	1.0000000
NODE_76804_length_401_cov_4.241722	125	180	0	14	55	0.2545455
NODE_76804_length_401_cov_4.241722	125	180	2	2	55	0.0363636
NODE_76804_length_401_cov_4.241722	125	180	3	4	55	0.0727273
NODE_76804_length_401_cov_4.241722	125	180	4	4	55	0.0727273
NODE_76804_length_401_cov_4.241722	125	180	6	31	55	0.5636364
NODE_76808_length_401_cov_4.132450	195	275	2	52	80	0.6500000
NODE_76808_length_401_cov_4.132450	195	275	4	15	80	0.1875000
NODE_76808_length_401_cov_4.132450	195	275	6	13	80	0.1625000
NODE_76811_length_401_cov_3.973510	138	181	5	7	43	0.1627907
NODE_76811_length_401_cov_3.973510	138	181	7	36	43	0.8372093
NODE_76828_length_401_cov_3.370861	141	221	0	80	80	1.0000000
NODE_76828_length_401_cov_3.370861	194	273	0	79	79	1.0000000
NODE_76830_length_401_cov_3.317881	67	147	0	42	80	0.5250000
NODE_76830_length_401_cov_3.317881	67	147	2	38	80	0.4750000
NODE_76918_length_401_cov_1.937086	160	239	4	3	79	0.0379747
NODE_76918_length_401_cov_1.937086	160	239	6	25	79	0.3164557
NODE_76918_length_401_cov_1.937086	160	239	8	15	79	0.1898734
NODE_76918_length_401_cov_1.937086	160	239	10	36	79	0.4556962
NODE_76978_length_401_cov_1.615894	205	269	11	1	64	0.0156250
NODE_76978_length_401_cov_1.615894	205	269	13	2	64	0.0312500
NODE_76978_length_401_cov_1.615894	205	269	17	2	64	0.0312500
NODE_76978_length_401_cov_1.615894	205	269	19	2	64	0.0312500
NODE_76978_length_401_cov_1.615894	205	269	21	2	64	0.0312500
NODE_76978_length_401_cov_1.615894	205	269	22	1	64	0.0156250
NODE_76978_length_401_cov_1.615894	205	269	26	2	64	0.0312500
NODE_76978_length_401_cov_1.615894	205	269	30	3	64	0.0468750
NODE_76978_length_401_cov_1.615894	205	269	32	1	64	0.0156250
NODE_76978_length_401_cov_1.615894	205	269	46	2	64	0.0312500
NODE_76978_length_401_cov_1.615894	205	269	48	1	64	0.0156250
NODE_76978_length_401_cov_1.615894	205	269	53	1	64	0.0156250
NODE_76978_length_401_cov_1.615894	205	269	59	1	64	0.0156250
NODE_76978_length_401_cov_1.615894	205	269	69	2	64	0.0312500
NODE_76978_length_401_cov_1.615894	205	269	74	1	64	0.0156250
NODE_76978_length_401_cov_1.615894	205	269	85	1	64	0.0156250
NODE_76978_length_401_cov_1.615894	205	269	95	1	64	0.0156250
NODE_76978_length_401_cov_1.615894	205	269	102	1	64	0.0156250
NODE_76978_length_401_cov_1.615894	205	269	103	2	64	0.0312500
NODE_76978_length_401_cov_1.615894	205	269	104	1	64	0.0156250
NODE_76978_length_401_cov_1.615894	205	269	108	1	64	0.0156250
NODE_76978_length_401_cov_1.615894	205	269	112	1	64	0.0156250
NODE_76978_length_401_cov_1.615894	205	269	116	1	64	0.0156250
NODE_76978_length_401_cov_1.615894	205	269	120	3	64	0.0468750
NODE_76978_length_401_cov_1.615894	205	269	124	1	64	0.0156250
NODE_76978_length_401_cov_1.615894	205	269	126	2	64	0.0312500
NODE_76978_length_401_cov_1.615894	205	269	128	3	64	0.0468750
NODE_76978_length_401_cov_1.615894	205	269	132	1	64	0.0156250
NODE_76978_length_401_cov_1.615894	205	269	135	4	64	0.0625000
NODE_76978_length_401_cov_1.615894	205	269	139	1	64	0.0156250
NODE_76978_length_401_cov_1.615894	205	269	143	2	64	0.0312500
NODE_76978_length_401_cov_1.615894	205	269	147	2	64	0.0312500
NODE_76978_length_401_cov_1.615894	205	269	149	1	64	0.0156250
NODE_76978_length_401_cov_1.615894	205	269	153	2	64	0.0312500
NODE_76978_length_401_cov_1.615894	205	269	155	1	64	0.0156250
NODE_76978_length_401_cov_1.615894	205	269	157	5	64	0.0781250
NODE_76978_length_401_cov_1.615894	205	269	159	1	64	0.0156250
NODE_76978_length_401_cov_1.615894	205	269	165	2	64	0.0312500
NODE_77017_length_401_cov_1.407285	23	92	0	47	69	0.6811594
NODE_77017_length_401_cov_1.407285	23	92	2	22	69	0.3188406
NODE_77017_length_401_cov_1.407285	76	122	2	46	46	1.0000000
NODE_77236_length_401_cov_0.675497	292	372	4	74	80	0.9250000
NODE_77236_length_401_cov_0.675497	292	372	6	6	80	0.0750000
NODE_77236_length_401_cov_0.675497	345	401	4	21	56	0.3750000
NODE_77236_length_401_cov_0.675497	345	401	6	35	56	0.6250000
NODE_77284_length_400_cov_40.584718	205	281	0	41	76	0.5394737
NODE_77284_length_400_cov_40.584718	205	281	2	11	76	0.1447368
NODE_77284_length_400_cov_40.584718	205	281	3	2	76	0.0263158
NODE_77284_length_400_cov_40.584718	205	281	17	22	76	0.2894737
NODE_77284_length_400_cov_40.584718	254	334	2	3	80	0.0375000
NODE_77284_length_400_cov_40.584718	254	334	3	2	80	0.0250000
NODE_77284_length_400_cov_40.584718	254	334	12	10	80	0.1250000
NODE_77284_length_400_cov_40.584718	254	334	15	1	80	0.0125000
NODE_77284_length_400_cov_40.584718	254	334	16	9	80	0.1125000
NODE_77284_length_400_cov_40.584718	254	334	17	40	80	0.5000000
NODE_77284_length_400_cov_40.584718	254	334	18	15	80	0.1875000
NODE_77289_length_400_cov_8.631229	307	372	12	65	65	1.0000000
NODE_77292_length_400_cov_6.850498	281	329	0	48	48	1.0000000
NODE_77322_length_400_cov_4.000000	82	140	2	14	58	0.2413793
NODE_77322_length_400_cov_4.000000	82	140	4	44	58	0.7586207
NODE_77358_length_400_cov_3.029900	204	284	0	80	80	1.0000000
NODE_77358_length_400_cov_3.029900	205	231	0	26	26	1.0000000
NODE_77362_length_400_cov_3.009967	146	220	12	5	74	0.0675676
NODE_77362_length_400_cov_3.009967	146	220	16	1	74	0.0135135
NODE_77362_length_400_cov_3.009967	146	220	18	3	74	0.0405405
NODE_77362_length_400_cov_3.009967	146	220	22	2	74	0.0270270
NODE_77362_length_400_cov_3.009967	146	220	24	2	74	0.0270270
NODE_77362_length_400_cov_3.009967	146	220	25	1	74	0.0135135
NODE_77362_length_400_cov_3.009967	146	220	26	20	74	0.2702703
NODE_77362_length_400_cov_3.009967	146	220	28	14	74	0.1891892
NODE_77362_length_400_cov_3.009967	146	220	30	26	74	0.3513514
NODE_77362_length_400_cov_3.009967	195	261	24	2	66	0.0303030
NODE_77362_length_400_cov_3.009967	195	261	25	9	66	0.1363636
NODE_77362_length_400_cov_3.009967	195	261	26	15	66	0.2272727
NODE_77362_length_400_cov_3.009967	195	261	28	7	66	0.1060606
NODE_77362_length_400_cov_3.009967	195	261	29	18	66	0.2727273
NODE_77362_length_400_cov_3.009967	195	261	30	8	66	0.1212121
NODE_77362_length_400_cov_3.009967	195	261	31	1	66	0.0151515
NODE_77362_length_400_cov_3.009967	195	261	32	6	66	0.0909091
NODE_77363_length_400_cov_2.990033	253	332	95	8	79	0.1012658
NODE_77363_length_400_cov_2.990033	253	332	96	9	79	0.1139240
NODE_77363_length_400_cov_2.990033	253	332	97	14	79	0.1772152
NODE_77363_length_400_cov_2.990033	253	332	98	6	79	0.0759494
NODE_77363_length_400_cov_2.990033	253	332	100	2	79	0.0253165
NODE_77363_length_400_cov_2.990033	253	332	101	2	79	0.0253165
NODE_77363_length_400_cov_2.990033	253	332	102	1	79	0.0126582
NODE_77363_length_400_cov_2.990033	253	332	104	2	79	0.0253165
NODE_77363_length_400_cov_2.990033	253	332	112	3	79	0.0379747
NODE_77363_length_400_cov_2.990033	253	332	114	3	79	0.0379747
NODE_77363_length_400_cov_2.990033	253	332	115	1	79	0.0126582
NODE_77363_length_400_cov_2.990033	253	332	116	1	79	0.0126582
NODE_77363_length_400_cov_2.990033	253	332	118	1	79	0.0126582
NODE_77363_length_400_cov_2.990033	253	332	122	2	79	0.0253165
NODE_77363_length_400_cov_2.990033	253	332	128	2	79	0.0253165
NODE_77363_length_400_cov_2.990033	253	332	131	3	79	0.0379747
NODE_77363_length_400_cov_2.990033	253	332	133	2	79	0.0253165
NODE_77363_length_400_cov_2.990033	253	332	134	3	79	0.0379747
NODE_77363_length_400_cov_2.990033	253	332	135	1	79	0.0126582
NODE_77363_length_400_cov_2.990033	253	332	138	1	79	0.0126582
NODE_77363_length_400_cov_2.990033	253	332	139	3	79	0.0379747
NODE_77363_length_400_cov_2.990033	253	332	141	1	79	0.0126582
NODE_77363_length_400_cov_2.990033	253	332	143	1	79	0.0126582
NODE_77363_length_400_cov_2.990033	253	332	144	1	79	0.0126582
NODE_77363_length_400_cov_2.990033	253	332	147	1	79	0.0126582
NODE_77363_length_400_cov_2.990033	253	332	148	1	79	0.0126582
NODE_77363_length_400_cov_2.990033	253	332	149	3	79	0.0379747
NODE_77363_length_400_cov_2.990033	253	332	150	1	79	0.0126582
NODE_77363_length_400_cov_2.990033	306	385	118	23	79	0.2911392
NODE_77363_length_400_cov_2.990033	306	385	119	2	79	0.0253165
NODE_77363_length_400_cov_2.990033	306	385	120	2	79	0.0253165
NODE_77363_length_400_cov_2.990033	306	385	121	7	79	0.0886076
NODE_77363_length_400_cov_2.990033	306	385	122	2	79	0.0253165
NODE_77363_length_400_cov_2.990033	306	385	123	1	79	0.0126582
NODE_77363_length_400_cov_2.990033	306	385	128	2	79	0.0253165
NODE_77363_length_400_cov_2.990033	306	385	131	8	79	0.1012658
NODE_77363_length_400_cov_2.990033	306	385	133	3	79	0.0379747
NODE_77363_length_400_cov_2.990033	306	385	134	3	79	0.0379747
NODE_77363_length_400_cov_2.990033	306	385	135	1	79	0.0126582
NODE_77363_length_400_cov_2.990033	306	385	138	1	79	0.0126582
NODE_77363_length_400_cov_2.990033	306	385	139	7	79	0.0886076
NODE_77363_length_400_cov_2.990033	306	385	141	1	79	0.0126582
NODE_77363_length_400_cov_2.990033	306	385	143	1	79	0.0126582
NODE_77363_length_400_cov_2.990033	306	385	144	3	79	0.0379747
NODE_77363_length_400_cov_2.990033	306	385	146	1	79	0.0126582
NODE_77363_length_400_cov_2.990033	306	385	147	4	79	0.0506329
NODE_77363_length_400_cov_2.990033	306	385	148	1	79	0.0126582
NODE_77363_length_400_cov_2.990033	306	385	149	3	79	0.0379747
NODE_77363_length_400_cov_2.990033	306	385	150	3	79	0.0379747
NODE_77368_length_400_cov_2.860465	365	400	0	35	35	1.0000000
NODE_77371_length_400_cov_2.797342	324	372	0	48	48	1.0000000
NODE_77380_length_400_cov_2.581395	192	254	0	62	62	1.0000000
NODE_77460_length_400_cov_1.940199	225	268	0	41	43	0.9534883
NODE_77460_length_400_cov_1.940199	225	268	2	2	43	0.0465116
NODE_77460_length_400_cov_1.940199	293	374	4	35	81	0.4320988
NODE_77460_length_400_cov_1.940199	293	374	6	46	81	0.5679013
NODE_77821_length_399_cov_71.493333	215	295	0	80	80	1.0000000
NODE_77821_length_399_cov_71.493333	268	348	0	80	80	1.0000000
NODE_77823_length_399_cov_7.510000	229	309	0	80	80	1.0000000
NODE_77823_length_399_cov_7.510000	282	362	0	80	80	1.0000000
NODE_77825_length_399_cov_7.310000	125	187	2	35	62	0.5645161
NODE_77825_length_399_cov_7.310000	125	187	4	27	62	0.4354839
NODE_77854_length_399_cov_4.293333	86	164	4	9	78	0.1153846
NODE_77854_length_399_cov_4.293333	86	164	6	2	78	0.0256410
NODE_77854_length_399_cov_4.293333	86	164	7	5	78	0.0641026
NODE_77854_length_399_cov_4.293333	86	164	8	8	78	0.1025641
NODE_77854_length_399_cov_4.293333	86	164	10	5	78	0.0641026
NODE_77854_length_399_cov_4.293333	86	164	12	49	78	0.6282051
NODE_77877_length_399_cov_3.406667	51	124	0	73	73	1.0000000
NODE_77933_length_399_cov_2.286667	310	390	0	80	80	1.0000000
NODE_77966_length_399_cov_1.916667	76	136	4	12	60	0.2000000
NODE_77966_length_399_cov_1.916667	76	136	6	12	60	0.2000000
NODE_77966_length_399_cov_1.916667	76	136	8	15	60	0.2500000
NODE_77966_length_399_cov_1.916667	76	136	10	1	60	0.0166667
NODE_77966_length_399_cov_1.916667	76	136	12	20	60	0.3333333
NODE_77966_length_399_cov_1.916667	123	189	12	19	66	0.2878788
NODE_77966_length_399_cov_1.916667	123	189	16	18	66	0.2727273
NODE_77966_length_399_cov_1.916667	123	189	17	10	66	0.1515152
NODE_77966_length_399_cov_1.916667	123	189	19	19	66	0.2878788
NODE_78276_length_399_cov_0.710000	313	392	0	50	79	0.6329114
NODE_78276_length_399_cov_0.710000	313	392	2	29	79	0.3670886
NODE_78354_length_398_cov_9.688963	1	81	0	80	80	1.0000000
NODE_78354_length_398_cov_9.688963	247	327	0	80	80	1.0000000
NODE_78354_length_398_cov_9.688963	300	380	0	80	80	1.0000000
NODE_78360_length_398_cov_6.488294	130	210	0	80	80	1.0000000
NODE_78364_length_398_cov_5.765886	253	333	6	50	80	0.6250000
NODE_78364_length_398_cov_5.765886	253	333	7	20	80	0.2500000
NODE_78364_length_398_cov_5.765886	253	333	8	10	80	0.1250000
NODE_78372_length_398_cov_5.244147	248	312	0	64	64	1.0000000
NODE_78376_length_398_cov_5.006689	116	196	0	80	80	1.0000000
NODE_78376_length_398_cov_5.006689	169	251	0	82	82	1.0000000
NODE_78383_length_398_cov_4.284281	63	117	0	54	54	1.0000000
NODE_78383_length_398_cov_4.284281	135	160	0	25	25	1.0000000
NODE_78420_length_398_cov_2.993311	229	309	1	6	80	0.0750000
NODE_78420_length_398_cov_2.993311	229	309	2	72	80	0.9000000
NODE_78420_length_398_cov_2.993311	229	309	3	2	80	0.0250000
NODE_78429_length_398_cov_2.822742	236	271	0	35	35	1.0000000
NODE_78891_length_397_cov_52.855705	124	204	0	80	80	1.0000000
NODE_78891_length_397_cov_52.855705	177	257	0	80	80	1.0000000
NODE_78894_length_397_cov_35.036913	173	253	0	4	80	0.0500000
NODE_78894_length_397_cov_35.036913	173	253	2	76	80	0.9500000
NODE_78895_length_397_cov_13.667785	94	174	0	80	80	1.0000000
NODE_78895_length_397_cov_13.667785	147	227	0	27	80	0.3375000
NODE_78895_length_397_cov_13.667785	147	227	4	53	80	0.6625000
NODE_78897_length_397_cov_7.496644	192	272	0	80	80	1.0000000
NODE_78897_length_397_cov_7.496644	245	325	0	80	80	1.0000000
NODE_78898_length_397_cov_6.828859	127	173	0	46	46	1.0000000
NODE_78913_length_397_cov_4.902685	293	364	0	71	71	1.0000000
NODE_78933_length_397_cov_3.765101	164	244	0	5	80	0.0625000
NODE_78933_length_397_cov_3.765101	164	244	2	75	80	0.9375000
NODE_78951_length_397_cov_3.325503	107	187	0	3	80	0.0375000
NODE_78951_length_397_cov_3.325503	107	187	1	39	80	0.4875000
NODE_78951_length_397_cov_3.325503	107	187	2	38	80	0.4750000
NODE_78951_length_397_cov_3.325503	163	236	2	52	73	0.7123288
NODE_78951_length_397_cov_3.325503	163	236	4	10	73	0.1369863
NODE_78951_length_397_cov_3.325503	163	236	6	11	73	0.1506849
NODE_78999_length_397_cov_2.530201	269	312	0	43	43	1.0000000
NODE_79047_length_397_cov_1.959732	154	193	0	39	39	1.0000000
NODE_79072_length_397_cov_1.791946	218	283	0	1	65	0.0153846
NODE_79072_length_397_cov_1.791946	218	283	4	23	65	0.3538462
NODE_79072_length_397_cov_1.791946	218	283	6	4	65	0.0615385
NODE_79072_length_397_cov_1.791946	218	283	8	7	65	0.1076923
NODE_79072_length_397_cov_1.791946	218	283	11	1	65	0.0153846
NODE_79072_length_397_cov_1.791946	218	283	15	5	65	0.0769231
NODE_79072_length_397_cov_1.791946	218	283	16	18	65	0.2769231
NODE_79072_length_397_cov_1.791946	218	283	18	6	65	0.0923077
NODE_79127_length_397_cov_1.560403	183	240	0	57	57	1.0000000
NODE_79456_length_396_cov_11.632997	162	242	0	80	80	1.0000000
NODE_79456_length_396_cov_11.632997	215	295	0	80	80	1.0000000
NODE_79460_length_396_cov_7.053872	71	101	0	30	30	1.0000000
NODE_79464_length_396_cov_6.097643	229	309	0	73	80	0.9125000
NODE_79464_length_396_cov_6.097643	229	309	2	7	80	0.0875000
NODE_79464_length_396_cov_6.097643	282	362	0	20	80	0.2500000
NODE_79464_length_396_cov_6.097643	282	362	2	60	80	0.7500000
NODE_79471_length_396_cov_5.484848	125	205	6	2	80	0.0250000
NODE_79471_length_396_cov_5.484848	125	205	10	47	80	0.5875000
NODE_79471_length_396_cov_5.484848	125	205	11	2	80	0.0250000
NODE_79471_length_396_cov_5.484848	125	205	12	26	80	0.3250000
NODE_79471_length_396_cov_5.484848	125	205	13	3	80	0.0375000
NODE_79471_length_396_cov_5.484848	178	259	2	7	81	0.0864198
NODE_79471_length_396_cov_5.484848	178	259	4	5	81	0.0617284
NODE_79471_length_396_cov_5.484848	178	259	8	41	81	0.5061728
NODE_79471_length_396_cov_5.484848	178	259	10	28	81	0.3456790
NODE_79473_length_396_cov_5.434343	224	275	0	46	51	0.9019608
NODE_79473_length_396_cov_5.434343	224	275	2	5	51	0.0980392
NODE_79473_length_396_cov_5.434343	272	331	0	59	59	1.0000000
NODE_79483_length_396_cov_4.414141	189	264	4	75	75	1.0000000
NODE_79483_length_396_cov_4.414141	241	317	0	41	76	0.5394737
NODE_79483_length_396_cov_4.414141	241	317	2	10	76	0.1315790
NODE_79483_length_396_cov_4.414141	241	317	4	25	76	0.3289474
NODE_79493_length_396_cov_4.010101	163	205	2	12	42	0.2857143
NODE_79493_length_396_cov_4.010101	163	205	4	30	42	0.7142857
NODE_79522_length_396_cov_3.080808	95	161	1	1	66	0.0151515
NODE_79522_length_396_cov_3.080808	95	161	2	59	66	0.8939394
NODE_79522_length_396_cov_3.080808	95	161	3	6	66	0.0909091
NODE_79524_length_396_cov_3.067340	252	316	2	25	64	0.3906250
NODE_79524_length_396_cov_3.067340	252	316	3	6	64	0.0937500
NODE_79524_length_396_cov_3.067340	252	316	5	31	64	0.4843750
NODE_79524_length_396_cov_3.067340	252	316	7	2	64	0.0312500
NODE_79535_length_396_cov_2.892256	136	217	0	16	81	0.1975309
NODE_79535_length_396_cov_2.892256	136	217	2	65	81	0.8024691
NODE_79557_length_396_cov_2.710438	88	168	6	9	80	0.1125000
NODE_79557_length_396_cov_2.710438	88	168	7	3	80	0.0375000
NODE_79557_length_396_cov_2.710438	88	168	9	2	80	0.0250000
NODE_79557_length_396_cov_2.710438	88	168	13	1	80	0.0125000
NODE_79557_length_396_cov_2.710438	88	168	17	1	80	0.0125000
NODE_79557_length_396_cov_2.710438	88	168	21	2	80	0.0250000
NODE_79557_length_396_cov_2.710438	88	168	23	1	80	0.0125000
NODE_79557_length_396_cov_2.710438	88	168	30	1	80	0.0125000
NODE_79557_length_396_cov_2.710438	88	168	34	1	80	0.0125000
NODE_79557_length_396_cov_2.710438	88	168	36	2	80	0.0250000
NODE_79557_length_396_cov_2.710438	88	168	38	1	80	0.0125000
NODE_79557_length_396_cov_2.710438	88	168	40	3	80	0.0375000
NODE_79557_length_396_cov_2.710438	88	168	42	4	80	0.0500000
NODE_79557_length_396_cov_2.710438	88	168	48	4	80	0.0500000
NODE_79557_length_396_cov_2.710438	88	168	52	2	80	0.0250000
NODE_79557_length_396_cov_2.710438	88	168	54	4	80	0.0500000
NODE_79557_length_396_cov_2.710438	88	168	56	6	80	0.0750000
NODE_79557_length_396_cov_2.710438	88	168	58	22	80	0.2750000
NODE_79557_length_396_cov_2.710438	88	168	60	11	80	0.1375000
NODE_79561_length_396_cov_2.680135	297	335	0	38	38	1.0000000
NODE_79562_length_396_cov_2.659933	68	148	0	80	80	1.0000000
NODE_79562_length_396_cov_2.659933	121	168	0	47	47	1.0000000
NODE_79616_length_396_cov_2.060606	308	388	2	80	80	1.0000000
NODE_79643_length_396_cov_1.939394	63	142	0	1	79	0.0126582
NODE_79643_length_396_cov_1.939394	63	142	6	1	79	0.0126582
NODE_79643_length_396_cov_1.939394	63	142	8	5	79	0.0632911
NODE_79643_length_396_cov_1.939394	63	142	10	1	79	0.0126582
NODE_79643_length_396_cov_1.939394	63	142	12	1	79	0.0126582
NODE_79643_length_396_cov_1.939394	63	142	14	9	79	0.1139240
NODE_79643_length_396_cov_1.939394	63	142	16	61	79	0.7721519
NODE_79643_length_396_cov_1.939394	115	164	14	22	49	0.4489796
NODE_79643_length_396_cov_1.939394	115	164	16	27	49	0.5510204
NODE_79683_length_396_cov_1.811448	82	162	0	80	80	1.0000000
NODE_79692_length_396_cov_1.734007	88	119	0	31	31	1.0000000
NODE_79930_length_396_cov_0.905724	101	151	10	36	50	0.7200000
NODE_79930_length_396_cov_0.905724	101	151	12	1	50	0.0200000
NODE_79930_length_396_cov_0.905724	101	151	14	12	50	0.2400000
NODE_79930_length_396_cov_0.905724	101	151	16	1	50	0.0200000
NODE_80057_length_395_cov_449.327703	0	79	36	1	79	0.0126582
NODE_80057_length_395_cov_449.327703	0	79	37	2	79	0.0253165
NODE_80057_length_395_cov_449.327703	0	79	42	1	79	0.0126582
NODE_80057_length_395_cov_449.327703	0	79	52	1	79	0.0126582
NODE_80057_length_395_cov_449.327703	0	79	74	1	79	0.0126582
NODE_80057_length_395_cov_449.327703	0	79	75	1	79	0.0126582
NODE_80057_length_395_cov_449.327703	0	79	76	1	79	0.0126582
NODE_80057_length_395_cov_449.327703	0	79	78	2	79	0.0253165
NODE_80057_length_395_cov_449.327703	0	79	93	1	79	0.0126582
NODE_80057_length_395_cov_449.327703	0	79	103	1	79	0.0126582
NODE_80057_length_395_cov_449.327703	0	79	109	1	79	0.0126582
NODE_80057_length_395_cov_449.327703	0	79	113	1	79	0.0126582
NODE_80057_length_395_cov_449.327703	0	79	117	1	79	0.0126582
NODE_80057_length_395_cov_449.327703	0	79	120	1	79	0.0126582
NODE_80057_length_395_cov_449.327703	0	79	130	2	79	0.0253165
NODE_80057_length_395_cov_449.327703	0	79	134	1	79	0.0126582
NODE_80057_length_395_cov_449.327703	0	79	141	1	79	0.0126582
NODE_80057_length_395_cov_449.327703	0	79	145	1	79	0.0126582
NODE_80057_length_395_cov_449.327703	0	79	155	1	79	0.0126582
NODE_80057_length_395_cov_449.327703	0	79	169	1	79	0.0126582
NODE_80057_length_395_cov_449.327703	0	79	174	1	79	0.0126582
NODE_80057_length_395_cov_449.327703	0	79	175	1	79	0.0126582
NODE_80057_length_395_cov_449.327703	0	79	182	1	79	0.0126582
NODE_80057_length_395_cov_449.327703	0	79	190	1	79	0.0126582
NODE_80057_length_395_cov_449.327703	0	79	200	1	79	0.0126582
NODE_80057_length_395_cov_449.327703	0	79	201	1	79	0.0126582
NODE_80057_length_395_cov_449.327703	0	79	206	1	79	0.0126582
NODE_80057_length_395_cov_449.327703	0	79	212	2	79	0.0253165
NODE_80057_length_395_cov_449.327703	0	79	219	1	79	0.0126582
NODE_80057_length_395_cov_449.327703	0	79	224	2	79	0.0253165
NODE_80057_length_395_cov_449.327703	0	79	226	2	79	0.0253165
NODE_80057_length_395_cov_449.327703	0	79	233	1	79	0.0126582
NODE_80057_length_395_cov_449.327703	0	79	236	1	79	0.0126582
NODE_80057_length_395_cov_449.327703	0	79	240	2	79	0.0253165
NODE_80057_length_395_cov_449.327703	0	79	261	1	79	0.0126582
NODE_80057_length_395_cov_449.327703	0	79	263	1	79	0.0126582
NODE_80057_length_395_cov_449.327703	0	79	273	1	79	0.0126582
NODE_80057_length_395_cov_449.327703	0	79	275	1	79	0.0126582
NODE_80057_length_395_cov_449.327703	0	79	278	1	79	0.0126582
NODE_80057_length_395_cov_449.327703	0	79	281	1	79	0.0126582
NODE_80057_length_395_cov_449.327703	0	79	285	1	79	0.0126582
NODE_80057_length_395_cov_449.327703	0	79	294	1	79	0.0126582
NODE_80057_length_395_cov_449.327703	0	79	296	4	79	0.0506329
NODE_80057_length_395_cov_449.327703	0	79	301	1	79	0.0126582
NODE_80057_length_395_cov_449.327703	0	79	302	4	79	0.0506329
NODE_80057_length_395_cov_449.327703	0	79	308	2	79	0.0253165
NODE_80057_length_395_cov_449.327703	0	79	309	1	79	0.0126582
NODE_80057_length_395_cov_449.327703	0	79	317	2	79	0.0253165
NODE_80057_length_395_cov_449.327703	0	79	321	1	79	0.0126582
NODE_80057_length_395_cov_449.327703	0	79	323	1	79	0.0126582
NODE_80057_length_395_cov_449.327703	0	79	326	1	79	0.0126582
NODE_80057_length_395_cov_449.327703	0	79	328	1	79	0.0126582
NODE_80057_length_395_cov_449.327703	0	79	332	1	79	0.0126582
NODE_80057_length_395_cov_449.327703	0	79	333	1	79	0.0126582
NODE_80057_length_395_cov_449.327703	0	79	338	1	79	0.0126582
NODE_80057_length_395_cov_449.327703	0	79	340	2	79	0.0253165
NODE_80057_length_395_cov_449.327703	0	79	342	1	79	0.0126582
NODE_80057_length_395_cov_449.327703	0	79	347	1	79	0.0126582
NODE_80057_length_395_cov_449.327703	0	79	351	1	79	0.0126582
NODE_80057_length_395_cov_449.327703	0	79	352	2	79	0.0253165
NODE_80057_length_395_cov_449.327703	0	79	356	2	79	0.0253165
NODE_80058_length_395_cov_13.695946	113	193	0	80	80	1.0000000
NODE_80058_length_395_cov_13.695946	166	246	0	80	80	1.0000000
NODE_80086_length_395_cov_4.179054	152	232	0	8	80	0.1000000
NODE_80086_length_395_cov_4.179054	152	232	4	23	80	0.2875000
NODE_80086_length_395_cov_4.179054	152	232	5	1	80	0.0125000
NODE_80086_length_395_cov_4.179054	152	232	8	48	80	0.6000000
NODE_80116_length_395_cov_2.962838	118	198	4	6	80	0.0750000
NODE_80116_length_395_cov_2.962838	118	198	6	5	80	0.0625000
NODE_80116_length_395_cov_2.962838	118	198	8	13	80	0.1625000
NODE_80116_length_395_cov_2.962838	118	198	10	56	80	0.7000000
NODE_80116_length_395_cov_2.962838	171	237	0	11	66	0.1666667
NODE_80116_length_395_cov_2.962838	171	237	2	6	66	0.0909091
NODE_80116_length_395_cov_2.962838	171	237	4	28	66	0.4242424
NODE_80116_length_395_cov_2.962838	171	237	6	5	66	0.0757576
NODE_80116_length_395_cov_2.962838	171	237	10	16	66	0.2424242
NODE_80121_length_395_cov_2.878378	261	301	2	40	40	1.0000000
NODE_80139_length_395_cov_2.587838	111	188	6	27	77	0.3506494
NODE_80139_length_395_cov_2.587838	111	188	8	5	77	0.0649351
NODE_80139_length_395_cov_2.587838	111	188	10	45	77	0.5844156
NODE_80139_length_395_cov_2.587838	232	301	2	30	69	0.4347826
NODE_80139_length_395_cov_2.587838	232	301	4	39	69	0.5652174
NODE_80139_length_395_cov_2.587838	258	302	2	31	44	0.7045454
NODE_80139_length_395_cov_2.587838	258	302	4	13	44	0.2954545
NODE_80141_length_395_cov_2.560811	123	187	0	64	64	1.0000000
NODE_80146_length_395_cov_2.527027	194	274	2	80	80	1.0000000
NODE_80146_length_395_cov_2.527027	247	327	0	27	80	0.3375000
NODE_80146_length_395_cov_2.527027	247	327	2	53	80	0.6625000
NODE_80439_length_395_cov_1.033784	103	151	0	48	48	1.0000000
NODE_80448_length_395_cov_1.010135	85	105	0	20	20	1.0000000
NODE_80639_length_394_cov_9.464407	211	291	0	3	80	0.0375000
NODE_80639_length_394_cov_9.464407	211	291	2	77	80	0.9625000
NODE_80639_length_394_cov_9.464407	264	344	0	56	80	0.7000000
NODE_80639_length_394_cov_9.464407	264	344	2	24	80	0.3000000
NODE_80643_length_394_cov_7.437288	221	301	0	32	80	0.4000000
NODE_80643_length_394_cov_7.437288	221	301	2	10	80	0.1250000
NODE_80643_length_394_cov_7.437288	221	301	4	27	80	0.3375000
NODE_80643_length_394_cov_7.437288	221	301	8	11	80	0.1375000
NODE_80643_length_394_cov_7.437288	274	331	4	16	57	0.2807018
NODE_80643_length_394_cov_7.437288	274	331	6	12	57	0.2105263
NODE_80643_length_394_cov_7.437288	274	331	8	29	57	0.5087720
NODE_80647_length_394_cov_6.444068	187	267	0	80	80	1.0000000
NODE_80647_length_394_cov_6.444068	240	320	0	80	80	1.0000000
NODE_80709_length_394_cov_2.932203	119	140	0	21	21	1.0000000
NODE_80710_length_394_cov_2.894915	79	135	2	22	56	0.3928571
NODE_80710_length_394_cov_2.894915	79	135	4	34	56	0.6071429
NODE_80710_length_394_cov_2.894915	166	202	0	36	36	1.0000000
NODE_81216_length_393_cov_4.261905	201	267	0	66	66	1.0000000
NODE_81216_length_393_cov_4.261905	240	282	0	42	42	1.0000000
NODE_81240_length_393_cov_3.503401	121	201	0	52	80	0.6500000
NODE_81240_length_393_cov_3.503401	121	201	2	28	80	0.3500000
NODE_81240_length_393_cov_3.503401	174	246	2	72	72	1.0000000
NODE_81277_length_393_cov_2.704082	198	271	0	73	73	1.0000000
NODE_81289_length_393_cov_2.493197	136	216	0	24	80	0.3000000
NODE_81289_length_393_cov_2.493197	136	216	2	56	80	0.7000000
NODE_81289_length_393_cov_2.493197	189	269	0	39	80	0.4875000
NODE_81289_length_393_cov_2.493197	189	269	2	41	80	0.5125000
NODE_81296_length_393_cov_2.360544	195	252	0	57	57	1.0000000
NODE_81416_length_393_cov_1.608844	207	270	0	63	63	1.0000000
NODE_81778_length_392_cov_7.873720	161	241	0	80	80	1.0000000
NODE_81778_length_392_cov_7.873720	214	294	0	80	80	1.0000000
NODE_81790_length_392_cov_5.262799	218	248	0	30	30	1.0000000
NODE_81805_length_392_cov_3.655290	109	157	0	8	48	0.1666667
NODE_81805_length_392_cov_3.655290	109	157	2	40	48	0.8333333
NODE_81805_length_392_cov_3.655290	306	386	0	80	80	1.0000000
NODE_81823_length_392_cov_3.197952	102	171	0	28	69	0.4057971
NODE_81823_length_392_cov_3.197952	102	171	4	4	69	0.0579710
NODE_81823_length_392_cov_3.197952	102	171	6	28	69	0.4057971
NODE_81823_length_392_cov_3.197952	102	171	10	9	69	0.1304348
NODE_81823_length_392_cov_3.197952	233	314	0	81	81	1.0000000
NODE_81857_length_392_cov_2.511945	67	133	34	2	66	0.0303030
NODE_81857_length_392_cov_2.511945	67	133	40	2	66	0.0303030
NODE_81857_length_392_cov_2.511945	67	133	42	1	66	0.0151515
NODE_81857_length_392_cov_2.511945	67	133	45	1	66	0.0151515
NODE_81857_length_392_cov_2.511945	67	133	47	6	66	0.0909091
NODE_81857_length_392_cov_2.511945	67	133	49	1	66	0.0151515
NODE_81857_length_392_cov_2.511945	67	133	51	3	66	0.0454545
NODE_81857_length_392_cov_2.511945	67	133	53	2	66	0.0303030
NODE_81857_length_392_cov_2.511945	67	133	61	1	66	0.0151515
NODE_81857_length_392_cov_2.511945	67	133	64	1	66	0.0151515
NODE_81857_length_392_cov_2.511945	67	133	66	1	66	0.0151515
NODE_81857_length_392_cov_2.511945	67	133	69	1	66	0.0151515
NODE_81857_length_392_cov_2.511945	67	133	71	2	66	0.0303030
NODE_81857_length_392_cov_2.511945	67	133	73	1	66	0.0151515
NODE_81857_length_392_cov_2.511945	67	133	75	1	66	0.0151515
NODE_81857_length_392_cov_2.511945	67	133	78	2	66	0.0303030
NODE_81857_length_392_cov_2.511945	67	133	86	1	66	0.0151515
NODE_81857_length_392_cov_2.511945	67	133	90	1	66	0.0151515
NODE_81857_length_392_cov_2.511945	67	133	96	1	66	0.0151515
NODE_81857_length_392_cov_2.511945	67	133	97	1	66	0.0151515
NODE_81857_length_392_cov_2.511945	67	133	109	2	66	0.0303030
NODE_81857_length_392_cov_2.511945	67	133	110	1	66	0.0151515
NODE_81857_length_392_cov_2.511945	67	133	114	2	66	0.0303030
NODE_81857_length_392_cov_2.511945	67	133	120	2	66	0.0303030
NODE_81857_length_392_cov_2.511945	67	133	128	3	66	0.0454545
NODE_81857_length_392_cov_2.511945	67	133	130	6	66	0.0909091
NODE_81857_length_392_cov_2.511945	67	133	131	1	66	0.0151515
NODE_81857_length_392_cov_2.511945	67	133	143	2	66	0.0303030
NODE_81857_length_392_cov_2.511945	67	133	145	1	66	0.0151515
NODE_81857_length_392_cov_2.511945	67	133	153	2	66	0.0303030
NODE_81857_length_392_cov_2.511945	67	133	155	1	66	0.0151515
NODE_81857_length_392_cov_2.511945	67	133	157	2	66	0.0303030
NODE_81857_length_392_cov_2.511945	67	133	159	1	66	0.0151515
NODE_81857_length_392_cov_2.511945	67	133	163	4	66	0.0606061
NODE_81857_length_392_cov_2.511945	67	133	167	2	66	0.0303030
NODE_81857_length_392_cov_2.511945	67	133	177	2	66	0.0303030
NODE_81857_length_392_cov_2.511945	120	206	153	1	86	0.0116279
NODE_81857_length_392_cov_2.511945	120	206	155	1	86	0.0116279
NODE_81857_length_392_cov_2.511945	120	206	157	2	86	0.0232558
NODE_81857_length_392_cov_2.511945	120	206	159	1	86	0.0116279
NODE_81857_length_392_cov_2.511945	120	206	163	4	86	0.0465116
NODE_81857_length_392_cov_2.511945	120	206	166	6	86	0.0697674
NODE_81857_length_392_cov_2.511945	120	206	167	3	86	0.0348837
NODE_81857_length_392_cov_2.511945	120	206	168	1	86	0.0116279
NODE_81857_length_392_cov_2.511945	120	206	177	2	86	0.0232558
NODE_81857_length_392_cov_2.511945	120	206	178	1	86	0.0116279
NODE_81857_length_392_cov_2.511945	120	206	179	3	86	0.0348837
NODE_81857_length_392_cov_2.511945	120	206	183	2	86	0.0232558
NODE_81857_length_392_cov_2.511945	120	206	185	2	86	0.0232558
NODE_81857_length_392_cov_2.511945	120	206	187	3	86	0.0348837
NODE_81857_length_392_cov_2.511945	120	206	189	1	86	0.0116279
NODE_81857_length_392_cov_2.511945	120	206	191	1	86	0.0116279
NODE_81857_length_392_cov_2.511945	120	206	193	1	86	0.0116279
NODE_81857_length_392_cov_2.511945	120	206	194	3	86	0.0348837
NODE_81857_length_392_cov_2.511945	120	206	196	5	86	0.0581395
NODE_81857_length_392_cov_2.511945	120	206	200	1	86	0.0116279
NODE_81857_length_392_cov_2.511945	120	206	202	1	86	0.0116279
NODE_81857_length_392_cov_2.511945	120	206	206	3	86	0.0348837
NODE_81857_length_392_cov_2.511945	120	206	210	2	86	0.0232558
NODE_81857_length_392_cov_2.511945	120	206	211	1	86	0.0116279
NODE_81857_length_392_cov_2.511945	120	206	212	1	86	0.0116279
NODE_81857_length_392_cov_2.511945	120	206	213	1	86	0.0116279
NODE_81857_length_392_cov_2.511945	120	206	214	2	86	0.0232558
NODE_81857_length_392_cov_2.511945	120	206	215	3	86	0.0348837
NODE_81857_length_392_cov_2.511945	120	206	216	3	86	0.0348837
NODE_81857_length_392_cov_2.511945	120	206	220	3	86	0.0348837
NODE_81857_length_392_cov_2.511945	120	206	222	5	86	0.0581395
NODE_81857_length_392_cov_2.511945	120	206	224	2	86	0.0232558
NODE_81857_length_392_cov_2.511945	120	206	226	4	86	0.0465116
NODE_81857_length_392_cov_2.511945	120	206	228	5	86	0.0581395
NODE_81857_length_392_cov_2.511945	120	206	230	2	86	0.0232558
NODE_81857_length_392_cov_2.511945	120	206	232	4	86	0.0465116
NODE_81914_length_392_cov_2.075085	268	349	12	4	81	0.0493827
NODE_81914_length_392_cov_2.075085	268	349	16	26	81	0.3209876
NODE_81914_length_392_cov_2.075085	268	349	18	1	81	0.0123457
NODE_81914_length_392_cov_2.075085	268	349	20	31	81	0.3827161
NODE_81914_length_392_cov_2.075085	268	349	22	19	81	0.2345679
NODE_81914_length_392_cov_2.075085	322	387	4	14	65	0.2153846
NODE_81914_length_392_cov_2.075085	322	387	6	1	65	0.0153846
NODE_81914_length_392_cov_2.075085	322	387	10	21	65	0.3230769
NODE_81914_length_392_cov_2.075085	322	387	16	15	65	0.2307692
NODE_81914_length_392_cov_2.075085	322	387	20	12	65	0.1846154
NODE_81914_length_392_cov_2.075085	322	387	22	2	65	0.0307692
NODE_81928_length_392_cov_1.955631	11	56	0	43	45	0.9555556
NODE_81928_length_392_cov_1.955631	11	56	12	2	45	0.0444444
NODE_81929_length_392_cov_1.952218	40	59	3	19	19	1.0000000
NODE_81940_length_392_cov_1.911263	238	315	2	19	77	0.2467532
NODE_81940_length_392_cov_1.911263	238	315	4	3	77	0.0389610
NODE_81940_length_392_cov_1.911263	238	315	6	55	77	0.7142857
NODE_81994_length_392_cov_1.631399	114	139	19	1	25	0.0400000
NODE_81994_length_392_cov_1.631399	114	139	23	2	25	0.0800000
NODE_81994_length_392_cov_1.631399	114	139	26	5	25	0.2000000
NODE_81994_length_392_cov_1.631399	114	139	27	1	25	0.0400000
NODE_81994_length_392_cov_1.631399	114	139	28	2	25	0.0800000
NODE_81994_length_392_cov_1.631399	114	139	34	3	25	0.1200000
NODE_81994_length_392_cov_1.631399	114	139	40	1	25	0.0400000
NODE_81994_length_392_cov_1.631399	114	139	42	3	25	0.1200000
NODE_81994_length_392_cov_1.631399	114	139	44	4	25	0.1600000
NODE_81994_length_392_cov_1.631399	114	139	46	3	25	0.1200000
NODE_82008_length_392_cov_1.559727	83	163	0	80	80	1.0000000
NODE_82015_length_392_cov_1.552901	32	52	0	20	20	1.0000000
NODE_82390_length_391_cov_69.510274	9	89	89	1	80	0.0125000
NODE_82390_length_391_cov_69.510274	9	89	94	1	80	0.0125000
NODE_82390_length_391_cov_69.510274	9	89	105	1	80	0.0125000
NODE_82390_length_391_cov_69.510274	9	89	108	1	80	0.0125000
NODE_82390_length_391_cov_69.510274	9	89	122	1	80	0.0125000
NODE_82390_length_391_cov_69.510274	9	89	128	1	80	0.0125000
NODE_82390_length_391_cov_69.510274	9	89	139	1	80	0.0125000
NODE_82390_length_391_cov_69.510274	9	89	141	2	80	0.0250000
NODE_82390_length_391_cov_69.510274	9	89	144	1	80	0.0125000
NODE_82390_length_391_cov_69.510274	9	89	146	3	80	0.0375000
NODE_82390_length_391_cov_69.510274	9	89	154	1	80	0.0125000
NODE_82390_length_391_cov_69.510274	9	89	158	1	80	0.0125000
NODE_82390_length_391_cov_69.510274	9	89	160	1	80	0.0125000
NODE_82390_length_391_cov_69.510274	9	89	161	1	80	0.0125000
NODE_82390_length_391_cov_69.510274	9	89	174	1	80	0.0125000
NODE_82390_length_391_cov_69.510274	9	89	176	1	80	0.0125000
NODE_82390_length_391_cov_69.510274	9	89	178	1	80	0.0125000
NODE_82390_length_391_cov_69.510274	9	89	184	2	80	0.0250000
NODE_82390_length_391_cov_69.510274	9	89	193	1	80	0.0125000
NODE_82390_length_391_cov_69.510274	9	89	195	1	80	0.0125000
NODE_82390_length_391_cov_69.510274	9	89	203	2	80	0.0250000
NODE_82390_length_391_cov_69.510274	9	89	221	1	80	0.0125000
NODE_82390_length_391_cov_69.510274	9	89	223	1	80	0.0125000
NODE_82390_length_391_cov_69.510274	9	89	234	1	80	0.0125000
NODE_82390_length_391_cov_69.510274	9	89	236	1	80	0.0125000
NODE_82390_length_391_cov_69.510274	9	89	238	2	80	0.0250000
NODE_82390_length_391_cov_69.510274	9	89	250	1	80	0.0125000
NODE_82390_length_391_cov_69.510274	9	89	259	1	80	0.0125000
NODE_82390_length_391_cov_69.510274	9	89	266	2	80	0.0250000
NODE_82390_length_391_cov_69.510274	9	89	269	2	80	0.0250000
NODE_82390_length_391_cov_69.510274	9	89	271	1	80	0.0125000
NODE_82390_length_391_cov_69.510274	9	89	273	1	80	0.0125000
NODE_82390_length_391_cov_69.510274	9	89	281	1	80	0.0125000
NODE_82390_length_391_cov_69.510274	9	89	285	1	80	0.0125000
NODE_82390_length_391_cov_69.510274	9	89	292	2	80	0.0250000
NODE_82390_length_391_cov_69.510274	9	89	294	2	80	0.0250000
NODE_82390_length_391_cov_69.510274	9	89	298	3	80	0.0375000
NODE_82390_length_391_cov_69.510274	9	89	304	1	80	0.0125000
NODE_82390_length_391_cov_69.510274	9	89	307	1	80	0.0125000
NODE_82390_length_391_cov_69.510274	9	89	309	3	80	0.0375000
NODE_82390_length_391_cov_69.510274	9	89	312	1	80	0.0125000
NODE_82390_length_391_cov_69.510274	9	89	318	1	80	0.0125000
NODE_82390_length_391_cov_69.510274	9	89	322	1	80	0.0125000
NODE_82390_length_391_cov_69.510274	9	89	326	1	80	0.0125000
NODE_82390_length_391_cov_69.510274	9	89	331	1	80	0.0125000
NODE_82390_length_391_cov_69.510274	9	89	335	2	80	0.0250000
NODE_82390_length_391_cov_69.510274	9	89	341	1	80	0.0125000
NODE_82390_length_391_cov_69.510274	9	89	343	2	80	0.0250000
NODE_82390_length_391_cov_69.510274	9	89	350	1	80	0.0125000
NODE_82390_length_391_cov_69.510274	9	89	351	3	80	0.0375000
NODE_82390_length_391_cov_69.510274	9	89	353	3	80	0.0375000
NODE_82390_length_391_cov_69.510274	9	89	354	1	80	0.0125000
NODE_82390_length_391_cov_69.510274	9	89	356	2	80	0.0250000
NODE_82390_length_391_cov_69.510274	9	89	358	1	80	0.0125000
NODE_82390_length_391_cov_69.510274	9	89	364	1	80	0.0125000
NODE_82390_length_391_cov_69.510274	9	89	371	2	80	0.0250000
NODE_82390_length_391_cov_69.510274	9	89	377	2	80	0.0250000
NODE_82391_length_391_cov_39.414384	0	66	0	4	66	0.0606061
NODE_82391_length_391_cov_39.414384	0	66	4	9	66	0.1363636
NODE_82391_length_391_cov_39.414384	0	66	6	5	66	0.0757576
NODE_82391_length_391_cov_39.414384	0	66	10	4	66	0.0606061
NODE_82391_length_391_cov_39.414384	0	66	17	7	66	0.1060606
NODE_82391_length_391_cov_39.414384	0	66	18	8	66	0.1212121
NODE_82391_length_391_cov_39.414384	0	66	20	2	66	0.0303030
NODE_82391_length_391_cov_39.414384	0	66	24	4	66	0.0606061
NODE_82391_length_391_cov_39.414384	0	66	29	5	66	0.0757576
NODE_82391_length_391_cov_39.414384	0	66	31	6	66	0.0909091
NODE_82391_length_391_cov_39.414384	0	66	33	12	66	0.1818182
NODE_82391_length_391_cov_39.414384	0	71	0	4	71	0.0563380
NODE_82391_length_391_cov_39.414384	0	71	4	9	71	0.1267606
NODE_82391_length_391_cov_39.414384	0	71	6	5	71	0.0704225
NODE_82391_length_391_cov_39.414384	0	71	10	4	71	0.0563380
NODE_82391_length_391_cov_39.414384	0	71	17	7	71	0.0985916
NODE_82391_length_391_cov_39.414384	0	71	18	8	71	0.1126761
NODE_82391_length_391_cov_39.414384	0	71	20	2	71	0.0281690
NODE_82391_length_391_cov_39.414384	0	71	24	4	71	0.0563380
NODE_82391_length_391_cov_39.414384	0	71	29	5	71	0.0704225
NODE_82391_length_391_cov_39.414384	0	71	31	6	71	0.0845070
NODE_82391_length_391_cov_39.414384	0	71	33	17	71	0.2394366
NODE_82391_length_391_cov_39.414384	44	124	26	4	80	0.0500000
NODE_82391_length_391_cov_39.414384	44	124	29	4	80	0.0500000
NODE_82391_length_391_cov_39.414384	44	124	31	6	80	0.0750000
NODE_82391_length_391_cov_39.414384	44	124	32	5	80	0.0625000
NODE_82391_length_391_cov_39.414384	44	124	33	52	80	0.6500000
NODE_82391_length_391_cov_39.414384	44	124	34	1	80	0.0125000
NODE_82391_length_391_cov_39.414384	44	124	35	8	80	0.1000000
NODE_82394_length_391_cov_10.352740	156	235	0	79	79	1.0000000
NODE_82415_length_391_cov_5.030822	85	166	12	5	81	0.0617284
NODE_82415_length_391_cov_5.030822	85	166	13	1	81	0.0123457
NODE_82415_length_391_cov_5.030822	85	166	18	2	81	0.0246914
NODE_82415_length_391_cov_5.030822	85	166	22	1	81	0.0123457
NODE_82415_length_391_cov_5.030822	85	166	24	5	81	0.0617284
NODE_82415_length_391_cov_5.030822	85	166	28	7	81	0.0864198
NODE_82415_length_391_cov_5.030822	85	166	30	1	81	0.0123457
NODE_82415_length_391_cov_5.030822	85	166	32	8	81	0.0987654
NODE_82415_length_391_cov_5.030822	85	166	35	1	81	0.0123457
NODE_82415_length_391_cov_5.030822	85	166	36	2	81	0.0246914
NODE_82415_length_391_cov_5.030822	85	166	38	48	81	0.5925926
NODE_82498_length_391_cov_2.660959	267	343	0	9	76	0.1184211
NODE_82498_length_391_cov_2.660959	267	343	2	19	76	0.2500000
NODE_82498_length_391_cov_2.660959	267	343	4	1	76	0.0131579
NODE_82498_length_391_cov_2.660959	267	343	6	47	76	0.6184211
NODE_82552_length_391_cov_2.089041	176	256	0	43	80	0.5375000
NODE_82552_length_391_cov_2.089041	176	256	2	14	80	0.1750000
NODE_82552_length_391_cov_2.089041	176	256	6	5	80	0.0625000
NODE_82552_length_391_cov_2.089041	176	256	8	18	80	0.2250000
NODE_82552_length_391_cov_2.089041	229	280	0	51	51	1.0000000
NODE_82574_length_391_cov_1.907534	200	257	0	57	57	1.0000000
NODE_82597_length_391_cov_1.773973	160	190	0	30	30	1.0000000
NODE_82632_length_391_cov_1.647260	298	378	0	80	80	1.0000000
NODE_82662_length_391_cov_1.561644	241	261	0	20	20	1.0000000
NODE_83015_length_390_cov_29.030928	86	166	6	2	80	0.0250000
NODE_83015_length_390_cov_29.030928	86	166	8	24	80	0.3000000
NODE_83015_length_390_cov_29.030928	86	166	10	8	80	0.1000000
NODE_83015_length_390_cov_29.030928	86	166	16	46	80	0.5750000
NODE_83015_length_390_cov_29.030928	139	219	2	2	80	0.0250000
NODE_83015_length_390_cov_29.030928	139	219	8	4	80	0.0500000
NODE_83015_length_390_cov_29.030928	139	219	14	26	80	0.3250000
NODE_83015_length_390_cov_29.030928	139	219	16	48	80	0.6000000
NODE_83016_length_390_cov_22.319588	118	198	0	80	80	1.0000000
NODE_83016_length_390_cov_22.319588	171	251	0	80	80	1.0000000
NODE_83044_length_390_cov_4.481100	208	277	0	69	69	1.0000000
NODE_83044_length_390_cov_4.481100	286	327	0	41	41	1.0000000
NODE_83045_length_390_cov_4.481100	93	171	2	7	78	0.0897436
NODE_83045_length_390_cov_4.481100	93	171	4	2	78	0.0256410
NODE_83045_length_390_cov_4.481100	93	171	8	23	78	0.2948718
NODE_83045_length_390_cov_4.481100	93	171	10	46	78	0.5897436
NODE_83045_length_390_cov_4.481100	144	210	6	1	66	0.0151515
NODE_83045_length_390_cov_4.481100	144	210	8	39	66	0.5909091
NODE_83045_length_390_cov_4.481100	144	210	10	26	66	0.3939394
NODE_83060_length_390_cov_3.814433	66	99	0	33	33	1.0000000
NODE_83061_length_390_cov_3.783505	188	268	0	80	80	1.0000000
NODE_83061_length_390_cov_3.783505	241	321	0	80	80	1.0000000
NODE_83066_length_390_cov_3.560137	304	367	6	63	63	1.0000000
NODE_83066_length_390_cov_3.560137	340	381	0	6	41	0.1463415
NODE_83066_length_390_cov_3.560137	340	381	2	1	41	0.0243902
NODE_83066_length_390_cov_3.560137	340	381	4	1	41	0.0243902
NODE_83066_length_390_cov_3.560137	340	381	6	33	41	0.8048781
NODE_83169_length_390_cov_2.127148	242	322	0	2	80	0.0250000
NODE_83169_length_390_cov_2.127148	242	322	2	7	80	0.0875000
NODE_83169_length_390_cov_2.127148	242	322	6	71	80	0.8875000
NODE_83171_length_390_cov_2.123711	133	177	0	2	44	0.0454545
NODE_83171_length_390_cov_2.123711	133	177	2	2	44	0.0454545
NODE_83171_length_390_cov_2.123711	133	177	3	18	44	0.4090909
NODE_83171_length_390_cov_2.123711	133	177	5	15	44	0.3409091
NODE_83171_length_390_cov_2.123711	133	177	7	2	44	0.0454545
NODE_83171_length_390_cov_2.123711	133	177	9	2	44	0.0454545
NODE_83171_length_390_cov_2.123711	133	177	11	3	44	0.0681818
NODE_83171_length_390_cov_2.123711	157	237	5	13	80	0.1625000
NODE_83171_length_390_cov_2.123711	157	237	7	2	80	0.0250000
NODE_83171_length_390_cov_2.123711	157	237	9	2	80	0.0250000
NODE_83171_length_390_cov_2.123711	157	237	11	4	80	0.0500000
NODE_83171_length_390_cov_2.123711	157	237	12	5	80	0.0625000
NODE_83171_length_390_cov_2.123711	157	237	16	1	80	0.0125000
NODE_83171_length_390_cov_2.123711	157	237	18	3	80	0.0375000
NODE_83171_length_390_cov_2.123711	157	237	19	3	80	0.0375000
NODE_83171_length_390_cov_2.123711	157	237	20	47	80	0.5875000
NODE_83288_length_390_cov_1.536082	223	276	0	4	53	0.0754717
NODE_83288_length_390_cov_1.536082	223	276	2	48	53	0.9056604
NODE_83288_length_390_cov_1.536082	223	276	4	1	53	0.0188679
NODE_83338_length_390_cov_1.398625	49	110	6	61	61	1.0000000
NODE_83463_length_390_cov_1.034364	78	158	0	80	80	1.0000000
NODE_83633_length_389_cov_63.710345	32	112	0	80	80	1.0000000
NODE_83633_length_389_cov_63.710345	85	165	0	80	80	1.0000000
NODE_83633_length_389_cov_63.710345	161	241	0	80	80	1.0000000
NODE_83633_length_389_cov_63.710345	214	294	0	80	80	1.0000000
NODE_83650_length_389_cov_5.382759	154	234	5	11	80	0.1375000
NODE_83650_length_389_cov_5.382759	154	234	9	13	80	0.1625000
NODE_83650_length_389_cov_5.382759	154	234	10	1	80	0.0125000
NODE_83650_length_389_cov_5.382759	154	234	11	15	80	0.1875000
NODE_83650_length_389_cov_5.382759	154	234	12	22	80	0.2750000
NODE_83650_length_389_cov_5.382759	154	234	13	18	80	0.2250000
NODE_83662_length_389_cov_4.468966	199	269	2	70	70	1.0000000
NODE_83663_length_389_cov_4.424138	68	148	72	7	80	0.0875000
NODE_83663_length_389_cov_4.424138	68	148	74	4	80	0.0500000
NODE_83663_length_389_cov_4.424138	68	148	76	4	80	0.0500000
NODE_83663_length_389_cov_4.424138	68	148	78	7	80	0.0875000
NODE_83663_length_389_cov_4.424138	68	148	80	11	80	0.1375000
NODE_83663_length_389_cov_4.424138	68	148	82	13	80	0.1625000
NODE_83663_length_389_cov_4.424138	68	148	84	4	80	0.0500000
NODE_83663_length_389_cov_4.424138	68	148	86	7	80	0.0875000
NODE_83663_length_389_cov_4.424138	68	148	88	3	80	0.0375000
NODE_83663_length_389_cov_4.424138	68	148	90	16	80	0.2000000
NODE_83663_length_389_cov_4.424138	68	148	92	3	80	0.0375000
NODE_83663_length_389_cov_4.424138	68	148	96	1	80	0.0125000
NODE_83685_length_389_cov_3.782759	194	225	6	31	31	1.0000000
NODE_83689_length_389_cov_3.555172	107	153	6	43	46	0.9347826
NODE_83689_length_389_cov_3.555172	107	153	8	3	46	0.0652174
NODE_83695_length_389_cov_3.251724	120	163	2	43	43	1.0000000
NODE_83695_length_389_cov_3.251724	136	206	0	26	70	0.3714286
NODE_83695_length_389_cov_3.251724	136	206	2	44	70	0.6285715
NODE_83816_length_389_cov_1.951724	68	148	0	80	80	1.0000000
NODE_83819_length_389_cov_1.937931	53	82	0	29	29	1.0000000
NODE_83819_length_389_cov_1.937931	153	233	22	6	80	0.0750000
NODE_83819_length_389_cov_1.937931	153	233	26	5	80	0.0625000
NODE_83819_length_389_cov_1.937931	153	233	28	1	80	0.0125000
NODE_83819_length_389_cov_1.937931	153	233	35	1	80	0.0125000
NODE_83819_length_389_cov_1.937931	153	233	40	7	80	0.0875000
NODE_83819_length_389_cov_1.937931	153	233	42	7	80	0.0875000
NODE_83819_length_389_cov_1.937931	153	233	44	2	80	0.0250000
NODE_83819_length_389_cov_1.937931	153	233	46	17	80	0.2125000
NODE_83819_length_389_cov_1.937931	153	233	47	7	80	0.0875000
NODE_83819_length_389_cov_1.937931	153	233	48	27	80	0.3375000
NODE_83829_length_389_cov_1.920690	296	365	0	19	69	0.2753623
NODE_83829_length_389_cov_1.920690	296	365	2	50	69	0.7246377
NODE_84182_length_389_cov_0.720690	294	374	0	80	80	1.0000000
NODE_84267_length_388_cov_9.179931	47	127	0	80	80	1.0000000
NODE_84267_length_388_cov_9.179931	100	180	0	80	80	1.0000000
NODE_84270_length_388_cov_7.249135	171	251	0	80	80	1.0000000
NODE_84270_length_388_cov_7.249135	224	304	0	80	80	1.0000000
NODE_84305_length_388_cov_3.913495	151	231	0	16	80	0.2000000
NODE_84305_length_388_cov_3.913495	151	231	2	17	80	0.2125000
NODE_84305_length_388_cov_3.913495	151	231	6	21	80	0.2625000
NODE_84305_length_388_cov_3.913495	151	231	8	8	80	0.1000000
NODE_84305_length_388_cov_3.913495	151	231	10	18	80	0.2250000
NODE_84308_length_388_cov_3.809689	233	277	2	44	44	1.0000000
NODE_84332_length_388_cov_3.103806	101	166	0	65	65	1.0000000
NODE_84332_length_388_cov_3.103806	147	227	0	80	80	1.0000000
NODE_84334_length_388_cov_3.041522	48	128	0	80	80	1.0000000
NODE_84410_length_388_cov_2.114187	82	141	0	59	59	1.0000000
NODE_84410_length_388_cov_2.114187	135	194	0	59	59	1.0000000
NODE_84423_length_388_cov_2.017301	99	151	6	37	52	0.7115384
NODE_84423_length_388_cov_2.017301	99	151	8	15	52	0.2884615
NODE_84427_length_388_cov_1.989619	0	76	0	76	76	1.0000000
NODE_84427_length_388_cov_1.989619	49	114	0	43	65	0.6615385
NODE_84427_length_388_cov_1.989619	49	114	1	22	65	0.3384615
NODE_84587_length_388_cov_1.352941	172	247	0	75	75	1.0000000
NODE_84631_length_388_cov_1.228374	308	339	4	31	31	1.0000000
NODE_84885_length_387_cov_33.052083	194	274	0	80	80	1.0000000
NODE_84885_length_387_cov_33.052083	247	327	0	80	80	1.0000000
NODE_84890_length_387_cov_6.871528	26	106	0	80	80	1.0000000
NODE_84890_length_387_cov_6.871528	79	159	0	80	80	1.0000000
NODE_84902_length_387_cov_5.420139	286	341	2	55	55	1.0000000
NODE_84946_length_387_cov_3.364583	287	367	0	80	80	1.0000000
NODE_85007_length_387_cov_2.260417	140	210	2	32	70	0.4571429
NODE_85007_length_387_cov_2.260417	140	210	4	38	70	0.5428572
NODE_85019_length_387_cov_2.128472	220	286	0	66	66	1.0000000
NODE_85019_length_387_cov_2.128472	273	329	0	56	56	1.0000000
NODE_85032_length_387_cov_2.090278	318	352	0	34	34	1.0000000
NODE_85037_length_387_cov_2.055556	23	45	0	22	22	1.0000000
NODE_85047_length_387_cov_1.979167	259	316	0	57	57	1.0000000
NODE_85047_length_387_cov_1.979167	312	369	0	57	57	1.0000000
NODE_85091_length_387_cov_1.770833	315	361	0	13	46	0.2826087
NODE_85091_length_387_cov_1.770833	315	361	2	7	46	0.1521739
NODE_85091_length_387_cov_1.770833	315	361	4	4	46	0.0869565
NODE_85091_length_387_cov_1.770833	315	361	10	3	46	0.0652174
NODE_85091_length_387_cov_1.770833	315	361	12	19	46	0.4130435
NODE_85528_length_386_cov_9.979094	38	118	0	80	80	1.0000000
NODE_85528_length_386_cov_9.979094	91	174	0	83	83	1.0000000
NODE_85546_length_386_cov_4.428571	197	249	0	52	52	1.0000000
NODE_85570_length_386_cov_3.355401	151	231	0	80	80	1.0000000
NODE_85570_length_386_cov_3.355401	204	265	0	61	61	1.0000000
NODE_85602_length_386_cov_2.686411	293	325	0	32	32	1.0000000
NODE_85602_length_386_cov_2.686411	349	379	2	30	30	1.0000000
NODE_85629_length_386_cov_2.442509	55	135	0	80	80	1.0000000
NODE_85629_length_386_cov_2.442509	108	164	0	56	56	1.0000000
NODE_85793_length_386_cov_1.494774	79	121	2	42	42	1.0000000
NODE_85793_length_386_cov_1.494774	93	156	2	42	63	0.6666667
NODE_85793_length_386_cov_1.494774	93	156	4	21	63	0.3333333
NODE_85816_length_386_cov_1.421603	160	236	0	76	76	1.0000000
NODE_85845_length_386_cov_1.372822	62	142	0	80	80	1.0000000
NODE_85845_length_386_cov_1.372822	115	195	0	80	80	1.0000000
NODE_85858_length_386_cov_1.317073	124	161	9	24	37	0.6486486
NODE_85858_length_386_cov_1.317073	124	161	10	10	37	0.2702703
NODE_85858_length_386_cov_1.317073	124	161	13	3	37	0.0810811
NODE_85902_length_386_cov_1.170732	260	308	6	1	48	0.0208333
NODE_85902_length_386_cov_1.170732	260	308	8	20	48	0.4166667
NODE_85902_length_386_cov_1.170732	260	308	10	12	48	0.2500000
NODE_85902_length_386_cov_1.170732	260	308	12	6	48	0.1250000
NODE_85902_length_386_cov_1.170732	260	308	14	9	48	0.1875000
NODE_86143_length_385_cov_167.877622	103	164	409	1	61	0.0163934
NODE_86143_length_385_cov_167.877622	103	164	428	1	61	0.0163934
NODE_86143_length_385_cov_167.877622	103	164	438	1	61	0.0163934
NODE_86143_length_385_cov_167.877622	103	164	449	2	61	0.0327869
NODE_86143_length_385_cov_167.877622	103	164	457	1	61	0.0163934
NODE_86143_length_385_cov_167.877622	103	164	468	1	61	0.0163934
NODE_86143_length_385_cov_167.877622	103	164	473	1	61	0.0163934
NODE_86143_length_385_cov_167.877622	103	164	478	2	61	0.0327869
NODE_86143_length_385_cov_167.877622	103	164	480	1	61	0.0163934
NODE_86143_length_385_cov_167.877622	103	164	481	2	61	0.0327869
NODE_86143_length_385_cov_167.877622	103	164	486	1	61	0.0163934
NODE_86143_length_385_cov_167.877622	103	164	487	1	61	0.0163934
NODE_86143_length_385_cov_167.877622	103	164	489	1	61	0.0163934
NODE_86143_length_385_cov_167.877622	103	164	490	2	61	0.0327869
NODE_86143_length_385_cov_167.877622	103	164	492	1	61	0.0163934
NODE_86143_length_385_cov_167.877622	103	164	493	1	61	0.0163934
NODE_86143_length_385_cov_167.877622	103	164	501	1	61	0.0163934
NODE_86143_length_385_cov_167.877622	103	164	503	1	61	0.0163934
NODE_86143_length_385_cov_167.877622	103	164	507	1	61	0.0163934
NODE_86143_length_385_cov_167.877622	103	164	532	1	61	0.0163934
NODE_86143_length_385_cov_167.877622	103	164	537	1	61	0.0163934
NODE_86143_length_385_cov_167.877622	103	164	538	1	61	0.0163934
NODE_86143_length_385_cov_167.877622	103	164	542	1	61	0.0163934
NODE_86143_length_385_cov_167.877622	103	164	556	1	61	0.0163934
NODE_86143_length_385_cov_167.877622	103	164	563	1	61	0.0163934
NODE_86143_length_385_cov_167.877622	103	164	568	1	61	0.0163934
NODE_86143_length_385_cov_167.877622	103	164	569	1	61	0.0163934
NODE_86143_length_385_cov_167.877622	103	164	570	1	61	0.0163934
NODE_86143_length_385_cov_167.877622	103	164	573	2	61	0.0327869
NODE_86143_length_385_cov_167.877622	103	164	575	1	61	0.0163934
NODE_86143_length_385_cov_167.877622	103	164	578	1	61	0.0163934
NODE_86143_length_385_cov_167.877622	103	164	581	2	61	0.0327869
NODE_86143_length_385_cov_167.877622	103	164	582	1	61	0.0163934
NODE_86143_length_385_cov_167.877622	103	164	584	2	61	0.0327869
NODE_86143_length_385_cov_167.877622	103	164	586	2	61	0.0327869
NODE_86143_length_385_cov_167.877622	103	164	590	1	61	0.0163934
NODE_86143_length_385_cov_167.877622	103	164	605	1	61	0.0163934
NODE_86143_length_385_cov_167.877622	103	164	613	1	61	0.0163934
NODE_86143_length_385_cov_167.877622	103	164	615	1	61	0.0163934
NODE_86143_length_385_cov_167.877622	103	164	617	1	61	0.0163934
NODE_86143_length_385_cov_167.877622	103	164	623	2	61	0.0327869
NODE_86143_length_385_cov_167.877622	103	164	625	5	61	0.0819672
NODE_86143_length_385_cov_167.877622	103	164	627	1	61	0.0163934
NODE_86143_length_385_cov_167.877622	103	164	630	1	61	0.0163934
NODE_86143_length_385_cov_167.877622	103	164	631	1	61	0.0163934
NODE_86143_length_385_cov_167.877622	103	164	638	1	61	0.0163934
NODE_86143_length_385_cov_167.877622	103	164	639	1	61	0.0163934
NODE_86143_length_385_cov_167.877622	103	164	644	1	61	0.0163934
NODE_86144_length_385_cov_38.695804	164	244	1	50	80	0.6250000
NODE_86144_length_385_cov_38.695804	164	244	2	30	80	0.3750000
NODE_86144_length_385_cov_38.695804	217	297	2	80	80	1.0000000
NODE_86169_length_385_cov_4.335664	173	250	0	77	77	1.0000000
NODE_86185_length_385_cov_3.793706	215	297	0	82	82	1.0000000
NODE_86230_length_385_cov_2.786713	99	179	0	35	80	0.4375000
NODE_86230_length_385_cov_2.786713	99	179	2	11	80	0.1375000
NODE_86230_length_385_cov_2.786713	99	179	6	34	80	0.4250000
NODE_86230_length_385_cov_2.786713	152	232	0	80	80	1.0000000
NODE_86230_length_385_cov_2.786713	281	362	0	81	81	1.0000000
NODE_86448_length_385_cov_1.381119	71	145	0	38	74	0.5135135
NODE_86448_length_385_cov_1.381119	71	145	4	13	74	0.1756757
NODE_86448_length_385_cov_1.381119	71	145	6	11	74	0.1486486
NODE_86448_length_385_cov_1.381119	71	145	8	12	74	0.1621622
NODE_86448_length_385_cov_1.381119	118	198	4	4	80	0.0500000
NODE_86448_length_385_cov_1.381119	118	198	6	22	80	0.2750000
NODE_86448_length_385_cov_1.381119	118	198	8	31	80	0.3875000
NODE_86448_length_385_cov_1.381119	118	198	9	20	80	0.2500000
NODE_86448_length_385_cov_1.381119	118	198	10	3	80	0.0375000
NODE_86798_length_384_cov_3.996491	135	217	0	82	82	1.0000000
NODE_86809_length_384_cov_3.729825	181	228	0	40	47	0.8510638
NODE_86809_length_384_cov_3.729825	181	228	2	7	47	0.1489362
NODE_86812_length_384_cov_3.715789	145	221	0	68	76	0.8947368
NODE_86812_length_384_cov_3.715789	145	221	2	2	76	0.0263158
NODE_86812_length_384_cov_3.715789	145	221	4	1	76	0.0131579
NODE_86812_length_384_cov_3.715789	145	221	8	5	76	0.0657895
NODE_86841_length_384_cov_2.996491	147	227	8	12	80	0.1500000
NODE_86841_length_384_cov_2.996491	147	227	10	2	80	0.0250000
NODE_86841_length_384_cov_2.996491	147	227	12	12	80	0.1500000
NODE_86841_length_384_cov_2.996491	147	227	14	19	80	0.2375000
NODE_86841_length_384_cov_2.996491	147	227	16	3	80	0.0375000
NODE_86841_length_384_cov_2.996491	147	227	18	7	80	0.0875000
NODE_86841_length_384_cov_2.996491	147	227	20	20	80	0.2500000
NODE_86841_length_384_cov_2.996491	147	227	22	5	80	0.0625000
NODE_86847_length_384_cov_2.835088	65	145	14	9	80	0.1125000
NODE_86847_length_384_cov_2.835088	65	145	18	2	80	0.0250000
NODE_86847_length_384_cov_2.835088	65	145	22	13	80	0.1625000
NODE_86847_length_384_cov_2.835088	65	145	24	24	80	0.3000000
NODE_86847_length_384_cov_2.835088	65	145	25	6	80	0.0750000
NODE_86847_length_384_cov_2.835088	65	145	26	3	80	0.0375000
NODE_86847_length_384_cov_2.835088	65	145	28	21	80	0.2625000
NODE_86847_length_384_cov_2.835088	65	145	30	2	80	0.0250000
NODE_86866_length_384_cov_2.575439	151	224	32	7	73	0.0958904
NODE_86866_length_384_cov_2.575439	151	224	34	6	73	0.0821918
NODE_86866_length_384_cov_2.575439	151	224	36	8	73	0.1095890
NODE_86866_length_384_cov_2.575439	151	224	38	10	73	0.1369863
NODE_86866_length_384_cov_2.575439	151	224	40	37	73	0.5068493
NODE_86866_length_384_cov_2.575439	151	224	42	5	73	0.0684932
NODE_86866_length_384_cov_2.575439	197	281	8	7	84	0.0833333
NODE_86866_length_384_cov_2.575439	197	281	11	4	84	0.0476190
NODE_86866_length_384_cov_2.575439	197	281	13	5	84	0.0595238
NODE_86866_length_384_cov_2.575439	197	281	15	1	84	0.0119048
NODE_86866_length_384_cov_2.575439	197	281	18	1	84	0.0119048
NODE_86866_length_384_cov_2.575439	197	281	20	2	84	0.0238095
NODE_86866_length_384_cov_2.575439	197	281	22	9	84	0.1071429
NODE_86866_length_384_cov_2.575439	197	281	24	13	84	0.1547619
NODE_86866_length_384_cov_2.575439	197	281	30	11	84	0.1309524
NODE_86866_length_384_cov_2.575439	197	281	32	8	84	0.0952381
NODE_86866_length_384_cov_2.575439	197	281	34	9	84	0.1071429
NODE_86866_length_384_cov_2.575439	197	281	36	3	84	0.0357143
NODE_86866_length_384_cov_2.575439	197	281	38	3	84	0.0357143
NODE_86866_length_384_cov_2.575439	197	281	40	8	84	0.0952381
NODE_86907_length_384_cov_2.231579	78	153	0	75	75	1.0000000
NODE_86942_length_384_cov_1.940351	73	153	0	80	80	1.0000000
NODE_87431_length_383_cov_4.869718	117	197	0	19	80	0.2375000
NODE_87431_length_383_cov_4.869718	117	197	2	61	80	0.7625000
NODE_87431_length_383_cov_4.869718	170	250	2	80	80	1.0000000
NODE_87432_length_383_cov_4.841549	121	180	0	59	59	1.0000000
NODE_87438_length_383_cov_4.559859	33	109	0	76	76	1.0000000
NODE_87487_length_383_cov_2.940141	185	265	0	80	80	1.0000000
NODE_87495_length_383_cov_2.760563	123	203	128	1	80	0.0125000
NODE_87495_length_383_cov_2.760563	123	203	135	1	80	0.0125000
NODE_87495_length_383_cov_2.760563	123	203	145	1	80	0.0125000
NODE_87495_length_383_cov_2.760563	123	203	147	2	80	0.0250000
NODE_87495_length_383_cov_2.760563	123	203	149	1	80	0.0125000
NODE_87495_length_383_cov_2.760563	123	203	150	1	80	0.0125000
NODE_87495_length_383_cov_2.760563	123	203	158	2	80	0.0250000
NODE_87495_length_383_cov_2.760563	123	203	160	1	80	0.0125000
NODE_87495_length_383_cov_2.760563	123	203	161	3	80	0.0375000
NODE_87495_length_383_cov_2.760563	123	203	165	2	80	0.0250000
NODE_87495_length_383_cov_2.760563	123	203	169	2	80	0.0250000
NODE_87495_length_383_cov_2.760563	123	203	183	1	80	0.0125000
NODE_87495_length_383_cov_2.760563	123	203	185	1	80	0.0125000
NODE_87495_length_383_cov_2.760563	123	203	187	1	80	0.0125000
NODE_87495_length_383_cov_2.760563	123	203	189	1	80	0.0125000
NODE_87495_length_383_cov_2.760563	123	203	196	3	80	0.0375000
NODE_87495_length_383_cov_2.760563	123	203	198	3	80	0.0375000
NODE_87495_length_383_cov_2.760563	123	203	200	2	80	0.0250000
NODE_87495_length_383_cov_2.760563	123	203	203	2	80	0.0250000
NODE_87495_length_383_cov_2.760563	123	203	204	1	80	0.0125000
NODE_87495_length_383_cov_2.760563	123	203	206	2	80	0.0250000
NODE_87495_length_383_cov_2.760563	123	203	207	1	80	0.0125000
NODE_87495_length_383_cov_2.760563	123	203	208	3	80	0.0375000
NODE_87495_length_383_cov_2.760563	123	203	210	5	80	0.0625000
NODE_87495_length_383_cov_2.760563	123	203	212	1	80	0.0125000
NODE_87495_length_383_cov_2.760563	123	203	216	2	80	0.0250000
NODE_87495_length_383_cov_2.760563	123	203	219	2	80	0.0250000
NODE_87495_length_383_cov_2.760563	123	203	221	1	80	0.0125000
NODE_87495_length_383_cov_2.760563	123	203	222	2	80	0.0250000
NODE_87495_length_383_cov_2.760563	123	203	223	1	80	0.0125000
NODE_87495_length_383_cov_2.760563	123	203	224	3	80	0.0375000
NODE_87495_length_383_cov_2.760563	123	203	226	2	80	0.0250000
NODE_87495_length_383_cov_2.760563	123	203	228	2	80	0.0250000
NODE_87495_length_383_cov_2.760563	123	203	229	1	80	0.0125000
NODE_87495_length_383_cov_2.760563	123	203	230	6	80	0.0750000
NODE_87495_length_383_cov_2.760563	123	203	231	1	80	0.0125000
NODE_87495_length_383_cov_2.760563	123	203	232	2	80	0.0250000
NODE_87495_length_383_cov_2.760563	123	203	233	2	80	0.0250000
NODE_87495_length_383_cov_2.760563	123	203	234	3	80	0.0375000
NODE_87495_length_383_cov_2.760563	123	203	235	2	80	0.0250000
NODE_87495_length_383_cov_2.760563	123	203	236	4	80	0.0500000
NODE_87495_length_383_cov_2.760563	169	249	59	2	80	0.0250000
NODE_87495_length_383_cov_2.760563	169	249	61	2	80	0.0250000
NODE_87495_length_383_cov_2.760563	169	249	66	2	80	0.0250000
NODE_87495_length_383_cov_2.760563	169	249	67	1	80	0.0125000
NODE_87495_length_383_cov_2.760563	169	249	69	1	80	0.0125000
NODE_87495_length_383_cov_2.760563	169	249	71	2	80	0.0250000
NODE_87495_length_383_cov_2.760563	169	249	74	1	80	0.0125000
NODE_87495_length_383_cov_2.760563	169	249	76	1	80	0.0125000
NODE_87495_length_383_cov_2.760563	169	249	78	1	80	0.0125000
NODE_87495_length_383_cov_2.760563	169	249	79	1	80	0.0125000
NODE_87495_length_383_cov_2.760563	169	249	80	6	80	0.0750000
NODE_87495_length_383_cov_2.760563	169	249	84	3	80	0.0375000
NODE_87495_length_383_cov_2.760563	169	249	89	1	80	0.0125000
NODE_87495_length_383_cov_2.760563	169	249	92	2	80	0.0250000
NODE_87495_length_383_cov_2.760563	169	249	94	5	80	0.0625000
NODE_87495_length_383_cov_2.760563	169	249	100	3	80	0.0375000
NODE_87495_length_383_cov_2.760563	169	249	102	3	80	0.0375000
NODE_87495_length_383_cov_2.760563	169	249	104	1	80	0.0125000
NODE_87495_length_383_cov_2.760563	169	249	108	3	80	0.0375000
NODE_87495_length_383_cov_2.760563	169	249	113	1	80	0.0125000
NODE_87495_length_383_cov_2.760563	169	249	116	1	80	0.0125000
NODE_87495_length_383_cov_2.760563	169	249	119	1	80	0.0125000
NODE_87495_length_383_cov_2.760563	169	249	120	1	80	0.0125000
NODE_87495_length_383_cov_2.760563	169	249	126	1	80	0.0125000
NODE_87495_length_383_cov_2.760563	169	249	128	1	80	0.0125000
NODE_87495_length_383_cov_2.760563	169	249	135	1	80	0.0125000
NODE_87495_length_383_cov_2.760563	169	249	145	1	80	0.0125000
NODE_87495_length_383_cov_2.760563	169	249	147	2	80	0.0250000
NODE_87495_length_383_cov_2.760563	169	249	149	1	80	0.0125000
NODE_87495_length_383_cov_2.760563	169	249	150	1	80	0.0125000
NODE_87495_length_383_cov_2.760563	169	249	158	2	80	0.0250000
NODE_87495_length_383_cov_2.760563	169	249	160	1	80	0.0125000
NODE_87495_length_383_cov_2.760563	169	249	161	3	80	0.0375000
NODE_87495_length_383_cov_2.760563	169	249	165	2	80	0.0250000
NODE_87495_length_383_cov_2.760563	169	249	169	2	80	0.0250000
NODE_87495_length_383_cov_2.760563	169	249	183	1	80	0.0125000
NODE_87495_length_383_cov_2.760563	169	249	185	1	80	0.0125000
NODE_87495_length_383_cov_2.760563	169	249	187	1	80	0.0125000
NODE_87495_length_383_cov_2.760563	169	249	189	1	80	0.0125000
NODE_87495_length_383_cov_2.760563	169	249	196	3	80	0.0375000
NODE_87495_length_383_cov_2.760563	169	249	198	1	80	0.0125000
NODE_87495_length_383_cov_2.760563	169	249	200	1	80	0.0125000
NODE_87495_length_383_cov_2.760563	169	249	208	3	80	0.0375000
NODE_87495_length_383_cov_2.760563	169	249	210	1	80	0.0125000
NODE_87495_length_383_cov_2.760563	169	249	216	2	80	0.0250000
NODE_87495_length_383_cov_2.760563	169	249	219	1	80	0.0125000
NODE_87495_length_383_cov_2.760563	169	249	222	1	80	0.0125000
NODE_87495_length_383_cov_2.760563	222	302	6	18	80	0.2250000
NODE_87495_length_383_cov_2.760563	222	302	7	7	80	0.0875000
NODE_87495_length_383_cov_2.760563	222	302	8	8	80	0.1000000
NODE_87495_length_383_cov_2.760563	222	302	10	3	80	0.0375000
NODE_87495_length_383_cov_2.760563	222	302	12	2	80	0.0250000
NODE_87495_length_383_cov_2.760563	222	302	14	1	80	0.0125000
NODE_87495_length_383_cov_2.760563	222	302	16	1	80	0.0125000
NODE_87495_length_383_cov_2.760563	222	302	33	2	80	0.0250000
NODE_87495_length_383_cov_2.760563	222	302	35	1	80	0.0125000
NODE_87495_length_383_cov_2.760563	222	302	41	1	80	0.0125000
NODE_87495_length_383_cov_2.760563	222	302	43	1	80	0.0125000
NODE_87495_length_383_cov_2.760563	222	302	46	2	80	0.0250000
NODE_87495_length_383_cov_2.760563	222	302	49	4	80	0.0500000
NODE_87495_length_383_cov_2.760563	222	302	51	2	80	0.0250000
NODE_87495_length_383_cov_2.760563	222	302	59	2	80	0.0250000
NODE_87495_length_383_cov_2.760563	222	302	61	2	80	0.0250000
NODE_87495_length_383_cov_2.760563	222	302	66	2	80	0.0250000
NODE_87495_length_383_cov_2.760563	222	302	67	1	80	0.0125000
NODE_87495_length_383_cov_2.760563	222	302	69	1	80	0.0125000
NODE_87495_length_383_cov_2.760563	222	302	71	2	80	0.0250000
NODE_87495_length_383_cov_2.760563	222	302	74	1	80	0.0125000
NODE_87495_length_383_cov_2.760563	222	302	76	1	80	0.0125000
NODE_87495_length_383_cov_2.760563	222	302	78	1	80	0.0125000
NODE_87495_length_383_cov_2.760563	222	302	79	1	80	0.0125000
NODE_87495_length_383_cov_2.760563	222	302	80	6	80	0.0750000
NODE_87495_length_383_cov_2.760563	222	302	84	3	80	0.0375000
NODE_87495_length_383_cov_2.760563	222	302	89	1	80	0.0125000
NODE_87495_length_383_cov_2.760563	222	302	92	2	80	0.0250000
NODE_87495_length_383_cov_2.760563	222	302	94	1	80	0.0125000
NODE_87566_length_383_cov_2.123239	29	94	0	65	65	1.0000000
NODE_87566_length_383_cov_2.123239	93	173	0	80	80	1.0000000
NODE_87566_length_383_cov_2.123239	146	193	0	47	47	1.0000000
NODE_87634_length_383_cov_1.728873	196	257	19	5	61	0.0819672
NODE_87634_length_383_cov_1.728873	196	257	20	3	61	0.0491803
NODE_87634_length_383_cov_1.728873	196	257	21	10	61	0.1639344
NODE_87634_length_383_cov_1.728873	196	257	22	31	61	0.5081967
NODE_87634_length_383_cov_1.728873	196	257	24	12	61	0.1967213
NODE_87634_length_383_cov_1.728873	239	310	14	10	71	0.1408451
NODE_87634_length_383_cov_1.728873	239	310	16	16	71	0.2253521
NODE_87634_length_383_cov_1.728873	239	310	20	1	71	0.0140845
NODE_87634_length_383_cov_1.728873	239	310	22	25	71	0.3521127
NODE_87634_length_383_cov_1.728873	239	310	24	5	71	0.0704225
NODE_87634_length_383_cov_1.728873	239	310	26	14	71	0.1971831
NODE_88039_length_382_cov_43.724382	245	325	0	44	80	0.5500000
NODE_88039_length_382_cov_43.724382	245	325	2	36	80	0.4500000
NODE_88039_length_382_cov_43.724382	298	378	0	80	80	1.0000000
NODE_88040_length_382_cov_35.908127	163	243	0	75	80	0.9375000
NODE_88040_length_382_cov_35.908127	163	243	2	5	80	0.0625000
NODE_88040_length_382_cov_35.908127	216	296	0	80	80	1.0000000
NODE_88040_length_382_cov_35.908127	292	372	0	80	80	1.0000000
NODE_88041_length_382_cov_26.240283	57	137	0	2	80	0.0250000
NODE_88041_length_382_cov_26.240283	57	137	8	78	80	0.9750000
NODE_88041_length_382_cov_26.240283	110	190	8	80	80	1.0000000
NODE_88054_length_382_cov_5.583039	63	143	0	80	80	1.0000000
NODE_88054_length_382_cov_5.583039	116	196	0	80	80	1.0000000
NODE_88063_length_382_cov_4.837456	19	78	0	59	59	1.0000000
NODE_88067_length_382_cov_4.618375	0	55	0	55	55	1.0000000
NODE_88067_length_382_cov_4.618375	104	184	0	56	80	0.7000000
NODE_88067_length_382_cov_4.618375	104	184	2	9	80	0.1125000
NODE_88067_length_382_cov_4.618375	104	184	4	15	80	0.1875000
NODE_88067_length_382_cov_4.618375	157	237	0	3	80	0.0375000
NODE_88067_length_382_cov_4.618375	157	237	2	9	80	0.1125000
NODE_88067_length_382_cov_4.618375	157	237	4	16	80	0.2000000
NODE_88067_length_382_cov_4.618375	157	237	6	52	80	0.6500000
NODE_88075_length_382_cov_4.268551	71	152	0	81	81	1.0000000
NODE_88075_length_382_cov_4.268551	124	205	0	81	81	1.0000000
NODE_88080_length_382_cov_4.091873	30	92	0	1	62	0.0161290
NODE_88080_length_382_cov_4.091873	30	92	2	61	62	0.9838710
NODE_88121_length_382_cov_3.031802	173	253	2	5	80	0.0625000
NODE_88121_length_382_cov_3.031802	173	253	4	10	80	0.1250000
NODE_88121_length_382_cov_3.031802	173	253	6	8	80	0.1000000
NODE_88121_length_382_cov_3.031802	173	253	8	14	80	0.1750000
NODE_88121_length_382_cov_3.031802	173	253	10	30	80	0.3750000
NODE_88121_length_382_cov_3.031802	173	253	12	13	80	0.1625000
NODE_88121_length_382_cov_3.031802	226	295	4	7	69	0.1014493
NODE_88121_length_382_cov_3.031802	226	295	6	2	69	0.0289855
NODE_88121_length_382_cov_3.031802	226	295	8	13	69	0.1884058
NODE_88121_length_382_cov_3.031802	226	295	10	24	69	0.3478261
NODE_88121_length_382_cov_3.031802	226	295	12	23	69	0.3333333
NODE_88135_length_382_cov_2.798587	231	293	0	24	62	0.3870968
NODE_88135_length_382_cov_2.798587	231	293	2	38	62	0.6129032
NODE_88136_length_382_cov_2.791519	195	244	2	8	49	0.1632653
NODE_88136_length_382_cov_2.791519	195	244	4	5	49	0.1020408
NODE_88136_length_382_cov_2.791519	195	244	8	36	49	0.7346939
NODE_88136_length_382_cov_2.791519	217	297	6	19	80	0.2375000
NODE_88136_length_382_cov_2.791519	217	297	8	61	80	0.7625000
NODE_88164_length_382_cov_2.611307	301	368	2	2	67	0.0298507
NODE_88164_length_382_cov_2.611307	301	368	4	20	67	0.2985075
NODE_88164_length_382_cov_2.611307	301	368	6	45	67	0.6716418
NODE_88276_length_382_cov_1.802120	0	60	0	60	60	1.0000000
NODE_88660_length_382_cov_0.738516	48	95	12	47	47	1.0000000
NODE_88660_length_382_cov_0.738516	68	148	12	76	80	0.9500000
NODE_88660_length_382_cov_0.738516	68	148	14	4	80	0.0500000
NODE_88758_length_381_cov_12.010638	195	274	8	10	79	0.1265823
NODE_88758_length_381_cov_12.010638	195	274	10	25	79	0.3164557
NODE_88758_length_381_cov_12.010638	195	274	12	10	79	0.1265823
NODE_88758_length_381_cov_12.010638	195	274	16	32	79	0.4050633
NODE_88758_length_381_cov_12.010638	195	274	18	2	79	0.0253165
NODE_88865_length_381_cov_2.606383	68	98	6	30	30	1.0000000
NODE_88867_length_381_cov_2.570922	115	175	0	37	60	0.6166667
NODE_88867_length_381_cov_2.570922	115	175	4	22	60	0.3666667
NODE_88867_length_381_cov_2.570922	115	175	6	1	60	0.0166667
NODE_88872_length_381_cov_2.514184	225	307	0	48	82	0.5853658
NODE_88872_length_381_cov_2.514184	225	307	1	17	82	0.2073171
NODE_88872_length_381_cov_2.514184	225	307	2	17	82	0.2073171
NODE_88900_length_381_cov_2.198582	193	276	0	58	83	0.6987952
NODE_88900_length_381_cov_2.198582	193	276	2	23	83	0.2771084
NODE_88900_length_381_cov_2.198582	193	276	5	1	83	0.0120482
NODE_88900_length_381_cov_2.198582	193	276	6	1	83	0.0120482
NODE_88935_length_381_cov_1.989362	279	325	6	43	46	0.9347826
NODE_88935_length_381_cov_1.989362	279	325	8	3	46	0.0652174
NODE_89009_length_381_cov_1.663121	51	128	2	29	77	0.3766234
NODE_89009_length_381_cov_1.663121	51	128	4	48	77	0.6233766
NODE_89009_length_381_cov_1.663121	101	181	4	43	80	0.5375000
NODE_89009_length_381_cov_1.663121	101	181	6	8	80	0.1000000
NODE_89009_length_381_cov_1.663121	101	181	8	27	80	0.3375000
NODE_89009_length_381_cov_1.663121	101	181	9	1	80	0.0125000
NODE_89009_length_381_cov_1.663121	101	181	10	1	80	0.0125000
NODE_89090_length_381_cov_1.400709	254	334	0	16	80	0.2000000
NODE_89090_length_381_cov_1.400709	254	334	2	64	80	0.8000000
NODE_89090_length_381_cov_1.400709	254	334	0	16	80	0.2000000
NODE_89090_length_381_cov_1.400709	254	334	2	64	80	0.8000000
NODE_89090_length_381_cov_1.400709	309	373	2	64	64	1.0000000
NODE_89482_length_380_cov_57.604982	196	276	0	9	80	0.1125000
NODE_89482_length_380_cov_57.604982	196	276	4	71	80	0.8875000
NODE_89482_length_380_cov_57.604982	249	329	0	18	80	0.2250000
NODE_89482_length_380_cov_57.604982	249	329	4	62	80	0.7750000
NODE_89482_length_380_cov_57.604982	325	359	0	34	34	1.0000000
NODE_89483_length_380_cov_11.185053	79	161	0	8	82	0.0975610
NODE_89483_length_380_cov_11.185053	79	161	1	10	82	0.1219512
NODE_89483_length_380_cov_11.185053	79	161	5	37	82	0.4512195
NODE_89483_length_380_cov_11.185053	79	161	6	27	82	0.3292683
NODE_89483_length_380_cov_11.185053	134	214	0	28	80	0.3500000
NODE_89483_length_380_cov_11.185053	134	214	1	1	80	0.0125000
NODE_89483_length_380_cov_11.185053	134	214	5	46	80	0.5750000
NODE_89483_length_380_cov_11.185053	134	214	6	5	80	0.0625000
NODE_89491_length_380_cov_5.811388	100	156	2	56	56	1.0000000
NODE_89491_length_380_cov_5.811388	177	213	2	36	36	1.0000000
NODE_89495_length_380_cov_5.377224	242	271	50	5	29	0.1724138
NODE_89495_length_380_cov_5.377224	242	271	52	3	29	0.1034483
NODE_89495_length_380_cov_5.377224	242	271	54	3	29	0.1034483
NODE_89495_length_380_cov_5.377224	242	271	55	7	29	0.2413793
NODE_89495_length_380_cov_5.377224	242	271	56	1	29	0.0344828
NODE_89495_length_380_cov_5.377224	242	271	58	5	29	0.1724138
NODE_89495_length_380_cov_5.377224	242	271	59	5	29	0.1724138
NODE_89508_length_380_cov_4.185053	158	230	0	5	72	0.0694444
NODE_89508_length_380_cov_4.185053	158	230	2	67	72	0.9305556
NODE_89508_length_380_cov_4.185053	159	229	0	4	70	0.0571429
NODE_89508_length_380_cov_4.185053	159	229	2	66	70	0.9428571
NODE_89508_length_380_cov_4.185053	203	283	0	14	80	0.1750000
NODE_89508_length_380_cov_4.185053	203	283	2	66	80	0.8250000
NODE_89508_length_380_cov_4.185053	203	283	0	14	80	0.1750000
NODE_89508_length_380_cov_4.185053	203	283	2	66	80	0.8250000
NODE_89527_length_380_cov_3.423488	164	233	4	39	69	0.5652174
NODE_89527_length_380_cov_3.423488	164	233	8	30	69	0.4347826
NODE_89540_length_380_cov_3.153025	188	260	6	13	72	0.1805556
NODE_89540_length_380_cov_3.153025	188	260	7	14	72	0.1944444
NODE_89540_length_380_cov_3.153025	188	260	8	11	72	0.1527778
NODE_89540_length_380_cov_3.153025	188	260	10	6	72	0.0833333
NODE_89540_length_380_cov_3.153025	188	260	12	28	72	0.3888889
NODE_89568_length_380_cov_2.718861	51	131	2	69	80	0.8625000
NODE_89568_length_380_cov_2.718861	51	131	4	11	80	0.1375000
NODE_89568_length_380_cov_2.718861	104	184	0	4	80	0.0500000
NODE_89568_length_380_cov_2.718861	104	184	2	65	80	0.8125000
NODE_89568_length_380_cov_2.718861	104	184	4	11	80	0.1375000
NODE_89658_length_380_cov_1.943060	22	56	0	5	34	0.1470588
NODE_89658_length_380_cov_1.943060	22	56	2	20	34	0.5882353
NODE_89658_length_380_cov_1.943060	22	56	4	2	34	0.0588235
NODE_89658_length_380_cov_1.943060	22	56	6	7	34	0.2058824
NODE_89750_length_380_cov_1.601423	292	332	45	6	40	0.1500000
NODE_89750_length_380_cov_1.601423	292	332	46	1	40	0.0250000
NODE_89750_length_380_cov_1.601423	292	332	48	2	40	0.0500000
NODE_89750_length_380_cov_1.601423	292	332	50	1	40	0.0250000
NODE_89750_length_380_cov_1.601423	292	332	54	2	40	0.0500000
NODE_89750_length_380_cov_1.601423	292	332	58	1	40	0.0250000
NODE_89750_length_380_cov_1.601423	292	332	62	1	40	0.0250000
NODE_89750_length_380_cov_1.601423	292	332	63	6	40	0.1500000
NODE_89750_length_380_cov_1.601423	292	332	65	2	40	0.0500000
NODE_89750_length_380_cov_1.601423	292	332	71	3	40	0.0750000
NODE_89750_length_380_cov_1.601423	292	332	73	1	40	0.0250000
NODE_89750_length_380_cov_1.601423	292	332	79	1	40	0.0250000
NODE_89750_length_380_cov_1.601423	292	332	82	1	40	0.0250000
NODE_89750_length_380_cov_1.601423	292	332	85	2	40	0.0500000
NODE_89750_length_380_cov_1.601423	292	332	86	2	40	0.0500000
NODE_89750_length_380_cov_1.601423	292	332	88	1	40	0.0250000
NODE_89750_length_380_cov_1.601423	292	332	89	2	40	0.0500000
NODE_89750_length_380_cov_1.601423	292	332	91	1	40	0.0250000
NODE_89750_length_380_cov_1.601423	292	332	93	2	40	0.0500000
NODE_89750_length_380_cov_1.601423	292	332	95	2	40	0.0500000
NODE_89911_length_380_cov_1.088968	312	353	0	41	41	1.0000000
NODE_89911_length_380_cov_1.088968	326	380	0	54	54	1.0000000
NODE_90152_length_379_cov_42.339286	10	90	0	80	80	1.0000000
NODE_90152_length_379_cov_42.339286	86	166	0	80	80	1.0000000
NODE_90152_length_379_cov_42.339286	139	219	0	80	80	1.0000000
NODE_90153_length_379_cov_32.075000	0	62	0	62	62	1.0000000
NODE_90165_length_379_cov_5.607143	279	338	0	59	59	1.0000000
NODE_90180_length_379_cov_4.432143	219	243	0	24	24	1.0000000
NODE_90193_length_379_cov_3.778571	271	300	0	29	29	1.0000000
NODE_90198_length_379_cov_3.585714	128	152	0	24	24	1.0000000
NODE_90198_length_379_cov_3.585714	169	249	0	80	80	1.0000000
NODE_90203_length_379_cov_3.375000	19	43	4	24	24	1.0000000
NODE_90247_length_379_cov_2.692857	121	201	6	1	80	0.0125000
NODE_90247_length_379_cov_2.692857	121	201	7	2	80	0.0250000
NODE_90247_length_379_cov_2.692857	121	201	9	14	80	0.1750000
NODE_90247_length_379_cov_2.692857	121	201	10	41	80	0.5125000
NODE_90247_length_379_cov_2.692857	121	201	12	22	80	0.2750000
NODE_90247_length_379_cov_2.692857	174	221	2	4	47	0.0851064
NODE_90247_length_379_cov_2.692857	174	221	4	15	47	0.3191489
NODE_90247_length_379_cov_2.692857	174	221	6	2	47	0.0425532
NODE_90247_length_379_cov_2.692857	174	221	7	2	47	0.0425532
NODE_90247_length_379_cov_2.692857	174	221	9	14	47	0.2978723
NODE_90247_length_379_cov_2.692857	174	221	10	10	47	0.2127660
NODE_90789_length_378_cov_53.039427	147	227	0	80	80	1.0000000
NODE_90789_length_378_cov_53.039427	200	280	0	80	80	1.0000000
NODE_90789_length_378_cov_53.039427	276	356	0	80	80	1.0000000
NODE_90789_length_378_cov_53.039427	329	378	0	49	49	1.0000000
NODE_90794_length_378_cov_6.569892	223	304	4	4	81	0.0493827
NODE_90794_length_378_cov_6.569892	223	304	6	24	81	0.2962963
NODE_90794_length_378_cov_6.569892	223	304	9	1	81	0.0123457
NODE_90794_length_378_cov_6.569892	223	304	10	9	81	0.1111111
NODE_90794_length_378_cov_6.569892	223	304	12	6	81	0.0740741
NODE_90794_length_378_cov_6.569892	223	304	14	26	81	0.3209876
NODE_90794_length_378_cov_6.569892	223	304	16	11	81	0.1358025
NODE_90795_length_378_cov_6.444444	217	297	4	80	80	1.0000000
NODE_90795_length_378_cov_6.444444	270	350	0	30	80	0.3750000
NODE_90795_length_378_cov_6.444444	270	350	4	50	80	0.6250000
NODE_90808_length_378_cov_4.899642	135	191	2	19	56	0.3392857
NODE_90808_length_378_cov_4.899642	135	191	4	15	56	0.2678571
NODE_90808_length_378_cov_4.899642	135	191	6	22	56	0.3928571
NODE_90855_length_378_cov_3.236559	143	212	8	4	69	0.0579710
NODE_90855_length_378_cov_3.236559	143	212	10	10	69	0.1449275
NODE_90855_length_378_cov_3.236559	143	212	12	55	69	0.7971014
NODE_90859_length_378_cov_3.132616	238	280	0	42	42	1.0000000
NODE_90898_length_378_cov_2.534050	203	243	0	40	40	1.0000000
NODE_90898_length_378_cov_2.534050	271	347	0	76	76	1.0000000
NODE_90898_length_378_cov_2.534050	331	360	0	29	29	1.0000000
NODE_90948_length_378_cov_2.093190	179	250	0	45	71	0.6338028
NODE_90948_length_378_cov_2.093190	179	250	2	22	71	0.3098592
NODE_90948_length_378_cov_2.093190	179	250	4	4	71	0.0563380
NODE_90948_length_378_cov_2.093190	183	219	0	14	36	0.3888889
NODE_90948_length_378_cov_2.093190	183	219	2	22	36	0.6111111
NODE_91002_length_378_cov_1.813620	36	89	0	53	53	1.0000000
NODE_91475_length_377_cov_71.723022	19	99	0	80	80	1.0000000
NODE_91475_length_377_cov_71.723022	72	152	0	80	80	1.0000000
NODE_91475_length_377_cov_71.723022	148	228	0	80	80	1.0000000
NODE_91475_length_377_cov_71.723022	201	281	0	80	80	1.0000000
NODE_91477_length_377_cov_41.787770	210	290	0	11	80	0.1375000
NODE_91477_length_377_cov_41.787770	210	290	4	7	80	0.0875000
NODE_91477_length_377_cov_41.787770	210	290	6	4	80	0.0500000
NODE_91477_length_377_cov_41.787770	210	290	8	58	80	0.7250000
NODE_91477_length_377_cov_41.787770	263	343	0	64	80	0.8000000
NODE_91477_length_377_cov_41.787770	263	343	4	7	80	0.0875000
NODE_91477_length_377_cov_41.787770	263	343	6	4	80	0.0500000
NODE_91477_length_377_cov_41.787770	263	343	8	5	80	0.0625000
NODE_91478_length_377_cov_9.982014	32	83	0	8	51	0.1568628
NODE_91478_length_377_cov_9.982014	32	83	2	43	51	0.8431373
NODE_91486_length_377_cov_6.244604	101	177	2	13	76	0.1710526
NODE_91486_length_377_cov_6.244604	101	177	4	60	76	0.7894737
NODE_91486_length_377_cov_6.244604	101	177	6	3	76	0.0394737
NODE_91494_length_377_cov_5.183453	169	224	0	55	55	1.0000000
NODE_91499_length_377_cov_4.586331	186	266	0	80	80	1.0000000
NODE_91499_length_377_cov_4.586331	239	319	0	80	80	1.0000000
NODE_91500_length_377_cov_4.431655	139	216	0	77	77	1.0000000
NODE_91502_length_377_cov_4.330935	134	214	0	80	80	1.0000000
NODE_91502_length_377_cov_4.330935	187	267	0	80	80	1.0000000
NODE_91506_length_377_cov_4.032374	124	181	2	45	57	0.7894737
NODE_91506_length_377_cov_4.032374	124	181	4	12	57	0.2105263
NODE_91506_length_377_cov_4.032374	154	201	0	16	47	0.3404255
NODE_91506_length_377_cov_4.032374	154	201	2	31	47	0.6595744
NODE_91526_length_377_cov_3.615108	82	140	0	58	58	1.0000000
NODE_91526_length_377_cov_3.615108	82	140	0	58	58	1.0000000
NODE_91526_length_377_cov_3.615108	113	193	0	80	80	1.0000000
NODE_91526_length_377_cov_3.615108	113	193	0	80	80	1.0000000
NODE_91526_length_377_cov_3.615108	189	258	0	69	69	1.0000000
NODE_91526_length_377_cov_3.615108	243	313	0	70	70	1.0000000
NODE_91553_length_377_cov_2.913669	38	61	2	23	23	1.0000000
NODE_91553_length_377_cov_2.913669	167	228	0	61	61	1.0000000
NODE_91619_length_377_cov_2.104317	137	188	0	51	51	1.0000000
NODE_91619_length_377_cov_2.104317	168	211	0	43	43	1.0000000
NODE_91619_length_377_cov_2.104317	190	241	0	51	51	1.0000000
NODE_91727_length_377_cov_1.622302	123	181	2	16	58	0.2758621
NODE_91727_length_377_cov_1.622302	123	181	6	42	58	0.7241379
NODE_91727_length_377_cov_1.622302	176	234	0	40	58	0.6896552
NODE_91727_length_377_cov_1.622302	176	234	2	18	58	0.3103448
NODE_91749_length_377_cov_1.539568	230	310	0	27	80	0.3375000
NODE_91749_length_377_cov_1.539568	230	310	10	53	80	0.6625000
NODE_91749_length_377_cov_1.539568	230	310	0	27	80	0.3375000
NODE_91749_length_377_cov_1.539568	230	310	10	53	80	0.6625000
NODE_91749_length_377_cov_1.539568	306	377	0	28	71	0.3943662
NODE_91749_length_377_cov_1.539568	306	377	10	43	71	0.6056338
NODE_91749_length_377_cov_1.539568	327	351	0	2	24	0.0833333
NODE_91749_length_377_cov_1.539568	327	351	10	22	24	0.9166667
NODE_91765_length_377_cov_1.471223	118	198	24	31	80	0.3875000
NODE_91765_length_377_cov_1.471223	118	198	28	49	80	0.6125000
NODE_91790_length_377_cov_1.456835	177	257	0	47	80	0.5875000
NODE_91790_length_377_cov_1.456835	177	257	2	33	80	0.4125000
NODE_91790_length_377_cov_1.456835	230	310	2	80	80	1.0000000
NODE_91817_length_377_cov_1.330935	0	44	2	8	44	0.1818182
NODE_91817_length_377_cov_1.330935	0	44	4	1	44	0.0227273
NODE_91817_length_377_cov_1.330935	0	44	6	35	44	0.7954546
NODE_91817_length_377_cov_1.330935	45	117	0	25	72	0.3472222
NODE_91817_length_377_cov_1.330935	45	117	2	1	72	0.0138889
NODE_91817_length_377_cov_1.330935	45	117	4	1	72	0.0138889
NODE_91817_length_377_cov_1.330935	45	117	6	45	72	0.6250000
NODE_92046_length_377_cov_0.762590	299	330	2	31	31	1.0000000
NODE_92166_length_376_cov_6.938628	0	63	21	7	63	0.1111111
NODE_92166_length_376_cov_6.938628	0	63	26	6	63	0.0952381
NODE_92166_length_376_cov_6.938628	0	63	34	1	63	0.0158730
NODE_92166_length_376_cov_6.938628	0	63	36	2	63	0.0317460
NODE_92166_length_376_cov_6.938628	0	63	41	2	63	0.0317460
NODE_92166_length_376_cov_6.938628	0	63	45	2	63	0.0317460
NODE_92166_length_376_cov_6.938628	0	63	47	5	63	0.0793651
NODE_92166_length_376_cov_6.938628	0	63	48	5	63	0.0793651
NODE_92166_length_376_cov_6.938628	0	63	52	3	63	0.0476190
NODE_92166_length_376_cov_6.938628	0	63	53	1	63	0.0158730
NODE_92166_length_376_cov_6.938628	0	63	55	1	63	0.0158730
NODE_92166_length_376_cov_6.938628	0	63	57	1	63	0.0158730
NODE_92166_length_376_cov_6.938628	0	63	59	2	63	0.0317460
NODE_92166_length_376_cov_6.938628	0	63	62	1	63	0.0158730
NODE_92166_length_376_cov_6.938628	0	63	64	4	63	0.0634921
NODE_92166_length_376_cov_6.938628	0	63	66	1	63	0.0158730
NODE_92166_length_376_cov_6.938628	0	63	68	3	63	0.0476190
NODE_92166_length_376_cov_6.938628	0	63	73	1	63	0.0158730
NODE_92166_length_376_cov_6.938628	0	63	81	3	63	0.0476190
NODE_92166_length_376_cov_6.938628	0	63	82	2	63	0.0317460
NODE_92166_length_376_cov_6.938628	0	63	84	2	63	0.0317460
NODE_92166_length_376_cov_6.938628	0	63	87	2	63	0.0317460
NODE_92166_length_376_cov_6.938628	0	63	93	1	63	0.0158730
NODE_92166_length_376_cov_6.938628	0	63	95	1	63	0.0158730
NODE_92166_length_376_cov_6.938628	0	63	99	4	63	0.0634921
NODE_92166_length_376_cov_6.938628	269	340	26	71	71	1.0000000
NODE_92168_length_376_cov_6.415162	177	257	0	80	80	1.0000000
NODE_92168_length_376_cov_6.415162	230	310	0	80	80	1.0000000
NODE_92173_length_376_cov_5.722022	100	171	12	8	71	0.1126761
NODE_92173_length_376_cov_5.722022	100	171	14	10	71	0.1408451
NODE_92173_length_376_cov_5.722022	100	171	16	12	71	0.1690141
NODE_92173_length_376_cov_5.722022	100	171	18	5	71	0.0704225
NODE_92173_length_376_cov_5.722022	100	171	22	36	71	0.5070422
NODE_92173_length_376_cov_5.722022	155	192	12	3	37	0.0810811
NODE_92173_length_376_cov_5.722022	155	192	22	28	37	0.7567568
NODE_92173_length_376_cov_5.722022	155	192	24	6	37	0.1621622
NODE_92191_length_376_cov_4.148014	300	330	0	30	30	1.0000000
NODE_92196_length_376_cov_3.859206	168	236	3	4	68	0.0588235
NODE_92196_length_376_cov_3.859206	168	236	10	1	68	0.0147059
NODE_92196_length_376_cov_3.859206	168	236	11	14	68	0.2058824
NODE_92196_length_376_cov_3.859206	168	236	13	25	68	0.3676471
NODE_92196_length_376_cov_3.859206	168	236	14	11	68	0.1617647
NODE_92196_length_376_cov_3.859206	168	236	15	13	68	0.1911765
NODE_92219_length_376_cov_3.140794	122	188	0	66	66	1.0000000
NODE_92442_length_376_cov_1.516245	57	106	4	2	49	0.0408163
NODE_92442_length_376_cov_1.516245	57	106	6	5	49	0.1020408
NODE_92442_length_376_cov_1.516245	57	106	8	12	49	0.2448980
NODE_92442_length_376_cov_1.516245	57	106	10	30	49	0.6122449
NODE_92879_length_375_cov_4.217391	321	350	0	29	29	1.0000000
NODE_92897_length_375_cov_3.699275	287	367	0	80	80	1.0000000
NODE_92911_length_375_cov_3.376812	70	136	0	9	66	0.1363636
NODE_92911_length_375_cov_3.376812	70	136	2	57	66	0.8636364
NODE_93031_length_375_cov_2.032609	162	224	0	11	62	0.1774193
NODE_93031_length_375_cov_2.032609	162	224	2	12	62	0.1935484
NODE_93031_length_375_cov_2.032609	162	224	4	7	62	0.1129032
NODE_93031_length_375_cov_2.032609	162	224	6	2	62	0.0322581
NODE_93031_length_375_cov_2.032609	162	224	8	30	62	0.4838710
NODE_93031_length_375_cov_2.032609	215	272	8	10	57	0.1754386
NODE_93031_length_375_cov_2.032609	215	272	10	7	57	0.1228070
NODE_93031_length_375_cov_2.032609	215	272	12	10	57	0.1754386
NODE_93031_length_375_cov_2.032609	215	272	16	18	57	0.3157895
NODE_93031_length_375_cov_2.032609	215	272	18	12	57	0.2105263
NODE_93050_length_375_cov_1.967391	131	190	2	1	59	0.0169492
NODE_93050_length_375_cov_1.967391	131	190	4	8	59	0.1355932
NODE_93050_length_375_cov_1.967391	131	190	6	50	59	0.8474576
NODE_93050_length_375_cov_1.967391	184	235	4	20	51	0.3921569
NODE_93050_length_375_cov_1.967391	184	235	6	16	51	0.3137255
NODE_93050_length_375_cov_1.967391	184	235	8	15	51	0.2941177
NODE_93081_length_375_cov_1.840580	195	276	4	16	81	0.1975309
NODE_93081_length_375_cov_1.840580	195	276	6	65	81	0.8024691
NODE_93386_length_375_cov_1.000000	320	375	0	55	55	1.0000000
NODE_93609_length_374_cov_4.563636	93	160	2	18	67	0.2686567
NODE_93609_length_374_cov_4.563636	93	160	3	15	67	0.2238806
NODE_93609_length_374_cov_4.563636	93	160	4	29	67	0.4328358
NODE_93609_length_374_cov_4.563636	93	160	10	5	67	0.0746269
NODE_93609_length_374_cov_4.563636	146	213	2	22	67	0.3283582
NODE_93609_length_374_cov_4.563636	146	213	4	45	67	0.6716418
NODE_93612_length_374_cov_4.523636	23	101	4	3	78	0.0384615
NODE_93612_length_374_cov_4.523636	23	101	6	75	78	0.9615384
NODE_93612_length_374_cov_4.523636	81	154	0	19	73	0.2602740
NODE_93612_length_374_cov_4.523636	81	154	2	29	73	0.3972603
NODE_93612_length_374_cov_4.523636	81	154	4	8	73	0.1095890
NODE_93612_length_374_cov_4.523636	81	154	6	17	73	0.2328767
NODE_93628_length_374_cov_3.810909	130	189	0	3	59	0.0508475
NODE_93628_length_374_cov_3.810909	130	189	4	4	59	0.0677966
NODE_93628_length_374_cov_3.810909	130	189	8	6	59	0.1016949
NODE_93628_length_374_cov_3.810909	130	189	10	21	59	0.3559322
NODE_93628_length_374_cov_3.810909	130	189	14	25	59	0.4237288
NODE_93628_length_374_cov_3.810909	162	242	4	10	80	0.1250000
NODE_93628_length_374_cov_3.810909	162	242	6	11	80	0.1375000
NODE_93628_length_374_cov_3.810909	162	242	10	7	80	0.0875000
NODE_93628_length_374_cov_3.810909	162	242	14	52	80	0.6500000
NODE_93630_length_374_cov_3.789091	236	271	6	35	35	1.0000000
NODE_93630_length_374_cov_3.789091	238	280	6	42	42	1.0000000
NODE_93637_length_374_cov_3.458182	190	248	2	3	58	0.0517241
NODE_93637_length_374_cov_3.458182	190	248	4	55	58	0.9482759
NODE_93688_length_374_cov_2.600000	142	217	2	36	75	0.4800000
NODE_93688_length_374_cov_2.600000	142	217	4	17	75	0.2266667
NODE_93688_length_374_cov_2.600000	142	217	7	22	75	0.2933333
NODE_93688_length_374_cov_2.600000	190	270	4	5	80	0.0625000
NODE_93688_length_374_cov_2.600000	190	270	6	9	80	0.1125000
NODE_93688_length_374_cov_2.600000	190	270	7	28	80	0.3500000
NODE_93688_length_374_cov_2.600000	190	270	10	16	80	0.2000000
NODE_93688_length_374_cov_2.600000	190	270	12	5	80	0.0625000
NODE_93688_length_374_cov_2.600000	190	270	14	6	80	0.0750000
NODE_93688_length_374_cov_2.600000	190	270	16	3	80	0.0375000
NODE_93688_length_374_cov_2.600000	190	270	18	8	80	0.1000000
NODE_93718_length_374_cov_2.330909	40	120	0	8	80	0.1000000
NODE_93718_length_374_cov_2.330909	40	120	2	72	80	0.9000000
NODE_93769_length_374_cov_2.010909	40	105	0	65	65	1.0000000
NODE_93821_length_374_cov_1.796364	254	288	0	6	34	0.1764706
NODE_93821_length_374_cov_1.796364	254	288	2	28	34	0.8235294
NODE_93852_length_374_cov_1.661818	95	157	5	32	62	0.5161290
NODE_93852_length_374_cov_1.661818	95	157	6	10	62	0.1612903
NODE_93852_length_374_cov_1.661818	95	157	7	20	62	0.3225806
NODE_93859_length_374_cov_1.621818	202	254	0	13	52	0.2500000
NODE_93859_length_374_cov_1.621818	202	254	8	39	52	0.7500000
NODE_93936_length_374_cov_1.360000	211	291	0	2	80	0.0250000
NODE_93936_length_374_cov_1.360000	211	291	2	20	80	0.2500000
NODE_93936_length_374_cov_1.360000	211	291	4	13	80	0.1625000
NODE_93936_length_374_cov_1.360000	211	291	6	6	80	0.0750000
NODE_93936_length_374_cov_1.360000	211	291	8	5	80	0.0625000
NODE_93936_length_374_cov_1.360000	211	291	10	34	80	0.4250000
NODE_93981_length_374_cov_1.236364	263	336	0	73	73	1.0000000
NODE_94321_length_373_cov_31.302920	0	53	3	3	53	0.0566038
NODE_94321_length_373_cov_31.302920	0	53	5	6	53	0.1132075
NODE_94321_length_373_cov_31.302920	0	53	11	2	53	0.0377358
NODE_94321_length_373_cov_31.302920	0	53	17	3	53	0.0566038
NODE_94321_length_373_cov_31.302920	0	53	18	13	53	0.2452830
NODE_94321_length_373_cov_31.302920	0	53	19	3	53	0.0566038
NODE_94321_length_373_cov_31.302920	0	53	23	1	53	0.0188679
NODE_94321_length_373_cov_31.302920	0	53	25	1	53	0.0188679
NODE_94321_length_373_cov_31.302920	0	53	28	9	53	0.1698113
NODE_94321_length_373_cov_31.302920	0	53	30	6	53	0.1132075
NODE_94321_length_373_cov_31.302920	0	53	44	5	53	0.0943396
NODE_94321_length_373_cov_31.302920	0	53	47	1	53	0.0188679
NODE_94321_length_373_cov_31.302920	0	53	3	3	53	0.0566038
NODE_94321_length_373_cov_31.302920	0	53	5	6	53	0.1132075
NODE_94321_length_373_cov_31.302920	0	53	11	2	53	0.0377358
NODE_94321_length_373_cov_31.302920	0	53	17	3	53	0.0566038
NODE_94321_length_373_cov_31.302920	0	53	18	13	53	0.2452830
NODE_94321_length_373_cov_31.302920	0	53	19	3	53	0.0566038
NODE_94321_length_373_cov_31.302920	0	53	23	1	53	0.0188679
NODE_94321_length_373_cov_31.302920	0	53	25	1	53	0.0188679
NODE_94321_length_373_cov_31.302920	0	53	28	9	53	0.1698113
NODE_94321_length_373_cov_31.302920	0	53	30	6	53	0.1132075
NODE_94321_length_373_cov_31.302920	0	53	44	5	53	0.0943396
NODE_94321_length_373_cov_31.302920	0	53	47	1	53	0.0188679
NODE_94321_length_373_cov_31.302920	0	53	3	3	53	0.0566038
NODE_94321_length_373_cov_31.302920	0	53	5	6	53	0.1132075
NODE_94321_length_373_cov_31.302920	0	53	11	2	53	0.0377358
NODE_94321_length_373_cov_31.302920	0	53	17	3	53	0.0566038
NODE_94321_length_373_cov_31.302920	0	53	18	13	53	0.2452830
NODE_94321_length_373_cov_31.302920	0	53	19	3	53	0.0566038
NODE_94321_length_373_cov_31.302920	0	53	23	1	53	0.0188679
NODE_94321_length_373_cov_31.302920	0	53	25	1	53	0.0188679
NODE_94321_length_373_cov_31.302920	0	53	28	9	53	0.1698113
NODE_94321_length_373_cov_31.302920	0	53	30	6	53	0.1132075
NODE_94321_length_373_cov_31.302920	0	53	44	5	53	0.0943396
NODE_94321_length_373_cov_31.302920	0	53	47	1	53	0.0188679
NODE_94321_length_373_cov_31.302920	26	106	18	1	80	0.0125000
NODE_94321_length_373_cov_31.302920	26	106	19	3	80	0.0375000
NODE_94321_length_373_cov_31.302920	26	106	23	1	80	0.0125000
NODE_94321_length_373_cov_31.302920	26	106	25	1	80	0.0125000
NODE_94321_length_373_cov_31.302920	26	106	28	9	80	0.1125000
NODE_94321_length_373_cov_31.302920	26	106	30	6	80	0.0750000
NODE_94321_length_373_cov_31.302920	26	106	44	5	80	0.0625000
NODE_94321_length_373_cov_31.302920	26	106	47	9	80	0.1125000
NODE_94321_length_373_cov_31.302920	26	106	49	7	80	0.0875000
NODE_94321_length_373_cov_31.302920	26	106	50	4	80	0.0500000
NODE_94321_length_373_cov_31.302920	26	106	54	30	80	0.3750000
NODE_94321_length_373_cov_31.302920	26	106	67	4	80	0.0500000
NODE_94340_length_373_cov_4.671533	76	142	4	66	66	1.0000000
NODE_94340_length_373_cov_4.671533	115	195	0	38	80	0.4750000
NODE_94340_length_373_cov_4.671533	115	195	2	15	80	0.1875000
NODE_94340_length_373_cov_4.671533	115	195	4	27	80	0.3375000
NODE_94340_length_373_cov_4.671533	115	195	0	38	80	0.4750000
NODE_94340_length_373_cov_4.671533	115	195	2	15	80	0.1875000
NODE_94340_length_373_cov_4.671533	115	195	4	27	80	0.3375000
NODE_94340_length_373_cov_4.671533	288	368	0	17	80	0.2125000
NODE_94340_length_373_cov_4.671533	288	368	2	2	80	0.0250000
NODE_94340_length_373_cov_4.671533	288	368	4	61	80	0.7625000
NODE_94352_length_373_cov_4.080292	109	189	2	80	80	1.0000000
NODE_94352_length_373_cov_4.080292	162	220	0	11	58	0.1896552
NODE_94352_length_373_cov_4.080292	162	220	2	47	58	0.8103448
NODE_94380_length_373_cov_3.167883	131	210	2	5	79	0.0632911
NODE_94380_length_373_cov_3.167883	131	210	4	6	79	0.0759494
NODE_94380_length_373_cov_3.167883	131	210	5	18	79	0.2278481
NODE_94380_length_373_cov_3.167883	131	210	6	35	79	0.4430380
NODE_94380_length_373_cov_3.167883	131	210	8	15	79	0.1898734
NODE_94414_length_373_cov_2.751825	80	151	0	61	71	0.8591549
NODE_94414_length_373_cov_2.751825	80	151	2	2	71	0.0281690
NODE_94414_length_373_cov_2.751825	80	151	4	2	71	0.0281690
NODE_94414_length_373_cov_2.751825	80	151	6	5	71	0.0704225
NODE_94414_length_373_cov_2.751825	80	151	10	1	71	0.0140845
NODE_94414_length_373_cov_2.751825	124	162	0	17	38	0.4473684
NODE_94414_length_373_cov_2.751825	124	162	2	2	38	0.0526316
NODE_94414_length_373_cov_2.751825	124	162	4	2	38	0.0526316
NODE_94414_length_373_cov_2.751825	124	162	6	5	38	0.1315790
NODE_94414_length_373_cov_2.751825	124	162	10	6	38	0.1578947
NODE_94414_length_373_cov_2.751825	124	162	12	1	38	0.0263158
NODE_94414_length_373_cov_2.751825	124	162	14	2	38	0.0526316
NODE_94414_length_373_cov_2.751825	124	162	15	1	38	0.0263158
NODE_94414_length_373_cov_2.751825	124	162	16	2	38	0.0526316
NODE_94493_length_373_cov_2.036496	248	326	6	74	78	0.9487180
NODE_94493_length_373_cov_2.036496	248	326	7	4	78	0.0512821
NODE_94493_length_373_cov_2.036496	299	359	3	6	60	0.1000000
NODE_94493_length_373_cov_2.036496	299	359	6	54	60	0.9000000
NODE_94500_length_373_cov_2.003650	150	194	0	44	44	1.0000000
NODE_94937_length_373_cov_0.759124	62	114	0	42	52	0.8076923
NODE_94937_length_373_cov_0.759124	62	114	2	10	52	0.1923077
NODE_95051_length_372_cov_30.135531	111	191	0	80	80	1.0000000
NODE_95051_length_372_cov_30.135531	159	222	0	63	63	1.0000000
NODE_95051_length_372_cov_30.135531	164	239	0	75	75	1.0000000
NODE_95051_length_372_cov_30.135531	182	253	0	71	71	1.0000000
NODE_95051_length_372_cov_30.135531	195	275	0	80	80	1.0000000
NODE_95051_length_372_cov_30.135531	213	276	0	63	63	1.0000000
NODE_95053_length_372_cov_9.091575	150	230	0	80	80	1.0000000
NODE_95053_length_372_cov_9.091575	203	283	0	80	80	1.0000000
NODE_95063_length_372_cov_5.706960	168	208	0	40	40	1.0000000
NODE_95067_length_372_cov_5.124542	146	211	0	8	65	0.1230769
NODE_95067_length_372_cov_5.124542	146	211	1	17	65	0.2615385
NODE_95067_length_372_cov_5.124542	146	211	2	38	65	0.5846154
NODE_95067_length_372_cov_5.124542	146	211	5	1	65	0.0153846
NODE_95067_length_372_cov_5.124542	146	211	6	1	65	0.0153846
NODE_95067_length_372_cov_5.124542	189	264	2	20	75	0.2666667
NODE_95067_length_372_cov_5.124542	189	264	5	1	75	0.0133333
NODE_95067_length_372_cov_5.124542	189	264	6	37	75	0.4933333
NODE_95067_length_372_cov_5.124542	189	264	12	17	75	0.2266667
NODE_95090_length_372_cov_3.761905	177	221	4	44	44	1.0000000
NODE_95109_length_372_cov_3.186813	137	218	0	48	81	0.5925926
NODE_95109_length_372_cov_3.186813	137	218	2	33	81	0.4074074
NODE_95159_length_372_cov_2.582418	167	239	24	2	72	0.0277778
NODE_95159_length_372_cov_2.582418	167	239	26	1	72	0.0138889
NODE_95159_length_372_cov_2.582418	167	239	28	2	72	0.0277778
NODE_95159_length_372_cov_2.582418	167	239	30	3	72	0.0416667
NODE_95159_length_372_cov_2.582418	167	239	32	1	72	0.0138889
NODE_95159_length_372_cov_2.582418	167	239	34	4	72	0.0555556
NODE_95159_length_372_cov_2.582418	167	239	36	45	72	0.6250000
NODE_95159_length_372_cov_2.582418	167	239	38	14	72	0.1944444
NODE_95159_length_372_cov_2.582418	212	292	4	8	80	0.1000000
NODE_95159_length_372_cov_2.582418	212	292	5	4	80	0.0500000
NODE_95159_length_372_cov_2.582418	212	292	7	1	80	0.0125000
NODE_95159_length_372_cov_2.582418	212	292	8	2	80	0.0250000
NODE_95159_length_372_cov_2.582418	212	292	16	4	80	0.0500000
NODE_95159_length_372_cov_2.582418	212	292	18	1	80	0.0125000
NODE_95159_length_372_cov_2.582418	212	292	20	4	80	0.0500000
NODE_95159_length_372_cov_2.582418	212	292	22	7	80	0.0875000
NODE_95159_length_372_cov_2.582418	212	292	24	4	80	0.0500000
NODE_95159_length_372_cov_2.582418	212	292	26	1	80	0.0125000
NODE_95159_length_372_cov_2.582418	212	292	28	1	80	0.0125000
NODE_95159_length_372_cov_2.582418	212	292	30	3	80	0.0375000
NODE_95159_length_372_cov_2.582418	212	292	32	1	80	0.0125000
NODE_95159_length_372_cov_2.582418	212	292	34	12	80	0.1500000
NODE_95159_length_372_cov_2.582418	212	292	36	14	80	0.1750000
NODE_95159_length_372_cov_2.582418	212	292	38	13	80	0.1625000
NODE_95183_length_372_cov_2.347985	97	141	0	44	44	1.0000000
NODE_95183_length_372_cov_2.347985	98	133	0	35	35	1.0000000
NODE_95183_length_372_cov_2.347985	178	243	2	65	65	1.0000000
NODE_95303_length_372_cov_1.699634	195	276	8	6	81	0.0740741
NODE_95303_length_372_cov_1.699634	195	276	10	43	81	0.5308642
NODE_95303_length_372_cov_1.699634	195	276	12	32	81	0.3950617
NODE_95453_length_372_cov_1.223443	264	334	2	11	70	0.1571429
NODE_95453_length_372_cov_1.223443	264	334	4	59	70	0.8428571
NODE_95784_length_371_cov_52.040441	104	184	0	75	80	0.9375000
NODE_95784_length_371_cov_52.040441	104	184	4	5	80	0.0625000
NODE_95784_length_371_cov_52.040441	157	237	0	22	80	0.2750000
NODE_95784_length_371_cov_52.040441	157	237	4	5	80	0.0625000
NODE_95784_length_371_cov_52.040441	157	237	6	13	80	0.1625000
NODE_95784_length_371_cov_52.040441	157	237	8	7	80	0.0875000
NODE_95784_length_371_cov_52.040441	157	237	14	3	80	0.0375000
NODE_95784_length_371_cov_52.040441	157	237	15	1	80	0.0125000
NODE_95784_length_371_cov_52.040441	157	237	16	2	80	0.0250000
NODE_95784_length_371_cov_52.040441	157	237	19	8	80	0.1000000
NODE_95784_length_371_cov_52.040441	157	237	20	4	80	0.0500000
NODE_95784_length_371_cov_52.040441	157	237	21	3	80	0.0375000
NODE_95784_length_371_cov_52.040441	157	237	23	3	80	0.0375000
NODE_95784_length_371_cov_52.040441	157	237	25	2	80	0.0250000
NODE_95784_length_371_cov_52.040441	157	237	28	1	80	0.0125000
NODE_95784_length_371_cov_52.040441	157	237	29	5	80	0.0625000
NODE_95784_length_371_cov_52.040441	157	237	31	1	80	0.0125000
NODE_95784_length_371_cov_52.040441	180	232	4	4	52	0.0769231
NODE_95784_length_371_cov_52.040441	180	232	6	13	52	0.2500000
NODE_95784_length_371_cov_52.040441	180	232	8	7	52	0.1346154
NODE_95784_length_371_cov_52.040441	180	232	14	3	52	0.0576923
NODE_95784_length_371_cov_52.040441	180	232	15	1	52	0.0192308
NODE_95784_length_371_cov_52.040441	180	232	16	2	52	0.0384615
NODE_95784_length_371_cov_52.040441	180	232	19	8	52	0.1538462
NODE_95784_length_371_cov_52.040441	180	232	20	4	52	0.0769231
NODE_95784_length_371_cov_52.040441	180	232	21	3	52	0.0576923
NODE_95784_length_371_cov_52.040441	180	232	23	3	52	0.0576923
NODE_95784_length_371_cov_52.040441	180	232	25	2	52	0.0384615
NODE_95784_length_371_cov_52.040441	180	232	28	1	52	0.0192308
NODE_95784_length_371_cov_52.040441	180	232	29	1	52	0.0192308
NODE_95785_length_371_cov_24.878676	91	171	4	14	80	0.1750000
NODE_95785_length_371_cov_24.878676	91	171	8	66	80	0.8250000
NODE_95785_length_371_cov_24.878676	144	224	0	42	80	0.5250000
NODE_95785_length_371_cov_24.878676	144	224	4	16	80	0.2000000
NODE_95785_length_371_cov_24.878676	144	224	8	22	80	0.2750000
NODE_95797_length_371_cov_5.738971	170	245	16	1	75	0.0133333
NODE_95797_length_371_cov_5.738971	170	245	17	4	75	0.0533333
NODE_95797_length_371_cov_5.738971	170	245	20	1	75	0.0133333
NODE_95797_length_371_cov_5.738971	170	245	22	11	75	0.1466667
NODE_95797_length_371_cov_5.738971	170	245	25	2	75	0.0266667
NODE_95797_length_371_cov_5.738971	170	245	27	3	75	0.0400000
NODE_95797_length_371_cov_5.738971	170	245	29	22	75	0.2933333
NODE_95797_length_371_cov_5.738971	170	245	30	8	75	0.1066667
NODE_95797_length_371_cov_5.738971	170	245	31	5	75	0.0666667
NODE_95797_length_371_cov_5.738971	170	245	32	9	75	0.1200000
NODE_95797_length_371_cov_5.738971	170	245	33	9	75	0.1200000
NODE_95797_length_371_cov_5.738971	218	298	18	4	80	0.0500000
NODE_95797_length_371_cov_5.738971	218	298	23	1	80	0.0125000
NODE_95797_length_371_cov_5.738971	218	298	24	27	80	0.3375000
NODE_95797_length_371_cov_5.738971	218	298	26	1	80	0.0125000
NODE_95797_length_371_cov_5.738971	218	298	29	22	80	0.2750000
NODE_95797_length_371_cov_5.738971	218	298	30	16	80	0.2000000
NODE_95797_length_371_cov_5.738971	218	298	32	9	80	0.1125000
NODE_95807_length_371_cov_4.452206	65	145	0	80	80	1.0000000
NODE_95807_length_371_cov_4.452206	118	198	0	80	80	1.0000000
NODE_95863_length_371_cov_2.841912	288	350	0	57	62	0.9193549
NODE_95863_length_371_cov_2.841912	288	350	3	3	62	0.0483871
NODE_95863_length_371_cov_2.841912	288	350	34	2	62	0.0322581
NODE_96013_length_371_cov_1.790441	188	235	0	47	47	1.0000000
NODE_96105_length_371_cov_1.422794	199	287	0	50	88	0.5681818
NODE_96105_length_371_cov_1.422794	199	287	6	38	88	0.4318182
NODE_96500_length_370_cov_50.380074	144	224	2	80	80	1.0000000
NODE_96500_length_370_cov_50.380074	197	277	0	46	80	0.5750000
NODE_96500_length_370_cov_50.380074	197	277	2	34	80	0.4250000
NODE_96504_length_370_cov_7.553506	105	162	2	21	57	0.3684210
NODE_96504_length_370_cov_7.553506	105	162	4	13	57	0.2280702
NODE_96504_length_370_cov_7.553506	105	162	6	23	57	0.4035088
NODE_96510_length_370_cov_5.811808	153	221	0	68	68	1.0000000
NODE_96510_length_370_cov_5.811808	206	286	0	80	80	1.0000000
NODE_96522_length_370_cov_4.915129	157	207	0	50	50	1.0000000
NODE_96528_length_370_cov_4.535055	141	221	0	80	80	1.0000000
NODE_96528_length_370_cov_4.535055	194	274	0	80	80	1.0000000
NODE_96532_length_370_cov_4.199262	230	275	4	45	45	1.0000000
NODE_96533_length_370_cov_4.151292	142	209	2	1	67	0.0149254
NODE_96533_length_370_cov_4.151292	142	209	6	5	67	0.0746269
NODE_96533_length_370_cov_4.151292	142	209	8	11	67	0.1641791
NODE_96533_length_370_cov_4.151292	142	209	10	50	67	0.7462686
NODE_96542_length_370_cov_3.719557	214	251	31	1	37	0.0270270
NODE_96542_length_370_cov_3.719557	214	251	33	8	37	0.2162162
NODE_96542_length_370_cov_3.719557	214	251	34	5	37	0.1351351
NODE_96542_length_370_cov_3.719557	214	251	35	2	37	0.0540541
NODE_96542_length_370_cov_3.719557	214	251	37	7	37	0.1891892
NODE_96542_length_370_cov_3.719557	214	251	39	14	37	0.3783784
NODE_96581_length_370_cov_2.822878	126	173	2	37	47	0.7872341
NODE_96581_length_370_cov_2.822878	126	173	4	10	47	0.2127660
NODE_96668_length_370_cov_2.081181	0	52	2	1	52	0.0192308
NODE_96668_length_370_cov_2.081181	0	52	7	6	52	0.1153846
NODE_96668_length_370_cov_2.081181	0	52	17	4	52	0.0769231
NODE_96668_length_370_cov_2.081181	0	52	19	3	52	0.0576923
NODE_96668_length_370_cov_2.081181	0	52	21	3	52	0.0576923
NODE_96668_length_370_cov_2.081181	0	52	24	6	52	0.1153846
NODE_96668_length_370_cov_2.081181	0	52	28	3	52	0.0576923
NODE_96668_length_370_cov_2.081181	0	52	30	3	52	0.0576923
NODE_96668_length_370_cov_2.081181	0	52	36	1	52	0.0192308
NODE_96668_length_370_cov_2.081181	0	52	40	5	52	0.0961538
NODE_96668_length_370_cov_2.081181	0	52	41	1	52	0.0192308
NODE_96668_length_370_cov_2.081181	0	52	45	1	52	0.0192308
NODE_96668_length_370_cov_2.081181	0	52	61	3	52	0.0576923
NODE_96668_length_370_cov_2.081181	0	52	65	1	52	0.0192308
NODE_96668_length_370_cov_2.081181	0	52	67	2	52	0.0384615
NODE_96668_length_370_cov_2.081181	0	52	69	9	52	0.1730769
NODE_97207_length_369_cov_36.811111	273	358	0	16	85	0.1882353
NODE_97207_length_369_cov_36.811111	273	358	18	1	85	0.0117647
NODE_97207_length_369_cov_36.811111	273	358	20	5	85	0.0588235
NODE_97207_length_369_cov_36.811111	273	358	24	4	85	0.0470588
NODE_97207_length_369_cov_36.811111	273	358	26	1	85	0.0117647
NODE_97207_length_369_cov_36.811111	273	358	36	4	85	0.0470588
NODE_97207_length_369_cov_36.811111	273	358	38	39	85	0.4588235
NODE_97207_length_369_cov_36.811111	273	358	39	6	85	0.0705882
NODE_97207_length_369_cov_36.811111	273	358	40	9	85	0.1058824
NODE_97207_length_369_cov_36.811111	273	358	0	16	85	0.1882353
NODE_97207_length_369_cov_36.811111	273	358	18	1	85	0.0117647
NODE_97207_length_369_cov_36.811111	273	358	20	5	85	0.0588235
NODE_97207_length_369_cov_36.811111	273	358	24	4	85	0.0470588
NODE_97207_length_369_cov_36.811111	273	358	26	1	85	0.0117647
NODE_97207_length_369_cov_36.811111	273	358	36	4	85	0.0470588
NODE_97207_length_369_cov_36.811111	273	358	38	39	85	0.4588235
NODE_97207_length_369_cov_36.811111	273	358	39	6	85	0.0705882
NODE_97207_length_369_cov_36.811111	273	358	40	9	85	0.1058824
NODE_97207_length_369_cov_36.811111	273	358	0	16	85	0.1882353
NODE_97207_length_369_cov_36.811111	273	358	18	1	85	0.0117647
NODE_97207_length_369_cov_36.811111	273	358	20	5	85	0.0588235
NODE_97207_length_369_cov_36.811111	273	358	24	4	85	0.0470588
NODE_97207_length_369_cov_36.811111	273	358	26	1	85	0.0117647
NODE_97207_length_369_cov_36.811111	273	358	36	4	85	0.0470588
NODE_97207_length_369_cov_36.811111	273	358	38	39	85	0.4588235
NODE_97207_length_369_cov_36.811111	273	358	39	6	85	0.0705882
NODE_97207_length_369_cov_36.811111	273	358	40	9	85	0.1058824
NODE_97211_length_369_cov_8.751852	107	187	0	38	80	0.4750000
NODE_97211_length_369_cov_8.751852	107	187	2	42	80	0.5250000
NODE_97226_length_369_cov_6.677778	189	269	2	80	80	1.0000000
NODE_97226_length_369_cov_6.677778	242	323	0	13	81	0.1604938
NODE_97226_length_369_cov_6.677778	242	323	2	68	81	0.8395061
NODE_97236_length_369_cov_5.337037	199	264	0	65	65	1.0000000
NODE_97249_length_369_cov_4.459259	89	157	4	68	68	1.0000000
NODE_97249_length_369_cov_4.459259	130	210	0	26	80	0.3250000
NODE_97249_length_369_cov_4.459259	130	210	4	54	80	0.6750000
NODE_97255_length_369_cov_4.111111	216	279	0	63	63	1.0000000
NODE_97265_length_369_cov_3.837037	205	238	2	33	33	1.0000000
NODE_97265_length_369_cov_3.837037	211	291	0	27	80	0.3375000
NODE_97265_length_369_cov_3.837037	211	291	2	53	80	0.6625000
NODE_97265_length_369_cov_3.837037	287	316	0	29	29	1.0000000
NODE_97346_length_369_cov_2.355556	62	142	0	44	80	0.5500000
NODE_97346_length_369_cov_2.355556	62	142	4	36	80	0.4500000
NODE_97346_length_369_cov_2.355556	114	195	4	81	81	1.0000000
NODE_97440_length_369_cov_1.803704	170	235	0	65	65	1.0000000
NODE_97936_length_368_cov_42.208178	231	311	0	3	80	0.0375000
NODE_97936_length_368_cov_42.208178	231	311	2	77	80	0.9625000
NODE_97936_length_368_cov_42.208178	284	364	0	56	80	0.7000000
NODE_97936_length_368_cov_42.208178	284	364	2	24	80	0.3000000
NODE_97939_length_368_cov_11.988848	47	127	0	80	80	1.0000000
NODE_97939_length_368_cov_11.988848	100	180	0	80	80	1.0000000
NODE_97945_length_368_cov_6.267658	133	213	0	80	80	1.0000000
NODE_97945_length_368_cov_6.267658	186	266	0	80	80	1.0000000
NODE_97997_length_368_cov_3.486989	127	207	2	76	80	0.9500000
NODE_97997_length_368_cov_3.486989	127	207	6	4	80	0.0500000
NODE_98008_length_368_cov_3.282528	182	255	12	2	73	0.0273973
NODE_98008_length_368_cov_3.282528	182	255	13	14	73	0.1917808
NODE_98008_length_368_cov_3.282528	182	255	14	30	73	0.4109589
NODE_98008_length_368_cov_3.282528	182	255	16	17	73	0.2328767
NODE_98008_length_368_cov_3.282528	182	255	18	1	73	0.0136986
NODE_98008_length_368_cov_3.282528	182	255	20	9	73	0.1232877
NODE_98058_length_368_cov_2.605948	192	246	0	23	54	0.4259259
NODE_98058_length_368_cov_2.605948	192	246	1	26	54	0.4814815
NODE_98058_length_368_cov_2.605948	192	246	2	5	54	0.0925926
NODE_98123_length_368_cov_2.182156	85	145	2	52	60	0.8666667
NODE_98123_length_368_cov_2.182156	85	145	4	8	60	0.1333333
NODE_98129_length_368_cov_2.137546	66	107	4	3	41	0.0731707
NODE_98129_length_368_cov_2.137546	66	107	6	3	41	0.0731707
NODE_98129_length_368_cov_2.137546	66	107	8	12	41	0.2926829
NODE_98129_length_368_cov_2.137546	66	107	10	6	41	0.1463415
NODE_98129_length_368_cov_2.137546	66	107	12	1	41	0.0243902
NODE_98129_length_368_cov_2.137546	66	107	14	16	41	0.3902439
NODE_98157_length_368_cov_1.944238	192	272	0	30	80	0.3750000
NODE_98157_length_368_cov_1.944238	192	272	2	32	80	0.4000000
NODE_98157_length_368_cov_1.944238	192	272	4	18	80	0.2250000
NODE_98723_length_367_cov_7.156716	174	254	2	28	80	0.3500000
NODE_98723_length_367_cov_7.156716	174	254	4	52	80	0.6500000
NODE_98723_length_367_cov_7.156716	227	307	0	21	80	0.2625000
NODE_98723_length_367_cov_7.156716	227	307	2	59	80	0.7375000
NODE_98734_length_367_cov_5.313433	148	206	2	7	58	0.1206897
NODE_98734_length_367_cov_5.313433	148	206	4	13	58	0.2241379
NODE_98734_length_367_cov_5.313433	148	206	6	8	58	0.1379310
NODE_98734_length_367_cov_5.313433	148	206	10	9	58	0.1551724
NODE_98734_length_367_cov_5.313433	148	206	12	1	58	0.0172414
NODE_98734_length_367_cov_5.313433	148	206	14	2	58	0.0344828
NODE_98734_length_367_cov_5.313433	148	206	16	4	58	0.0689655
NODE_98734_length_367_cov_5.313433	148	206	18	5	58	0.0862069
NODE_98734_length_367_cov_5.313433	148	206	20	1	58	0.0172414
NODE_98734_length_367_cov_5.313433	148	206	24	8	58	0.1379310
NODE_98737_length_367_cov_5.138060	58	138	0	80	80	1.0000000
NODE_98737_length_367_cov_5.138060	111	191	0	80	80	1.0000000
NODE_98796_length_367_cov_3.059701	110	154	4	7	44	0.1590909
NODE_98796_length_367_cov_3.059701	110	154	6	27	44	0.6136364
NODE_98796_length_367_cov_3.059701	110	154	8	10	44	0.2272727
NODE_98796_length_367_cov_3.059701	111	146	4	7	35	0.2000000
NODE_98796_length_367_cov_3.059701	111	146	6	26	35	0.7428572
NODE_98796_length_367_cov_3.059701	111	146	8	2	35	0.0571429
NODE_98843_length_367_cov_2.384328	246	326	4	14	80	0.1750000
NODE_98843_length_367_cov_2.384328	246	326	6	66	80	0.8250000
NODE_98843_length_367_cov_2.384328	299	367	0	14	68	0.2058824
NODE_98843_length_367_cov_2.384328	299	367	2	24	68	0.3529412
NODE_98843_length_367_cov_2.384328	299	367	4	14	68	0.2058824
NODE_98843_length_367_cov_2.384328	299	367	6	16	68	0.2352941
NODE_98849_length_367_cov_2.332090	127	207	0	80	80	1.0000000
NODE_98909_length_367_cov_1.944030	91	156	0	42	65	0.6461539
NODE_98909_length_367_cov_1.944030	91	156	3	23	65	0.3538462
NODE_98980_length_367_cov_1.679104	173	252	10	7	79	0.0886076
NODE_98980_length_367_cov_1.679104	173	252	11	2	79	0.0253165
NODE_98980_length_367_cov_1.679104	173	252	12	12	79	0.1518987
NODE_98980_length_367_cov_1.679104	173	252	13	4	79	0.0506329
NODE_98980_length_367_cov_1.679104	173	252	17	2	79	0.0253165
NODE_98980_length_367_cov_1.679104	173	252	18	44	79	0.5569620
NODE_98980_length_367_cov_1.679104	173	252	19	4	79	0.0506329
NODE_98980_length_367_cov_1.679104	173	252	20	4	79	0.0506329
NODE_99005_length_367_cov_1.552239	148	200	2	7	52	0.1346154
NODE_99005_length_367_cov_1.552239	148	200	4	45	52	0.8653846
NODE_99138_length_367_cov_1.201493	79	159	0	80	80	1.0000000
NODE_99138_length_367_cov_1.201493	136	179	0	43	43	1.0000000
NODE_99318_length_367_cov_0.761194	288	357	0	69	69	1.0000000
NODE_99451_length_366_cov_5.239700	193	253	0	60	60	1.0000000
NODE_99472_length_366_cov_4.168539	302	355	0	53	53	1.0000000
NODE_99478_length_366_cov_3.913858	183	229	4	19	46	0.4130435
NODE_99478_length_366_cov_3.913858	183	229	6	27	46	0.5869565
NODE_99478_length_366_cov_3.913858	203	282	2	25	79	0.3164557
NODE_99478_length_366_cov_3.913858	203	282	4	42	79	0.5316456
NODE_99478_length_366_cov_3.913858	203	282	6	12	79	0.1518987
NODE_99496_length_366_cov_3.168539	88	160	0	72	72	1.0000000
NODE_99496_length_366_cov_3.168539	133	193	0	60	60	1.0000000
NODE_100137_length_365_cov_140.101504	40	107	134	1	67	0.0149254
NODE_100137_length_365_cov_140.101504	40	107	138	1	67	0.0149254
NODE_100137_length_365_cov_140.101504	40	107	141	1	67	0.0149254
NODE_100137_length_365_cov_140.101504	40	107	145	2	67	0.0298507
NODE_100137_length_365_cov_140.101504	40	107	147	2	67	0.0298507
NODE_100137_length_365_cov_140.101504	40	107	151	1	67	0.0149254
NODE_100137_length_365_cov_140.101504	40	107	153	1	67	0.0149254
NODE_100137_length_365_cov_140.101504	40	107	155	4	67	0.0597015
NODE_100137_length_365_cov_140.101504	40	107	161	1	67	0.0149254
NODE_100137_length_365_cov_140.101504	40	107	169	2	67	0.0298507
NODE_100137_length_365_cov_140.101504	40	107	171	3	67	0.0447761
NODE_100137_length_365_cov_140.101504	40	107	173	1	67	0.0149254
NODE_100137_length_365_cov_140.101504	40	107	181	2	67	0.0298507
NODE_100137_length_365_cov_140.101504	40	107	185	3	67	0.0447761
NODE_100137_length_365_cov_140.101504	40	107	187	2	67	0.0298507
NODE_100137_length_365_cov_140.101504	40	107	191	1	67	0.0149254
NODE_100137_length_365_cov_140.101504	40	107	192	1	67	0.0149254
NODE_100137_length_365_cov_140.101504	40	107	198	3	67	0.0447761
NODE_100137_length_365_cov_140.101504	40	107	212	3	67	0.0447761
NODE_100137_length_365_cov_140.101504	40	107	214	2	67	0.0298507
NODE_100137_length_365_cov_140.101504	40	107	216	2	67	0.0298507
NODE_100137_length_365_cov_140.101504	40	107	218	3	67	0.0447761
NODE_100137_length_365_cov_140.101504	40	107	220	2	67	0.0298507
NODE_100137_length_365_cov_140.101504	40	107	222	6	67	0.0895522
NODE_100137_length_365_cov_140.101504	40	107	224	1	67	0.0149254
NODE_100137_length_365_cov_140.101504	40	107	228	1	67	0.0149254
NODE_100137_length_365_cov_140.101504	40	107	232	2	67	0.0298507
NODE_100137_length_365_cov_140.101504	40	107	234	10	67	0.1492537
NODE_100137_length_365_cov_140.101504	40	107	236	3	67	0.0447761
NODE_100138_length_365_cov_45.815789	0	38	0	38	38	1.0000000
NODE_100138_length_365_cov_45.815789	11	91	0	80	80	1.0000000
NODE_100140_length_365_cov_8.169173	191	244	0	2	53	0.0377358
NODE_100140_length_365_cov_8.169173	191	244	2	51	53	0.9622642
NODE_100140_length_365_cov_8.169173	217	297	2	80	80	1.0000000
NODE_100145_length_365_cov_5.954887	136	216	4	12	80	0.1500000
NODE_100145_length_365_cov_5.954887	136	216	6	40	80	0.5000000
NODE_100145_length_365_cov_5.954887	136	216	7	17	80	0.2125000
NODE_100145_length_365_cov_5.954887	136	216	8	11	80	0.1375000
NODE_100145_length_365_cov_5.954887	189	269	2	21	80	0.2625000
NODE_100145_length_365_cov_5.954887	189	269	4	9	80	0.1125000
NODE_100145_length_365_cov_5.954887	189	269	7	16	80	0.2000000
NODE_100145_length_365_cov_5.954887	189	269	8	34	80	0.4250000
NODE_100147_length_365_cov_5.721805	37	78	0	41	41	1.0000000
NODE_100168_length_365_cov_4.195489	269	329	31	4	60	0.0666667
NODE_100168_length_365_cov_4.195489	269	329	33	1	60	0.0166667
NODE_100168_length_365_cov_4.195489	269	329	35	7	60	0.1166667
NODE_100168_length_365_cov_4.195489	269	329	37	2	60	0.0333333
NODE_100168_length_365_cov_4.195489	269	329	39	13	60	0.2166667
NODE_100168_length_365_cov_4.195489	269	329	41	33	60	0.5500000
NODE_100172_length_365_cov_4.071429	106	186	0	80	80	1.0000000
NODE_100172_length_365_cov_4.071429	159	239	0	57	80	0.7125000
NODE_100172_length_365_cov_4.071429	159	239	2	23	80	0.2875000
NODE_100180_length_365_cov_3.879699	131	187	22	20	56	0.3571429
NODE_100180_length_365_cov_3.879699	131	187	23	1	56	0.0178571
NODE_100180_length_365_cov_3.879699	131	187	24	6	56	0.1071429
NODE_100180_length_365_cov_3.879699	131	187	25	20	56	0.3571429
NODE_100180_length_365_cov_3.879699	131	187	26	9	56	0.1607143
NODE_100206_length_365_cov_3.270677	211	280	0	25	69	0.3623188
NODE_100206_length_365_cov_3.270677	211	280	6	44	69	0.6376812
NODE_100253_length_365_cov_2.601504	189	265	4	76	76	1.0000000
NODE_100293_length_365_cov_2.289474	169	249	0	80	80	1.0000000
NODE_100407_length_365_cov_1.635338	156	235	2	12	79	0.1518987
NODE_100407_length_365_cov_1.635338	156	235	4	1	79	0.0126582
NODE_100407_length_365_cov_1.635338	156	235	6	3	79	0.0379747
NODE_100407_length_365_cov_1.635338	156	235	9	9	79	0.1139240
NODE_100407_length_365_cov_1.635338	156	235	11	1	79	0.0126582
NODE_100407_length_365_cov_1.635338	156	235	15	1	79	0.0126582
NODE_100407_length_365_cov_1.635338	156	235	18	2	79	0.0253165
NODE_100407_length_365_cov_1.635338	156	235	20	2	79	0.0253165
NODE_100407_length_365_cov_1.635338	156	235	22	2	79	0.0253165
NODE_100407_length_365_cov_1.635338	156	235	36	1	79	0.0126582
NODE_100407_length_365_cov_1.635338	156	235	38	2	79	0.0253165
NODE_100407_length_365_cov_1.635338	156	235	40	9	79	0.1139240
NODE_100407_length_365_cov_1.635338	156	235	42	1	79	0.0126582
NODE_100407_length_365_cov_1.635338	156	235	44	2	79	0.0253165
NODE_100407_length_365_cov_1.635338	156	235	48	31	79	0.3924051
NODE_100485_length_365_cov_1.421053	228	309	0	81	81	1.0000000
NODE_100570_length_365_cov_1.169173	57	137	0	80	80	1.0000000
NODE_100570_length_365_cov_1.169173	65	145	0	80	80	1.0000000
NODE_100570_length_365_cov_1.169173	194	274	12	9	80	0.1125000
NODE_100570_length_365_cov_1.169173	194	274	13	1	80	0.0125000
NODE_100570_length_365_cov_1.169173	194	274	14	21	80	0.2625000
NODE_100570_length_365_cov_1.169173	194	274	16	2	80	0.0250000
NODE_100570_length_365_cov_1.169173	194	274	18	47	80	0.5875000
NODE_100893_length_364_cov_24.600000	101	181	0	80	80	1.0000000
NODE_100893_length_364_cov_24.600000	154	234	0	80	80	1.0000000
NODE_100896_length_364_cov_7.377358	0	50	0	50	50	1.0000000
NODE_100933_length_364_cov_3.988679	122	168	0	46	46	1.0000000
NODE_100935_length_364_cov_3.913208	151	208	0	42	57	0.7368421
NODE_100935_length_364_cov_3.913208	151	208	2	2	57	0.0350877
NODE_100935_length_364_cov_3.913208	151	208	6	13	57	0.2280702
NODE_100959_length_364_cov_3.305660	296	358	0	53	62	0.8548387
NODE_100959_length_364_cov_3.305660	296	358	2	9	62	0.1451613
NODE_100966_length_364_cov_3.181132	78	138	1	10	60	0.1666667
NODE_100966_length_364_cov_3.181132	78	138	2	50	60	0.8333333
NODE_100975_length_364_cov_3.041509	264	321	2	57	57	1.0000000
NODE_100975_length_364_cov_3.041509	294	359	2	65	65	1.0000000
NODE_100978_length_364_cov_3.015094	238	274	0	36	36	1.0000000
NODE_101087_length_364_cov_1.977358	126	201	4	3	75	0.0400000
NODE_101087_length_364_cov_1.977358	126	201	5	1	75	0.0133333
NODE_101087_length_364_cov_1.977358	126	201	6	23	75	0.3066667
NODE_101087_length_364_cov_1.977358	126	201	12	44	75	0.5866666
NODE_101087_length_364_cov_1.977358	126	201	14	4	75	0.0533333
NODE_101141_length_364_cov_1.811321	209	256	0	47	47	1.0000000
NODE_101148_length_364_cov_1.781132	130	203	6	6	73	0.0821918
NODE_101148_length_364_cov_1.781132	130	203	8	3	73	0.0410959
NODE_101148_length_364_cov_1.781132	130	203	10	18	73	0.2465753
NODE_101148_length_364_cov_1.781132	130	203	14	11	73	0.1506849
NODE_101148_length_364_cov_1.781132	130	203	20	5	73	0.0684932
NODE_101148_length_364_cov_1.781132	130	203	22	4	73	0.0547945
NODE_101148_length_364_cov_1.781132	130	203	24	8	73	0.1095890
NODE_101148_length_364_cov_1.781132	130	203	26	5	73	0.0684932
NODE_101148_length_364_cov_1.781132	130	203	28	3	73	0.0410959
NODE_101148_length_364_cov_1.781132	130	203	30	10	73	0.1369863
NODE_101148_length_364_cov_1.781132	183	203	6	6	20	0.3000000
NODE_101148_length_364_cov_1.781132	183	203	8	3	20	0.1500000
NODE_101148_length_364_cov_1.781132	183	203	10	11	20	0.5500000
NODE_101720_length_363_cov_7.791667	121	200	2	44	79	0.5569620
NODE_101720_length_363_cov_7.791667	121	200	3	7	79	0.0886076
NODE_101720_length_363_cov_7.791667	121	200	5	28	79	0.3544304
NODE_101725_length_363_cov_6.484848	33	90	0	20	57	0.3508772
NODE_101725_length_363_cov_6.484848	33	90	4	4	57	0.0701754
NODE_101725_length_363_cov_6.484848	33	90	8	33	57	0.5789474
NODE_101725_length_363_cov_6.484848	93	146	8	53	53	1.0000000
NODE_101734_length_363_cov_4.825758	154	215	0	61	61	1.0000000
NODE_101760_length_363_cov_3.950758	112	183	0	13	71	0.1830986
NODE_101760_length_363_cov_3.950758	112	183	2	43	71	0.6056338
NODE_101760_length_363_cov_3.950758	112	183	4	15	71	0.2112676
NODE_101760_length_363_cov_3.950758	156	236	0	66	80	0.8250000
NODE_101760_length_363_cov_3.950758	156	236	2	14	80	0.1750000
NODE_101769_length_363_cov_3.617424	16	79	0	63	63	1.0000000
NODE_101774_length_363_cov_3.409091	241	267	0	26	26	1.0000000
NODE_101791_length_363_cov_3.087121	228	308	13	2	80	0.0250000
NODE_101791_length_363_cov_3.087121	228	308	14	26	80	0.3250000
NODE_101791_length_363_cov_3.087121	228	308	16	22	80	0.2750000
NODE_101791_length_363_cov_3.087121	228	308	18	27	80	0.3375000
NODE_101791_length_363_cov_3.087121	228	308	20	3	80	0.0375000
NODE_101809_length_363_cov_2.795455	240	320	22	2	80	0.0250000
NODE_101809_length_363_cov_2.795455	240	320	24	5	80	0.0625000
NODE_101809_length_363_cov_2.795455	240	320	25	2	80	0.0250000
NODE_101809_length_363_cov_2.795455	240	320	26	1	80	0.0125000
NODE_101809_length_363_cov_2.795455	240	320	28	2	80	0.0250000
NODE_101809_length_363_cov_2.795455	240	320	32	1	80	0.0125000
NODE_101809_length_363_cov_2.795455	240	320	34	1	80	0.0125000
NODE_101809_length_363_cov_2.795455	240	320	36	5	80	0.0625000
NODE_101809_length_363_cov_2.795455	240	320	38	1	80	0.0125000
NODE_101809_length_363_cov_2.795455	240	320	42	1	80	0.0125000
NODE_101809_length_363_cov_2.795455	240	320	43	1	80	0.0125000
NODE_101809_length_363_cov_2.795455	240	320	45	3	80	0.0375000
NODE_101809_length_363_cov_2.795455	240	320	47	4	80	0.0500000
NODE_101809_length_363_cov_2.795455	240	320	49	6	80	0.0750000
NODE_101809_length_363_cov_2.795455	240	320	53	4	80	0.0500000
NODE_101809_length_363_cov_2.795455	240	320	60	1	80	0.0125000
NODE_101809_length_363_cov_2.795455	240	320	62	7	80	0.0875000
NODE_101809_length_363_cov_2.795455	240	320	64	3	80	0.0375000
NODE_101809_length_363_cov_2.795455	240	320	68	10	80	0.1250000
NODE_101809_length_363_cov_2.795455	240	320	70	2	80	0.0250000
NODE_101809_length_363_cov_2.795455	240	320	74	2	80	0.0250000
NODE_101809_length_363_cov_2.795455	240	320	76	2	80	0.0250000
NODE_101809_length_363_cov_2.795455	240	320	78	1	80	0.0125000
NODE_101809_length_363_cov_2.795455	240	320	79	2	80	0.0250000
NODE_101809_length_363_cov_2.795455	240	320	80	9	80	0.1125000
NODE_101809_length_363_cov_2.795455	240	320	81	1	80	0.0125000
NODE_101809_length_363_cov_2.795455	240	320	84	1	80	0.0125000
NODE_101822_length_363_cov_2.481061	86	166	0	80	80	1.0000000
NODE_101822_length_363_cov_2.481061	139	219	0	80	80	1.0000000
NODE_101879_length_363_cov_2.034091	46	126	0	80	80	1.0000000
NODE_101879_length_363_cov_2.034091	99	153	0	54	54	1.0000000
NODE_101992_length_363_cov_1.541667	235	315	2	80	80	1.0000000
NODE_102022_length_363_cov_1.477273	141	202	3	1	61	0.0163934
NODE_102022_length_363_cov_1.477273	141	202	4	8	61	0.1311475
NODE_102022_length_363_cov_1.477273	141	202	8	7	61	0.1147541
NODE_102022_length_363_cov_1.477273	141	202	10	6	61	0.0983607
NODE_102022_length_363_cov_1.477273	141	202	14	1	61	0.0163934
NODE_102022_length_363_cov_1.477273	141	202	18	2	61	0.0327869
NODE_102022_length_363_cov_1.477273	141	202	20	3	61	0.0491803
NODE_102022_length_363_cov_1.477273	141	202	22	5	61	0.0819672
NODE_102022_length_363_cov_1.477273	141	202	26	3	61	0.0491803
NODE_102022_length_363_cov_1.477273	141	202	28	5	61	0.0819672
NODE_102022_length_363_cov_1.477273	141	202	30	3	61	0.0491803
NODE_102022_length_363_cov_1.477273	141	202	32	17	61	0.2786885
NODE_102022_length_363_cov_1.477273	153	210	8	4	57	0.0701754
NODE_102022_length_363_cov_1.477273	153	210	10	6	57	0.1052632
NODE_102022_length_363_cov_1.477273	153	210	14	1	57	0.0175439
NODE_102022_length_363_cov_1.477273	153	210	18	2	57	0.0350877
NODE_102022_length_363_cov_1.477273	153	210	20	3	57	0.0526316
NODE_102022_length_363_cov_1.477273	153	210	22	5	57	0.0877193
NODE_102022_length_363_cov_1.477273	153	210	26	3	57	0.0526316
NODE_102022_length_363_cov_1.477273	153	210	28	5	57	0.0877193
NODE_102022_length_363_cov_1.477273	153	210	30	3	57	0.0526316
NODE_102022_length_363_cov_1.477273	153	210	32	25	57	0.4385965
NODE_102187_length_363_cov_1.113636	245	316	2	37	71	0.5211267
NODE_102187_length_363_cov_1.113636	245	316	4	15	71	0.2112676
NODE_102187_length_363_cov_1.113636	245	316	5	1	71	0.0140845
NODE_102187_length_363_cov_1.113636	245	316	6	18	71	0.2535211
NODE_102464_length_362_cov_54.927757	52	116	0	64	64	1.0000000
NODE_102465_length_362_cov_29.273764	86	166	0	80	80	1.0000000
NODE_102465_length_362_cov_29.273764	139	219	0	80	80	1.0000000
NODE_102467_length_362_cov_14.847909	130	210	0	49	80	0.6125000
NODE_102467_length_362_cov_14.847909	130	210	2	25	80	0.3125000
NODE_102467_length_362_cov_14.847909	130	210	6	1	80	0.0125000
NODE_102467_length_362_cov_14.847909	130	210	7	5	80	0.0625000
NODE_102467_length_362_cov_14.847909	183	263	2	21	80	0.2625000
NODE_102467_length_362_cov_14.847909	183	263	6	15	80	0.1875000
NODE_102467_length_362_cov_14.847909	183	263	7	6	80	0.0750000
NODE_102467_length_362_cov_14.847909	183	263	8	38	80	0.4750000
NODE_102633_length_362_cov_2.159696	133	216	0	83	83	1.0000000
NODE_103259_length_361_cov_4.641221	249	312	2	12	63	0.1904762
NODE_103259_length_361_cov_4.641221	249	312	6	4	63	0.0634921
NODE_103259_length_361_cov_4.641221	249	312	13	5	63	0.0793651
NODE_103259_length_361_cov_4.641221	249	312	14	18	63	0.2857143
NODE_103259_length_361_cov_4.641221	249	312	16	19	63	0.3015873
NODE_103259_length_361_cov_4.641221	249	312	18	5	63	0.0793651
NODE_103280_length_361_cov_3.717557	185	265	2	29	80	0.3625000
NODE_103280_length_361_cov_3.717557	185	265	4	50	80	0.6250000
NODE_103280_length_361_cov_3.717557	185	265	6	1	80	0.0125000
NODE_103280_length_361_cov_3.717557	238	265	4	27	27	1.0000000
NODE_103314_length_361_cov_2.988550	121	201	6	4	80	0.0500000
NODE_103314_length_361_cov_2.988550	121	201	8	61	80	0.7625000
NODE_103314_length_361_cov_2.988550	121	201	10	15	80	0.1875000
NODE_103314_length_361_cov_2.988550	174	216	2	1	42	0.0238095
NODE_103314_length_361_cov_2.988550	174	216	4	12	42	0.2857143
NODE_103314_length_361_cov_2.988550	174	216	8	14	42	0.3333333
NODE_103314_length_361_cov_2.988550	174	216	10	15	42	0.3571429
NODE_103338_length_361_cov_2.641221	4	33	8	29	29	1.0000000
NODE_103338_length_361_cov_2.641221	101	182	0	44	81	0.5432099
NODE_103338_length_361_cov_2.641221	101	182	4	9	81	0.1111111
NODE_103338_length_361_cov_2.641221	101	182	6	28	81	0.3456790
NODE_103391_length_361_cov_2.137405	138	194	0	56	56	1.0000000
NODE_103396_length_361_cov_2.106870	192	256	0	64	64	1.0000000
NODE_103418_length_361_cov_1.969466	137	198	6	10	61	0.1639344
NODE_103418_length_361_cov_1.969466	137	198	8	10	61	0.1639344
NODE_103418_length_361_cov_1.969466	137	198	10	11	61	0.1803279
NODE_103418_length_361_cov_1.969466	137	198	11	2	61	0.0327869
NODE_103418_length_361_cov_1.969466	137	198	12	28	61	0.4590164
NODE_103632_length_361_cov_1.343511	171	250	0	79	79	1.0000000
NODE_103802_length_361_cov_1.000000	60	123	0	63	63	1.0000000
NODE_104057_length_360_cov_8.191571	171	242	0	39	71	0.5492958
NODE_104057_length_360_cov_8.191571	171	242	8	32	71	0.4507042
NODE_104057_length_360_cov_8.191571	176	242	0	34	66	0.5151515
NODE_104057_length_360_cov_8.191571	176	242	8	32	66	0.4848485
NODE_104057_length_360_cov_8.191571	215	279	8	64	64	1.0000000
NODE_104057_length_360_cov_8.191571	215	279	8	64	64	1.0000000
NODE_104079_length_360_cov_5.003831	86	166	0	11	80	0.1375000
NODE_104079_length_360_cov_5.003831	86	166	2	5	80	0.0625000
NODE_104079_length_360_cov_5.003831	86	166	4	64	80	0.8000000
NODE_104091_length_360_cov_4.111111	158	238	115	2	80	0.0250000
NODE_104091_length_360_cov_4.111111	158	238	119	2	80	0.0250000
NODE_104091_length_360_cov_4.111111	158	238	127	1	80	0.0125000
NODE_104091_length_360_cov_4.111111	158	238	135	2	80	0.0250000
NODE_104091_length_360_cov_4.111111	158	238	144	2	80	0.0250000
NODE_104091_length_360_cov_4.111111	158	238	145	1	80	0.0125000
NODE_104091_length_360_cov_4.111111	158	238	146	1	80	0.0125000
NODE_104091_length_360_cov_4.111111	158	238	148	1	80	0.0125000
NODE_104091_length_360_cov_4.111111	158	238	149	2	80	0.0250000
NODE_104091_length_360_cov_4.111111	158	238	152	1	80	0.0125000
NODE_104091_length_360_cov_4.111111	158	238	153	2	80	0.0250000
NODE_104091_length_360_cov_4.111111	158	238	154	1	80	0.0125000
NODE_104091_length_360_cov_4.111111	158	238	155	3	80	0.0375000
NODE_104091_length_360_cov_4.111111	158	238	156	10	80	0.1250000
NODE_104091_length_360_cov_4.111111	158	238	158	1	80	0.0125000
NODE_104091_length_360_cov_4.111111	158	238	159	1	80	0.0125000
NODE_104091_length_360_cov_4.111111	158	238	160	4	80	0.0500000
NODE_104091_length_360_cov_4.111111	158	238	162	2	80	0.0250000
NODE_104091_length_360_cov_4.111111	158	238	164	4	80	0.0500000
NODE_104091_length_360_cov_4.111111	158	238	166	6	80	0.0750000
NODE_104091_length_360_cov_4.111111	158	238	168	3	80	0.0375000
NODE_104091_length_360_cov_4.111111	158	238	170	14	80	0.1750000
NODE_104091_length_360_cov_4.111111	158	238	172	1	80	0.0125000
NODE_104091_length_360_cov_4.111111	158	238	174	13	80	0.1625000
NODE_104102_length_360_cov_3.613027	123	203	0	80	80	1.0000000
NODE_104102_length_360_cov_3.613027	176	256	0	80	80	1.0000000
NODE_104129_length_360_cov_3.080460	48	70	0	22	22	1.0000000
NODE_104162_length_360_cov_2.689655	118	198	11	4	80	0.0500000
NODE_104162_length_360_cov_2.689655	118	198	13	2	80	0.0250000
NODE_104162_length_360_cov_2.689655	118	198	14	1	80	0.0125000
NODE_104162_length_360_cov_2.689655	118	198	15	1	80	0.0125000
NODE_104162_length_360_cov_2.689655	118	198	16	13	80	0.1625000
NODE_104162_length_360_cov_2.689655	118	198	17	59	80	0.7375000
NODE_104261_length_360_cov_1.977011	235	286	6	51	51	1.0000000
NODE_104572_length_360_cov_1.149425	273	353	0	60	80	0.7500000
NODE_104572_length_360_cov_1.149425	273	353	2	20	80	0.2500000
NODE_104669_length_360_cov_0.965517	119	175	10	10	56	0.1785714
NODE_104669_length_360_cov_0.965517	119	175	12	22	56	0.3928571
NODE_104669_length_360_cov_0.965517	119	175	14	19	56	0.3392857
NODE_104669_length_360_cov_0.965517	119	175	16	5	56	0.0892857
NODE_104671_length_360_cov_0.957854	140	186	0	46	46	1.0000000
NODE_104858_length_359_cov_45.519231	140	220	0	46	80	0.5750000
NODE_104858_length_359_cov_45.519231	140	220	2	8	80	0.1000000
NODE_104858_length_359_cov_45.519231	140	220	4	26	80	0.3250000
NODE_104858_length_359_cov_45.519231	193	273	2	8	80	0.1000000
NODE_104858_length_359_cov_45.519231	193	273	4	72	80	0.9000000
NODE_104932_length_359_cov_3.296154	67	147	4	17	80	0.2125000
NODE_104932_length_359_cov_3.296154	67	147	6	24	80	0.3000000
NODE_104932_length_359_cov_3.296154	67	147	12	8	80	0.1000000
NODE_104932_length_359_cov_3.296154	67	147	13	1	80	0.0125000
NODE_104932_length_359_cov_3.296154	67	147	14	30	80	0.3750000
NODE_104932_length_359_cov_3.296154	120	177	11	28	57	0.4912281
NODE_104932_length_359_cov_3.296154	120	177	12	4	57	0.0701754
NODE_104932_length_359_cov_3.296154	120	177	13	3	57	0.0526316
NODE_104932_length_359_cov_3.296154	120	177	14	22	57	0.3859649
NODE_104932_length_359_cov_3.296154	201	256	1	29	55	0.5272727
NODE_104932_length_359_cov_3.296154	201	256	2	1	55	0.0181818
NODE_104932_length_359_cov_3.296154	201	256	3	12	55	0.2181818
NODE_104932_length_359_cov_3.296154	201	256	5	1	55	0.0181818
NODE_104932_length_359_cov_3.296154	201	256	9	12	55	0.2181818
NODE_104936_length_359_cov_3.276923	5	95	2	90	90	1.0000000
NODE_104954_length_359_cov_3.007692	156	212	6	56	56	1.0000000
NODE_104998_length_359_cov_2.523077	148	228	0	80	80	1.0000000
NODE_104998_length_359_cov_2.523077	201	278	0	76	77	0.9870130
NODE_104998_length_359_cov_2.523077	201	278	2	1	77	0.0129870
NODE_105002_length_359_cov_2.419231	106	186	0	18	80	0.2250000
NODE_105002_length_359_cov_2.419231	106	186	2	62	80	0.7750000
NODE_105002_length_359_cov_2.419231	159	211	0	1	52	0.0192308
NODE_105002_length_359_cov_2.419231	159	211	2	49	52	0.9423077
NODE_105002_length_359_cov_2.419231	159	211	12	2	52	0.0384615
NODE_105006_length_359_cov_2.353846	172	243	0	29	71	0.4084507
NODE_105006_length_359_cov_2.353846	172	243	1	1	71	0.0140845
NODE_105006_length_359_cov_2.353846	172	243	2	41	71	0.5774648
NODE_105006_length_359_cov_2.353846	216	296	0	24	80	0.3000000
NODE_105006_length_359_cov_2.353846	216	296	2	56	80	0.7000000
NODE_105026_length_359_cov_2.257692	211	270	0	6	59	0.1016949
NODE_105026_length_359_cov_2.257692	211	270	2	53	59	0.8983051
NODE_105063_length_359_cov_2.003846	8	88	0	80	80	1.0000000
NODE_105063_length_359_cov_2.003846	61	139	0	77	78	0.9871795
NODE_105063_length_359_cov_2.003846	61	139	2	1	78	0.0128205
NODE_105106_length_359_cov_1.815385	126	207	0	81	81	1.0000000
NODE_105106_length_359_cov_1.815385	180	227	0	47	47	1.0000000
NODE_105142_length_359_cov_1.692308	88	116	0	28	28	1.0000000
NODE_105373_length_359_cov_1.096154	64	89	0	25	25	1.0000000
NODE_105599_length_359_cov_0.711538	222	248	0	26	26	1.0000000
NODE_105600_length_359_cov_0.707692	10	90	0	80	80	1.0000000
NODE_105600_length_359_cov_0.707692	10	90	0	80	80	1.0000000
NODE_105600_length_359_cov_0.707692	63	143	0	80	80	1.0000000
NODE_105678_length_358_cov_19.760618	213	293	10	80	80	1.0000000
NODE_105678_length_358_cov_19.760618	266	346	0	30	80	0.3750000
NODE_105678_length_358_cov_19.760618	266	346	2	6	80	0.0750000
NODE_105678_length_358_cov_19.760618	266	346	9	1	80	0.0125000
NODE_105678_length_358_cov_19.760618	266	346	10	43	80	0.5375000
NODE_105679_length_358_cov_18.455598	303	358	0	1	55	0.0181818
NODE_105679_length_358_cov_18.455598	303	358	1	12	55	0.2181818
NODE_105679_length_358_cov_18.455598	303	358	2	4	55	0.0727273
NODE_105679_length_358_cov_18.455598	303	358	3	1	55	0.0181818
NODE_105679_length_358_cov_18.455598	303	358	11	37	55	0.6727273
NODE_105680_length_358_cov_17.023166	0	63	7	2	63	0.0317460
NODE_105680_length_358_cov_17.023166	0	63	9	44	63	0.6984127
NODE_105680_length_358_cov_17.023166	0	63	11	5	63	0.0793651
NODE_105680_length_358_cov_17.023166	0	63	15	2	63	0.0317460
NODE_105680_length_358_cov_17.023166	0	63	17	2	63	0.0317460
NODE_105680_length_358_cov_17.023166	0	63	23	8	63	0.1269841
NODE_105680_length_358_cov_17.023166	0	63	7	2	63	0.0317460
NODE_105680_length_358_cov_17.023166	0	63	9	44	63	0.6984127
NODE_105680_length_358_cov_17.023166	0	63	11	5	63	0.0793651
NODE_105680_length_358_cov_17.023166	0	63	15	2	63	0.0317460
NODE_105680_length_358_cov_17.023166	0	63	17	2	63	0.0317460
NODE_105680_length_358_cov_17.023166	0	63	23	8	63	0.1269841
NODE_105680_length_358_cov_17.023166	0	63	7	2	63	0.0317460
NODE_105680_length_358_cov_17.023166	0	63	9	44	63	0.6984127
NODE_105680_length_358_cov_17.023166	0	63	11	5	63	0.0793651
NODE_105680_length_358_cov_17.023166	0	63	15	2	63	0.0317460
NODE_105680_length_358_cov_17.023166	0	63	17	2	63	0.0317460
NODE_105680_length_358_cov_17.023166	0	63	23	8	63	0.1269841
NODE_105680_length_358_cov_17.023166	36	116	9	10	80	0.1250000
NODE_105680_length_358_cov_17.023166	36	116	11	5	80	0.0625000
NODE_105680_length_358_cov_17.023166	36	116	15	2	80	0.0250000
NODE_105680_length_358_cov_17.023166	36	116	17	8	80	0.1000000
NODE_105680_length_358_cov_17.023166	36	116	23	55	80	0.6875000
NODE_105680_length_358_cov_17.023166	53	115	17	7	62	0.1129032
NODE_105680_length_358_cov_17.023166	53	115	23	55	62	0.8870968
NODE_105686_length_358_cov_6.509653	109	155	0	46	46	1.0000000
NODE_105710_length_358_cov_4.239382	114	143	6	6	29	0.2068966
NODE_105710_length_358_cov_4.239382	114	143	8	4	29	0.1379310
NODE_105710_length_358_cov_4.239382	114	143	10	13	29	0.4482759
NODE_105710_length_358_cov_4.239382	114	143	12	5	29	0.1724138
NODE_105710_length_358_cov_4.239382	114	143	14	1	29	0.0344828
NODE_105710_length_358_cov_4.239382	180	245	10	23	65	0.3538462
NODE_105710_length_358_cov_4.239382	180	245	12	4	65	0.0615385
NODE_105710_length_358_cov_4.239382	180	245	14	4	65	0.0615385
NODE_105710_length_358_cov_4.239382	180	245	16	34	65	0.5230770
NODE_105710_length_358_cov_4.239382	218	298	4	31	80	0.3875000
NODE_105710_length_358_cov_4.239382	218	298	6	7	80	0.0875000
NODE_105710_length_358_cov_4.239382	218	298	8	14	80	0.1750000
NODE_105710_length_358_cov_4.239382	218	298	10	15	80	0.1875000
NODE_105710_length_358_cov_4.239382	218	298	12	4	80	0.0500000
NODE_105710_length_358_cov_4.239382	218	298	14	2	80	0.0250000
NODE_105710_length_358_cov_4.239382	218	298	16	7	80	0.0875000
NODE_105846_length_358_cov_2.162162	229	305	0	35	76	0.4605263
NODE_105846_length_358_cov_2.162162	229	305	1	18	76	0.2368421
NODE_105846_length_358_cov_2.162162	229	305	3	23	76	0.3026316
NODE_105902_length_358_cov_1.926641	290	358	0	68	68	1.0000000
NODE_105910_length_358_cov_1.884170	250	317	2	67	67	1.0000000
NODE_105923_length_358_cov_1.841699	189	269	22	2	80	0.0250000
NODE_105923_length_358_cov_1.841699	189	269	24	4	80	0.0500000
NODE_105923_length_358_cov_1.841699	189	269	26	1	80	0.0125000
NODE_105923_length_358_cov_1.841699	189	269	28	1	80	0.0125000
NODE_105923_length_358_cov_1.841699	189	269	30	2	80	0.0250000
NODE_105923_length_358_cov_1.841699	189	269	32	1	80	0.0125000
NODE_105923_length_358_cov_1.841699	189	269	34	3	80	0.0375000
NODE_105923_length_358_cov_1.841699	189	269	36	6	80	0.0750000
NODE_105923_length_358_cov_1.841699	189	269	38	4	80	0.0500000
NODE_105923_length_358_cov_1.841699	189	269	39	12	80	0.1500000
NODE_105923_length_358_cov_1.841699	189	269	42	1	80	0.0125000
NODE_105923_length_358_cov_1.841699	189	269	43	5	80	0.0625000
NODE_105923_length_358_cov_1.841699	189	269	45	32	80	0.4000000
NODE_105923_length_358_cov_1.841699	189	269	47	6	80	0.0750000
NODE_106096_length_358_cov_1.235521	99	179	8	4	80	0.0500000
NODE_106096_length_358_cov_1.235521	99	179	10	2	80	0.0250000
NODE_106096_length_358_cov_1.235521	99	179	12	16	80	0.2000000
NODE_106096_length_358_cov_1.235521	99	179	14	6	80	0.0750000
NODE_106096_length_358_cov_1.235521	99	179	16	5	80	0.0625000
NODE_106096_length_358_cov_1.235521	99	179	19	1	80	0.0125000
NODE_106096_length_358_cov_1.235521	99	179	20	2	80	0.0250000
NODE_106096_length_358_cov_1.235521	99	179	22	1	80	0.0125000
NODE_106096_length_358_cov_1.235521	99	179	24	26	80	0.3250000
NODE_106096_length_358_cov_1.235521	99	179	26	17	80	0.2125000
NODE_106096_length_358_cov_1.235521	152	222	0	25	70	0.3571429
NODE_106096_length_358_cov_1.235521	152	222	2	7	70	0.1000000
NODE_106096_length_358_cov_1.235521	152	222	4	6	70	0.0857143
NODE_106096_length_358_cov_1.235521	152	222	6	3	70	0.0428571
NODE_106096_length_358_cov_1.235521	152	222	8	6	70	0.0857143
NODE_106096_length_358_cov_1.235521	152	222	10	2	70	0.0285714
NODE_106096_length_358_cov_1.235521	152	222	12	16	70	0.2285714
NODE_106096_length_358_cov_1.235521	152	222	14	5	70	0.0714286
NODE_106189_length_358_cov_1.096525	148	228	0	80	80	1.0000000
NODE_106233_length_358_cov_0.984556	193	265	0	72	72	1.0000000
NODE_106489_length_357_cov_381.833333	244	324	104	1	80	0.0125000
NODE_106489_length_357_cov_381.833333	244	324	106	3	80	0.0375000
NODE_106489_length_357_cov_381.833333	244	324	112	6	80	0.0750000
NODE_106489_length_357_cov_381.833333	244	324	116	1	80	0.0125000
NODE_106489_length_357_cov_381.833333	244	324	118	1	80	0.0125000
NODE_106489_length_357_cov_381.833333	244	324	132	1	80	0.0125000
NODE_106489_length_357_cov_381.833333	244	324	134	5	80	0.0625000
NODE_106489_length_357_cov_381.833333	244	324	138	2	80	0.0250000
NODE_106489_length_357_cov_381.833333	244	324	140	4	80	0.0500000
NODE_106489_length_357_cov_381.833333	244	324	142	1	80	0.0125000
NODE_106489_length_357_cov_381.833333	244	324	144	1	80	0.0125000
NODE_106489_length_357_cov_381.833333	244	324	146	1	80	0.0125000
NODE_106489_length_357_cov_381.833333	244	324	148	1	80	0.0125000
NODE_106489_length_357_cov_381.833333	244	324	151	6	80	0.0750000
NODE_106489_length_357_cov_381.833333	244	324	152	18	80	0.2250000
NODE_106489_length_357_cov_381.833333	244	324	153	28	80	0.3500000
NODE_106493_length_357_cov_7.643411	45	125	0	69	80	0.8625000
NODE_106493_length_357_cov_7.643411	45	125	2	11	80	0.1375000
NODE_106493_length_357_cov_7.643411	98	178	0	16	80	0.2000000
NODE_106493_length_357_cov_7.643411	98	178	2	64	80	0.8000000
NODE_106495_length_357_cov_7.027132	157	237	0	36	80	0.4500000
NODE_106495_length_357_cov_7.027132	157	237	2	44	80	0.5500000
NODE_106495_length_357_cov_7.027132	210	252	0	42	42	1.0000000
NODE_106496_length_357_cov_6.732558	183	263	20	38	80	0.4750000
NODE_106496_length_357_cov_6.732558	183	263	22	42	80	0.5250000
NODE_106529_length_357_cov_4.081395	145	225	0	80	80	1.0000000
NODE_106529_length_357_cov_4.081395	198	271	0	73	73	1.0000000
NODE_106542_length_357_cov_3.724806	192	265	2	62	73	0.8493150
NODE_106542_length_357_cov_3.724806	192	265	3	11	73	0.1506849
NODE_106558_length_357_cov_3.341085	205	285	0	80	80	1.0000000
NODE_106558_length_357_cov_3.341085	258	338	0	80	80	1.0000000
NODE_106625_length_357_cov_2.414729	245	302	0	57	57	1.0000000
NODE_106625_length_357_cov_2.414729	275	355	0	80	80	1.0000000
NODE_106661_length_357_cov_2.174419	250	330	0	80	80	1.0000000
NODE_106666_length_357_cov_2.166667	103	133	0	30	30	1.0000000
NODE_106666_length_357_cov_2.166667	112	133	0	21	21	1.0000000
NODE_106702_length_357_cov_1.961240	150	169	0	19	19	1.0000000
NODE_106708_length_357_cov_1.918605	173	253	15	1	80	0.0125000
NODE_106708_length_357_cov_1.918605	173	253	17	1	80	0.0125000
NODE_106708_length_357_cov_1.918605	173	253	19	11	80	0.1375000
NODE_106708_length_357_cov_1.918605	173	253	20	1	80	0.0125000
NODE_106708_length_357_cov_1.918605	173	253	24	8	80	0.1000000
NODE_106708_length_357_cov_1.918605	173	253	25	7	80	0.0875000
NODE_106708_length_357_cov_1.918605	173	253	26	3	80	0.0375000
NODE_106708_length_357_cov_1.918605	173	253	29	14	80	0.1750000
NODE_106708_length_357_cov_1.918605	173	253	30	19	80	0.2375000
NODE_106708_length_357_cov_1.918605	173	253	32	9	80	0.1125000
NODE_106708_length_357_cov_1.918605	173	253	38	6	80	0.0750000
NODE_106737_length_357_cov_1.782946	73	142	0	47	69	0.6811594
NODE_106737_length_357_cov_1.782946	73	142	2	22	69	0.3188406
NODE_106737_length_357_cov_1.782946	115	195	0	5	80	0.0625000
NODE_106737_length_357_cov_1.782946	115	195	2	75	80	0.9375000
NODE_107002_length_357_cov_1.127907	98	129	6	1	31	0.0322581
NODE_107002_length_357_cov_1.127907	98	129	8	30	31	0.9677419
NODE_107306_length_356_cov_5.299611	140	200	10	5	60	0.0833333
NODE_107306_length_356_cov_5.299611	140	200	12	55	60	0.9166667
NODE_107347_length_356_cov_3.400778	255	317	6	16	62	0.2580645
NODE_107347_length_356_cov_3.400778	255	317	8	46	62	0.7419355
NODE_107347_length_356_cov_3.400778	308	353	0	12	45	0.2666667
NODE_107347_length_356_cov_3.400778	308	353	4	1	45	0.0222222
NODE_107347_length_356_cov_3.400778	308	353	6	32	45	0.7111111
NODE_107402_length_356_cov_2.657588	256	298	76	5	42	0.1190476
NODE_107402_length_356_cov_2.657588	256	298	77	13	42	0.3095238
NODE_107402_length_356_cov_2.657588	256	298	78	5	42	0.1190476
NODE_107402_length_356_cov_2.657588	256	298	79	10	42	0.2380952
NODE_107402_length_356_cov_2.657588	256	298	80	9	42	0.2142857
NODE_107402_length_356_cov_2.657588	265	338	23	1	73	0.0136986
NODE_107402_length_356_cov_2.657588	265	338	25	1	73	0.0136986
NODE_107402_length_356_cov_2.657588	265	338	30	1	73	0.0136986
NODE_107402_length_356_cov_2.657588	265	338	31	2	73	0.0273973
NODE_107402_length_356_cov_2.657588	265	338	33	3	73	0.0410959
NODE_107402_length_356_cov_2.657588	265	338	37	1	73	0.0136986
NODE_107402_length_356_cov_2.657588	265	338	39	1	73	0.0136986
NODE_107402_length_356_cov_2.657588	265	338	45	1	73	0.0136986
NODE_107402_length_356_cov_2.657588	265	338	46	1	73	0.0136986
NODE_107402_length_356_cov_2.657588	265	338	48	1	73	0.0136986
NODE_107402_length_356_cov_2.657588	265	338	50	1	73	0.0136986
NODE_107402_length_356_cov_2.657588	265	338	57	1	73	0.0136986
NODE_107402_length_356_cov_2.657588	265	338	58	3	73	0.0410959
NODE_107402_length_356_cov_2.657588	265	338	62	3	73	0.0410959
NODE_107402_length_356_cov_2.657588	265	338	66	1	73	0.0136986
NODE_107402_length_356_cov_2.657588	265	338	68	3	73	0.0410959
NODE_107402_length_356_cov_2.657588	265	338	70	4	73	0.0547945
NODE_107402_length_356_cov_2.657588	265	338	73	1	73	0.0136986
NODE_107402_length_356_cov_2.657588	265	338	74	6	73	0.0821918
NODE_107402_length_356_cov_2.657588	265	338	75	2	73	0.0273973
NODE_107402_length_356_cov_2.657588	265	338	76	2	73	0.0273973
NODE_107402_length_356_cov_2.657588	265	338	77	15	73	0.2054795
NODE_107402_length_356_cov_2.657588	265	338	78	2	73	0.0273973
NODE_107402_length_356_cov_2.657588	265	338	79	7	73	0.0958904
NODE_107402_length_356_cov_2.657588	265	338	80	9	73	0.1232877
NODE_107402_length_356_cov_2.657588	299	351	10	1	52	0.0192308
NODE_107402_length_356_cov_2.657588	299	351	11	1	52	0.0192308
NODE_107402_length_356_cov_2.657588	299	351	13	2	52	0.0384615
NODE_107402_length_356_cov_2.657588	299	351	14	1	52	0.0192308
NODE_107402_length_356_cov_2.657588	299	351	18	3	52	0.0576923
NODE_107402_length_356_cov_2.657588	299	351	22	1	52	0.0192308
NODE_107402_length_356_cov_2.657588	299	351	23	5	52	0.0961538
NODE_107402_length_356_cov_2.657588	299	351	25	1	52	0.0192308
NODE_107402_length_356_cov_2.657588	299	351	30	1	52	0.0192308
NODE_107402_length_356_cov_2.657588	299	351	31	2	52	0.0384615
NODE_107402_length_356_cov_2.657588	299	351	33	3	52	0.0576923
NODE_107402_length_356_cov_2.657588	299	351	37	1	52	0.0192308
NODE_107402_length_356_cov_2.657588	299	351	39	1	52	0.0192308
NODE_107402_length_356_cov_2.657588	299	351	45	1	52	0.0192308
NODE_107402_length_356_cov_2.657588	299	351	46	1	52	0.0192308
NODE_107402_length_356_cov_2.657588	299	351	48	1	52	0.0192308
NODE_107402_length_356_cov_2.657588	299	351	50	1	52	0.0192308
NODE_107402_length_356_cov_2.657588	299	351	57	1	52	0.0192308
NODE_107402_length_356_cov_2.657588	299	351	58	3	52	0.0576923
NODE_107402_length_356_cov_2.657588	299	351	62	3	52	0.0576923
NODE_107402_length_356_cov_2.657588	299	351	66	1	52	0.0192308
NODE_107402_length_356_cov_2.657588	299	351	68	3	52	0.0576923
NODE_107402_length_356_cov_2.657588	299	351	70	4	52	0.0769231
NODE_107402_length_356_cov_2.657588	299	351	73	1	52	0.0192308
NODE_107402_length_356_cov_2.657588	299	351	74	6	52	0.1153846
NODE_107402_length_356_cov_2.657588	299	351	75	2	52	0.0384615
NODE_107402_length_356_cov_2.657588	299	351	77	1	52	0.0192308
NODE_107452_length_356_cov_2.237354	90	135	2	8	45	0.1777778
NODE_107452_length_356_cov_2.237354	90	135	4	6	45	0.1333333
NODE_107452_length_356_cov_2.237354	90	135	6	30	45	0.6666667
NODE_107452_length_356_cov_2.237354	90	135	8	1	45	0.0222222
NODE_107475_length_356_cov_1.996109	127	194	0	66	67	0.9850746
NODE_107475_length_356_cov_1.996109	127	194	3	1	67	0.0149254
NODE_107521_length_356_cov_1.813230	296	341	0	45	45	1.0000000
NODE_107606_length_356_cov_1.560311	192	272	0	12	80	0.1500000
NODE_107606_length_356_cov_1.560311	192	272	2	17	80	0.2125000
NODE_107606_length_356_cov_1.560311	192	272	3	11	80	0.1375000
NODE_107606_length_356_cov_1.560311	192	272	5	3	80	0.0375000
NODE_107606_length_356_cov_1.560311	192	272	7	37	80	0.4625000
NODE_107606_length_356_cov_1.560311	245	319	0	59	74	0.7972973
NODE_107606_length_356_cov_1.560311	245	319	2	15	74	0.2027027
NODE_108122_length_355_cov_6.796875	127	173	0	46	46	1.0000000
NODE_108210_length_355_cov_2.734375	111	162	0	51	51	1.0000000
NODE_108210_length_355_cov_2.734375	142	222	0	80	80	1.0000000
NODE_108215_length_355_cov_2.707031	277	314	5	4	37	0.1081081
NODE_108215_length_355_cov_2.707031	277	314	6	33	37	0.8918919
NODE_108215_length_355_cov_2.707031	287	353	2	19	66	0.2878788
NODE_108215_length_355_cov_2.707031	287	353	4	6	66	0.0909091
NODE_108215_length_355_cov_2.707031	287	353	5	18	66	0.2727273
NODE_108215_length_355_cov_2.707031	287	353	6	23	66	0.3484848
NODE_108239_length_355_cov_2.500000	38	82	12	16	44	0.3636364
NODE_108239_length_355_cov_2.500000	38	82	14	28	44	0.6363636
NODE_108278_length_355_cov_2.207031	258	308	0	50	50	1.0000000
NODE_108284_length_355_cov_2.179688	153	233	0	8	80	0.1000000
NODE_108284_length_355_cov_2.179688	153	233	1	63	80	0.7875000
NODE_108284_length_355_cov_2.179688	153	233	2	9	80	0.1125000
NODE_108284_length_355_cov_2.179688	206	286	0	37	80	0.4625000
NODE_108284_length_355_cov_2.179688	206	286	1	19	80	0.2375000
NODE_108284_length_355_cov_2.179688	206	286	2	24	80	0.3000000
NODE_108291_length_355_cov_2.132812	261	334	0	73	73	1.0000000
NODE_108291_length_355_cov_2.132812	301	342	0	41	41	1.0000000
NODE_108315_length_355_cov_2.007812	281	347	2	66	66	1.0000000
NODE_108395_length_355_cov_1.765625	186	247	6	20	61	0.3278688
NODE_108395_length_355_cov_1.765625	186	247	8	25	61	0.4098361
NODE_108395_length_355_cov_1.765625	186	247	10	16	61	0.2622951
NODE_108395_length_355_cov_1.765625	220	300	2	5	80	0.0625000
NODE_108395_length_355_cov_1.765625	220	300	4	16	80	0.2000000
NODE_108395_length_355_cov_1.765625	220	300	6	52	80	0.6500000
NODE_108395_length_355_cov_1.765625	220	300	8	7	80	0.0875000
NODE_109015_length_354_cov_6.843137	53	132	0	79	79	1.0000000
NODE_109015_length_354_cov_6.843137	53	132	0	79	79	1.0000000
NODE_109015_length_354_cov_6.843137	105	185	0	80	80	1.0000000
NODE_109015_length_354_cov_6.843137	105	185	0	80	80	1.0000000
NODE_109033_length_354_cov_4.823529	208	255	0	47	47	1.0000000
NODE_109054_length_354_cov_3.956863	145	208	0	63	63	1.0000000
NODE_109054_length_354_cov_3.956863	181	261	0	80	80	1.0000000
NODE_109057_length_354_cov_3.878431	198	244	1	46	46	1.0000000
NODE_109089_length_354_cov_3.207843	130	199	0	69	69	1.0000000
NODE_109126_length_354_cov_2.725490	179	259	2	29	80	0.3625000
NODE_109126_length_354_cov_2.725490	179	259	8	21	80	0.2625000
NODE_109126_length_354_cov_2.725490	179	259	10	16	80	0.2000000
NODE_109126_length_354_cov_2.725490	179	259	12	14	80	0.1750000
NODE_109126_length_354_cov_2.725490	235	312	10	67	77	0.8701299
NODE_109126_length_354_cov_2.725490	235	312	12	10	77	0.1298701
NODE_109128_length_354_cov_2.713725	16	76	2	39	60	0.6500000
NODE_109128_length_354_cov_2.713725	16	76	4	21	60	0.3500000
NODE_109128_length_354_cov_2.713725	90	149	4	59	59	1.0000000
NODE_109140_length_354_cov_2.580392	176	234	0	6	58	0.1034483
NODE_109140_length_354_cov_2.580392	176	234	2	10	58	0.1724138
NODE_109140_length_354_cov_2.580392	176	234	4	23	58	0.3965517
NODE_109140_length_354_cov_2.580392	176	234	6	3	58	0.0517241
NODE_109140_length_354_cov_2.580392	176	234	7	1	58	0.0172414
NODE_109140_length_354_cov_2.580392	176	234	8	3	58	0.0517241
NODE_109140_length_354_cov_2.580392	176	234	10	12	58	0.2068966
NODE_109140_length_354_cov_2.580392	207	251	4	8	44	0.1818182
NODE_109140_length_354_cov_2.580392	207	251	6	3	44	0.0681818
NODE_109140_length_354_cov_2.580392	207	251	7	1	44	0.0227273
NODE_109140_length_354_cov_2.580392	207	251	8	3	44	0.0681818
NODE_109140_length_354_cov_2.580392	207	251	10	29	44	0.6590909
NODE_109237_length_354_cov_1.996078	79	145	0	62	66	0.9393939
NODE_109237_length_354_cov_1.996078	79	145	2	4	66	0.0606061
NODE_109237_length_354_cov_1.996078	118	200	0	23	82	0.2804878
NODE_109237_length_354_cov_1.996078	118	200	2	59	82	0.7195122
NODE_109244_length_354_cov_1.988235	7	77	0	70	70	1.0000000
NODE_109244_length_354_cov_1.988235	64	130	0	48	66	0.7272727
NODE_109244_length_354_cov_1.988235	64	130	2	9	66	0.1363636
NODE_109244_length_354_cov_1.988235	64	130	8	9	66	0.1363636
NODE_109321_length_354_cov_1.682353	99	171	6	8	72	0.1111111
NODE_109321_length_354_cov_1.682353	99	171	8	10	72	0.1388889
NODE_109321_length_354_cov_1.682353	99	171	10	54	72	0.7500000
NODE_109321_length_354_cov_1.682353	144	224	0	18	80	0.2250000
NODE_109321_length_354_cov_1.682353	144	224	2	21	80	0.2625000
NODE_109321_length_354_cov_1.682353	144	224	6	22	80	0.2750000
NODE_109321_length_354_cov_1.682353	144	224	10	19	80	0.2375000
NODE_109852_length_353_cov_11.169291	14	90	0	76	76	1.0000000
NODE_109852_length_353_cov_11.169291	67	143	0	76	76	1.0000000
NODE_109911_length_353_cov_3.874016	220	256	0	36	36	1.0000000
NODE_109911_length_353_cov_3.874016	265	334	0	4	69	0.0579710
NODE_109911_length_353_cov_3.874016	265	334	4	65	69	0.9420290
NODE_109928_length_353_cov_3.488189	200	282	9	1	82	0.0121951
NODE_109928_length_353_cov_3.488189	200	282	12	12	82	0.1463415
NODE_109928_length_353_cov_3.488189	200	282	13	18	82	0.2195122
NODE_109928_length_353_cov_3.488189	200	282	14	15	82	0.1829268
NODE_109928_length_353_cov_3.488189	200	282	16	21	82	0.2560976
NODE_109928_length_353_cov_3.488189	200	282	18	15	82	0.1829268
NODE_109976_length_353_cov_2.826772	8	88	0	41	80	0.5125000
NODE_109976_length_353_cov_2.826772	8	88	2	39	80	0.4875000
NODE_109976_length_353_cov_2.826772	61	120	2	59	59	1.0000000
NODE_110022_length_353_cov_2.417323	260	336	0	76	76	1.0000000
NODE_110610_length_353_cov_0.744094	299	318	0	19	19	1.0000000
NODE_110708_length_352_cov_34.691700	110	203	0	52	93	0.5591398
NODE_110708_length_352_cov_34.691700	110	203	2	39	93	0.4193548
NODE_110708_length_352_cov_34.691700	110	203	17	1	93	0.0107527
NODE_110708_length_352_cov_34.691700	110	203	44	1	93	0.0107527
NODE_110710_length_352_cov_17.944664	20	100	0	80	80	1.0000000
NODE_110710_length_352_cov_17.944664	73	153	0	80	80	1.0000000
NODE_110710_length_352_cov_17.944664	273	352	0	45	79	0.5696203
NODE_110710_length_352_cov_17.944664	273	352	4	20	79	0.2531646
NODE_110710_length_352_cov_17.944664	273	352	6	14	79	0.1772152
NODE_110735_length_352_cov_4.707510	157	237	6	15	80	0.1875000
NODE_110735_length_352_cov_4.707510	157	237	8	15	80	0.1875000
NODE_110735_length_352_cov_4.707510	157	237	12	12	80	0.1500000
NODE_110735_length_352_cov_4.707510	157	237	14	5	80	0.0625000
NODE_110735_length_352_cov_4.707510	157	237	16	2	80	0.0250000
NODE_110735_length_352_cov_4.707510	157	237	18	9	80	0.1125000
NODE_110735_length_352_cov_4.707510	157	237	20	13	80	0.1625000
NODE_110735_length_352_cov_4.707510	157	237	22	9	80	0.1125000
NODE_110749_length_352_cov_4.221344	144	205	0	61	61	1.0000000
NODE_110749_length_352_cov_4.221344	178	259	0	81	81	1.0000000
NODE_110754_length_352_cov_4.011858	98	143	0	45	45	1.0000000
NODE_110754_length_352_cov_4.011858	151	228	0	77	77	1.0000000
NODE_110798_length_352_cov_2.849802	74	154	0	1	80	0.0125000
NODE_110798_length_352_cov_2.849802	74	154	2	18	80	0.2250000
NODE_110798_length_352_cov_2.849802	74	154	4	61	80	0.7625000
NODE_110798_length_352_cov_2.849802	127	198	0	12	71	0.1690141
NODE_110798_length_352_cov_2.849802	127	198	2	33	71	0.4647887
NODE_110798_length_352_cov_2.849802	127	198	4	26	71	0.3661972
NODE_110820_length_352_cov_2.683794	0	77	0	43	77	0.5584416
NODE_110820_length_352_cov_2.683794	0	77	2	4	77	0.0519481
NODE_110820_length_352_cov_2.683794	0	77	4	3	77	0.0389610
NODE_110820_length_352_cov_2.683794	0	77	6	6	77	0.0779221
NODE_110820_length_352_cov_2.683794	0	77	8	21	77	0.2727273
NODE_110820_length_352_cov_2.683794	50	130	6	6	80	0.0750000
NODE_110820_length_352_cov_2.683794	50	130	8	74	80	0.9250000
NODE_110832_length_352_cov_2.608696	90	136	0	46	46	1.0000000
NODE_110832_length_352_cov_2.608696	144	189	0	45	45	1.0000000
NODE_110838_length_352_cov_2.577075	111	191	2	51	80	0.6375000
NODE_110838_length_352_cov_2.577075	111	191	4	29	80	0.3625000
NODE_110876_length_352_cov_2.264822	171	251	0	80	80	1.0000000
NODE_110938_length_352_cov_2.007905	277	326	0	49	49	1.0000000
NODE_111439_length_352_cov_0.806324	165	238	32	2	73	0.0273973
NODE_111439_length_352_cov_0.806324	165	238	34	2	73	0.0273973
NODE_111439_length_352_cov_0.806324	165	238	40	1	73	0.0136986
NODE_111439_length_352_cov_0.806324	165	238	45	5	73	0.0684932
NODE_111439_length_352_cov_0.806324	165	238	49	1	73	0.0136986
NODE_111439_length_352_cov_0.806324	165	238	53	1	73	0.0136986
NODE_111439_length_352_cov_0.806324	165	238	59	1	73	0.0136986
NODE_111439_length_352_cov_0.806324	165	238	61	1	73	0.0136986
NODE_111439_length_352_cov_0.806324	165	238	62	1	73	0.0136986
NODE_111439_length_352_cov_0.806324	165	238	63	1	73	0.0136986
NODE_111439_length_352_cov_0.806324	165	238	69	1	73	0.0136986
NODE_111439_length_352_cov_0.806324	165	238	76	2	73	0.0273973
NODE_111439_length_352_cov_0.806324	165	238	80	1	73	0.0136986
NODE_111439_length_352_cov_0.806324	165	238	81	4	73	0.0547945
NODE_111439_length_352_cov_0.806324	165	238	85	1	73	0.0136986
NODE_111439_length_352_cov_0.806324	165	238	86	1	73	0.0136986
NODE_111439_length_352_cov_0.806324	165	238	87	1	73	0.0136986
NODE_111439_length_352_cov_0.806324	165	238	89	1	73	0.0136986
NODE_111439_length_352_cov_0.806324	165	238	91	2	73	0.0273973
NODE_111439_length_352_cov_0.806324	165	238	106	1	73	0.0136986
NODE_111439_length_352_cov_0.806324	165	238	112	1	73	0.0136986
NODE_111439_length_352_cov_0.806324	165	238	113	1	73	0.0136986
NODE_111439_length_352_cov_0.806324	165	238	114	1	73	0.0136986
NODE_111439_length_352_cov_0.806324	165	238	116	1	73	0.0136986
NODE_111439_length_352_cov_0.806324	165	238	121	1	73	0.0136986
NODE_111439_length_352_cov_0.806324	165	238	125	2	73	0.0273973
NODE_111439_length_352_cov_0.806324	165	238	127	12	73	0.1643836
NODE_111439_length_352_cov_0.806324	165	238	131	4	73	0.0547945
NODE_111439_length_352_cov_0.806324	165	238	133	1	73	0.0136986
NODE_111439_length_352_cov_0.806324	165	238	140	2	73	0.0273973
NODE_111439_length_352_cov_0.806324	165	238	142	1	73	0.0136986
NODE_111439_length_352_cov_0.806324	165	238	144	1	73	0.0136986
NODE_111439_length_352_cov_0.806324	165	238	146	2	73	0.0273973
NODE_111439_length_352_cov_0.806324	165	238	152	2	73	0.0273973
NODE_111439_length_352_cov_0.806324	165	238	153	1	73	0.0136986
NODE_111439_length_352_cov_0.806324	165	238	155	2	73	0.0273973
NODE_111439_length_352_cov_0.806324	165	238	161	7	73	0.0958904
NODE_111593_length_351_cov_5.003968	115	195	2	6	80	0.0750000
NODE_111593_length_351_cov_5.003968	115	195	4	54	80	0.6750000
NODE_111593_length_351_cov_5.003968	115	195	6	20	80	0.2500000
NODE_111662_length_351_cov_2.900794	289	320	0	31	31	1.0000000
NODE_111738_length_351_cov_2.376984	79	159	2	22	80	0.2750000
NODE_111738_length_351_cov_2.376984	79	159	4	56	80	0.7000000
NODE_111738_length_351_cov_2.376984	79	159	6	2	80	0.0250000
NODE_111759_length_351_cov_2.226190	116	170	18	30	54	0.5555556
NODE_111759_length_351_cov_2.226190	116	170	20	24	54	0.4444444
NODE_111769_length_351_cov_2.186508	198	277	0	41	79	0.5189874
NODE_111769_length_351_cov_2.186508	198	277	2	38	79	0.4810127
NODE_111861_length_351_cov_1.809524	276	309	0	31	33	0.9393939
NODE_111861_length_351_cov_1.809524	276	309	2	2	33	0.0606061
NODE_111969_length_351_cov_1.515873	228	299	0	71	71	1.0000000
NODE_112493_length_350_cov_232.529880	25	92	81	1	67	0.0149254
NODE_112493_length_350_cov_232.529880	25	92	86	1	67	0.0149254
NODE_112493_length_350_cov_232.529880	25	92	91	1	67	0.0149254
NODE_112493_length_350_cov_232.529880	25	92	93	1	67	0.0149254
NODE_112493_length_350_cov_232.529880	25	92	95	3	67	0.0447761
NODE_112493_length_350_cov_232.529880	25	92	99	2	67	0.0298507
NODE_112493_length_350_cov_232.529880	25	92	101	1	67	0.0149254
NODE_112493_length_350_cov_232.529880	25	92	105	2	67	0.0298507
NODE_112493_length_350_cov_232.529880	25	92	107	1	67	0.0149254
NODE_112493_length_350_cov_232.529880	25	92	123	1	67	0.0149254
NODE_112493_length_350_cov_232.529880	25	92	131	1	67	0.0149254
NODE_112493_length_350_cov_232.529880	25	92	133	2	67	0.0298507
NODE_112493_length_350_cov_232.529880	25	92	137	1	67	0.0149254
NODE_112493_length_350_cov_232.529880	25	92	139	2	67	0.0298507
NODE_112493_length_350_cov_232.529880	25	92	141	1	67	0.0149254
NODE_112493_length_350_cov_232.529880	25	92	143	1	67	0.0149254
NODE_112493_length_350_cov_232.529880	25	92	149	2	67	0.0298507
NODE_112493_length_350_cov_232.529880	25	92	152	1	67	0.0149254
NODE_112493_length_350_cov_232.529880	25	92	155	2	67	0.0298507
NODE_112493_length_350_cov_232.529880	25	92	161	2	67	0.0298507
NODE_112493_length_350_cov_232.529880	25	92	168	1	67	0.0149254
NODE_112493_length_350_cov_232.529880	25	92	180	1	67	0.0149254
NODE_112493_length_350_cov_232.529880	25	92	190	1	67	0.0149254
NODE_112493_length_350_cov_232.529880	25	92	197	1	67	0.0149254
NODE_112493_length_350_cov_232.529880	25	92	202	1	67	0.0149254
NODE_112493_length_350_cov_232.529880	25	92	204	1	67	0.0149254
NODE_112493_length_350_cov_232.529880	25	92	208	1	67	0.0149254
NODE_112493_length_350_cov_232.529880	25	92	210	3	67	0.0447761
NODE_112493_length_350_cov_232.529880	25	92	215	1	67	0.0149254
NODE_112493_length_350_cov_232.529880	25	92	217	5	67	0.0746269
NODE_112493_length_350_cov_232.529880	25	92	218	1	67	0.0149254
NODE_112493_length_350_cov_232.529880	25	92	219	2	67	0.0298507
NODE_112493_length_350_cov_232.529880	25	92	221	1	67	0.0149254
NODE_112493_length_350_cov_232.529880	25	92	223	1	67	0.0149254
NODE_112493_length_350_cov_232.529880	25	92	227	2	67	0.0298507
NODE_112493_length_350_cov_232.529880	25	92	231	3	67	0.0447761
NODE_112493_length_350_cov_232.529880	25	92	235	6	67	0.0895522
NODE_112493_length_350_cov_232.529880	25	92	237	2	67	0.0298507
NODE_112493_length_350_cov_232.529880	25	92	238	1	67	0.0149254
NODE_112493_length_350_cov_232.529880	25	92	241	1	67	0.0149254
NODE_112493_length_350_cov_232.529880	25	92	242	2	67	0.0298507
NODE_112494_length_350_cov_40.677291	181	246	14	1	65	0.0153846
NODE_112494_length_350_cov_40.677291	181	246	16	22	65	0.3384615
NODE_112494_length_350_cov_40.677291	181	246	18	19	65	0.2923077
NODE_112494_length_350_cov_40.677291	181	246	20	11	65	0.1692308
NODE_112494_length_350_cov_40.677291	181	246	22	6	65	0.0923077
NODE_112494_length_350_cov_40.677291	181	246	24	6	65	0.0923077
NODE_112535_length_350_cov_4.179283	114	194	2	33	80	0.4125000
NODE_112535_length_350_cov_4.179283	114	194	6	32	80	0.4000000
NODE_112535_length_350_cov_4.179283	114	194	8	15	80	0.1875000
NODE_112535_length_350_cov_4.179283	167	244	6	12	77	0.1558442
NODE_112535_length_350_cov_4.179283	167	244	8	22	77	0.2857143
NODE_112535_length_350_cov_4.179283	167	244	9	1	77	0.0129870
NODE_112535_length_350_cov_4.179283	167	244	10	19	77	0.2467532
NODE_112535_length_350_cov_4.179283	167	244	12	1	77	0.0129870
NODE_112535_length_350_cov_4.179283	167	244	14	22	77	0.2857143
NODE_112554_length_350_cov_3.573705	128	202	12	33	74	0.4459459
NODE_112554_length_350_cov_3.573705	128	202	29	2	74	0.0270270
NODE_112554_length_350_cov_3.573705	128	202	30	1	74	0.0135135
NODE_112554_length_350_cov_3.573705	128	202	32	2	74	0.0270270
NODE_112554_length_350_cov_3.573705	128	202	35	1	74	0.0135135
NODE_112554_length_350_cov_3.573705	128	202	37	12	74	0.1621622
NODE_112554_length_350_cov_3.573705	128	202	38	4	74	0.0540541
NODE_112554_length_350_cov_3.573705	128	202	40	8	74	0.1081081
NODE_112554_length_350_cov_3.573705	128	202	42	3	74	0.0405405
NODE_112554_length_350_cov_3.573705	128	202	46	8	74	0.1081081
NODE_112554_length_350_cov_3.573705	178	241	1	12	63	0.1904762
NODE_112554_length_350_cov_3.573705	178	241	2	1	63	0.0158730
NODE_112554_length_350_cov_3.573705	178	241	4	8	63	0.1269841
NODE_112554_length_350_cov_3.573705	178	241	12	42	63	0.6666667
NODE_112627_length_350_cov_2.478088	266	297	0	31	31	1.0000000
NODE_112647_length_350_cov_2.346614	97	148	78	3	51	0.0588235
NODE_112647_length_350_cov_2.346614	97	148	81	1	51	0.0196078
NODE_112647_length_350_cov_2.346614	97	148	82	1	51	0.0196078
NODE_112647_length_350_cov_2.346614	97	148	83	9	51	0.1764706
NODE_112647_length_350_cov_2.346614	97	148	84	1	51	0.0196078
NODE_112647_length_350_cov_2.346614	97	148	85	4	51	0.0784314
NODE_112647_length_350_cov_2.346614	97	148	87	5	51	0.0980392
NODE_112647_length_350_cov_2.346614	97	148	92	2	51	0.0392157
NODE_112647_length_350_cov_2.346614	97	148	93	7	51	0.1372549
NODE_112647_length_350_cov_2.346614	97	148	94	1	51	0.0196078
NODE_112647_length_350_cov_2.346614	97	148	96	1	51	0.0196078
NODE_112647_length_350_cov_2.346614	97	148	98	3	51	0.0588235
NODE_112647_length_350_cov_2.346614	97	148	100	3	51	0.0588235
NODE_112647_length_350_cov_2.346614	97	148	102	10	51	0.1960784
NODE_112714_length_350_cov_2.031873	181	238	16	8	57	0.1403509
NODE_112714_length_350_cov_2.031873	181	238	18	4	57	0.0701754
NODE_112714_length_350_cov_2.031873	181	238	22	7	57	0.1228070
NODE_112714_length_350_cov_2.031873	181	238	24	10	57	0.1754386
NODE_112714_length_350_cov_2.031873	181	238	26	6	57	0.1052632
NODE_112714_length_350_cov_2.031873	181	238	28	5	57	0.0877193
NODE_112714_length_350_cov_2.031873	181	238	30	1	57	0.0175439
NODE_112714_length_350_cov_2.031873	181	238	32	16	57	0.2807018
NODE_112997_length_350_cov_1.223108	202	275	0	37	73	0.5068493
NODE_112997_length_350_cov_1.223108	202	275	11	4	73	0.0547945
NODE_112997_length_350_cov_1.223108	202	275	13	6	73	0.0821918
NODE_112997_length_350_cov_1.223108	202	275	17	7	73	0.0958904
NODE_112997_length_350_cov_1.223108	202	275	19	8	73	0.1095890
NODE_112997_length_350_cov_1.223108	202	275	21	3	73	0.0410959
NODE_112997_length_350_cov_1.223108	202	275	23	8	73	0.1095890
NODE_113450_length_349_cov_4.268000	83	163	0	80	80	1.0000000
NODE_113450_length_349_cov_4.268000	83	163	0	80	80	1.0000000
NODE_113450_length_349_cov_4.268000	136	216	0	80	80	1.0000000
NODE_113450_length_349_cov_4.268000	145	180	0	35	35	1.0000000
NODE_113473_length_349_cov_3.648000	219	300	1	5	81	0.0617284
NODE_113473_length_349_cov_3.648000	219	300	3	1	81	0.0123457
NODE_113473_length_349_cov_3.648000	219	300	7	8	81	0.0987654
NODE_113473_length_349_cov_3.648000	219	300	8	13	81	0.1604938
NODE_113473_length_349_cov_3.648000	219	300	10	7	81	0.0864198
NODE_113473_length_349_cov_3.648000	219	300	12	47	81	0.5802469
NODE_113480_length_349_cov_3.484000	196	276	2	6	80	0.0750000
NODE_113480_length_349_cov_3.484000	196	276	4	2	80	0.0250000
NODE_113480_length_349_cov_3.484000	196	276	6	3	80	0.0375000
NODE_113480_length_349_cov_3.484000	196	276	8	1	80	0.0125000
NODE_113480_length_349_cov_3.484000	196	276	10	1	80	0.0125000
NODE_113480_length_349_cov_3.484000	196	276	12	27	80	0.3375000
NODE_113480_length_349_cov_3.484000	196	276	14	7	80	0.0875000
NODE_113480_length_349_cov_3.484000	196	276	16	5	80	0.0625000
NODE_113480_length_349_cov_3.484000	196	276	18	12	80	0.1500000
NODE_113480_length_349_cov_3.484000	196	276	20	16	80	0.2000000
NODE_113486_length_349_cov_3.364000	219	284	4	5	65	0.0769231
NODE_113486_length_349_cov_3.364000	219	284	6	60	65	0.9230769
NODE_113511_length_349_cov_2.916000	94	189	0	6	95	0.0631579
NODE_113511_length_349_cov_2.916000	94	189	2	24	95	0.2526316
NODE_113511_length_349_cov_2.916000	94	189	3	11	95	0.1157895
NODE_113511_length_349_cov_2.916000	94	189	4	3	95	0.0315789
NODE_113511_length_349_cov_2.916000	94	189	6	3	95	0.0315789
NODE_113511_length_349_cov_2.916000	94	189	8	7	95	0.0736842
NODE_113511_length_349_cov_2.916000	94	189	10	41	95	0.4315789
NODE_113571_length_349_cov_2.420000	35	54	0	19	19	1.0000000
NODE_113647_length_349_cov_1.964000	32	63	0	31	31	1.0000000
NODE_113654_length_349_cov_1.928000	9	77	0	68	68	1.0000000
NODE_113654_length_349_cov_1.928000	62	115	0	53	53	1.0000000
NODE_113710_length_349_cov_1.684000	225	265	2	26	40	0.6500000
NODE_113710_length_349_cov_1.684000	225	265	6	4	40	0.1000000
NODE_113710_length_349_cov_1.684000	225	265	8	2	40	0.0500000
NODE_113710_length_349_cov_1.684000	225	265	10	1	40	0.0250000
NODE_113710_length_349_cov_1.684000	225	265	12	5	40	0.1250000
NODE_113710_length_349_cov_1.684000	225	265	20	1	40	0.0250000
NODE_113710_length_349_cov_1.684000	225	265	22	1	40	0.0250000
NODE_113825_length_349_cov_1.392000	32	95	0	3	63	0.0476190
NODE_113825_length_349_cov_1.392000	32	95	2	60	63	0.9523810
NODE_113961_length_349_cov_1.056000	316	339	2	23	23	1.0000000
NODE_114002_length_349_cov_1.020000	177	257	2	4	80	0.0500000
NODE_114002_length_349_cov_1.020000	177	257	3	17	80	0.2125000
NODE_114002_length_349_cov_1.020000	177	257	4	18	80	0.2250000
NODE_114002_length_349_cov_1.020000	177	257	5	6	80	0.0750000
NODE_114002_length_349_cov_1.020000	177	257	6	35	80	0.4375000
NODE_114263_length_348_cov_34.867470	156	236	0	50	80	0.6250000
NODE_114263_length_348_cov_34.867470	156	236	2	1	80	0.0125000
NODE_114263_length_348_cov_34.867470	156	236	4	29	80	0.3625000
NODE_114263_length_348_cov_34.867470	209	289	0	35	80	0.4375000
NODE_114263_length_348_cov_34.867470	209	289	4	45	80	0.5625000
NODE_114296_length_348_cov_4.180723	106	186	0	80	80	1.0000000
NODE_114296_length_348_cov_4.180723	159	239	0	80	80	1.0000000
NODE_114330_length_348_cov_3.277108	83	137	0	54	54	1.0000000
NODE_114330_length_348_cov_3.277108	145	197	0	52	52	1.0000000
NODE_114424_length_348_cov_2.305221	204	273	0	37	69	0.5362319
NODE_114424_length_348_cov_2.305221	204	273	2	14	69	0.2028985
NODE_114424_length_348_cov_2.305221	204	273	4	18	69	0.2608696
NODE_114448_length_348_cov_2.216867	103	152	0	3	49	0.0612245
NODE_114448_length_348_cov_2.216867	103	152	2	46	49	0.9387755
NODE_114505_length_348_cov_1.995984	170	239	0	38	69	0.5507246
NODE_114505_length_348_cov_1.995984	170	239	2	30	69	0.4347826
NODE_114505_length_348_cov_1.995984	170	239	4	1	69	0.0144928
NODE_114591_length_348_cov_1.638554	309	346	0	37	37	1.0000000
NODE_114643_length_348_cov_1.485944	9	60	0	4	51	0.0784314
NODE_114643_length_348_cov_1.485944	9	60	2	3	51	0.0588235
NODE_114643_length_348_cov_1.485944	9	60	4	2	51	0.0392157
NODE_114643_length_348_cov_1.485944	9	60	6	42	51	0.8235294
NODE_115147_length_347_cov_15.100806	57	137	4	80	80	1.0000000
NODE_115147_length_347_cov_15.100806	110	152	4	42	42	1.0000000
NODE_115147_length_347_cov_15.100806	182	209	0	27	27	1.0000000
NODE_115147_length_347_cov_15.100806	290	317	0	27	27	1.0000000
NODE_115161_length_347_cov_5.967742	110	173	2	63	63	1.0000000
NODE_115195_length_347_cov_4.028226	260	329	0	69	69	1.0000000
NODE_115321_length_347_cov_2.463710	99	141	0	13	42	0.3095238
NODE_115321_length_347_cov_2.463710	99	141	2	29	42	0.6904762
NODE_115321_length_347_cov_2.463710	108	143	0	5	35	0.1428571
NODE_115321_length_347_cov_2.463710	108	143	2	30	35	0.8571429
NODE_115331_length_347_cov_2.391129	35	70	2	13	35	0.3714286
NODE_115331_length_347_cov_2.391129	35	70	4	22	35	0.6285715
NODE_115331_length_347_cov_2.391129	37	79	2	11	42	0.2619048
NODE_115331_length_347_cov_2.391129	37	79	4	31	42	0.7380952
NODE_115331_length_347_cov_2.391129	77	105	4	28	28	1.0000000
NODE_115397_length_347_cov_2.048387	15	34	0	19	19	1.0000000
NODE_115417_length_347_cov_1.967742	205	268	0	63	63	1.0000000
NODE_115450_length_347_cov_1.818548	109	156	0	47	47	1.0000000
NODE_115771_length_347_cov_1.028226	230	255	0	25	25	1.0000000
NODE_116114_length_346_cov_74.433198	10	90	0	39	80	0.4875000
NODE_116114_length_346_cov_74.433198	10	90	4	7	80	0.0875000
NODE_116114_length_346_cov_74.433198	10	90	6	34	80	0.4250000
NODE_116114_length_346_cov_74.433198	19	90	0	30	71	0.4225352
NODE_116114_length_346_cov_74.433198	19	90	4	7	71	0.0985916
NODE_116114_length_346_cov_74.433198	19	90	6	34	71	0.4788733
NODE_116114_length_346_cov_74.433198	192	272	8	9	80	0.1125000
NODE_116114_length_346_cov_74.433198	192	272	10	8	80	0.1000000
NODE_116114_length_346_cov_74.433198	192	272	14	53	80	0.6625000
NODE_116114_length_346_cov_74.433198	192	272	16	10	80	0.1250000
NODE_116115_length_346_cov_67.834008	133	213	0	44	80	0.5500000
NODE_116115_length_346_cov_67.834008	133	213	5	36	80	0.4500000
NODE_116115_length_346_cov_67.834008	186	266	5	74	80	0.9250000
NODE_116115_length_346_cov_67.834008	186	266	6	6	80	0.0750000
NODE_116117_length_346_cov_10.299595	190	270	0	80	80	1.0000000
NODE_116117_length_346_cov_10.299595	243	323	0	80	80	1.0000000
NODE_116119_length_346_cov_9.566802	159	239	2	36	80	0.4500000
NODE_116119_length_346_cov_9.566802	159	239	4	1	80	0.0125000
NODE_116119_length_346_cov_9.566802	159	239	6	36	80	0.4500000
NODE_116119_length_346_cov_9.566802	159	239	8	2	80	0.0250000
NODE_116119_length_346_cov_9.566802	159	239	10	5	80	0.0625000
NODE_116119_length_346_cov_9.566802	212	292	2	28	80	0.3500000
NODE_116119_length_346_cov_9.566802	212	292	4	1	80	0.0125000
NODE_116119_length_346_cov_9.566802	212	292	6	3	80	0.0375000
NODE_116119_length_346_cov_9.566802	212	292	9	1	80	0.0125000
NODE_116119_length_346_cov_9.566802	212	292	10	47	80	0.5875000
NODE_116134_length_346_cov_5.506073	157	238	6	2	81	0.0246914
NODE_116134_length_346_cov_5.506073	157	238	8	26	81	0.3209876
NODE_116134_length_346_cov_5.506073	157	238	10	25	81	0.3086420
NODE_116134_length_346_cov_5.506073	157	238	11	24	81	0.2962963
NODE_116134_length_346_cov_5.506073	157	238	12	4	81	0.0493827
NODE_116155_length_346_cov_4.368421	205	264	0	59	59	1.0000000
NODE_116159_length_346_cov_4.032389	121	141	0	20	20	1.0000000
NODE_116184_length_346_cov_3.400810	194	253	0	59	59	1.0000000
NODE_116212_length_346_cov_3.008097	183	263	0	80	80	1.0000000
NODE_116257_length_346_cov_2.538462	47	102	0	55	55	1.0000000
NODE_116257_length_346_cov_2.538462	118	173	0	55	55	1.0000000
NODE_116439_length_346_cov_1.700405	71	107	0	24	36	0.6666667
NODE_116439_length_346_cov_1.700405	71	107	2	12	36	0.3333333
NODE_117035_length_345_cov_47.699187	0	66	0	66	66	1.0000000
NODE_117035_length_345_cov_47.699187	39	119	0	80	80	1.0000000
NODE_117035_length_345_cov_47.699187	115	182	0	6	67	0.0895522
NODE_117035_length_345_cov_47.699187	115	182	4	13	67	0.1940299
NODE_117035_length_345_cov_47.699187	115	182	6	48	67	0.7164179
NODE_117035_length_345_cov_47.699187	246	311	0	65	65	1.0000000
NODE_117036_length_345_cov_13.439024	28	108	0	80	80	1.0000000
NODE_117036_length_345_cov_13.439024	81	161	0	80	80	1.0000000
NODE_117037_length_345_cov_9.906504	224	283	0	59	59	1.0000000
NODE_117051_length_345_cov_5.475610	52	132	6	54	80	0.6750000
NODE_117051_length_345_cov_5.475610	52	132	8	26	80	0.3250000
NODE_117051_length_345_cov_5.475610	105	185	6	10	80	0.1250000
NODE_117051_length_345_cov_5.475610	105	185	8	23	80	0.2875000
NODE_117051_length_345_cov_5.475610	105	185	10	47	80	0.5875000
NODE_117055_length_345_cov_5.321138	104	152	0	48	48	1.0000000
NODE_117065_length_345_cov_4.524390	205	269	0	64	64	1.0000000
NODE_117075_length_345_cov_4.109756	95	157	3	57	62	0.9193549
NODE_117075_length_345_cov_4.109756	95	157	5	5	62	0.0806452
NODE_117075_length_345_cov_4.109756	162	204	3	42	42	1.0000000
NODE_117076_length_345_cov_4.073171	251	326	0	75	75	1.0000000
NODE_117084_length_345_cov_3.776423	199	273	0	74	74	1.0000000
NODE_117084_length_345_cov_3.776423	246	326	0	80	80	1.0000000
NODE_117148_length_345_cov_2.821138	61	141	2	80	80	1.0000000
NODE_117205_length_345_cov_2.333333	47	90	4	1	43	0.0232558
NODE_117205_length_345_cov_2.333333	47	90	8	1	43	0.0232558
NODE_117205_length_345_cov_2.333333	47	90	10	1	43	0.0232558
NODE_117205_length_345_cov_2.333333	47	90	12	2	43	0.0465116
NODE_117205_length_345_cov_2.333333	47	90	14	1	43	0.0232558
NODE_117205_length_345_cov_2.333333	47	90	16	2	43	0.0465116
NODE_117205_length_345_cov_2.333333	47	90	20	3	43	0.0697674
NODE_117205_length_345_cov_2.333333	47	90	26	4	43	0.0930233
NODE_117205_length_345_cov_2.333333	47	90	28	6	43	0.1395349
NODE_117205_length_345_cov_2.333333	47	90	30	1	43	0.0232558
NODE_117205_length_345_cov_2.333333	47	90	34	4	43	0.0930233
NODE_117205_length_345_cov_2.333333	47	90	38	8	43	0.1860465
NODE_117205_length_345_cov_2.333333	47	90	40	1	43	0.0232558
NODE_117205_length_345_cov_2.333333	47	90	42	1	43	0.0232558
NODE_117205_length_345_cov_2.333333	47	90	44	2	43	0.0465116
NODE_117205_length_345_cov_2.333333	47	90	46	5	43	0.1162791
NODE_117205_length_345_cov_2.333333	63	147	28	5	84	0.0595238
NODE_117205_length_345_cov_2.333333	63	147	30	1	84	0.0119048
NODE_117205_length_345_cov_2.333333	63	147	34	4	84	0.0476190
NODE_117205_length_345_cov_2.333333	63	147	38	8	84	0.0952381
NODE_117205_length_345_cov_2.333333	63	147	40	1	84	0.0119048
NODE_117205_length_345_cov_2.333333	63	147	42	8	84	0.0952381
NODE_117205_length_345_cov_2.333333	63	147	44	13	84	0.1547619
NODE_117205_length_345_cov_2.333333	63	147	46	16	84	0.1904762
NODE_117205_length_345_cov_2.333333	63	147	48	16	84	0.1904762
NODE_117205_length_345_cov_2.333333	63	147	50	12	84	0.1428571
NODE_117219_length_345_cov_2.239837	0	81	0	1	81	0.0123457
NODE_117219_length_345_cov_2.239837	0	81	2	1	81	0.0123457
NODE_117219_length_345_cov_2.239837	0	81	4	1	81	0.0123457
NODE_117219_length_345_cov_2.239837	0	81	10	2	81	0.0246914
NODE_117219_length_345_cov_2.239837	0	81	12	2	81	0.0246914
NODE_117219_length_345_cov_2.239837	0	81	14	1	81	0.0123457
NODE_117219_length_345_cov_2.239837	0	81	16	7	81	0.0864198
NODE_117219_length_345_cov_2.239837	0	81	21	1	81	0.0123457
NODE_117219_length_345_cov_2.239837	0	81	22	2	81	0.0246914
NODE_117219_length_345_cov_2.239837	0	81	26	7	81	0.0864198
NODE_117219_length_345_cov_2.239837	0	81	28	6	81	0.0740741
NODE_117219_length_345_cov_2.239837	0	81	30	5	81	0.0617284
NODE_117219_length_345_cov_2.239837	0	81	34	7	81	0.0864198
NODE_117219_length_345_cov_2.239837	0	81	38	15	81	0.1851852
NODE_117219_length_345_cov_2.239837	0	81	40	23	81	0.2839506
NODE_117669_length_345_cov_1.040650	6	73	1	2	67	0.0298507
NODE_117669_length_345_cov_1.040650	6	73	6	1	67	0.0149254
NODE_117669_length_345_cov_1.040650	6	73	9	3	67	0.0447761
NODE_117669_length_345_cov_1.040650	6	73	11	10	67	0.1492537
NODE_117669_length_345_cov_1.040650	6	73	13	8	67	0.1194030
NODE_117669_length_345_cov_1.040650	6	73	17	1	67	0.0149254
NODE_117669_length_345_cov_1.040650	6	73	27	4	67	0.0597015
NODE_117669_length_345_cov_1.040650	6	73	28	4	67	0.0597015
NODE_117669_length_345_cov_1.040650	6	73	34	1	67	0.0149254
NODE_117669_length_345_cov_1.040650	6	73	35	1	67	0.0149254
NODE_117669_length_345_cov_1.040650	6	73	39	21	67	0.3134328
NODE_117669_length_345_cov_1.040650	6	73	41	11	67	0.1641791
NODE_117989_length_344_cov_54.020408	6	55	0	28	49	0.5714286
NODE_117989_length_344_cov_54.020408	6	55	1	21	49	0.4285714
NODE_117989_length_344_cov_54.020408	28	105	0	6	77	0.0779221
NODE_117989_length_344_cov_54.020408	28	105	1	48	77	0.6233766
NODE_117989_length_344_cov_54.020408	28	105	2	23	77	0.2987013
NODE_117989_length_344_cov_54.020408	28	105	0	6	77	0.0779221
NODE_117989_length_344_cov_54.020408	28	105	1	48	77	0.6233766
NODE_117989_length_344_cov_54.020408	28	105	2	23	77	0.2987013
NODE_117989_length_344_cov_54.020408	112	178	2	6	66	0.0909091
NODE_117989_length_344_cov_54.020408	112	178	4	5	66	0.0757576
NODE_117989_length_344_cov_54.020408	112	178	8	15	66	0.2272727
NODE_117989_length_344_cov_54.020408	112	178	10	1	66	0.0151515
NODE_117989_length_344_cov_54.020408	112	178	14	39	66	0.5909091
NODE_118009_length_344_cov_5.016327	72	125	17	3	53	0.0566038
NODE_118009_length_344_cov_5.016327	72	125	18	2	53	0.0377358
NODE_118009_length_344_cov_5.016327	72	125	20	3	53	0.0566038
NODE_118009_length_344_cov_5.016327	72	125	22	3	53	0.0566038
NODE_118009_length_344_cov_5.016327	72	125	26	2	53	0.0377358
NODE_118009_length_344_cov_5.016327	72	125	27	5	53	0.0943396
NODE_118009_length_344_cov_5.016327	72	125	28	1	53	0.0188679
NODE_118009_length_344_cov_5.016327	72	125	30	5	53	0.0943396
NODE_118009_length_344_cov_5.016327	72	125	34	29	53	0.5471698
NODE_118009_length_344_cov_5.016327	136	203	8	10	67	0.1492537
NODE_118009_length_344_cov_5.016327	136	203	10	4	67	0.0597015
NODE_118009_length_344_cov_5.016327	136	203	12	7	67	0.1044776
NODE_118009_length_344_cov_5.016327	136	203	14	1	67	0.0149254
NODE_118009_length_344_cov_5.016327	136	203	16	7	67	0.1044776
NODE_118009_length_344_cov_5.016327	136	203	18	5	67	0.0746269
NODE_118009_length_344_cov_5.016327	136	203	20	12	67	0.1791045
NODE_118009_length_344_cov_5.016327	136	203	22	6	67	0.0895522
NODE_118009_length_344_cov_5.016327	136	203	30	3	67	0.0447761
NODE_118009_length_344_cov_5.016327	136	203	32	12	67	0.1791045
NODE_118017_length_344_cov_4.579592	172	254	0	82	82	1.0000000
NODE_118045_length_344_cov_3.840816	197	240	0	43	43	1.0000000
NODE_118074_length_344_cov_3.293878	149	189	4	22	40	0.5500000
NODE_118074_length_344_cov_3.293878	149	189	8	18	40	0.4500000
NODE_118074_length_344_cov_3.293878	162	229	2	31	67	0.4626866
NODE_118074_length_344_cov_3.293878	162	229	4	31	67	0.4626866
NODE_118074_length_344_cov_3.293878	162	229	8	5	67	0.0746269
NODE_118111_length_344_cov_2.751020	24	87	4	63	63	1.0000000
NODE_118179_length_344_cov_2.126531	274	305	1	2	31	0.0645161
NODE_118179_length_344_cov_2.126531	274	305	2	13	31	0.4193548
NODE_118179_length_344_cov_2.126531	274	305	4	9	31	0.2903226
NODE_118179_length_344_cov_2.126531	274	305	6	7	31	0.2258064
NODE_118243_length_344_cov_1.914286	114	194	0	80	80	1.0000000
NODE_118243_length_344_cov_1.914286	167	247	0	30	80	0.3750000
NODE_118243_length_344_cov_1.914286	167	247	2	50	80	0.6250000
NODE_118297_length_344_cov_1.685714	180	220	2	28	40	0.7000000
NODE_118297_length_344_cov_1.685714	180	220	4	12	40	0.3000000
NODE_118393_length_344_cov_1.457143	160	240	16	3	80	0.0375000
NODE_118393_length_344_cov_1.457143	160	240	18	3	80	0.0375000
NODE_118393_length_344_cov_1.457143	160	240	20	1	80	0.0125000
NODE_118393_length_344_cov_1.457143	160	240	22	10	80	0.1250000
NODE_118393_length_344_cov_1.457143	160	240	24	5	80	0.0625000
NODE_118393_length_344_cov_1.457143	160	240	28	21	80	0.2625000
NODE_118393_length_344_cov_1.457143	160	240	30	14	80	0.1750000
NODE_118393_length_344_cov_1.457143	160	240	34	23	80	0.2875000
NODE_118393_length_344_cov_1.457143	213	273	5	5	60	0.0833333
NODE_118393_length_344_cov_1.457143	213	273	8	1	60	0.0166667
NODE_118393_length_344_cov_1.457143	213	273	10	6	60	0.1000000
NODE_118393_length_344_cov_1.457143	213	273	12	2	60	0.0333333
NODE_118393_length_344_cov_1.457143	213	273	14	13	60	0.2166667
NODE_118393_length_344_cov_1.457143	213	273	16	9	60	0.1500000
NODE_118393_length_344_cov_1.457143	213	273	18	3	60	0.0500000
NODE_118393_length_344_cov_1.457143	213	273	20	1	60	0.0166667
NODE_118393_length_344_cov_1.457143	213	273	22	10	60	0.1666667
NODE_118393_length_344_cov_1.457143	213	273	24	5	60	0.0833333
NODE_118393_length_344_cov_1.457143	213	273	28	5	60	0.0833333
NODE_118743_length_344_cov_0.800000	123	163	2	7	40	0.1750000
NODE_118743_length_344_cov_0.800000	123	163	4	11	40	0.2750000
NODE_118743_length_344_cov_0.800000	123	163	6	22	40	0.5500000
NODE_118899_length_343_cov_3.770492	2	60	0	58	58	1.0000000
NODE_118905_length_343_cov_3.598361	97	170	4	2	73	0.0273973
NODE_118905_length_343_cov_3.598361	97	170	6	2	73	0.0273973
NODE_118905_length_343_cov_3.598361	97	170	7	1	73	0.0136986
NODE_118905_length_343_cov_3.598361	97	170	9	3	73	0.0410959
NODE_118905_length_343_cov_3.598361	97	170	11	5	73	0.0684932
NODE_118905_length_343_cov_3.598361	97	170	13	14	73	0.1917808
NODE_118905_length_343_cov_3.598361	97	170	15	9	73	0.1232877
NODE_118905_length_343_cov_3.598361	97	170	17	37	73	0.5068493
NODE_118905_length_343_cov_3.598361	150	223	6	2	73	0.0273973
NODE_118905_length_343_cov_3.598361	150	223	8	16	73	0.2191781
NODE_118905_length_343_cov_3.598361	150	223	11	1	73	0.0136986
NODE_118905_length_343_cov_3.598361	150	223	13	4	73	0.0547945
NODE_118905_length_343_cov_3.598361	150	223	15	2	73	0.0273973
NODE_118905_length_343_cov_3.598361	150	223	17	22	73	0.3013699
NODE_118905_length_343_cov_3.598361	150	223	19	1	73	0.0136986
NODE_118905_length_343_cov_3.598361	150	223	21	25	73	0.3424658
NODE_118911_length_343_cov_3.401639	48	128	13	4	80	0.0500000
NODE_118911_length_343_cov_3.401639	48	128	15	4	80	0.0500000
NODE_118911_length_343_cov_3.401639	48	128	17	1	80	0.0125000
NODE_118911_length_343_cov_3.401639	48	128	21	3	80	0.0375000
NODE_118911_length_343_cov_3.401639	48	128	23	3	80	0.0375000
NODE_118911_length_343_cov_3.401639	48	128	25	1	80	0.0125000
NODE_118911_length_343_cov_3.401639	48	128	29	1	80	0.0125000
NODE_118911_length_343_cov_3.401639	48	128	30	1	80	0.0125000
NODE_118911_length_343_cov_3.401639	48	128	31	2	80	0.0250000
NODE_118911_length_343_cov_3.401639	48	128	33	3	80	0.0375000
NODE_118911_length_343_cov_3.401639	48	128	35	2	80	0.0250000
NODE_118911_length_343_cov_3.401639	48	128	37	5	80	0.0625000
NODE_118911_length_343_cov_3.401639	48	128	41	1	80	0.0125000
NODE_118911_length_343_cov_3.401639	48	128	43	1	80	0.0125000
NODE_118911_length_343_cov_3.401639	48	128	45	4	80	0.0500000
NODE_118911_length_343_cov_3.401639	48	128	47	1	80	0.0125000
NODE_118911_length_343_cov_3.401639	48	128	48	1	80	0.0125000
NODE_118911_length_343_cov_3.401639	48	128	49	13	80	0.1625000
NODE_118911_length_343_cov_3.401639	48	128	50	4	80	0.0500000
NODE_118911_length_343_cov_3.401639	48	128	52	13	80	0.1625000
NODE_118911_length_343_cov_3.401639	48	128	54	7	80	0.0875000
NODE_118911_length_343_cov_3.401639	48	128	56	5	80	0.0625000
NODE_118941_length_343_cov_3.049180	12	62	2	50	50	1.0000000
NODE_118941_length_343_cov_3.049180	82	111	0	4	29	0.1379310
NODE_118941_length_343_cov_3.049180	82	111	2	25	29	0.8620690
NODE_118941_length_343_cov_3.049180	133	205	0	8	72	0.1111111
NODE_118941_length_343_cov_3.049180	133	205	4	13	72	0.1805556
NODE_118941_length_343_cov_3.049180	133	205	6	4	72	0.0555556
NODE_118941_length_343_cov_3.049180	133	205	8	1	72	0.0138889
NODE_118941_length_343_cov_3.049180	133	205	11	11	72	0.1527778
NODE_118941_length_343_cov_3.049180	133	205	14	22	72	0.3055556
NODE_118941_length_343_cov_3.049180	133	205	16	13	72	0.1805556
NODE_118957_length_343_cov_2.770492	236	316	14	6	80	0.0750000
NODE_118957_length_343_cov_2.770492	236	316	16	5	80	0.0625000
NODE_118957_length_343_cov_2.770492	236	316	19	3	80	0.0375000
NODE_118957_length_343_cov_2.770492	236	316	21	17	80	0.2125000
NODE_118957_length_343_cov_2.770492	236	316	22	5	80	0.0625000
NODE_118957_length_343_cov_2.770492	236	316	24	1	80	0.0125000
NODE_118957_length_343_cov_2.770492	236	316	32	2	80	0.0250000
NODE_118957_length_343_cov_2.770492	236	316	34	18	80	0.2250000
NODE_118957_length_343_cov_2.770492	236	316	36	1	80	0.0125000
NODE_118957_length_343_cov_2.770492	236	316	38	17	80	0.2125000
NODE_118957_length_343_cov_2.770492	236	316	40	4	80	0.0500000
NODE_118957_length_343_cov_2.770492	236	316	44	1	80	0.0125000
NODE_118978_length_343_cov_2.590164	167	225	2	7	58	0.1206897
NODE_118978_length_343_cov_2.590164	167	225	6	9	58	0.1551724
NODE_118978_length_343_cov_2.590164	167	225	8	6	58	0.1034483
NODE_118978_length_343_cov_2.590164	167	225	10	36	58	0.6206896
NODE_118998_length_343_cov_2.430328	208	274	0	8	66	0.1212121
NODE_118998_length_343_cov_2.430328	208	274	2	2	66	0.0303030
NODE_118998_length_343_cov_2.430328	208	274	6	48	66	0.7272727
NODE_118998_length_343_cov_2.430328	208	274	8	8	66	0.1212121
NODE_119040_length_343_cov_2.209016	32	111	0	79	79	1.0000000
NODE_119067_length_343_cov_2.081967	95	177	0	82	82	1.0000000
NODE_119067_length_343_cov_2.081967	150	199	0	49	49	1.0000000
NODE_119202_length_343_cov_1.635246	0	52	0	52	52	1.0000000
NODE_119439_length_343_cov_1.143443	60	120	0	60	60	1.0000000
NODE_119834_length_342_cov_3.872428	136	216	0	31	80	0.3875000
NODE_119834_length_342_cov_3.872428	136	216	4	18	80	0.2250000
NODE_119834_length_342_cov_3.872428	136	216	8	2	80	0.0250000
NODE_119834_length_342_cov_3.872428	136	216	10	29	80	0.3625000
NODE_119834_length_342_cov_3.872428	189	259	0	22	70	0.3142857
NODE_119834_length_342_cov_3.872428	189	259	4	48	70	0.6857143
NODE_119840_length_342_cov_3.769547	146	212	0	66	66	1.0000000
NODE_119841_length_342_cov_3.740741	113	146	0	33	33	1.0000000
NODE_119846_length_342_cov_3.674897	20	100	0	80	80	1.0000000
NODE_119846_length_342_cov_3.674897	73	153	0	80	80	1.0000000
NODE_119847_length_342_cov_3.588477	117	197	0	80	80	1.0000000
NODE_119849_length_342_cov_3.530864	72	151	0	44	79	0.5569620
NODE_119849_length_342_cov_3.530864	72	151	2	35	79	0.4430380
NODE_119852_length_342_cov_3.423868	172	252	2	34	80	0.4250000
NODE_119852_length_342_cov_3.423868	172	252	4	46	80	0.5750000
NODE_119852_length_342_cov_3.423868	225	283	2	51	58	0.8793104
NODE_119852_length_342_cov_3.423868	225	283	4	7	58	0.1206897
NODE_119922_length_342_cov_2.432099	16	81	0	65	65	1.0000000
NODE_119993_length_342_cov_2.049383	249	317	0	68	68	1.0000000
NODE_120047_length_342_cov_1.864198	138	190	12	5	52	0.0961538
NODE_120047_length_342_cov_1.864198	138	190	14	1	52	0.0192308
NODE_120047_length_342_cov_1.864198	138	190	18	8	52	0.1538462
NODE_120047_length_342_cov_1.864198	138	190	20	6	52	0.1153846
NODE_120047_length_342_cov_1.864198	138	190	22	8	52	0.1538462
NODE_120047_length_342_cov_1.864198	138	190	24	18	52	0.3461539
NODE_120047_length_342_cov_1.864198	138	190	26	6	52	0.1153846
NODE_120047_length_342_cov_1.864198	183	243	10	7	60	0.1166667
NODE_120047_length_342_cov_1.864198	183	243	14	4	60	0.0666667
NODE_120047_length_342_cov_1.864198	183	243	16	1	60	0.0166667
NODE_120047_length_342_cov_1.864198	183	243	17	1	60	0.0166667
NODE_120047_length_342_cov_1.864198	183	243	18	14	60	0.2333333
NODE_120047_length_342_cov_1.864198	183	243	20	4	60	0.0666667
NODE_120047_length_342_cov_1.864198	183	243	21	8	60	0.1333333
NODE_120047_length_342_cov_1.864198	183	243	22	6	60	0.1000000
NODE_120047_length_342_cov_1.864198	183	243	24	15	60	0.2500000
NODE_120073_length_342_cov_1.720165	91	147	24	26	56	0.4642857
NODE_120073_length_342_cov_1.720165	91	147	26	30	56	0.5357143
NODE_120284_length_342_cov_1.271605	201	240	2	3	39	0.0769231
NODE_120284_length_342_cov_1.271605	201	240	4	36	39	0.9230769
NODE_120755_length_341_cov_15.896694	50	130	0	70	80	0.8750000
NODE_120755_length_341_cov_15.896694	50	130	2	10	80	0.1250000
NODE_120755_length_341_cov_15.896694	103	183	0	17	80	0.2125000
NODE_120755_length_341_cov_15.896694	103	183	2	63	80	0.7875000
NODE_120757_length_341_cov_9.756198	117	196	0	57	79	0.7215190
NODE_120757_length_341_cov_9.756198	117	196	2	22	79	0.2784810
NODE_120770_length_341_cov_5.404959	141	220	0	10	79	0.1265823
NODE_120770_length_341_cov_5.404959	141	220	2	14	79	0.1772152
NODE_120770_length_341_cov_5.404959	141	220	3	10	79	0.1265823
NODE_120770_length_341_cov_5.404959	141	220	5	5	79	0.0632911
NODE_120770_length_341_cov_5.404959	141	220	6	16	79	0.2025317
NODE_120770_length_341_cov_5.404959	141	220	8	4	79	0.0506329
NODE_120770_length_341_cov_5.404959	141	220	10	1	79	0.0126582
NODE_120770_length_341_cov_5.404959	141	220	12	7	79	0.0886076
NODE_120770_length_341_cov_5.404959	141	220	18	8	79	0.1012658
NODE_120770_length_341_cov_5.404959	141	220	22	2	79	0.0253165
NODE_120770_length_341_cov_5.404959	141	220	24	2	79	0.0253165
NODE_120780_length_341_cov_4.669421	301	320	0	19	19	1.0000000
NODE_120783_length_341_cov_4.438017	57	132	0	1	75	0.0133333
NODE_120783_length_341_cov_4.438017	57	132	2	17	75	0.2266667
NODE_120783_length_341_cov_4.438017	57	132	4	57	75	0.7600000
NODE_120783_length_341_cov_4.438017	110	185	2	11	75	0.1466667
NODE_120783_length_341_cov_4.438017	110	185	3	10	75	0.1333333
NODE_120783_length_341_cov_4.438017	110	185	4	43	75	0.5733333
NODE_120783_length_341_cov_4.438017	110	185	5	11	75	0.1466667
NODE_120785_length_341_cov_4.400826	164	244	2	3	80	0.0375000
NODE_120785_length_341_cov_4.400826	164	244	4	77	80	0.9625000
NODE_120785_length_341_cov_4.400826	224	297	0	24	73	0.3287671
NODE_120785_length_341_cov_4.400826	224	297	2	22	73	0.3013699
NODE_120785_length_341_cov_4.400826	224	297	4	27	73	0.3698630
NODE_120797_length_341_cov_3.896694	58	122	9	1	64	0.0156250
NODE_120797_length_341_cov_3.896694	58	122	11	1	64	0.0156250
NODE_120797_length_341_cov_3.896694	58	122	13	2	64	0.0312500
NODE_120797_length_341_cov_3.896694	58	122	16	2	64	0.0312500
NODE_120797_length_341_cov_3.896694	58	122	17	4	64	0.0625000
NODE_120797_length_341_cov_3.896694	58	122	19	3	64	0.0468750
NODE_120797_length_341_cov_3.896694	58	122	23	1	64	0.0156250
NODE_120797_length_341_cov_3.896694	58	122	24	6	64	0.0937500
NODE_120797_length_341_cov_3.896694	58	122	28	3	64	0.0468750
NODE_120797_length_341_cov_3.896694	58	122	30	3	64	0.0468750
NODE_120797_length_341_cov_3.896694	58	122	31	2	64	0.0312500
NODE_120797_length_341_cov_3.896694	58	122	33	1	64	0.0156250
NODE_120797_length_341_cov_3.896694	58	122	34	3	64	0.0468750
NODE_120797_length_341_cov_3.896694	58	122	35	14	64	0.2187500
NODE_120797_length_341_cov_3.896694	58	122	36	1	64	0.0156250
NODE_120797_length_341_cov_3.896694	58	122	37	2	64	0.0312500
NODE_120797_length_341_cov_3.896694	58	122	38	2	64	0.0312500
NODE_120797_length_341_cov_3.896694	58	122	42	1	64	0.0156250
NODE_120797_length_341_cov_3.896694	58	122	43	3	64	0.0468750
NODE_120797_length_341_cov_3.896694	58	122	45	1	64	0.0156250
NODE_120797_length_341_cov_3.896694	58	122	49	1	64	0.0156250
NODE_120797_length_341_cov_3.896694	58	122	53	6	64	0.0937500
NODE_120797_length_341_cov_3.896694	58	122	55	1	64	0.0156250
NODE_120805_length_341_cov_3.727273	191	273	6	16	82	0.1951219
NODE_120805_length_341_cov_3.727273	191	273	8	30	82	0.3658537
NODE_120805_length_341_cov_3.727273	191	273	10	2	82	0.0243902
NODE_120805_length_341_cov_3.727273	191	273	12	3	82	0.0365854
NODE_120805_length_341_cov_3.727273	191	273	13	1	82	0.0121951
NODE_120805_length_341_cov_3.727273	191	273	14	8	82	0.0975610
NODE_120805_length_341_cov_3.727273	191	273	15	19	82	0.2317073
NODE_120805_length_341_cov_3.727273	191	273	16	3	82	0.0365854
NODE_120805_length_341_cov_3.727273	253	326	3	24	73	0.3287671
NODE_120805_length_341_cov_3.727273	253	326	6	3	73	0.0410959
NODE_120805_length_341_cov_3.727273	253	326	7	3	73	0.0410959
NODE_120805_length_341_cov_3.727273	253	326	8	43	73	0.5890411
NODE_120839_length_341_cov_3.000000	91	161	4	2	70	0.0285714
NODE_120839_length_341_cov_3.000000	91	161	6	68	70	0.9714286
NODE_120839_length_341_cov_3.000000	146	215	0	39	69	0.5652174
NODE_120839_length_341_cov_3.000000	146	215	2	4	69	0.0579710
NODE_120839_length_341_cov_3.000000	146	215	4	13	69	0.1884058
NODE_120839_length_341_cov_3.000000	146	215	6	13	69	0.1884058
NODE_120840_length_341_cov_3.000000	127	207	0	80	80	1.0000000
NODE_120892_length_341_cov_2.533058	92	172	10	17	80	0.2125000
NODE_120892_length_341_cov_2.533058	92	172	11	52	80	0.6500000
NODE_120892_length_341_cov_2.533058	92	172	12	11	80	0.1375000
NODE_120901_length_341_cov_2.495868	8	89	0	39	81	0.4814815
NODE_120901_length_341_cov_2.495868	8	89	4	42	81	0.5185185
NODE_120946_length_341_cov_2.235537	10	90	0	80	80	1.0000000
NODE_120972_length_341_cov_2.103306	46	125	0	7	79	0.0886076
NODE_120972_length_341_cov_2.103306	46	125	2	8	79	0.1012658
NODE_120972_length_341_cov_2.103306	46	125	4	64	79	0.8101266
NODE_120994_length_341_cov_2.066116	147	184	6	4	37	0.1081081
NODE_120994_length_341_cov_2.066116	147	184	7	3	37	0.0810811
NODE_120994_length_341_cov_2.066116	147	184	9	4	37	0.1081081
NODE_120994_length_341_cov_2.066116	147	184	10	26	37	0.7027027
NODE_121052_length_341_cov_1.772727	179	250	0	71	71	1.0000000
NODE_121064_length_341_cov_1.727273	105	185	0	80	80	1.0000000
NODE_121160_length_341_cov_1.475207	120	185	8	8	65	0.1230769
NODE_121160_length_341_cov_1.475207	120	185	10	26	65	0.4000000
NODE_121160_length_341_cov_1.475207	120	185	12	31	65	0.4769231
NODE_121160_length_341_cov_1.475207	158	238	4	4	80	0.0500000
NODE_121160_length_341_cov_1.475207	158	238	5	10	80	0.1250000
NODE_121160_length_341_cov_1.475207	158	238	6	22	80	0.2750000
NODE_121160_length_341_cov_1.475207	158	238	8	25	80	0.3125000
NODE_121160_length_341_cov_1.475207	158	238	10	7	80	0.0875000
NODE_121160_length_341_cov_1.475207	158	238	12	12	80	0.1500000
NODE_121173_length_341_cov_1.471074	186	266	10	80	80	1.0000000
NODE_121173_length_341_cov_1.471074	239	319	0	36	80	0.4500000
NODE_121173_length_341_cov_1.471074	239	319	9	14	80	0.1750000
NODE_121173_length_341_cov_1.471074	239	319	10	30	80	0.3750000
NODE_121211_length_341_cov_1.342975	284	322	0	38	38	1.0000000
NODE_121431_length_341_cov_0.991736	36	89	4	2	53	0.0377358
NODE_121431_length_341_cov_0.991736	36	89	6	51	53	0.9622642
NODE_121693_length_340_cov_541.348548	86	144	806	1	58	0.0172414
NODE_121693_length_340_cov_541.348548	86	144	814	1	58	0.0172414
NODE_121693_length_340_cov_541.348548	86	144	826	1	58	0.0172414
NODE_121693_length_340_cov_541.348548	86	144	828	1	58	0.0172414
NODE_121693_length_340_cov_541.348548	86	144	856	1	58	0.0172414
NODE_121693_length_340_cov_541.348548	86	144	869	1	58	0.0172414
NODE_121693_length_340_cov_541.348548	86	144	899	1	58	0.0172414
NODE_121693_length_340_cov_541.348548	86	144	916	1	58	0.0172414
NODE_121693_length_340_cov_541.348548	86	144	947	1	58	0.0172414
NODE_121693_length_340_cov_541.348548	86	144	1012	1	58	0.0172414
NODE_121693_length_340_cov_541.348548	86	144	1044	1	58	0.0172414
NODE_121693_length_340_cov_541.348548	86	144	1069	1	58	0.0172414
NODE_121693_length_340_cov_541.348548	86	144	1087	1	58	0.0172414
NODE_121693_length_340_cov_541.348548	86	144	1149	1	58	0.0172414
NODE_121693_length_340_cov_541.348548	86	144	1202	1	58	0.0172414
NODE_121693_length_340_cov_541.348548	86	144	1219	1	58	0.0172414
NODE_121693_length_340_cov_541.348548	86	144	1259	1	58	0.0172414
NODE_121693_length_340_cov_541.348548	86	144	1271	1	58	0.0172414
NODE_121693_length_340_cov_541.348548	86	144	1290	1	58	0.0172414
NODE_121693_length_340_cov_541.348548	86	144	1316	1	58	0.0172414
NODE_121693_length_340_cov_541.348548	86	144	1372	1	58	0.0172414
NODE_121693_length_340_cov_541.348548	86	144	1420	1	58	0.0172414
NODE_121693_length_340_cov_541.348548	86	144	1421	1	58	0.0172414
NODE_121693_length_340_cov_541.348548	86	144	1435	1	58	0.0172414
NODE_121693_length_340_cov_541.348548	86	144	1443	1	58	0.0172414
NODE_121693_length_340_cov_541.348548	86	144	1460	1	58	0.0172414
NODE_121693_length_340_cov_541.348548	86	144	1508	2	58	0.0344828
NODE_121693_length_340_cov_541.348548	86	144	1544	1	58	0.0172414
NODE_121693_length_340_cov_541.348548	86	144	1558	1	58	0.0172414
NODE_121693_length_340_cov_541.348548	86	144	1600	1	58	0.0172414
NODE_121693_length_340_cov_541.348548	86	144	1628	1	58	0.0172414
NODE_121693_length_340_cov_541.348548	86	144	1638	1	58	0.0172414
NODE_121693_length_340_cov_541.348548	86	144	1657	1	58	0.0172414
NODE_121693_length_340_cov_541.348548	86	144	1706	1	58	0.0172414
NODE_121693_length_340_cov_541.348548	86	144	1713	1	58	0.0172414
NODE_121693_length_340_cov_541.348548	86	144	1727	1	58	0.0172414
NODE_121693_length_340_cov_541.348548	86	144	1733	1	58	0.0172414
NODE_121693_length_340_cov_541.348548	86	144	1738	1	58	0.0172414
NODE_121693_length_340_cov_541.348548	86	144	1770	1	58	0.0172414
NODE_121693_length_340_cov_541.348548	86	144	1798	1	58	0.0172414
NODE_121693_length_340_cov_541.348548	86	144	1828	1	58	0.0172414
NODE_121693_length_340_cov_541.348548	86	144	1842	1	58	0.0172414
NODE_121693_length_340_cov_541.348548	86	144	1879	1	58	0.0172414
NODE_121693_length_340_cov_541.348548	86	144	1883	1	58	0.0172414
NODE_121693_length_340_cov_541.348548	86	144	1912	1	58	0.0172414
NODE_121693_length_340_cov_541.348548	86	144	1927	1	58	0.0172414
NODE_121693_length_340_cov_541.348548	86	144	1953	1	58	0.0172414
NODE_121693_length_340_cov_541.348548	86	144	1973	1	58	0.0172414
NODE_121693_length_340_cov_541.348548	86	144	2007	1	58	0.0172414
NODE_121693_length_340_cov_541.348548	86	144	2065	1	58	0.0172414
NODE_121693_length_340_cov_541.348548	86	144	2106	1	58	0.0172414
NODE_121693_length_340_cov_541.348548	86	144	2153	1	58	0.0172414
NODE_121693_length_340_cov_541.348548	86	144	2180	1	58	0.0172414
NODE_121693_length_340_cov_541.348548	86	144	2200	1	58	0.0172414
NODE_121693_length_340_cov_541.348548	86	144	2211	1	58	0.0172414
NODE_121693_length_340_cov_541.348548	86	144	2241	1	58	0.0172414
NODE_121693_length_340_cov_541.348548	86	144	2274	1	58	0.0172414
NODE_121693_length_340_cov_541.348548	86	154	806	1	68	0.0147059
NODE_121693_length_340_cov_541.348548	86	154	814	1	68	0.0147059
NODE_121693_length_340_cov_541.348548	86	154	826	1	68	0.0147059
NODE_121693_length_340_cov_541.348548	86	154	828	1	68	0.0147059
NODE_121693_length_340_cov_541.348548	86	154	856	1	68	0.0147059
NODE_121693_length_340_cov_541.348548	86	154	869	1	68	0.0147059
NODE_121693_length_340_cov_541.348548	86	154	899	1	68	0.0147059
NODE_121693_length_340_cov_541.348548	86	154	916	1	68	0.0147059
NODE_121693_length_340_cov_541.348548	86	154	947	1	68	0.0147059
NODE_121693_length_340_cov_541.348548	86	154	1012	1	68	0.0147059
NODE_121693_length_340_cov_541.348548	86	154	1044	1	68	0.0147059
NODE_121693_length_340_cov_541.348548	86	154	1069	1	68	0.0147059
NODE_121693_length_340_cov_541.348548	86	154	1087	1	68	0.0147059
NODE_121693_length_340_cov_541.348548	86	154	1149	1	68	0.0147059
NODE_121693_length_340_cov_541.348548	86	154	1202	1	68	0.0147059
NODE_121693_length_340_cov_541.348548	86	154	1219	1	68	0.0147059
NODE_121693_length_340_cov_541.348548	86	154	1259	1	68	0.0147059
NODE_121693_length_340_cov_541.348548	86	154	1271	1	68	0.0147059
NODE_121693_length_340_cov_541.348548	86	154	1290	1	68	0.0147059
NODE_121693_length_340_cov_541.348548	86	154	1316	1	68	0.0147059
NODE_121693_length_340_cov_541.348548	86	154	1372	1	68	0.0147059
NODE_121693_length_340_cov_541.348548	86	154	1420	1	68	0.0147059
NODE_121693_length_340_cov_541.348548	86	154	1421	1	68	0.0147059
NODE_121693_length_340_cov_541.348548	86	154	1435	1	68	0.0147059
NODE_121693_length_340_cov_541.348548	86	154	1443	1	68	0.0147059
NODE_121693_length_340_cov_541.348548	86	154	1460	1	68	0.0147059
NODE_121693_length_340_cov_541.348548	86	154	1508	2	68	0.0294118
NODE_121693_length_340_cov_541.348548	86	154	1544	1	68	0.0147059
NODE_121693_length_340_cov_541.348548	86	154	1558	1	68	0.0147059
NODE_121693_length_340_cov_541.348548	86	154	1600	1	68	0.0147059
NODE_121693_length_340_cov_541.348548	86	154	1628	1	68	0.0147059
NODE_121693_length_340_cov_541.348548	86	154	1638	1	68	0.0147059
NODE_121693_length_340_cov_541.348548	86	154	1657	1	68	0.0147059
NODE_121693_length_340_cov_541.348548	86	154	1706	1	68	0.0147059
NODE_121693_length_340_cov_541.348548	86	154	1713	1	68	0.0147059
NODE_121693_length_340_cov_541.348548	86	154	1727	1	68	0.0147059
NODE_121693_length_340_cov_541.348548	86	154	1733	1	68	0.0147059
NODE_121693_length_340_cov_541.348548	86	154	1738	1	68	0.0147059
NODE_121693_length_340_cov_541.348548	86	154	1770	1	68	0.0147059
NODE_121693_length_340_cov_541.348548	86	154	1798	1	68	0.0147059
NODE_121693_length_340_cov_541.348548	86	154	1828	1	68	0.0147059
NODE_121693_length_340_cov_541.348548	86	154	1842	1	68	0.0147059
NODE_121693_length_340_cov_541.348548	86	154	1879	1	68	0.0147059
NODE_121693_length_340_cov_541.348548	86	154	1883	1	68	0.0147059
NODE_121693_length_340_cov_541.348548	86	154	1912	1	68	0.0147059
NODE_121693_length_340_cov_541.348548	86	154	1927	1	68	0.0147059
NODE_121693_length_340_cov_541.348548	86	154	1953	1	68	0.0147059
NODE_121693_length_340_cov_541.348548	86	154	1973	1	68	0.0147059
NODE_121693_length_340_cov_541.348548	86	154	2007	1	68	0.0147059
NODE_121693_length_340_cov_541.348548	86	154	2065	1	68	0.0147059
NODE_121693_length_340_cov_541.348548	86	154	2106	1	68	0.0147059
NODE_121693_length_340_cov_541.348548	86	154	2153	1	68	0.0147059
NODE_121693_length_340_cov_541.348548	86	154	2180	1	68	0.0147059
NODE_121693_length_340_cov_541.348548	86	154	2200	1	68	0.0147059
NODE_121693_length_340_cov_541.348548	86	154	2211	1	68	0.0147059
NODE_121693_length_340_cov_541.348548	86	154	2241	1	68	0.0147059
NODE_121693_length_340_cov_541.348548	86	154	2274	1	68	0.0147059
NODE_121693_length_340_cov_541.348548	86	154	2316	1	68	0.0147059
NODE_121693_length_340_cov_541.348548	86	154	2330	1	68	0.0147059
NODE_121693_length_340_cov_541.348548	86	154	2342	1	68	0.0147059
NODE_121693_length_340_cov_541.348548	86	154	2344	1	68	0.0147059
NODE_121693_length_340_cov_541.348548	86	154	2355	1	68	0.0147059
NODE_121693_length_340_cov_541.348548	86	154	2358	1	68	0.0147059
NODE_121693_length_340_cov_541.348548	86	154	2361	1	68	0.0147059
NODE_121693_length_340_cov_541.348548	86	154	2387	1	68	0.0147059
NODE_121693_length_340_cov_541.348548	86	154	2404	1	68	0.0147059
NODE_121693_length_340_cov_541.348548	86	154	2441	1	68	0.0147059
NODE_121693_length_340_cov_541.348548	86	107	806	1	21	0.0476190
NODE_121693_length_340_cov_541.348548	86	107	814	1	21	0.0476190
NODE_121693_length_340_cov_541.348548	86	107	826	1	21	0.0476190
NODE_121693_length_340_cov_541.348548	86	107	828	1	21	0.0476190
NODE_121693_length_340_cov_541.348548	86	107	856	1	21	0.0476190
NODE_121693_length_340_cov_541.348548	86	107	869	1	21	0.0476190
NODE_121693_length_340_cov_541.348548	86	107	899	1	21	0.0476190
NODE_121693_length_340_cov_541.348548	86	107	916	1	21	0.0476190
NODE_121693_length_340_cov_541.348548	86	107	947	1	21	0.0476190
NODE_121693_length_340_cov_541.348548	86	107	1012	1	21	0.0476190
NODE_121693_length_340_cov_541.348548	86	107	1044	1	21	0.0476190
NODE_121693_length_340_cov_541.348548	86	107	1069	1	21	0.0476190
NODE_121693_length_340_cov_541.348548	86	107	1087	1	21	0.0476190
NODE_121693_length_340_cov_541.348548	86	107	1149	1	21	0.0476190
NODE_121693_length_340_cov_541.348548	86	107	1202	1	21	0.0476190
NODE_121693_length_340_cov_541.348548	86	107	1219	1	21	0.0476190
NODE_121693_length_340_cov_541.348548	86	107	1259	1	21	0.0476190
NODE_121693_length_340_cov_541.348548	86	107	1271	1	21	0.0476190
NODE_121693_length_340_cov_541.348548	86	107	1290	1	21	0.0476190
NODE_121693_length_340_cov_541.348548	86	107	1316	1	21	0.0476190
NODE_121693_length_340_cov_541.348548	86	107	1372	1	21	0.0476190
NODE_121694_length_340_cov_50.755187	196	266	19	1	70	0.0142857
NODE_121694_length_340_cov_50.755187	196	266	20	6	70	0.0857143
NODE_121694_length_340_cov_50.755187	196	266	22	21	70	0.3000000
NODE_121694_length_340_cov_50.755187	196	266	24	4	70	0.0571429
NODE_121694_length_340_cov_50.755187	196	266	26	18	70	0.2571429
NODE_121694_length_340_cov_50.755187	196	266	28	20	70	0.2857143
NODE_121696_length_340_cov_8.917012	240	270	2	16	30	0.5333334
NODE_121696_length_340_cov_8.917012	240	270	5	14	30	0.4666667
NODE_121696_length_340_cov_8.917012	243	315	0	29	72	0.4027778
NODE_121696_length_340_cov_8.917012	243	315	2	32	72	0.4444444
NODE_121696_length_340_cov_8.917012	243	315	5	11	72	0.1527778
NODE_121702_length_340_cov_6.439834	175	255	0	47	80	0.5875000
NODE_121702_length_340_cov_6.439834	175	255	2	33	80	0.4125000
NODE_121702_length_340_cov_6.439834	228	310	2	82	82	1.0000000
NODE_121708_length_340_cov_5.883817	72	121	0	1	49	0.0204082
NODE_121708_length_340_cov_5.883817	72	121	4	1	49	0.0204082
NODE_121708_length_340_cov_5.883817	72	121	6	3	49	0.0612245
NODE_121708_length_340_cov_5.883817	72	121	8	17	49	0.3469388
NODE_121708_length_340_cov_5.883817	72	121	10	27	49	0.5510204
NODE_121708_length_340_cov_5.883817	82	113	8	14	31	0.4516129
NODE_121708_length_340_cov_5.883817	82	113	10	17	31	0.5483871
NODE_121714_length_340_cov_5.228216	116	186	0	42	70	0.6000000
NODE_121714_length_340_cov_5.228216	116	186	2	28	70	0.4000000
NODE_121714_length_340_cov_5.228216	159	201	2	39	42	0.9285714
NODE_121714_length_340_cov_5.228216	159	201	4	3	42	0.0714286
NODE_121730_length_340_cov_4.497925	136	184	0	48	48	1.0000000
NODE_121752_length_340_cov_3.759336	88	169	0	81	81	1.0000000
NODE_121849_length_340_cov_2.506224	68	114	0	46	46	1.0000000
NODE_121951_length_340_cov_1.995851	29	101	2	12	72	0.1666667
NODE_121951_length_340_cov_1.995851	29	101	4	19	72	0.2638889
NODE_121951_length_340_cov_1.995851	29	101	8	8	72	0.1111111
NODE_121951_length_340_cov_1.995851	29	101	10	5	72	0.0694444
NODE_121951_length_340_cov_1.995851	29	101	12	10	72	0.1388889
NODE_121951_length_340_cov_1.995851	29	101	14	18	72	0.2500000
NODE_121951_length_340_cov_1.995851	96	143	10	5	47	0.1063830
NODE_121951_length_340_cov_1.995851	96	143	14	42	47	0.8936170
NODE_122154_length_340_cov_1.427386	244	274	4	1	30	0.0333333
NODE_122154_length_340_cov_1.427386	244	274	6	29	30	0.9666666
NODE_122218_length_340_cov_1.282158	71	135	0	7	64	0.1093750
NODE_122218_length_340_cov_1.282158	71	135	2	57	64	0.8906250
NODE_122218_length_340_cov_1.282158	128	188	2	60	60	1.0000000
NODE_122218_length_340_cov_1.282158	142	189	2	47	47	1.0000000
NODE_122220_length_340_cov_1.278008	51	102	0	16	51	0.3137255
NODE_122220_length_340_cov_1.278008	51	102	2	9	51	0.1764706
NODE_122220_length_340_cov_1.278008	51	102	4	4	51	0.0784314
NODE_122220_length_340_cov_1.278008	51	102	6	3	51	0.0588235
NODE_122220_length_340_cov_1.278008	51	102	8	19	51	0.3725490
NODE_122321_length_340_cov_1.199170	98	160	0	62	62	1.0000000
NODE_122381_length_340_cov_1.070539	32	65	4	1	33	0.0303030
NODE_122381_length_340_cov_1.070539	32	65	6	32	33	0.9696970
NODE_122429_length_340_cov_1.020747	209	228	0	19	19	1.0000000
NODE_122686_length_339_cov_87.841667	149	227	117	2	78	0.0256410
NODE_122686_length_339_cov_87.841667	149	227	121	1	78	0.0128205
NODE_122686_length_339_cov_87.841667	149	227	123	1	78	0.0128205
NODE_122686_length_339_cov_87.841667	149	227	125	1	78	0.0128205
NODE_122686_length_339_cov_87.841667	149	227	127	1	78	0.0128205
NODE_122686_length_339_cov_87.841667	149	227	131	2	78	0.0256410
NODE_122686_length_339_cov_87.841667	149	227	133	3	78	0.0384615
NODE_122686_length_339_cov_87.841667	149	227	135	1	78	0.0128205
NODE_122686_length_339_cov_87.841667	149	227	141	1	78	0.0128205
NODE_122686_length_339_cov_87.841667	149	227	143	2	78	0.0256410
NODE_122686_length_339_cov_87.841667	149	227	151	2	78	0.0256410
NODE_122686_length_339_cov_87.841667	149	227	168	3	78	0.0384615
NODE_122686_length_339_cov_87.841667	149	227	170	2	78	0.0256410
NODE_122686_length_339_cov_87.841667	149	227	173	3	78	0.0384615
NODE_122686_length_339_cov_87.841667	149	227	174	1	78	0.0128205
NODE_122686_length_339_cov_87.841667	149	227	175	2	78	0.0256410
NODE_122686_length_339_cov_87.841667	149	227	176	2	78	0.0256410
NODE_122686_length_339_cov_87.841667	149	227	177	1	78	0.0128205
NODE_122686_length_339_cov_87.841667	149	227	178	4	78	0.0512821
NODE_122686_length_339_cov_87.841667	149	227	179	1	78	0.0128205
NODE_122686_length_339_cov_87.841667	149	227	180	1	78	0.0128205
NODE_122686_length_339_cov_87.841667	149	227	184	1	78	0.0128205
NODE_122686_length_339_cov_87.841667	149	227	186	1	78	0.0128205
NODE_122686_length_339_cov_87.841667	149	227	190	1	78	0.0128205
NODE_122686_length_339_cov_87.841667	149	227	192	3	78	0.0384615
NODE_122686_length_339_cov_87.841667	149	227	194	1	78	0.0128205
NODE_122686_length_339_cov_87.841667	149	227	195	2	78	0.0256410
NODE_122686_length_339_cov_87.841667	149	227	196	3	78	0.0384615
NODE_122686_length_339_cov_87.841667	149	227	197	1	78	0.0128205
NODE_122686_length_339_cov_87.841667	149	227	198	1	78	0.0128205
NODE_122686_length_339_cov_87.841667	149	227	211	1	78	0.0128205
NODE_122686_length_339_cov_87.841667	149	227	213	1	78	0.0128205
NODE_122686_length_339_cov_87.841667	149	227	215	1	78	0.0128205
NODE_122686_length_339_cov_87.841667	149	227	217	1	78	0.0128205
NODE_122686_length_339_cov_87.841667	149	227	221	1	78	0.0128205
NODE_122686_length_339_cov_87.841667	149	227	222	1	78	0.0128205
NODE_122686_length_339_cov_87.841667	149	227	223	3	78	0.0384615
NODE_122686_length_339_cov_87.841667	149	227	224	1	78	0.0128205
NODE_122686_length_339_cov_87.841667	149	227	225	1	78	0.0128205
NODE_122686_length_339_cov_87.841667	149	227	226	4	78	0.0512821
NODE_122686_length_339_cov_87.841667	149	227	228	4	78	0.0512821
NODE_122686_length_339_cov_87.841667	149	227	229	1	78	0.0128205
NODE_122686_length_339_cov_87.841667	149	227	231	1	78	0.0128205
NODE_122686_length_339_cov_87.841667	149	227	232	1	78	0.0128205
NODE_122686_length_339_cov_87.841667	149	227	233	1	78	0.0128205
NODE_122686_length_339_cov_87.841667	149	227	234	1	78	0.0128205
NODE_122686_length_339_cov_87.841667	149	227	235	1	78	0.0128205
NODE_122686_length_339_cov_87.841667	149	227	237	1	78	0.0128205
NODE_122686_length_339_cov_87.841667	149	227	240	1	78	0.0128205
NODE_122687_length_339_cov_14.304167	69	138	4	6	69	0.0869565
NODE_122687_length_339_cov_14.304167	69	138	6	2	69	0.0289855
NODE_122687_length_339_cov_14.304167	69	138	10	11	69	0.1594203
NODE_122687_length_339_cov_14.304167	69	138	12	5	69	0.0724638
NODE_122687_length_339_cov_14.304167	69	138	18	45	69	0.6521739
NODE_122687_length_339_cov_14.304167	69	138	4	6	69	0.0869565
NODE_122687_length_339_cov_14.304167	69	138	6	2	69	0.0289855
NODE_122687_length_339_cov_14.304167	69	138	10	11	69	0.1594203
NODE_122687_length_339_cov_14.304167	69	138	12	5	69	0.0724638
NODE_122687_length_339_cov_14.304167	69	138	18	45	69	0.6521739
NODE_122687_length_339_cov_14.304167	69	138	4	6	69	0.0869565
NODE_122687_length_339_cov_14.304167	69	138	6	2	69	0.0289855
NODE_122687_length_339_cov_14.304167	69	138	10	11	69	0.1594203
NODE_122687_length_339_cov_14.304167	69	138	12	5	69	0.0724638
NODE_122687_length_339_cov_14.304167	69	138	18	45	69	0.6521739
NODE_122687_length_339_cov_14.304167	88	138	4	6	50	0.1200000
NODE_122687_length_339_cov_14.304167	88	138	6	2	50	0.0400000
NODE_122687_length_339_cov_14.304167	88	138	10	11	50	0.2200000
NODE_122687_length_339_cov_14.304167	88	138	12	5	50	0.1000000
NODE_122687_length_339_cov_14.304167	88	138	18	26	50	0.5200000
NODE_122687_length_339_cov_14.304167	111	160	0	17	49	0.3469388
NODE_122687_length_339_cov_14.304167	111	160	4	11	49	0.2244898
NODE_122687_length_339_cov_14.304167	111	160	6	2	49	0.0408163
NODE_122687_length_339_cov_14.304167	111	160	10	11	49	0.2244898
NODE_122687_length_339_cov_14.304167	111	160	12	5	49	0.1020408
NODE_122687_length_339_cov_14.304167	111	160	18	3	49	0.0612245
NODE_122727_length_339_cov_4.320833	187	267	3	7	80	0.0875000
NODE_122727_length_339_cov_4.320833	187	267	4	73	80	0.9125000
NODE_122804_length_339_cov_2.754167	45	125	0	6	80	0.0750000
NODE_122804_length_339_cov_2.754167	45	125	13	2	80	0.0250000
NODE_122804_length_339_cov_2.754167	45	125	14	3	80	0.0375000
NODE_122804_length_339_cov_2.754167	45	125	16	69	80	0.8625000
NODE_122971_length_339_cov_1.841667	265	312	0	47	47	1.0000000
NODE_123041_length_339_cov_1.662500	10	57	2	47	47	1.0000000
NODE_123182_length_339_cov_1.275000	247	312	0	65	65	1.0000000
NODE_123285_length_339_cov_1.070833	147	169	0	22	22	1.0000000
NODE_123633_length_338_cov_57.163180	59	120	0	61	61	1.0000000
NODE_123633_length_338_cov_57.163180	102	176	0	74	74	1.0000000
NODE_123674_length_338_cov_4.263598	113	165	0	52	52	1.0000000
NODE_123679_length_338_cov_4.079498	96	151	8	55	55	1.0000000
NODE_123689_length_338_cov_3.841004	122	149	2	27	27	1.0000000
NODE_123793_length_338_cov_2.393305	216	288	4	1	72	0.0138889
NODE_123793_length_338_cov_2.393305	216	288	6	71	72	0.9861111
NODE_123795_length_338_cov_2.380753	29	93	0	64	64	1.0000000
NODE_123919_length_338_cov_1.878661	146	232	0	1	86	0.0116279
NODE_123919_length_338_cov_1.878661	146	232	2	12	86	0.1395349
NODE_123919_length_338_cov_1.878661	146	232	3	1	86	0.0116279
NODE_123919_length_338_cov_1.878661	146	232	4	9	86	0.1046512
NODE_123919_length_338_cov_1.878661	146	232	6	56	86	0.6511628
NODE_123919_length_338_cov_1.878661	146	232	8	4	86	0.0465116
NODE_123919_length_338_cov_1.878661	146	232	12	3	86	0.0348837
NODE_123944_length_338_cov_1.740586	79	159	0	10	80	0.1250000
NODE_123944_length_338_cov_1.740586	79	159	2	23	80	0.2875000
NODE_123944_length_338_cov_1.740586	79	159	4	47	80	0.5875000
NODE_123946_length_338_cov_1.732218	216	257	0	41	41	1.0000000
NODE_124046_length_338_cov_1.493724	14	90	0	76	76	1.0000000
NODE_124247_length_338_cov_1.100418	265	333	0	68	68	1.0000000
NODE_124456_length_338_cov_0.849372	281	338	0	57	57	1.0000000
NODE_124533_length_338_cov_0.711297	188	263	7	19	75	0.2533333
NODE_124533_length_338_cov_0.711297	188	263	9	44	75	0.5866666
NODE_124533_length_338_cov_0.711297	188	263	11	12	75	0.1600000
NODE_124625_length_337_cov_468.180672	107	187	45	12	80	0.1500000
NODE_124625_length_337_cov_468.180672	107	187	46	2	80	0.0250000
NODE_124625_length_337_cov_468.180672	107	187	47	2	80	0.0250000
NODE_124625_length_337_cov_468.180672	107	187	55	6	80	0.0750000
NODE_124625_length_337_cov_468.180672	107	187	59	4	80	0.0500000
NODE_124625_length_337_cov_468.180672	107	187	61	5	80	0.0625000
NODE_124625_length_337_cov_468.180672	107	187	63	1	80	0.0125000
NODE_124625_length_337_cov_468.180672	107	187	66	1	80	0.0125000
NODE_124625_length_337_cov_468.180672	107	187	67	4	80	0.0500000
NODE_124625_length_337_cov_468.180672	107	187	68	2	80	0.0250000
NODE_124625_length_337_cov_468.180672	107	187	70	3	80	0.0375000
NODE_124625_length_337_cov_468.180672	107	187	71	14	80	0.1750000
NODE_124625_length_337_cov_468.180672	107	187	73	9	80	0.1125000
NODE_124625_length_337_cov_468.180672	107	187	74	8	80	0.1000000
NODE_124625_length_337_cov_468.180672	107	187	75	7	80	0.0875000
NODE_124625_length_337_cov_468.180672	160	230	0	6	70	0.0857143
NODE_124625_length_337_cov_468.180672	160	230	6	5	70	0.0714286
NODE_124625_length_337_cov_468.180672	160	230	7	3	70	0.0428571
NODE_124625_length_337_cov_468.180672	160	230	8	8	70	0.1142857
NODE_124625_length_337_cov_468.180672	160	230	9	2	70	0.0285714
NODE_124625_length_337_cov_468.180672	160	230	10	4	70	0.0571429
NODE_124625_length_337_cov_468.180672	160	230	19	1	70	0.0142857
NODE_124625_length_337_cov_468.180672	160	230	26	1	70	0.0142857
NODE_124625_length_337_cov_468.180672	160	230	30	1	70	0.0142857
NODE_124625_length_337_cov_468.180672	160	230	32	2	70	0.0285714
NODE_124625_length_337_cov_468.180672	160	230	34	1	70	0.0142857
NODE_124625_length_337_cov_468.180672	160	230	38	1	70	0.0142857
NODE_124625_length_337_cov_468.180672	160	230	42	1	70	0.0142857
NODE_124625_length_337_cov_468.180672	160	230	43	6	70	0.0857143
NODE_124625_length_337_cov_468.180672	160	230	45	13	70	0.1857143
NODE_124625_length_337_cov_468.180672	160	230	46	2	70	0.0285714
NODE_124625_length_337_cov_468.180672	160	230	47	2	70	0.0285714
NODE_124625_length_337_cov_468.180672	160	230	55	6	70	0.0857143
NODE_124625_length_337_cov_468.180672	160	230	59	4	70	0.0571429
NODE_124625_length_337_cov_468.180672	160	230	61	1	70	0.0142857
NODE_124625_length_337_cov_468.180672	226	306	8	8	80	0.1000000
NODE_124625_length_337_cov_468.180672	226	306	10	72	80	0.9000000
NODE_124625_length_337_cov_468.180672	279	337	0	5	58	0.0862069
NODE_124625_length_337_cov_468.180672	279	337	6	20	58	0.3448276
NODE_124625_length_337_cov_468.180672	279	337	8	11	58	0.1896552
NODE_124625_length_337_cov_468.180672	279	337	10	22	58	0.3793103
NODE_124626_length_337_cov_91.344538	1	50	10	1	49	0.0204082
NODE_124626_length_337_cov_91.344538	1	50	14	4	49	0.0816327
NODE_124626_length_337_cov_91.344538	1	50	18	1	49	0.0204082
NODE_124626_length_337_cov_91.344538	1	50	20	8	49	0.1632653
NODE_124626_length_337_cov_91.344538	1	50	22	1	49	0.0204082
NODE_124626_length_337_cov_91.344538	1	50	24	1	49	0.0204082
NODE_124626_length_337_cov_91.344538	1	50	33	3	49	0.0612245
NODE_124626_length_337_cov_91.344538	1	50	40	1	49	0.0204082
NODE_124626_length_337_cov_91.344538	1	50	47	2	49	0.0408163
NODE_124626_length_337_cov_91.344538	1	50	51	1	49	0.0204082
NODE_124626_length_337_cov_91.344538	1	50	55	9	49	0.1836735
NODE_124626_length_337_cov_91.344538	1	50	63	2	49	0.0408163
NODE_124626_length_337_cov_91.344538	1	50	65	1	49	0.0204082
NODE_124626_length_337_cov_91.344538	1	50	69	1	49	0.0204082
NODE_124626_length_337_cov_91.344538	1	50	70	1	49	0.0204082
NODE_124626_length_337_cov_91.344538	1	50	72	1	49	0.0204082
NODE_124626_length_337_cov_91.344538	1	50	74	1	49	0.0204082
NODE_124626_length_337_cov_91.344538	1	50	75	1	49	0.0204082
NODE_124626_length_337_cov_91.344538	1	50	79	1	49	0.0204082
NODE_124626_length_337_cov_91.344538	1	50	83	2	49	0.0408163
NODE_124626_length_337_cov_91.344538	1	50	85	2	49	0.0408163
NODE_124626_length_337_cov_91.344538	1	50	87	1	49	0.0204082
NODE_124626_length_337_cov_91.344538	1	50	89	3	49	0.0612245
NODE_124626_length_337_cov_91.344538	23	103	51	1	80	0.0125000
NODE_124626_length_337_cov_91.344538	23	103	55	9	80	0.1125000
NODE_124626_length_337_cov_91.344538	23	103	63	2	80	0.0250000
NODE_124626_length_337_cov_91.344538	23	103	65	1	80	0.0125000
NODE_124626_length_337_cov_91.344538	23	103	69	1	80	0.0125000
NODE_124626_length_337_cov_91.344538	23	103	70	1	80	0.0125000
NODE_124626_length_337_cov_91.344538	23	103	72	1	80	0.0125000
NODE_124626_length_337_cov_91.344538	23	103	74	1	80	0.0125000
NODE_124626_length_337_cov_91.344538	23	103	75	1	80	0.0125000
NODE_124626_length_337_cov_91.344538	23	103	79	1	80	0.0125000
NODE_124626_length_337_cov_91.344538	23	103	83	2	80	0.0250000
NODE_124626_length_337_cov_91.344538	23	103	85	2	80	0.0250000
NODE_124626_length_337_cov_91.344538	23	103	87	1	80	0.0125000
NODE_124626_length_337_cov_91.344538	23	103	89	3	80	0.0375000
NODE_124626_length_337_cov_91.344538	23	103	93	1	80	0.0125000
NODE_124626_length_337_cov_91.344538	23	103	95	4	80	0.0500000
NODE_124626_length_337_cov_91.344538	23	103	100	1	80	0.0125000
NODE_124626_length_337_cov_91.344538	23	103	104	1	80	0.0125000
NODE_124626_length_337_cov_91.344538	23	103	106	1	80	0.0125000
NODE_124626_length_337_cov_91.344538	23	103	110	2	80	0.0250000
NODE_124626_length_337_cov_91.344538	23	103	114	4	80	0.0500000
NODE_124626_length_337_cov_91.344538	23	103	116	3	80	0.0375000
NODE_124626_length_337_cov_91.344538	23	103	118	1	80	0.0125000
NODE_124626_length_337_cov_91.344538	23	103	120	1	80	0.0125000
NODE_124626_length_337_cov_91.344538	23	103	122	4	80	0.0500000
NODE_124626_length_337_cov_91.344538	23	103	124	1	80	0.0125000
NODE_124626_length_337_cov_91.344538	23	103	126	1	80	0.0125000
NODE_124626_length_337_cov_91.344538	23	103	131	1	80	0.0125000
NODE_124626_length_337_cov_91.344538	23	103	134	2	80	0.0250000
NODE_124626_length_337_cov_91.344538	23	103	136	3	80	0.0375000
NODE_124626_length_337_cov_91.344538	23	103	138	4	80	0.0500000
NODE_124626_length_337_cov_91.344538	23	103	140	3	80	0.0375000
NODE_124626_length_337_cov_91.344538	23	103	142	3	80	0.0375000
NODE_124626_length_337_cov_91.344538	23	103	146	1	80	0.0125000
NODE_124626_length_337_cov_91.344538	23	103	150	4	80	0.0500000
NODE_124626_length_337_cov_91.344538	23	103	152	5	80	0.0625000
NODE_124626_length_337_cov_91.344538	23	103	156	1	80	0.0125000
NODE_124626_length_337_cov_91.344538	23	103	158	1	80	0.0125000
NODE_124627_length_337_cov_73.352941	71	151	2	80	80	1.0000000
NODE_124627_length_337_cov_73.352941	124	204	0	42	80	0.5250000
NODE_124627_length_337_cov_73.352941	124	204	2	38	80	0.4750000
NODE_124629_length_337_cov_46.978992	220	305	2	8	85	0.0941176
NODE_124629_length_337_cov_46.978992	220	305	6	20	85	0.2352941
NODE_124629_length_337_cov_46.978992	220	305	8	57	85	0.6705883
NODE_124629_length_337_cov_46.978992	220	305	2	8	85	0.0941176
NODE_124629_length_337_cov_46.978992	220	305	6	20	85	0.2352941
NODE_124629_length_337_cov_46.978992	220	305	8	57	85	0.6705883
NODE_124629_length_337_cov_46.978992	220	305	2	8	85	0.0941176
NODE_124629_length_337_cov_46.978992	220	305	6	20	85	0.2352941
NODE_124629_length_337_cov_46.978992	220	305	8	57	85	0.6705883
NODE_124629_length_337_cov_46.978992	278	327	0	21	49	0.4285714
NODE_124629_length_337_cov_46.978992	278	327	2	9	49	0.1836735
NODE_124629_length_337_cov_46.978992	278	327	6	14	49	0.2857143
NODE_124629_length_337_cov_46.978992	278	327	8	5	49	0.1020408
NODE_124629_length_337_cov_46.978992	278	337	0	31	59	0.5254237
NODE_124629_length_337_cov_46.978992	278	337	2	9	59	0.1525424
NODE_124629_length_337_cov_46.978992	278	337	6	14	59	0.2372881
NODE_124629_length_337_cov_46.978992	278	337	8	5	59	0.0847458
NODE_124629_length_337_cov_46.978992	283	337	0	31	54	0.5740741
NODE_124629_length_337_cov_46.978992	283	337	2	9	54	0.1666667
NODE_124629_length_337_cov_46.978992	283	337	6	14	54	0.2592593
NODE_124640_length_337_cov_6.214286	52	95	0	43	43	1.0000000
NODE_124669_length_337_cov_4.298319	5	58	0	53	53	1.0000000
NODE_124703_length_337_cov_3.478992	179	259	35	4	80	0.0500000
NODE_124703_length_337_cov_3.478992	179	259	37	4	80	0.0500000
NODE_124703_length_337_cov_3.478992	179	259	38	5	80	0.0625000
NODE_124703_length_337_cov_3.478992	179	259	39	1	80	0.0125000
NODE_124703_length_337_cov_3.478992	179	259	40	5	80	0.0625000
NODE_124703_length_337_cov_3.478992	179	259	41	1	80	0.0125000
NODE_124703_length_337_cov_3.478992	179	259	42	14	80	0.1750000
NODE_124703_length_337_cov_3.478992	179	259	43	19	80	0.2375000
NODE_124703_length_337_cov_3.478992	179	259	44	22	80	0.2750000
NODE_124703_length_337_cov_3.478992	179	259	45	2	80	0.0250000
NODE_124703_length_337_cov_3.478992	179	259	46	3	80	0.0375000
NODE_124703_length_337_cov_3.478992	232	307	6	1	75	0.0133333
NODE_124703_length_337_cov_3.478992	232	307	8	3	75	0.0400000
NODE_124703_length_337_cov_3.478992	232	307	12	2	75	0.0266667
NODE_124703_length_337_cov_3.478992	232	307	16	8	75	0.1066667
NODE_124703_length_337_cov_3.478992	232	307	17	8	75	0.1066667
NODE_124703_length_337_cov_3.478992	232	307	19	10	75	0.1333333
NODE_124703_length_337_cov_3.478992	232	307	21	2	75	0.0266667
NODE_124703_length_337_cov_3.478992	232	307	23	6	75	0.0800000
NODE_124703_length_337_cov_3.478992	232	307	24	2	75	0.0266667
NODE_124703_length_337_cov_3.478992	232	307	26	2	75	0.0266667
NODE_124703_length_337_cov_3.478992	232	307	27	1	75	0.0133333
NODE_124703_length_337_cov_3.478992	232	307	33	3	75	0.0400000
NODE_124703_length_337_cov_3.478992	232	307	35	4	75	0.0533333
NODE_124703_length_337_cov_3.478992	232	307	37	4	75	0.0533333
NODE_124703_length_337_cov_3.478992	232	307	42	9	75	0.1200000
NODE_124703_length_337_cov_3.478992	232	307	43	1	75	0.0133333
NODE_124703_length_337_cov_3.478992	232	307	44	9	75	0.1200000
NODE_124759_length_337_cov_2.647059	80	146	0	6	66	0.0909091
NODE_124759_length_337_cov_2.647059	80	146	2	60	66	0.9090909
NODE_124858_length_337_cov_2.121849	23	103	4	8	80	0.1000000
NODE_124858_length_337_cov_2.121849	23	103	6	72	80	0.9000000
NODE_124858_length_337_cov_2.121849	76	141	2	2	65	0.0307692
NODE_124858_length_337_cov_2.121849	76	141	4	44	65	0.6769231
NODE_124858_length_337_cov_2.121849	76	141	6	19	65	0.2923077
NODE_125001_length_337_cov_1.689076	138	218	2	1	80	0.0125000
NODE_125001_length_337_cov_1.689076	138	218	4	42	80	0.5250000
NODE_125001_length_337_cov_1.689076	138	218	6	4	80	0.0500000
NODE_125001_length_337_cov_1.689076	138	218	8	33	80	0.4125000
NODE_125024_length_337_cov_1.592437	109	151	0	42	42	1.0000000
NODE_125024_length_337_cov_1.592437	126	204	0	78	78	1.0000000
NODE_125074_length_337_cov_1.466387	266	332	0	66	66	1.0000000
NODE_125271_length_337_cov_1.071429	279	319	0	40	40	1.0000000
NODE_125332_length_337_cov_0.978992	227	272	0	45	45	1.0000000
NODE_125633_length_336_cov_7.843882	151	231	0	80	80	1.0000000
NODE_125645_length_336_cov_5.578059	159	220	0	17	61	0.2786885
NODE_125645_length_336_cov_5.578059	159	220	2	44	61	0.7213115
NODE_125645_length_336_cov_5.578059	212	273	2	61	61	1.0000000
NODE_125663_length_336_cov_4.481013	129	207	28	1	78	0.0128205
NODE_125663_length_336_cov_4.481013	129	207	30	10	78	0.1282051
NODE_125663_length_336_cov_4.481013	129	207	32	28	78	0.3589744
NODE_125663_length_336_cov_4.481013	129	207	34	12	78	0.1538462
NODE_125663_length_336_cov_4.481013	129	207	36	12	78	0.1538462
NODE_125663_length_336_cov_4.481013	129	207	37	1	78	0.0128205
NODE_125663_length_336_cov_4.481013	129	207	38	14	78	0.1794872
NODE_125752_length_336_cov_2.755274	83	112	2	23	29	0.7931035
NODE_125752_length_336_cov_2.755274	83	112	4	6	29	0.2068966
NODE_125752_length_336_cov_2.755274	187	268	2	33	81	0.4074074
NODE_125752_length_336_cov_2.755274	187	268	4	11	81	0.1358025
NODE_125752_length_336_cov_2.755274	187	268	6	13	81	0.1604938
NODE_125752_length_336_cov_2.755274	187	268	8	24	81	0.2962963
NODE_125806_length_336_cov_2.358650	60	133	2	63	73	0.8630137
NODE_125806_length_336_cov_2.358650	60	133	4	10	73	0.1369863
NODE_125811_length_336_cov_2.337553	93	173	0	80	80	1.0000000
NODE_125965_length_336_cov_1.729958	78	141	2	3	63	0.0476190
NODE_125965_length_336_cov_1.729958	78	141	4	60	63	0.9523810
NODE_125965_length_336_cov_1.729958	131	194	0	48	63	0.7619048
NODE_125965_length_336_cov_1.729958	131	194	2	8	63	0.1269841
NODE_125965_length_336_cov_1.729958	131	194	4	7	63	0.1111111
NODE_126134_length_336_cov_1.333333	34	114	0	74	80	0.9250000
NODE_126134_length_336_cov_1.333333	34	114	2	6	80	0.0750000
NODE_126134_length_336_cov_1.333333	87	124	0	26	37	0.7027027
NODE_126134_length_336_cov_1.333333	87	124	2	11	37	0.2972973
NODE_126134_length_336_cov_1.333333	182	213	6	20	31	0.6451613
NODE_126134_length_336_cov_1.333333	182	213	10	9	31	0.2903226
NODE_126134_length_336_cov_1.333333	182	213	12	2	31	0.0645161
NODE_126216_length_336_cov_1.244726	222	276	0	54	54	1.0000000
NODE_126216_length_336_cov_1.244726	288	312	0	24	24	1.0000000
NODE_126260_length_336_cov_1.143460	129	154	0	25	25	1.0000000
NODE_126545_length_336_cov_0.670886	259	288	2	29	29	1.0000000
NODE_126606_length_335_cov_16.114407	162	242	0	80	80	1.0000000
NODE_126606_length_335_cov_16.114407	215	295	0	80	80	1.0000000
NODE_126609_length_335_cov_9.258475	177	250	0	73	73	1.0000000
NODE_126614_length_335_cov_7.207627	29	109	0	22	80	0.2750000
NODE_126614_length_335_cov_7.207627	29	109	4	17	80	0.2125000
NODE_126614_length_335_cov_7.207627	29	109	8	41	80	0.5125000
NODE_126614_length_335_cov_7.207627	82	162	8	80	80	1.0000000
NODE_126636_length_335_cov_5.046610	182	263	0	81	81	1.0000000
NODE_126639_length_335_cov_4.995763	144	215	0	71	71	1.0000000
NODE_126665_length_335_cov_3.923729	163	231	0	10	68	0.1470588
NODE_126665_length_335_cov_3.923729	163	231	2	58	68	0.8529412
NODE_126787_length_335_cov_2.411017	230	294	6	57	64	0.8906250
NODE_126787_length_335_cov_2.411017	230	294	8	7	64	0.1093750
NODE_126791_length_335_cov_2.402542	164	240	8	1	76	0.0131579
NODE_126791_length_335_cov_2.402542	164	240	10	2	76	0.0263158
NODE_126791_length_335_cov_2.402542	164	240	12	37	76	0.4868421
NODE_126791_length_335_cov_2.402542	164	240	16	3	76	0.0394737
NODE_126791_length_335_cov_2.402542	164	240	18	5	76	0.0657895
NODE_126791_length_335_cov_2.402542	164	240	19	3	76	0.0394737
NODE_126791_length_335_cov_2.402542	164	240	20	7	76	0.0921053
NODE_126791_length_335_cov_2.402542	164	240	24	8	76	0.1052632
NODE_126791_length_335_cov_2.402542	164	240	26	10	76	0.1315790
NODE_126792_length_335_cov_2.398305	116	179	0	63	63	1.0000000
NODE_126826_length_335_cov_2.161017	82	141	0	59	59	1.0000000
NODE_126835_length_335_cov_2.152542	61	134	0	73	73	1.0000000
NODE_126835_length_335_cov_2.152542	114	134	0	20	20	1.0000000
NODE_126920_length_335_cov_1.766949	257	330	0	11	73	0.1506849
NODE_126920_length_335_cov_1.766949	257	330	2	35	73	0.4794520
NODE_126920_length_335_cov_1.766949	257	330	4	27	73	0.3698630
NODE_126920_length_335_cov_1.766949	297	335	0	16	38	0.4210526
NODE_126920_length_335_cov_1.766949	297	335	2	22	38	0.5789474
NODE_127022_length_335_cov_1.529661	255	320	2	65	65	1.0000000
NODE_127023_length_335_cov_1.525424	222	266	2	44	44	1.0000000
NODE_127062_length_335_cov_1.457627	38	87	0	49	49	1.0000000
NODE_127130_length_335_cov_1.296610	291	311	0	20	20	1.0000000
NODE_127130_length_335_cov_1.296610	291	311	0	20	20	1.0000000
NODE_127143_length_335_cov_1.292373	202	232	8	13	30	0.4333333
NODE_127143_length_335_cov_1.292373	202	232	10	12	30	0.4000000
NODE_127143_length_335_cov_1.292373	202	232	12	1	30	0.0333333
NODE_127143_length_335_cov_1.292373	202	232	14	4	30	0.1333333
NODE_127200_length_335_cov_1.194915	75	156	21	1	81	0.0123457
NODE_127200_length_335_cov_1.194915	75	156	25	2	81	0.0246914
NODE_127200_length_335_cov_1.194915	75	156	27	10	81	0.1234568
NODE_127200_length_335_cov_1.194915	75	156	29	40	81	0.4938272
NODE_127200_length_335_cov_1.194915	75	156	31	11	81	0.1358025
NODE_127200_length_335_cov_1.194915	75	156	32	17	81	0.2098765
NODE_127200_length_335_cov_1.194915	129	195	20	1	66	0.0151515
NODE_127200_length_335_cov_1.194915	129	195	21	4	66	0.0606061
NODE_127200_length_335_cov_1.194915	129	195	23	1	66	0.0151515
NODE_127200_length_335_cov_1.194915	129	195	24	7	66	0.1060606
NODE_127200_length_335_cov_1.194915	129	195	25	6	66	0.0909091
NODE_127200_length_335_cov_1.194915	129	195	26	4	66	0.0606061
NODE_127200_length_335_cov_1.194915	129	195	27	14	66	0.2121212
NODE_127200_length_335_cov_1.194915	129	195	29	23	66	0.3484848
NODE_127200_length_335_cov_1.194915	129	195	30	4	66	0.0606061
NODE_127200_length_335_cov_1.194915	129	195	31	2	66	0.0303030
NODE_127310_length_335_cov_0.983051	96	117	0	21	21	1.0000000
NODE_127585_length_334_cov_275.425532	135	215	439	2	80	0.0250000
NODE_127585_length_334_cov_275.425532	135	215	442	1	80	0.0125000
NODE_127585_length_334_cov_275.425532	135	215	452	1	80	0.0125000
NODE_127585_length_334_cov_275.425532	135	215	466	1	80	0.0125000
NODE_127585_length_334_cov_275.425532	135	215	475	1	80	0.0125000
NODE_127585_length_334_cov_275.425532	135	215	483	1	80	0.0125000
NODE_127585_length_334_cov_275.425532	135	215	487	1	80	0.0125000
NODE_127585_length_334_cov_275.425532	135	215	489	1	80	0.0125000
NODE_127585_length_334_cov_275.425532	135	215	500	1	80	0.0125000
NODE_127585_length_334_cov_275.425532	135	215	504	1	80	0.0125000
NODE_127585_length_334_cov_275.425532	135	215	507	1	80	0.0125000
NODE_127585_length_334_cov_275.425532	135	215	508	1	80	0.0125000
NODE_127585_length_334_cov_275.425532	135	215	509	2	80	0.0250000
NODE_127585_length_334_cov_275.425532	135	215	510	1	80	0.0125000
NODE_127585_length_334_cov_275.425532	135	215	511	1	80	0.0125000
NODE_127585_length_334_cov_275.425532	135	215	514	1	80	0.0125000
NODE_127585_length_334_cov_275.425532	135	215	519	2	80	0.0250000
NODE_127585_length_334_cov_275.425532	135	215	523	1	80	0.0125000
NODE_127585_length_334_cov_275.425532	135	215	528	1	80	0.0125000
NODE_127585_length_334_cov_275.425532	135	215	529	2	80	0.0250000
NODE_127585_length_334_cov_275.425532	135	215	531	1	80	0.0125000
NODE_127585_length_334_cov_275.425532	135	215	537	1	80	0.0125000
NODE_127585_length_334_cov_275.425532	135	215	544	2	80	0.0250000
NODE_127585_length_334_cov_275.425532	135	215	550	1	80	0.0125000
NODE_127585_length_334_cov_275.425532	135	215	563	1	80	0.0125000
NODE_127585_length_334_cov_275.425532	135	215	565	1	80	0.0125000
NODE_127585_length_334_cov_275.425532	135	215	566	1	80	0.0125000
NODE_127585_length_334_cov_275.425532	135	215	567	1	80	0.0125000
NODE_127585_length_334_cov_275.425532	135	215	568	3	80	0.0375000
NODE_127585_length_334_cov_275.425532	135	215	569	1	80	0.0125000
NODE_127585_length_334_cov_275.425532	135	215	570	2	80	0.0250000
NODE_127585_length_334_cov_275.425532	135	215	571	1	80	0.0125000
NODE_127585_length_334_cov_275.425532	135	215	572	1	80	0.0125000
NODE_127585_length_334_cov_275.425532	135	215	576	1	80	0.0125000
NODE_127585_length_334_cov_275.425532	135	215	586	1	80	0.0125000
NODE_127585_length_334_cov_275.425532	135	215	587	1	80	0.0125000
NODE_127585_length_334_cov_275.425532	135	215	589	1	80	0.0125000
NODE_127585_length_334_cov_275.425532	135	215	590	2	80	0.0250000
NODE_127585_length_334_cov_275.425532	135	215	594	1	80	0.0125000
NODE_127585_length_334_cov_275.425532	135	215	595	1	80	0.0125000
NODE_127585_length_334_cov_275.425532	135	215	601	1	80	0.0125000
NODE_127585_length_334_cov_275.425532	135	215	602	2	80	0.0250000
NODE_127585_length_334_cov_275.425532	135	215	604	1	80	0.0125000
NODE_127585_length_334_cov_275.425532	135	215	608	1	80	0.0125000
NODE_127585_length_334_cov_275.425532	135	215	618	1	80	0.0125000
NODE_127585_length_334_cov_275.425532	135	215	621	1	80	0.0125000
NODE_127585_length_334_cov_275.425532	135	215	623	1	80	0.0125000
NODE_127585_length_334_cov_275.425532	135	215	625	1	80	0.0125000
NODE_127585_length_334_cov_275.425532	135	215	626	1	80	0.0125000
NODE_127585_length_334_cov_275.425532	135	215	628	3	80	0.0375000
NODE_127585_length_334_cov_275.425532	135	215	630	1	80	0.0125000
NODE_127585_length_334_cov_275.425532	135	215	631	1	80	0.0125000
NODE_127585_length_334_cov_275.425532	135	215	632	1	80	0.0125000
NODE_127585_length_334_cov_275.425532	135	215	636	2	80	0.0250000
NODE_127585_length_334_cov_275.425532	135	215	640	1	80	0.0125000
NODE_127585_length_334_cov_275.425532	135	215	641	1	80	0.0125000
NODE_127585_length_334_cov_275.425532	135	215	644	1	80	0.0125000
NODE_127585_length_334_cov_275.425532	135	215	645	1	80	0.0125000
NODE_127585_length_334_cov_275.425532	135	215	647	1	80	0.0125000
NODE_127585_length_334_cov_275.425532	135	215	648	2	80	0.0250000
NODE_127585_length_334_cov_275.425532	135	215	650	1	80	0.0125000
NODE_127585_length_334_cov_275.425532	135	215	652	1	80	0.0125000
NODE_127585_length_334_cov_275.425532	135	215	654	1	80	0.0125000
NODE_127585_length_334_cov_275.425532	135	215	655	2	80	0.0250000
NODE_127585_length_334_cov_275.425532	135	215	656	1	80	0.0125000
NODE_127585_length_334_cov_275.425532	188	269	371	2	81	0.0246914
NODE_127585_length_334_cov_275.425532	188	269	373	2	81	0.0246914
NODE_127585_length_334_cov_275.425532	188	269	374	3	81	0.0370370
NODE_127585_length_334_cov_275.425532	188	269	375	1	81	0.0123457
NODE_127585_length_334_cov_275.425532	188	269	377	6	81	0.0740741
NODE_127585_length_334_cov_275.425532	188	269	382	7	81	0.0864198
NODE_127585_length_334_cov_275.425532	188	269	384	3	81	0.0370370
NODE_127585_length_334_cov_275.425532	188	269	387	1	81	0.0123457
NODE_127585_length_334_cov_275.425532	188	269	388	1	81	0.0123457
NODE_127585_length_334_cov_275.425532	188	269	391	2	81	0.0246914
NODE_127585_length_334_cov_275.425532	188	269	392	1	81	0.0123457
NODE_127585_length_334_cov_275.425532	188	269	397	1	81	0.0123457
NODE_127585_length_334_cov_275.425532	188	269	400	1	81	0.0123457
NODE_127585_length_334_cov_275.425532	188	269	401	4	81	0.0493827
NODE_127585_length_334_cov_275.425532	188	269	403	1	81	0.0123457
NODE_127585_length_334_cov_275.425532	188	269	413	2	81	0.0246914
NODE_127585_length_334_cov_275.425532	188	269	415	1	81	0.0123457
NODE_127585_length_334_cov_275.425532	188	269	430	1	81	0.0123457
NODE_127585_length_334_cov_275.425532	188	269	432	1	81	0.0123457
NODE_127585_length_334_cov_275.425532	188	269	441	1	81	0.0123457
NODE_127585_length_334_cov_275.425532	188	269	461	1	81	0.0123457
NODE_127585_length_334_cov_275.425532	188	269	464	2	81	0.0246914
NODE_127585_length_334_cov_275.425532	188	269	466	1	81	0.0123457
NODE_127585_length_334_cov_275.425532	188	269	469	1	81	0.0123457
NODE_127585_length_334_cov_275.425532	188	269	480	1	81	0.0123457
NODE_127585_length_334_cov_275.425532	188	269	482	3	81	0.0370370
NODE_127585_length_334_cov_275.425532	188	269	483	1	81	0.0123457
NODE_127585_length_334_cov_275.425532	188	269	489	1	81	0.0123457
NODE_127585_length_334_cov_275.425532	188	269	505	1	81	0.0123457
NODE_127585_length_334_cov_275.425532	188	269	507	1	81	0.0123457
NODE_127585_length_334_cov_275.425532	188	269	508	1	81	0.0123457
NODE_127585_length_334_cov_275.425532	188	269	509	2	81	0.0246914
NODE_127585_length_334_cov_275.425532	188	269	510	1	81	0.0123457
NODE_127585_length_334_cov_275.425532	188	269	511	1	81	0.0123457
NODE_127585_length_334_cov_275.425532	188	269	514	1	81	0.0123457
NODE_127585_length_334_cov_275.425532	188	269	519	1	81	0.0123457
NODE_127585_length_334_cov_275.425532	188	269	523	1	81	0.0123457
NODE_127585_length_334_cov_275.425532	188	269	528	1	81	0.0123457
NODE_127585_length_334_cov_275.425532	188	269	529	2	81	0.0246914
NODE_127585_length_334_cov_275.425532	188	269	531	1	81	0.0123457
NODE_127585_length_334_cov_275.425532	188	269	537	1	81	0.0123457
NODE_127585_length_334_cov_275.425532	188	269	544	1	81	0.0123457
NODE_127585_length_334_cov_275.425532	188	269	550	1	81	0.0123457
NODE_127585_length_334_cov_275.425532	188	269	563	1	81	0.0123457
NODE_127585_length_334_cov_275.425532	188	269	566	1	81	0.0123457
NODE_127585_length_334_cov_275.425532	188	269	567	1	81	0.0123457
NODE_127585_length_334_cov_275.425532	188	269	568	3	81	0.0370370
NODE_127585_length_334_cov_275.425532	188	269	569	1	81	0.0123457
NODE_127585_length_334_cov_275.425532	188	269	570	2	81	0.0246914
NODE_127585_length_334_cov_275.425532	188	269	572	1	81	0.0123457
NODE_127585_length_334_cov_275.425532	188	269	576	1	81	0.0123457
NODE_127586_length_334_cov_14.753191	135	215	0	80	80	1.0000000
NODE_127586_length_334_cov_14.753191	188	268	0	80	80	1.0000000
NODE_127610_length_334_cov_4.829787	92	174	0	26	82	0.3170732
NODE_127610_length_334_cov_4.829787	92	174	1	8	82	0.0975610
NODE_127610_length_334_cov_4.829787	92	174	2	48	82	0.5853658
NODE_127610_length_334_cov_4.829787	151	237	2	86	86	1.0000000
NODE_127612_length_334_cov_4.817021	179	231	0	52	52	1.0000000
NODE_127626_length_334_cov_4.438298	121	201	10	31	80	0.3875000
NODE_127626_length_334_cov_4.438298	121	201	12	42	80	0.5250000
NODE_127626_length_334_cov_4.438298	121	201	14	7	80	0.0875000
NODE_127672_length_334_cov_3.604255	248	314	2	66	66	1.0000000
NODE_127672_length_334_cov_3.604255	287	334	2	47	47	1.0000000
NODE_127844_length_334_cov_2.165957	0	48	0	48	48	1.0000000
NODE_128026_length_334_cov_1.595745	253	328	2	3	75	0.0400000
NODE_128026_length_334_cov_1.595745	253	328	4	72	75	0.9600000
NODE_128258_length_334_cov_1.157447	146	177	0	31	31	1.0000000
NODE_128665_length_333_cov_5.423077	172	242	0	63	70	0.9000000
NODE_128665_length_333_cov_5.423077	172	242	1	2	70	0.0285714
NODE_128665_length_333_cov_5.423077	172	242	2	5	70	0.0714286
NODE_128673_length_333_cov_4.867521	122	172	0	5	50	0.1000000
NODE_128673_length_333_cov_4.867521	122	172	2	45	50	0.9000000
NODE_128673_length_333_cov_4.867521	175	255	0	51	80	0.6375000
NODE_128673_length_333_cov_4.867521	175	255	2	29	80	0.3625000
NODE_128673_length_333_cov_4.867521	194	219	0	15	25	0.6000000
NODE_128673_length_333_cov_4.867521	194	219	2	10	25	0.4000000
NODE_128717_length_333_cov_3.717949	49	129	0	40	80	0.5000000
NODE_128717_length_333_cov_3.717949	49	129	2	33	80	0.4125000
NODE_128717_length_333_cov_3.717949	49	129	4	7	80	0.0875000
NODE_128717_length_333_cov_3.717949	102	182	2	20	80	0.2500000
NODE_128717_length_333_cov_3.717949	102	182	4	31	80	0.3875000
NODE_128717_length_333_cov_3.717949	102	182	6	29	80	0.3625000
NODE_128767_length_333_cov_2.897436	59	139	7	5	80	0.0625000
NODE_128767_length_333_cov_2.897436	59	139	8	14	80	0.1750000
NODE_128767_length_333_cov_2.897436	59	139	9	4	80	0.0500000
NODE_128767_length_333_cov_2.897436	59	139	10	17	80	0.2125000
NODE_128767_length_333_cov_2.897436	59	139	14	11	80	0.1375000
NODE_128767_length_333_cov_2.897436	59	139	15	10	80	0.1250000
NODE_128767_length_333_cov_2.897436	59	139	19	4	80	0.0500000
NODE_128767_length_333_cov_2.897436	59	139	20	15	80	0.1875000
NODE_128850_length_333_cov_2.307692	68	148	2	80	80	1.0000000
NODE_128933_length_333_cov_1.940171	135	215	0	55	80	0.6875000
NODE_128933_length_333_cov_1.940171	135	215	2	25	80	0.3125000
NODE_129252_length_333_cov_1.200855	0	80	0	80	80	1.0000000
NODE_129263_length_333_cov_1.170940	146	193	6	3	47	0.0638298
NODE_129263_length_333_cov_1.170940	146	193	8	17	47	0.3617021
NODE_129263_length_333_cov_1.170940	146	193	10	27	47	0.5744681
NODE_129263_length_333_cov_1.170940	203	243	6	9	40	0.2250000
NODE_129263_length_333_cov_1.170940	203	243	8	8	40	0.2000000
NODE_129263_length_333_cov_1.170940	203	243	10	23	40	0.5750000
NODE_129303_length_333_cov_1.089744	241	306	4	65	65	1.0000000
NODE_129310_length_333_cov_1.089744	206	226	0	16	20	0.8000000
NODE_129310_length_333_cov_1.089744	206	226	2	4	20	0.2000000
NODE_129665_length_332_cov_5.386266	101	167	0	66	66	1.0000000
NODE_129680_length_332_cov_4.768240	221	250	4	29	29	1.0000000
NODE_129695_length_332_cov_4.343348	130	179	0	49	49	1.0000000
NODE_129698_length_332_cov_4.201717	191	237	4	10	46	0.2173913
NODE_129698_length_332_cov_4.201717	191	237	6	36	46	0.7826087
NODE_129698_length_332_cov_4.201717	211	290	0	14	79	0.1772152
NODE_129698_length_332_cov_4.201717	211	290	2	14	79	0.1772152
NODE_129698_length_332_cov_4.201717	211	290	6	51	79	0.6455696
NODE_129879_length_332_cov_2.274678	187	227	16	10	40	0.2500000
NODE_129879_length_332_cov_2.274678	187	227	18	3	40	0.0750000
NODE_129879_length_332_cov_2.274678	187	227	20	1	40	0.0250000
NODE_129879_length_332_cov_2.274678	187	227	24	1	40	0.0250000
NODE_129879_length_332_cov_2.274678	187	227	26	3	40	0.0750000
NODE_129879_length_332_cov_2.274678	187	227	32	3	40	0.0750000
NODE_129879_length_332_cov_2.274678	187	227	36	1	40	0.0250000
NODE_129879_length_332_cov_2.274678	187	227	40	1	40	0.0250000
NODE_129879_length_332_cov_2.274678	187	227	47	1	40	0.0250000
NODE_129879_length_332_cov_2.274678	187	227	50	1	40	0.0250000
NODE_129879_length_332_cov_2.274678	187	227	58	1	40	0.0250000
NODE_129879_length_332_cov_2.274678	187	227	64	2	40	0.0500000
NODE_129879_length_332_cov_2.274678	187	227	70	1	40	0.0250000
NODE_129879_length_332_cov_2.274678	187	227	72	1	40	0.0250000
NODE_129879_length_332_cov_2.274678	187	227	74	1	40	0.0250000
NODE_129879_length_332_cov_2.274678	187	227	76	1	40	0.0250000
NODE_129879_length_332_cov_2.274678	187	227	80	1	40	0.0250000
NODE_129879_length_332_cov_2.274678	187	227	84	3	40	0.0750000
NODE_129879_length_332_cov_2.274678	187	227	86	2	40	0.0500000
NODE_129879_length_332_cov_2.274678	187	227	88	1	40	0.0250000
NODE_129879_length_332_cov_2.274678	187	227	90	1	40	0.0250000
NODE_129901_length_332_cov_2.184549	194	258	0	33	64	0.5156250
NODE_129901_length_332_cov_2.184549	194	258	2	31	64	0.4843750
NODE_130053_length_332_cov_1.682403	241	316	0	75	75	1.0000000
NODE_130055_length_332_cov_1.673820	157	220	0	63	63	1.0000000
NODE_130183_length_332_cov_1.364807	132	212	0	43	80	0.5375000
NODE_130183_length_332_cov_1.364807	132	212	2	18	80	0.2250000
NODE_130183_length_332_cov_1.364807	132	212	4	5	80	0.0625000
NODE_130183_length_332_cov_1.364807	132	212	8	14	80	0.1750000
NODE_130187_length_332_cov_1.356223	276	332	0	1	56	0.0178571
NODE_130187_length_332_cov_1.356223	276	332	3	1	56	0.0178571
NODE_130187_length_332_cov_1.356223	276	332	6	6	56	0.1071429
NODE_130187_length_332_cov_1.356223	276	332	8	48	56	0.8571429
NODE_130312_length_332_cov_1.210300	120	176	0	8	56	0.1428571
NODE_130312_length_332_cov_1.210300	120	176	4	18	56	0.3214286
NODE_130312_length_332_cov_1.210300	120	176	8	25	56	0.4464286
NODE_130312_length_332_cov_1.210300	120	176	10	5	56	0.0892857
NODE_130757_length_331_cov_5.254310	141	221	0	35	80	0.4375000
NODE_130757_length_331_cov_5.254310	141	221	2	45	80	0.5625000
NODE_130757_length_331_cov_5.254310	194	274	0	29	80	0.3625000
NODE_130757_length_331_cov_5.254310	194	274	2	51	80	0.6375000
NODE_130781_length_331_cov_4.323276	26	108	2	9	82	0.1097561
NODE_130781_length_331_cov_4.323276	26	108	4	4	82	0.0487805
NODE_130781_length_331_cov_4.323276	26	108	6	34	82	0.4146341
NODE_130781_length_331_cov_4.323276	26	108	7	6	82	0.0731707
NODE_130781_length_331_cov_4.323276	26	108	11	6	82	0.0731707
NODE_130781_length_331_cov_4.323276	26	108	13	2	82	0.0243902
NODE_130781_length_331_cov_4.323276	26	108	15	20	82	0.2439024
NODE_130781_length_331_cov_4.323276	26	108	17	1	82	0.0121951
NODE_130902_length_331_cov_2.603448	128	181	0	41	53	0.7735849
NODE_130902_length_331_cov_2.603448	128	181	2	12	53	0.2264151
NODE_131036_length_331_cov_1.965517	183	216	2	33	33	1.0000000
NODE_131054_length_331_cov_1.896552	266	331	0	4	65	0.0615385
NODE_131054_length_331_cov_1.896552	266	331	2	51	65	0.7846154
NODE_131054_length_331_cov_1.896552	266	331	4	10	65	0.1538462
NODE_131817_length_330_cov_14.731602	209	280	0	9	71	0.1267606
NODE_131817_length_330_cov_14.731602	209	280	2	25	71	0.3521127
NODE_131817_length_330_cov_14.731602	209	280	5	1	71	0.0140845
NODE_131817_length_330_cov_14.731602	209	280	6	36	71	0.5070422
NODE_131840_length_330_cov_4.935065	16	97	20	12	81	0.1481481
NODE_131840_length_330_cov_4.935065	16	97	22	1	81	0.0123457
NODE_131840_length_330_cov_4.935065	16	97	24	68	81	0.8395061
NODE_131840_length_330_cov_4.935065	81	149	0	14	68	0.2058824
NODE_131840_length_330_cov_4.935065	81	149	4	16	68	0.2352941
NODE_131840_length_330_cov_4.935065	81	149	6	6	68	0.0882353
NODE_131840_length_330_cov_4.935065	81	149	10	12	68	0.1764706
NODE_131840_length_330_cov_4.935065	81	149	14	3	68	0.0441176
NODE_131840_length_330_cov_4.935065	81	149	16	1	68	0.0147059
NODE_131840_length_330_cov_4.935065	81	149	20	5	68	0.0735294
NODE_131840_length_330_cov_4.935065	81	149	22	1	68	0.0147059
NODE_131840_length_330_cov_4.935065	81	149	24	10	68	0.1470588
NODE_131841_length_330_cov_4.891775	177	255	0	10	78	0.1282051
NODE_131841_length_330_cov_4.891775	177	255	2	68	78	0.8717949
NODE_131845_length_330_cov_4.740260	134	209	0	7	75	0.0933333
NODE_131845_length_330_cov_4.740260	134	209	1	3	75	0.0400000
NODE_131845_length_330_cov_4.740260	134	209	2	2	75	0.0266667
NODE_131845_length_330_cov_4.740260	134	209	3	21	75	0.2800000
NODE_131845_length_330_cov_4.740260	134	209	6	42	75	0.5600000
NODE_131892_length_330_cov_3.467532	161	225	5	15	64	0.2343750
NODE_131892_length_330_cov_3.467532	161	225	7	43	64	0.6718750
NODE_131892_length_330_cov_3.467532	161	225	9	6	64	0.0937500
NODE_131969_length_330_cov_2.601732	8	88	0	80	80	1.0000000
NODE_132188_length_330_cov_1.623377	154	200	0	46	46	1.0000000
NODE_132238_length_330_cov_1.541126	98	156	0	58	58	1.0000000
NODE_132268_length_330_cov_1.467532	234	287	0	53	53	1.0000000
NODE_132268_length_330_cov_1.467532	242	283	0	41	41	1.0000000
NODE_132306_length_330_cov_1.346320	230	296	4	59	66	0.8939394
NODE_132306_length_330_cov_1.346320	230	296	6	7	66	0.1060606
NODE_132306_length_330_cov_1.346320	230	257	4	20	27	0.7407407
NODE_132306_length_330_cov_1.346320	230	257	6	7	27	0.2592593
NODE_132410_length_330_cov_1.220779	249	272	0	23	23	1.0000000
NODE_132478_length_330_cov_1.103896	189	227	0	38	38	1.0000000
NODE_132542_length_330_cov_1.038961	219	297	20	3	78	0.0384615
NODE_132542_length_330_cov_1.038961	219	297	21	3	78	0.0384615
NODE_132542_length_330_cov_1.038961	219	297	23	3	78	0.0384615
NODE_132542_length_330_cov_1.038961	219	297	28	2	78	0.0256410
NODE_132542_length_330_cov_1.038961	219	297	39	8	78	0.1025641
NODE_132542_length_330_cov_1.038961	219	297	43	1	78	0.0128205
NODE_132542_length_330_cov_1.038961	219	297	47	5	78	0.0641026
NODE_132542_length_330_cov_1.038961	219	297	50	2	78	0.0256410
NODE_132542_length_330_cov_1.038961	219	297	53	9	78	0.1153846
NODE_132542_length_330_cov_1.038961	219	297	68	6	78	0.0769231
NODE_132542_length_330_cov_1.038961	219	297	70	2	78	0.0256410
NODE_132542_length_330_cov_1.038961	219	297	71	1	78	0.0128205
NODE_132542_length_330_cov_1.038961	219	297	73	2	78	0.0256410
NODE_132542_length_330_cov_1.038961	219	297	75	4	78	0.0512821
NODE_132542_length_330_cov_1.038961	219	297	76	1	78	0.0128205
NODE_132542_length_330_cov_1.038961	219	297	77	2	78	0.0256410
NODE_132542_length_330_cov_1.038961	219	297	82	1	78	0.0128205
NODE_132542_length_330_cov_1.038961	219	297	86	4	78	0.0512821
NODE_132542_length_330_cov_1.038961	219	297	90	1	78	0.0128205
NODE_132542_length_330_cov_1.038961	219	297	92	2	78	0.0256410
NODE_132542_length_330_cov_1.038961	219	297	94	2	78	0.0256410
NODE_132542_length_330_cov_1.038961	219	297	96	2	78	0.0256410
NODE_132542_length_330_cov_1.038961	219	297	97	2	78	0.0256410
NODE_132542_length_330_cov_1.038961	219	297	101	2	78	0.0256410
NODE_132542_length_330_cov_1.038961	219	297	102	1	78	0.0128205
NODE_132542_length_330_cov_1.038961	219	297	110	1	78	0.0128205
NODE_132542_length_330_cov_1.038961	219	297	112	4	78	0.0512821
NODE_132542_length_330_cov_1.038961	219	297	113	1	78	0.0128205
NODE_132542_length_330_cov_1.038961	219	297	114	1	78	0.0128205
NODE_132688_length_330_cov_0.883117	284	330	0	46	46	1.0000000
NODE_132873_length_329_cov_110.178261	138	167	14	11	29	0.3793103
NODE_132873_length_329_cov_110.178261	138	167	15	1	29	0.0344828
NODE_132873_length_329_cov_110.178261	138	167	16	17	29	0.5862069
NODE_132873_length_329_cov_110.178261	189	269	6	4	80	0.0500000
NODE_132873_length_329_cov_110.178261	189	269	10	7	80	0.0875000
NODE_132873_length_329_cov_110.178261	189	269	12	2	80	0.0250000
NODE_132873_length_329_cov_110.178261	189	269	14	11	80	0.1375000
NODE_132873_length_329_cov_110.178261	189	269	16	4	80	0.0500000
NODE_132873_length_329_cov_110.178261	189	269	18	14	80	0.1750000
NODE_132873_length_329_cov_110.178261	189	269	20	2	80	0.0250000
NODE_132873_length_329_cov_110.178261	189	269	23	10	80	0.1250000
NODE_132873_length_329_cov_110.178261	189	269	24	14	80	0.1750000
NODE_132873_length_329_cov_110.178261	189	269	25	4	80	0.0500000
NODE_132873_length_329_cov_110.178261	189	269	26	8	80	0.1000000
NODE_132873_length_329_cov_110.178261	242	322	0	19	80	0.2375000
NODE_132873_length_329_cov_110.178261	242	322	2	12	80	0.1500000
NODE_132873_length_329_cov_110.178261	242	322	4	5	80	0.0625000
NODE_132873_length_329_cov_110.178261	242	322	6	21	80	0.2625000
NODE_132873_length_329_cov_110.178261	242	322	10	7	80	0.0875000
NODE_132873_length_329_cov_110.178261	242	322	12	2	80	0.0250000
NODE_132873_length_329_cov_110.178261	242	322	14	11	80	0.1375000
NODE_132873_length_329_cov_110.178261	242	322	16	3	80	0.0375000
NODE_132879_length_329_cov_8.882609	61	141	0	80	80	1.0000000
NODE_132879_length_329_cov_8.882609	114	194	0	80	80	1.0000000
NODE_132885_length_329_cov_6.586957	166	207	8	41	41	1.0000000
NODE_132908_length_329_cov_4.617391	175	229	0	54	54	1.0000000
NODE_132970_length_329_cov_3.160870	59	139	0	80	80	1.0000000
NODE_133003_length_329_cov_2.821739	164	209	6	45	45	1.0000000
NODE_133003_length_329_cov_2.821739	184	262	0	2	78	0.0256410
NODE_133003_length_329_cov_2.821739	184	262	2	14	78	0.1794872
NODE_133003_length_329_cov_2.821739	184	262	4	32	78	0.4102564
NODE_133003_length_329_cov_2.821739	184	262	6	30	78	0.3846154
NODE_133033_length_329_cov_2.560870	139	201	0	27	62	0.4354839
NODE_133033_length_329_cov_2.560870	139	201	2	35	62	0.5645161
NODE_133036_length_329_cov_2.543478	145	206	2	61	61	1.0000000
NODE_133123_length_329_cov_2.143478	39	119	6	21	80	0.2625000
NODE_133123_length_329_cov_2.143478	39	119	8	3	80	0.0375000
NODE_133123_length_329_cov_2.143478	39	119	10	3	80	0.0375000
NODE_133123_length_329_cov_2.143478	39	119	12	3	80	0.0375000
NODE_133123_length_329_cov_2.143478	39	119	16	5	80	0.0625000
NODE_133123_length_329_cov_2.143478	39	119	18	6	80	0.0750000
NODE_133123_length_329_cov_2.143478	39	119	20	25	80	0.3125000
NODE_133123_length_329_cov_2.143478	39	119	22	14	80	0.1750000
NODE_133123_length_329_cov_2.143478	92	158	18	18	66	0.2727273
NODE_133123_length_329_cov_2.143478	92	158	20	22	66	0.3333333
NODE_133123_length_329_cov_2.143478	92	158	22	26	66	0.3939394
NODE_133184_length_329_cov_1.865217	182	252	3	21	70	0.3000000
NODE_133184_length_329_cov_1.865217	182	252	9	4	70	0.0571429
NODE_133184_length_329_cov_1.865217	182	252	13	4	70	0.0571429
NODE_133184_length_329_cov_1.865217	182	252	17	9	70	0.1285714
NODE_133184_length_329_cov_1.865217	182	252	20	32	70	0.4571429
NODE_133200_length_329_cov_1.791304	50	84	0	34	34	1.0000000
NODE_133200_length_329_cov_1.791304	92	149	0	57	57	1.0000000
NODE_133200_length_329_cov_1.791304	145	203	0	27	58	0.4655173
NODE_133200_length_329_cov_1.791304	145	203	2	2	58	0.0344828
NODE_133200_length_329_cov_1.791304	145	203	4	29	58	0.5000000
NODE_133332_length_329_cov_1.508696	261	323	0	62	62	1.0000000
NODE_133348_length_329_cov_1.469565	168	237	0	69	69	1.0000000
NODE_133376_length_329_cov_1.391304	275	307	17	30	32	0.9375000
NODE_133376_length_329_cov_1.391304	275	307	19	2	32	0.0625000
NODE_133547_length_329_cov_1.165217	199	242	0	43	43	1.0000000
NODE_133768_length_329_cov_0.878261	221	296	2	16	75	0.2133333
NODE_133768_length_329_cov_0.878261	221	296	4	59	75	0.7866667
NODE_133970_length_328_cov_4.484716	95	175	10	6	80	0.0750000
NODE_133970_length_328_cov_4.484716	95	175	12	45	80	0.5625000
NODE_133970_length_328_cov_4.484716	95	175	14	29	80	0.3625000
NODE_133989_length_328_cov_4.087336	79	159	3	3	80	0.0375000
NODE_133989_length_328_cov_4.087336	79	159	4	4	80	0.0500000
NODE_133989_length_328_cov_4.087336	79	159	8	58	80	0.7250000
NODE_133989_length_328_cov_4.087336	79	159	10	15	80	0.1875000
NODE_133989_length_328_cov_4.087336	132	207	3	27	75	0.3600000
NODE_133989_length_328_cov_4.087336	132	207	4	23	75	0.3066667
NODE_133989_length_328_cov_4.087336	132	207	5	5	75	0.0666667
NODE_133989_length_328_cov_4.087336	132	207	8	7	75	0.0933333
NODE_133989_length_328_cov_4.087336	132	207	10	13	75	0.1733333
NODE_133993_length_328_cov_3.895197	110	190	8	12	80	0.1500000
NODE_133993_length_328_cov_3.895197	110	190	10	68	80	0.8500000
NODE_134019_length_328_cov_3.393013	30	78	2	48	48	1.0000000
NODE_134144_length_328_cov_2.161572	103	134	8	23	31	0.7419355
NODE_134144_length_328_cov_2.161572	103	134	10	3	31	0.0967742
NODE_134144_length_328_cov_2.161572	103	134	12	5	31	0.1612903
NODE_134247_length_328_cov_1.781659	16	44	0	28	28	1.0000000
NODE_134335_length_328_cov_1.567686	0	76	0	76	76	1.0000000
NODE_134335_length_328_cov_1.567686	49	94	0	44	45	0.9777778
NODE_134335_length_328_cov_1.567686	49	94	2	1	45	0.0222222
NODE_134452_length_328_cov_1.336245	0	73	0	73	73	1.0000000
NODE_134508_length_328_cov_1.266376	78	158	0	39	80	0.4875000
NODE_134508_length_328_cov_1.266376	78	158	2	41	80	0.5125000
NODE_135002_length_327_cov_4.934211	170	250	0	25	80	0.3125000
NODE_135002_length_327_cov_4.934211	170	250	2	55	80	0.6875000
NODE_135009_length_327_cov_4.701754	225	305	0	45	80	0.5625000
NODE_135009_length_327_cov_4.701754	225	305	2	24	80	0.3000000
NODE_135009_length_327_cov_4.701754	225	305	4	11	80	0.1375000
NODE_135018_length_327_cov_4.241228	97	173	12	2	76	0.0263158
NODE_135018_length_327_cov_4.241228	97	173	15	4	76	0.0526316
NODE_135018_length_327_cov_4.241228	97	173	17	23	76	0.3026316
NODE_135018_length_327_cov_4.241228	97	173	19	47	76	0.6184211
NODE_135037_length_327_cov_3.719298	70	150	0	45	80	0.5625000
NODE_135037_length_327_cov_3.719298	70	150	2	35	80	0.4375000
NODE_135063_length_327_cov_3.350877	156	227	0	66	71	0.9295775
NODE_135063_length_327_cov_3.350877	156	227	2	5	71	0.0704225
NODE_135328_length_327_cov_1.780702	191	271	13	1	80	0.0125000
NODE_135328_length_327_cov_1.780702	191	271	17	5	80	0.0625000
NODE_135328_length_327_cov_1.780702	191	271	18	1	80	0.0125000
NODE_135328_length_327_cov_1.780702	191	271	20	7	80	0.0875000
NODE_135328_length_327_cov_1.780702	191	271	26	4	80	0.0500000
NODE_135328_length_327_cov_1.780702	191	271	28	1	80	0.0125000
NODE_135328_length_327_cov_1.780702	191	271	30	2	80	0.0250000
NODE_135328_length_327_cov_1.780702	191	271	32	59	80	0.7375000
NODE_136081_length_326_cov_3.964758	178	228	0	50	50	1.0000000
NODE_136100_length_326_cov_3.502203	211	253	0	42	42	1.0000000
NODE_136100_length_326_cov_3.502203	220	255	0	35	35	1.0000000
NODE_136116_length_326_cov_3.202643	149	203	0	2	54	0.0370370
NODE_136116_length_326_cov_3.202643	149	203	2	4	54	0.0740741
NODE_136116_length_326_cov_3.202643	149	203	4	3	54	0.0555556
NODE_136116_length_326_cov_3.202643	149	203	6	6	54	0.1111111
NODE_136116_length_326_cov_3.202643	149	203	8	39	54	0.7222222
NODE_136130_length_326_cov_3.057269	107	126	0	19	19	1.0000000
NODE_136176_length_326_cov_2.594714	125	196	0	2	71	0.0281690
NODE_136176_length_326_cov_2.594714	125	196	4	69	71	0.9718310
NODE_136283_length_326_cov_2.123348	184	244	2	60	60	1.0000000
NODE_136496_length_326_cov_1.515419	86	166	0	80	80	1.0000000
NODE_137182_length_325_cov_4.893805	142	222	47	8	80	0.1000000
NODE_137182_length_325_cov_4.893805	142	222	49	19	80	0.2375000
NODE_137182_length_325_cov_4.893805	142	222	50	4	80	0.0500000
NODE_137182_length_325_cov_4.893805	142	222	52	8	80	0.1000000
NODE_137182_length_325_cov_4.893805	142	222	54	12	80	0.1500000
NODE_137182_length_325_cov_4.893805	142	222	56	8	80	0.1000000
NODE_137182_length_325_cov_4.893805	142	222	58	6	80	0.0750000
NODE_137182_length_325_cov_4.893805	142	222	60	14	80	0.1750000
NODE_137182_length_325_cov_4.893805	142	222	62	1	80	0.0125000
NODE_137182_length_325_cov_4.893805	195	275	15	3	80	0.0375000
NODE_137182_length_325_cov_4.893805	195	275	17	3	80	0.0375000
NODE_137182_length_325_cov_4.893805	195	275	19	9	80	0.1125000
NODE_137182_length_325_cov_4.893805	195	275	20	7	80	0.0875000
NODE_137182_length_325_cov_4.893805	195	275	21	1	80	0.0125000
NODE_137182_length_325_cov_4.893805	195	275	22	3	80	0.0375000
NODE_137182_length_325_cov_4.893805	195	275	24	1	80	0.0125000
NODE_137182_length_325_cov_4.893805	195	275	26	1	80	0.0125000
NODE_137182_length_325_cov_4.893805	195	275	27	1	80	0.0125000
NODE_137182_length_325_cov_4.893805	195	275	29	4	80	0.0500000
NODE_137182_length_325_cov_4.893805	195	275	33	2	80	0.0250000
NODE_137182_length_325_cov_4.893805	195	275	34	1	80	0.0125000
NODE_137182_length_325_cov_4.893805	195	275	36	1	80	0.0125000
NODE_137182_length_325_cov_4.893805	195	275	38	1	80	0.0125000
NODE_137182_length_325_cov_4.893805	195	275	39	1	80	0.0125000
NODE_137182_length_325_cov_4.893805	195	275	40	2	80	0.0250000
NODE_137182_length_325_cov_4.893805	195	275	42	3	80	0.0375000
NODE_137182_length_325_cov_4.893805	195	275	52	8	80	0.1000000
NODE_137182_length_325_cov_4.893805	195	275	54	4	80	0.0500000
NODE_137182_length_325_cov_4.893805	195	275	56	3	80	0.0375000
NODE_137182_length_325_cov_4.893805	195	275	58	6	80	0.0750000
NODE_137182_length_325_cov_4.893805	195	275	60	14	80	0.1750000
NODE_137182_length_325_cov_4.893805	195	275	62	1	80	0.0125000
NODE_137199_length_325_cov_4.000000	134	198	0	64	64	1.0000000
NODE_137221_length_325_cov_3.513274	191	266	38	2	75	0.0266667
NODE_137221_length_325_cov_3.513274	191	266	40	8	75	0.1066667
NODE_137221_length_325_cov_3.513274	191	266	42	10	75	0.1333333
NODE_137221_length_325_cov_3.513274	191	266	44	10	75	0.1333333
NODE_137221_length_325_cov_3.513274	191	266	45	1	75	0.0133333
NODE_137221_length_325_cov_3.513274	191	266	46	2	75	0.0266667
NODE_137221_length_325_cov_3.513274	191	266	47	6	75	0.0800000
NODE_137221_length_325_cov_3.513274	191	266	48	10	75	0.1333333
NODE_137221_length_325_cov_3.513274	191	266	49	5	75	0.0666667
NODE_137221_length_325_cov_3.513274	191	266	50	5	75	0.0666667
NODE_137221_length_325_cov_3.513274	191	266	52	3	75	0.0400000
NODE_137221_length_325_cov_3.513274	191	266	53	2	75	0.0266667
NODE_137221_length_325_cov_3.513274	191	266	56	2	75	0.0266667
NODE_137221_length_325_cov_3.513274	191	266	58	9	75	0.1200000
NODE_137221_length_325_cov_3.513274	240	319	2	5	79	0.0632911
NODE_137221_length_325_cov_3.513274	240	319	6	3	79	0.0379747
NODE_137221_length_325_cov_3.513274	240	319	8	10	79	0.1265823
NODE_137221_length_325_cov_3.513274	240	319	10	1	79	0.0126582
NODE_137221_length_325_cov_3.513274	240	319	12	1	79	0.0126582
NODE_137221_length_325_cov_3.513274	240	319	14	1	79	0.0126582
NODE_137221_length_325_cov_3.513274	240	319	20	7	79	0.0886076
NODE_137221_length_325_cov_3.513274	240	319	22	2	79	0.0253165
NODE_137221_length_325_cov_3.513274	240	319	24	1	79	0.0126582
NODE_137221_length_325_cov_3.513274	240	319	26	2	79	0.0253165
NODE_137221_length_325_cov_3.513274	240	319	28	2	79	0.0253165
NODE_137221_length_325_cov_3.513274	240	319	29	5	79	0.0632911
NODE_137221_length_325_cov_3.513274	240	319	30	1	79	0.0126582
NODE_137221_length_325_cov_3.513274	240	319	31	4	79	0.0506329
NODE_137221_length_325_cov_3.513274	240	319	33	1	79	0.0126582
NODE_137221_length_325_cov_3.513274	240	319	35	2	79	0.0253165
NODE_137221_length_325_cov_3.513274	240	319	36	4	79	0.0506329
NODE_137221_length_325_cov_3.513274	240	319	38	3	79	0.0379747
NODE_137221_length_325_cov_3.513274	240	319	40	8	79	0.1012658
NODE_137221_length_325_cov_3.513274	240	319	42	9	79	0.1139240
NODE_137221_length_325_cov_3.513274	240	319	44	7	79	0.0886076
NODE_137223_length_325_cov_3.469027	216	278	0	62	62	1.0000000
NODE_137224_length_325_cov_3.429204	178	224	2	46	46	1.0000000
NODE_137243_length_325_cov_3.168142	188	274	6	86	86	1.0000000
NODE_137268_length_325_cov_2.880531	72	152	0	13	80	0.1625000
NODE_137268_length_325_cov_2.880531	72	152	2	38	80	0.4750000
NODE_137268_length_325_cov_2.880531	72	152	3	7	80	0.0875000
NODE_137268_length_325_cov_2.880531	72	152	4	8	80	0.1000000
NODE_137268_length_325_cov_2.880531	72	152	6	14	80	0.1750000
NODE_137268_length_325_cov_2.880531	125	205	3	5	80	0.0625000
NODE_137268_length_325_cov_2.880531	125	205	4	8	80	0.1000000
NODE_137268_length_325_cov_2.880531	125	205	6	29	80	0.3625000
NODE_137268_length_325_cov_2.880531	125	205	8	20	80	0.2500000
NODE_137268_length_325_cov_2.880531	125	205	10	18	80	0.2250000
NODE_137291_length_325_cov_2.707965	203	261	0	58	58	1.0000000
NODE_137296_length_325_cov_2.703540	68	148	2	10	80	0.1250000
NODE_137296_length_325_cov_2.703540	68	148	4	70	80	0.8750000
NODE_137330_length_325_cov_2.500000	0	42	0	42	42	1.0000000
NODE_137407_length_325_cov_2.048673	122	202	14	9	80	0.1125000
NODE_137407_length_325_cov_2.048673	122	202	18	2	80	0.0250000
NODE_137407_length_325_cov_2.048673	122	202	24	2	80	0.0250000
NODE_137407_length_325_cov_2.048673	122	202	26	2	80	0.0250000
NODE_137407_length_325_cov_2.048673	122	202	28	6	80	0.0750000
NODE_137407_length_325_cov_2.048673	122	202	29	12	80	0.1500000
NODE_137407_length_325_cov_2.048673	122	202	30	8	80	0.1000000
NODE_137407_length_325_cov_2.048673	122	202	31	6	80	0.0750000
NODE_137407_length_325_cov_2.048673	122	202	32	10	80	0.1250000
NODE_137407_length_325_cov_2.048673	122	202	33	15	80	0.1875000
NODE_137407_length_325_cov_2.048673	122	202	35	1	80	0.0125000
NODE_137407_length_325_cov_2.048673	122	202	37	7	80	0.0875000
NODE_137409_length_325_cov_2.035398	83	154	0	71	71	1.0000000
NODE_137642_length_325_cov_1.464602	153	224	0	71	71	1.0000000
NODE_137939_length_325_cov_1.017699	103	134	2	31	31	1.0000000
NODE_138113_length_325_cov_0.827434	258	308	0	3	50	0.0600000
NODE_138113_length_325_cov_0.827434	258	308	2	2	50	0.0400000
NODE_138113_length_325_cov_0.827434	258	308	6	45	50	0.9000000
NODE_138309_length_324_cov_4.737778	113	160	0	47	47	1.0000000
NODE_138309_length_324_cov_4.737778	142	213	0	71	71	1.0000000
NODE_138358_length_324_cov_3.626667	218	273	0	19	55	0.3454545
NODE_138358_length_324_cov_3.626667	218	273	2	36	55	0.6545454
NODE_138396_length_324_cov_3.124444	101	181	0	80	80	1.0000000
NODE_138396_length_324_cov_3.124444	256	285	0	16	29	0.5517241
NODE_138396_length_324_cov_3.124444	256	285	2	13	29	0.4482759
NODE_138416_length_324_cov_2.924444	114	198	4	27	84	0.3214286
NODE_138416_length_324_cov_2.924444	114	198	6	57	84	0.6785714
NODE_138416_length_324_cov_2.924444	178	237	4	24	59	0.4067796
NODE_138416_length_324_cov_2.924444	178	237	6	27	59	0.4576271
NODE_138416_length_324_cov_2.924444	178	237	8	1	59	0.0169492
NODE_138416_length_324_cov_2.924444	178	237	10	7	59	0.1186441
NODE_138418_length_324_cov_2.915556	141	221	0	80	80	1.0000000
NODE_138434_length_324_cov_2.715556	4	51	2	47	47	1.0000000
NODE_138434_length_324_cov_2.715556	24	104	0	21	80	0.2625000
NODE_138434_length_324_cov_2.715556	24	104	2	59	80	0.7375000
NODE_138463_length_324_cov_2.506667	270	306	0	36	36	1.0000000
NODE_138483_length_324_cov_2.448889	187	238	6	51	51	1.0000000
NODE_138527_length_324_cov_2.248889	30	96	0	66	66	1.0000000
NODE_138778_length_324_cov_1.502222	10	90	2	2	80	0.0250000
NODE_138778_length_324_cov_1.502222	10	90	4	23	80	0.2875000
NODE_138778_length_324_cov_1.502222	10	90	6	55	80	0.6875000
NODE_138792_length_324_cov_1.457778	0	45	0	31	45	0.6888889
NODE_138792_length_324_cov_1.457778	0	45	2	14	45	0.3111111
NODE_138792_length_324_cov_1.457778	18	75	0	13	57	0.2280702
NODE_138792_length_324_cov_1.457778	18	75	2	35	57	0.6140351
NODE_138792_length_324_cov_1.457778	18	75	4	1	57	0.0175439
NODE_138792_length_324_cov_1.457778	18	75	10	1	57	0.0175439
NODE_138792_length_324_cov_1.457778	18	75	21	2	57	0.0350877
NODE_138792_length_324_cov_1.457778	18	75	23	2	57	0.0350877
NODE_138792_length_324_cov_1.457778	18	75	29	3	57	0.0526316
NODE_138808_length_324_cov_1.382222	263	304	0	41	41	1.0000000
NODE_139129_length_324_cov_1.017778	0	59	0	59	59	1.0000000
NODE_139497_length_323_cov_6.669643	215	286	2	50	71	0.7042254
NODE_139497_length_323_cov_6.669643	215	286	4	21	71	0.2957746
NODE_139497_length_323_cov_6.669643	268	315	0	17	47	0.3617021
NODE_139497_length_323_cov_6.669643	268	315	2	30	47	0.6382979
NODE_139511_length_323_cov_5.089286	224	290	2	10	66	0.1515152
NODE_139511_length_323_cov_5.089286	224	290	8	56	66	0.8484849
NODE_139511_length_323_cov_5.089286	263	319	8	56	56	1.0000000
NODE_139572_length_323_cov_3.276786	189	269	0	4	80	0.0500000
NODE_139572_length_323_cov_3.276786	189	269	7	25	80	0.3125000
NODE_139572_length_323_cov_3.276786	189	269	8	5	80	0.0625000
NODE_139572_length_323_cov_3.276786	189	269	9	16	80	0.2000000
NODE_139572_length_323_cov_3.276786	189	269	10	1	80	0.0125000
NODE_139572_length_323_cov_3.276786	189	269	11	1	80	0.0125000
NODE_139572_length_323_cov_3.276786	189	269	12	1	80	0.0125000
NODE_139572_length_323_cov_3.276786	189	269	14	1	80	0.0125000
NODE_139572_length_323_cov_3.276786	189	269	17	2	80	0.0250000
NODE_139572_length_323_cov_3.276786	189	269	18	8	80	0.1000000
NODE_139572_length_323_cov_3.276786	189	269	22	3	80	0.0375000
NODE_139572_length_323_cov_3.276786	189	269	24	7	80	0.0875000
NODE_139572_length_323_cov_3.276786	189	269	26	4	80	0.0500000
NODE_139572_length_323_cov_3.276786	189	269	32	2	80	0.0250000
NODE_139575_length_323_cov_3.263393	101	181	30	50	80	0.6250000
NODE_139575_length_323_cov_3.263393	101	181	32	17	80	0.2125000
NODE_139575_length_323_cov_3.263393	101	181	34	9	80	0.1125000
NODE_139575_length_323_cov_3.263393	101	181	36	4	80	0.0500000
NODE_139591_length_323_cov_3.089286	128	208	0	80	80	1.0000000
NODE_139591_length_323_cov_3.089286	166	208	0	42	42	1.0000000
NODE_139591_length_323_cov_3.089286	181	261	0	80	80	1.0000000
NODE_139591_length_323_cov_3.089286	181	261	0	80	80	1.0000000
NODE_139629_length_323_cov_2.683036	144	215	4	1	71	0.0140845
NODE_139629_length_323_cov_2.683036	144	215	10	1	71	0.0140845
NODE_139629_length_323_cov_2.683036	144	215	14	1	71	0.0140845
NODE_139629_length_323_cov_2.683036	144	215	21	2	71	0.0281690
NODE_139629_length_323_cov_2.683036	144	215	22	4	71	0.0563380
NODE_139629_length_323_cov_2.683036	144	215	26	1	71	0.0140845
NODE_139629_length_323_cov_2.683036	144	215	28	61	71	0.8591549
NODE_139746_length_323_cov_2.089286	64	144	0	28	80	0.3500000
NODE_139746_length_323_cov_2.089286	64	144	4	52	80	0.6500000
NODE_139797_length_323_cov_1.888393	148	207	2	9	59	0.1525424
NODE_139797_length_323_cov_1.888393	148	207	6	18	59	0.3050847
NODE_139797_length_323_cov_1.888393	148	207	8	32	59	0.5423729
NODE_139901_length_323_cov_1.705357	195	262	0	42	67	0.6268657
NODE_139901_length_323_cov_1.705357	195	262	2	25	67	0.3731343
NODE_139901_length_323_cov_1.705357	235	315	0	2	80	0.0250000
NODE_139901_length_323_cov_1.705357	235	315	2	78	80	0.9750000
NODE_140651_length_322_cov_5.475336	56	136	0	80	80	1.0000000
NODE_140651_length_322_cov_5.475336	113	189	0	76	76	1.0000000
NODE_140692_length_322_cov_3.753363	63	133	0	70	70	1.0000000
NODE_140692_length_322_cov_3.753363	116	190	0	74	74	1.0000000
NODE_140693_length_322_cov_3.735426	60	86	0	26	26	1.0000000
NODE_140693_length_322_cov_3.735426	99	139	0	40	40	1.0000000
NODE_140701_length_322_cov_3.605381	73	116	4	3	43	0.0697674
NODE_140701_length_322_cov_3.605381	73	116	6	2	43	0.0465116
NODE_140701_length_322_cov_3.605381	73	116	7	1	43	0.0232558
NODE_140701_length_322_cov_3.605381	73	116	12	2	43	0.0465116
NODE_140701_length_322_cov_3.605381	73	116	14	1	43	0.0232558
NODE_140701_length_322_cov_3.605381	73	116	16	34	43	0.7906977
NODE_140702_length_322_cov_3.600897	75	145	2	53	70	0.7571428
NODE_140702_length_322_cov_3.600897	75	145	4	17	70	0.2428571
NODE_140820_length_322_cov_2.304933	182	213	6	22	31	0.7096774
NODE_140820_length_322_cov_2.304933	182	213	8	9	31	0.2903226
NODE_141738_length_321_cov_8.527027	176	240	32	5	64	0.0781250
NODE_141738_length_321_cov_8.527027	176	240	34	9	64	0.1406250
NODE_141738_length_321_cov_8.527027	176	240	36	16	64	0.2500000
NODE_141738_length_321_cov_8.527027	176	240	38	34	64	0.5312500
NODE_141786_length_321_cov_4.094595	196	266	0	70	70	1.0000000
NODE_141811_length_321_cov_3.563063	59	131	10	2	72	0.0277778
NODE_141811_length_321_cov_3.563063	59	131	12	1	72	0.0138889
NODE_141811_length_321_cov_3.563063	59	131	14	16	72	0.2222222
NODE_141811_length_321_cov_3.563063	59	131	16	18	72	0.2500000
NODE_141811_length_321_cov_3.563063	59	131	18	4	72	0.0555556
NODE_141811_length_321_cov_3.563063	59	131	20	9	72	0.1250000
NODE_141811_length_321_cov_3.563063	59	131	22	22	72	0.3055556
NODE_141811_length_321_cov_3.563063	112	183	4	12	71	0.1690141
NODE_141811_length_321_cov_3.563063	112	183	8	30	71	0.4225352
NODE_141811_length_321_cov_3.563063	112	183	10	12	71	0.1690141
NODE_141811_length_321_cov_3.563063	112	183	12	1	71	0.0140845
NODE_141811_length_321_cov_3.563063	112	183	14	4	71	0.0563380
NODE_141811_length_321_cov_3.563063	112	183	16	3	71	0.0422535
NODE_141811_length_321_cov_3.563063	112	183	18	3	71	0.0422535
NODE_141811_length_321_cov_3.563063	112	183	20	1	71	0.0140845
NODE_141811_length_321_cov_3.563063	112	183	22	5	71	0.0704225
NODE_141813_length_321_cov_3.540541	112	141	6	6	29	0.2068966
NODE_141813_length_321_cov_3.540541	112	141	8	2	29	0.0689655
NODE_141813_length_321_cov_3.540541	112	141	10	21	29	0.7241379
NODE_141833_length_321_cov_3.049550	65	115	32	3	50	0.0600000
NODE_141833_length_321_cov_3.049550	65	115	36	10	50	0.2000000
NODE_141833_length_321_cov_3.049550	65	115	40	2	50	0.0400000
NODE_141833_length_321_cov_3.049550	65	115	42	5	50	0.1000000
NODE_141833_length_321_cov_3.049550	65	115	44	9	50	0.1800000
NODE_141833_length_321_cov_3.049550	65	115	48	21	50	0.4200000
NODE_141833_length_321_cov_3.049550	95	138	44	13	43	0.3023256
NODE_141833_length_321_cov_3.049550	95	138	45	3	43	0.0697674
NODE_141833_length_321_cov_3.049550	95	138	46	2	43	0.0465116
NODE_141833_length_321_cov_3.049550	95	138	47	9	43	0.2093023
NODE_141833_length_321_cov_3.049550	95	138	48	16	43	0.3720930
NODE_141833_length_321_cov_3.049550	118	168	9	1	50	0.0200000
NODE_141833_length_321_cov_3.049550	118	168	13	1	50	0.0200000
NODE_141833_length_321_cov_3.049550	118	168	14	1	50	0.0200000
NODE_141833_length_321_cov_3.049550	118	168	16	1	50	0.0200000
NODE_141833_length_321_cov_3.049550	118	168	18	1	50	0.0200000
NODE_141833_length_321_cov_3.049550	118	168	22	4	50	0.0800000
NODE_141833_length_321_cov_3.049550	118	168	24	1	50	0.0200000
NODE_141833_length_321_cov_3.049550	118	168	27	1	50	0.0200000
NODE_141833_length_321_cov_3.049550	118	168	30	1	50	0.0200000
NODE_141833_length_321_cov_3.049550	118	168	31	1	50	0.0200000
NODE_141833_length_321_cov_3.049550	118	168	36	1	50	0.0200000
NODE_141833_length_321_cov_3.049550	118	168	37	1	50	0.0200000
NODE_141833_length_321_cov_3.049550	118	168	38	1	50	0.0200000
NODE_141833_length_321_cov_3.049550	118	168	44	6	50	0.1200000
NODE_141833_length_321_cov_3.049550	118	168	45	17	50	0.3400000
NODE_141833_length_321_cov_3.049550	118	168	46	2	50	0.0400000
NODE_141833_length_321_cov_3.049550	118	168	47	9	50	0.1800000
NODE_141837_length_321_cov_2.995495	146	220	0	74	74	1.0000000
NODE_141842_length_321_cov_2.981982	251	304	0	53	53	1.0000000
NODE_141876_length_321_cov_2.734234	239	306	2	26	67	0.3880597
NODE_141876_length_321_cov_2.734234	239	306	4	41	67	0.6119403
NODE_141910_length_321_cov_2.427928	221	265	0	44	44	1.0000000
NODE_141922_length_321_cov_2.315315	22	65	0	43	43	1.0000000
NODE_141951_length_321_cov_2.270270	43	105	4	7	62	0.1129032
NODE_141951_length_321_cov_2.270270	43	105	8	6	62	0.0967742
NODE_141951_length_321_cov_2.270270	43	105	10	3	62	0.0483871
NODE_141951_length_321_cov_2.270270	43	105	12	2	62	0.0322581
NODE_141951_length_321_cov_2.270270	43	105	14	7	62	0.1129032
NODE_141951_length_321_cov_2.270270	43	105	16	35	62	0.5645161
NODE_141951_length_321_cov_2.270270	43	105	18	2	62	0.0322581
NODE_141951_length_321_cov_2.270270	120	203	10	40	83	0.4819277
NODE_141951_length_321_cov_2.270270	120	203	12	1	83	0.0120482
NODE_141951_length_321_cov_2.270270	120	203	14	4	83	0.0481928
NODE_141951_length_321_cov_2.270270	120	203	16	23	83	0.2771084
NODE_141951_length_321_cov_2.270270	120	203	18	15	83	0.1807229
NODE_141951_length_321_cov_2.270270	127	208	8	2	81	0.0246914
NODE_141951_length_321_cov_2.270270	127	208	10	43	81	0.5308642
NODE_141951_length_321_cov_2.270270	127	208	12	1	81	0.0123457
NODE_141951_length_321_cov_2.270270	127	208	14	4	81	0.0493827
NODE_141951_length_321_cov_2.270270	127	208	16	22	81	0.2716049
NODE_141951_length_321_cov_2.270270	127	208	18	9	81	0.1111111
NODE_142200_length_321_cov_1.576577	241	321	0	80	80	1.0000000
NODE_142363_length_321_cov_1.319820	253	304	2	37	51	0.7254902
NODE_142363_length_321_cov_1.319820	253	304	4	14	51	0.2745098
NODE_142484_length_321_cov_1.130631	0	43	0	43	43	1.0000000
NODE_142700_length_321_cov_0.869369	248	294	0	12	46	0.2608696
NODE_142700_length_321_cov_0.869369	248	294	2	34	46	0.7391304
NODE_142885_length_320_cov_200.484163	264	320	8	1	56	0.0178571
NODE_142885_length_320_cov_200.484163	264	320	19	1	56	0.0178571
NODE_142885_length_320_cov_200.484163	264	320	21	1	56	0.0178571
NODE_142885_length_320_cov_200.484163	264	320	22	1	56	0.0178571
NODE_142885_length_320_cov_200.484163	264	320	23	2	56	0.0357143
NODE_142885_length_320_cov_200.484163	264	320	25	2	56	0.0357143
NODE_142885_length_320_cov_200.484163	264	320	26	4	56	0.0714286
NODE_142885_length_320_cov_200.484163	264	320	28	2	56	0.0357143
NODE_142885_length_320_cov_200.484163	264	320	32	1	56	0.0178571
NODE_142885_length_320_cov_200.484163	264	320	35	1	56	0.0178571
NODE_142885_length_320_cov_200.484163	264	320	39	1	56	0.0178571
NODE_142885_length_320_cov_200.484163	264	320	46	1	56	0.0178571
NODE_142885_length_320_cov_200.484163	264	320	52	1	56	0.0178571
NODE_142885_length_320_cov_200.484163	264	320	56	2	56	0.0357143
NODE_142885_length_320_cov_200.484163	264	320	64	2	56	0.0357143
NODE_142885_length_320_cov_200.484163	264	320	66	18	56	0.3214286
NODE_142885_length_320_cov_200.484163	264	320	68	2	56	0.0357143
NODE_142885_length_320_cov_200.484163	264	320	72	5	56	0.0892857
NODE_142885_length_320_cov_200.484163	264	320	74	8	56	0.1428571
NODE_142886_length_320_cov_73.357466	51	97	0	28	46	0.6086956
NODE_142886_length_320_cov_73.357466	51	97	2	18	46	0.3913043
NODE_142886_length_320_cov_73.357466	108	154	2	28	46	0.6086956
NODE_142886_length_320_cov_73.357466	108	154	3	18	46	0.3913043
NODE_142886_length_320_cov_73.357466	165	245	4	18	80	0.2250000
NODE_142886_length_320_cov_73.357466	165	245	8	62	80	0.7750000
NODE_142886_length_320_cov_73.357466	218	296	0	28	78	0.3589744
NODE_142886_length_320_cov_73.357466	218	296	4	37	78	0.4743590
NODE_142886_length_320_cov_73.357466	218	296	8	13	78	0.1666667
NODE_142887_length_320_cov_35.787330	212	292	28	6	80	0.0750000
NODE_142887_length_320_cov_35.787330	212	292	32	1	80	0.0125000
NODE_142887_length_320_cov_35.787330	212	292	35	2	80	0.0250000
NODE_142887_length_320_cov_35.787330	212	292	36	6	80	0.0750000
NODE_142887_length_320_cov_35.787330	212	292	39	1	80	0.0125000
NODE_142887_length_320_cov_35.787330	212	292	42	7	80	0.0875000
NODE_142887_length_320_cov_35.787330	212	292	43	57	80	0.7125000
NODE_142887_length_320_cov_35.787330	212	292	28	6	80	0.0750000
NODE_142887_length_320_cov_35.787330	212	292	32	1	80	0.0125000
NODE_142887_length_320_cov_35.787330	212	292	35	2	80	0.0250000
NODE_142887_length_320_cov_35.787330	212	292	36	6	80	0.0750000
NODE_142887_length_320_cov_35.787330	212	292	39	1	80	0.0125000
NODE_142887_length_320_cov_35.787330	212	292	42	7	80	0.0875000
NODE_142887_length_320_cov_35.787330	212	292	43	57	80	0.7125000
NODE_142887_length_320_cov_35.787330	212	292	28	6	80	0.0750000
NODE_142887_length_320_cov_35.787330	212	292	32	1	80	0.0125000
NODE_142887_length_320_cov_35.787330	212	292	35	2	80	0.0250000
NODE_142887_length_320_cov_35.787330	212	292	36	6	80	0.0750000
NODE_142887_length_320_cov_35.787330	212	292	39	1	80	0.0125000
NODE_142887_length_320_cov_35.787330	212	292	42	7	80	0.0875000
NODE_142887_length_320_cov_35.787330	212	292	43	57	80	0.7125000
NODE_142887_length_320_cov_35.787330	212	292	28	6	80	0.0750000
NODE_142887_length_320_cov_35.787330	212	292	32	1	80	0.0125000
NODE_142887_length_320_cov_35.787330	212	292	35	2	80	0.0250000
NODE_142887_length_320_cov_35.787330	212	292	36	6	80	0.0750000
NODE_142887_length_320_cov_35.787330	212	292	39	1	80	0.0125000
NODE_142887_length_320_cov_35.787330	212	292	42	7	80	0.0875000
NODE_142887_length_320_cov_35.787330	212	292	43	57	80	0.7125000
NODE_142887_length_320_cov_35.787330	212	292	28	6	80	0.0750000
NODE_142887_length_320_cov_35.787330	212	292	32	1	80	0.0125000
NODE_142887_length_320_cov_35.787330	212	292	35	2	80	0.0250000
NODE_142887_length_320_cov_35.787330	212	292	36	6	80	0.0750000
NODE_142887_length_320_cov_35.787330	212	292	39	1	80	0.0125000
NODE_142887_length_320_cov_35.787330	212	292	42	7	80	0.0875000
NODE_142887_length_320_cov_35.787330	212	292	43	57	80	0.7125000
NODE_142887_length_320_cov_35.787330	265	314	0	1	49	0.0204082
NODE_142887_length_320_cov_35.787330	265	314	18	1	49	0.0204082
NODE_142887_length_320_cov_35.787330	265	314	19	13	49	0.2653061
NODE_142887_length_320_cov_35.787330	265	314	23	7	49	0.1428571
NODE_142887_length_320_cov_35.787330	265	314	28	6	49	0.1224490
NODE_142887_length_320_cov_35.787330	265	314	32	1	49	0.0204082
NODE_142887_length_320_cov_35.787330	265	314	36	6	49	0.1224490
NODE_142887_length_320_cov_35.787330	265	314	42	7	49	0.1428571
NODE_142887_length_320_cov_35.787330	265	314	43	7	49	0.1428571
NODE_142887_length_320_cov_35.787330	265	320	0	7	55	0.1272727
NODE_142887_length_320_cov_35.787330	265	320	18	1	55	0.0181818
NODE_142887_length_320_cov_35.787330	265	320	19	13	55	0.2363636
NODE_142887_length_320_cov_35.787330	265	320	23	7	55	0.1272727
NODE_142887_length_320_cov_35.787330	265	320	28	6	55	0.1090909
NODE_142887_length_320_cov_35.787330	265	320	32	1	55	0.0181818
NODE_142887_length_320_cov_35.787330	265	320	36	6	55	0.1090909
NODE_142887_length_320_cov_35.787330	265	320	42	7	55	0.1272727
NODE_142887_length_320_cov_35.787330	265	320	43	7	55	0.1272727
NODE_142887_length_320_cov_35.787330	265	320	0	7	55	0.1272727
NODE_142887_length_320_cov_35.787330	265	320	18	1	55	0.0181818
NODE_142887_length_320_cov_35.787330	265	320	19	13	55	0.2363636
NODE_142887_length_320_cov_35.787330	265	320	23	7	55	0.1272727
NODE_142887_length_320_cov_35.787330	265	320	28	6	55	0.1090909
NODE_142887_length_320_cov_35.787330	265	320	32	1	55	0.0181818
NODE_142887_length_320_cov_35.787330	265	320	36	6	55	0.1090909
NODE_142887_length_320_cov_35.787330	265	320	42	7	55	0.1272727
NODE_142887_length_320_cov_35.787330	265	320	43	7	55	0.1272727
NODE_142887_length_320_cov_35.787330	268	320	0	7	52	0.1346154
NODE_142887_length_320_cov_35.787330	268	320	18	1	52	0.0192308
NODE_142887_length_320_cov_35.787330	268	320	19	13	52	0.2500000
NODE_142887_length_320_cov_35.787330	268	320	23	7	52	0.1346154
NODE_142887_length_320_cov_35.787330	268	320	28	6	52	0.1153846
NODE_142887_length_320_cov_35.787330	268	320	32	1	52	0.0192308
NODE_142887_length_320_cov_35.787330	268	320	36	6	52	0.1153846
NODE_142887_length_320_cov_35.787330	268	320	42	7	52	0.1346154
NODE_142887_length_320_cov_35.787330	268	320	43	4	52	0.0769231
NODE_142887_length_320_cov_35.787330	270	320	0	7	50	0.1400000
NODE_142887_length_320_cov_35.787330	270	320	18	1	50	0.0200000
NODE_142887_length_320_cov_35.787330	270	320	19	13	50	0.2600000
NODE_142887_length_320_cov_35.787330	270	320	23	7	50	0.1400000
NODE_142887_length_320_cov_35.787330	270	320	28	6	50	0.1200000
NODE_142887_length_320_cov_35.787330	270	320	32	1	50	0.0200000
NODE_142887_length_320_cov_35.787330	270	320	36	6	50	0.1200000
NODE_142887_length_320_cov_35.787330	270	320	42	7	50	0.1400000
NODE_142887_length_320_cov_35.787330	270	320	43	2	50	0.0400000
NODE_142900_length_320_cov_5.841629	115	172	2	25	57	0.4385965
NODE_142900_length_320_cov_5.841629	115	172	4	9	57	0.1578947
NODE_142900_length_320_cov_5.841629	115	172	6	23	57	0.4035088
NODE_142900_length_320_cov_5.841629	168	225	0	47	57	0.8245614
NODE_142900_length_320_cov_5.841629	168	225	1	1	57	0.0175439
NODE_142900_length_320_cov_5.841629	168	225	2	9	57	0.1578947
NODE_142934_length_320_cov_4.153846	134	200	0	66	66	1.0000000
NODE_142958_length_320_cov_3.733032	5	40	0	35	35	1.0000000
NODE_142985_length_320_cov_3.402715	142	222	6	12	80	0.1500000
NODE_142985_length_320_cov_3.402715	142	222	8	4	80	0.0500000
NODE_142985_length_320_cov_3.402715	142	222	10	27	80	0.3375000
NODE_142985_length_320_cov_3.402715	142	222	12	6	80	0.0750000
NODE_142985_length_320_cov_3.402715	142	222	14	31	80	0.3875000
NODE_143076_length_320_cov_2.475113	120	187	6	17	67	0.2537313
NODE_143076_length_320_cov_2.475113	120	187	8	2	67	0.0298507
NODE_143076_length_320_cov_2.475113	120	187	10	2	67	0.0298507
NODE_143076_length_320_cov_2.475113	120	187	12	10	67	0.1492537
NODE_143076_length_320_cov_2.475113	120	187	14	2	67	0.0298507
NODE_143076_length_320_cov_2.475113	120	187	20	2	67	0.0298507
NODE_143076_length_320_cov_2.475113	120	187	22	2	67	0.0298507
NODE_143076_length_320_cov_2.475113	120	187	24	1	67	0.0149254
NODE_143076_length_320_cov_2.475113	120	187	25	1	67	0.0149254
NODE_143076_length_320_cov_2.475113	120	187	26	4	67	0.0597015
NODE_143076_length_320_cov_2.475113	120	187	28	1	67	0.0149254
NODE_143076_length_320_cov_2.475113	120	187	30	1	67	0.0149254
NODE_143076_length_320_cov_2.475113	120	187	32	8	67	0.1194030
NODE_143076_length_320_cov_2.475113	120	187	36	1	67	0.0149254
NODE_143076_length_320_cov_2.475113	120	187	38	1	67	0.0149254
NODE_143076_length_320_cov_2.475113	120	187	40	1	67	0.0149254
NODE_143076_length_320_cov_2.475113	120	187	42	1	67	0.0149254
NODE_143076_length_320_cov_2.475113	120	187	48	1	67	0.0149254
NODE_143076_length_320_cov_2.475113	120	187	52	1	67	0.0149254
NODE_143076_length_320_cov_2.475113	120	187	60	1	67	0.0149254
NODE_143076_length_320_cov_2.475113	120	187	70	1	67	0.0149254
NODE_143076_length_320_cov_2.475113	120	187	72	2	67	0.0298507
NODE_143076_length_320_cov_2.475113	120	187	76	2	67	0.0298507
NODE_143076_length_320_cov_2.475113	120	187	80	2	67	0.0298507
NODE_143142_length_320_cov_2.171946	16	96	0	1	80	0.0125000
NODE_143142_length_320_cov_2.171946	16	96	2	1	80	0.0125000
NODE_143142_length_320_cov_2.171946	16	96	5	3	80	0.0375000
NODE_143142_length_320_cov_2.171946	16	96	7	4	80	0.0500000
NODE_143142_length_320_cov_2.171946	16	96	9	8	80	0.1000000
NODE_143142_length_320_cov_2.171946	16	96	12	2	80	0.0250000
NODE_143142_length_320_cov_2.171946	16	96	14	9	80	0.1125000
NODE_143142_length_320_cov_2.171946	16	96	16	2	80	0.0250000
NODE_143142_length_320_cov_2.171946	16	96	20	17	80	0.2125000
NODE_143142_length_320_cov_2.171946	16	96	24	4	80	0.0500000
NODE_143142_length_320_cov_2.171946	16	96	26	29	80	0.3625000
NODE_143142_length_320_cov_2.171946	69	149	24	2	80	0.0250000
NODE_143142_length_320_cov_2.171946	69	149	26	28	80	0.3500000
NODE_143142_length_320_cov_2.171946	69	149	33	4	80	0.0500000
NODE_143142_length_320_cov_2.171946	69	149	34	13	80	0.1625000
NODE_143142_length_320_cov_2.171946	69	149	35	3	80	0.0375000
NODE_143142_length_320_cov_2.171946	69	149	36	6	80	0.0750000
NODE_143142_length_320_cov_2.171946	69	149	37	8	80	0.1000000
NODE_143142_length_320_cov_2.171946	69	149	38	16	80	0.2000000
NODE_143207_length_320_cov_1.900452	37	117	4	10	80	0.1250000
NODE_143207_length_320_cov_1.900452	37	117	6	2	80	0.0250000
NODE_143207_length_320_cov_1.900452	37	117	8	68	80	0.8500000
NODE_143207_length_320_cov_1.900452	90	164	0	30	74	0.4054054
NODE_143207_length_320_cov_1.900452	90	164	2	3	74	0.0405405
NODE_143207_length_320_cov_1.900452	90	164	4	9	74	0.1216216
NODE_143207_length_320_cov_1.900452	90	164	8	32	74	0.4324324
NODE_143230_length_320_cov_1.846154	188	220	0	32	32	1.0000000
NODE_143309_length_320_cov_1.665158	144	198	8	10	54	0.1851852
NODE_143309_length_320_cov_1.665158	144	198	12	2	54	0.0370370
NODE_143309_length_320_cov_1.665158	144	198	14	24	54	0.4444444
NODE_143309_length_320_cov_1.665158	144	198	15	11	54	0.2037037
NODE_143309_length_320_cov_1.665158	144	198	16	7	54	0.1296296
NODE_143309_length_320_cov_1.665158	198	251	8	3	53	0.0566038
NODE_143309_length_320_cov_1.665158	198	251	9	1	53	0.0188679
NODE_143309_length_320_cov_1.665158	198	251	11	5	53	0.0943396
NODE_143309_length_320_cov_1.665158	198	251	15	44	53	0.8301887
NODE_143351_length_320_cov_1.601810	157	181	2	24	24	1.0000000
NODE_143351_length_320_cov_1.601810	231	290	0	59	59	1.0000000
NODE_143366_length_320_cov_1.556561	0	39	0	6	39	0.1538462
NODE_143366_length_320_cov_1.556561	0	39	4	1	39	0.0256410
NODE_143366_length_320_cov_1.556561	0	39	5	5	39	0.1282051
NODE_143366_length_320_cov_1.556561	0	39	7	5	39	0.1282051
NODE_143366_length_320_cov_1.556561	0	39	8	7	39	0.1794872
NODE_143366_length_320_cov_1.556561	0	39	11	1	39	0.0256410
NODE_143366_length_320_cov_1.556561	0	39	15	1	39	0.0256410
NODE_143366_length_320_cov_1.556561	0	39	17	8	39	0.2051282
NODE_143366_length_320_cov_1.556561	0	39	23	1	39	0.0256410
NODE_143366_length_320_cov_1.556561	0	39	25	4	39	0.1025641
NODE_143442_length_320_cov_1.384615	18	98	0	80	80	1.0000000
NODE_143442_length_320_cov_1.384615	71	145	0	37	74	0.5000000
NODE_143442_length_320_cov_1.384615	71	145	2	4	74	0.0540541
NODE_143442_length_320_cov_1.384615	71	145	3	6	74	0.0810811
NODE_143442_length_320_cov_1.384615	71	145	4	3	74	0.0405405
NODE_143442_length_320_cov_1.384615	71	145	6	8	74	0.1081081
NODE_143442_length_320_cov_1.384615	71	145	8	16	74	0.2162162
NODE_143521_length_320_cov_1.312217	117	170	2	53	53	1.0000000
NODE_143670_length_320_cov_1.117647	58	109	2	18	51	0.3529412
NODE_143670_length_320_cov_1.117647	58	109	6	10	51	0.1960784
NODE_143670_length_320_cov_1.117647	58	109	8	23	51	0.4509804
NODE_144091_length_319_cov_5.940909	122	202	0	74	80	0.9250000
NODE_144091_length_319_cov_5.940909	122	202	2	6	80	0.0750000
NODE_144107_length_319_cov_4.700000	16	47	0	31	31	1.0000000
NODE_144137_length_319_cov_4.068182	5	36	1	31	31	1.0000000
NODE_144162_length_319_cov_3.568182	149	229	0	80	80	1.0000000
NODE_144206_length_319_cov_3.036364	112	174	0	62	62	1.0000000
NODE_144226_length_319_cov_2.800000	25	106	4	5	81	0.0617284
NODE_144226_length_319_cov_2.800000	25	106	6	2	81	0.0246914
NODE_144226_length_319_cov_2.800000	25	106	16	1	81	0.0123457
NODE_144226_length_319_cov_2.800000	25	106	19	1	81	0.0123457
NODE_144226_length_319_cov_2.800000	25	106	22	5	81	0.0617284
NODE_144226_length_319_cov_2.800000	25	106	24	2	81	0.0246914
NODE_144226_length_319_cov_2.800000	25	106	25	2	81	0.0246914
NODE_144226_length_319_cov_2.800000	25	106	27	1	81	0.0123457
NODE_144226_length_319_cov_2.800000	25	106	34	1	81	0.0123457
NODE_144226_length_319_cov_2.800000	25	106	37	1	81	0.0123457
NODE_144226_length_319_cov_2.800000	25	106	44	2	81	0.0246914
NODE_144226_length_319_cov_2.800000	25	106	48	1	81	0.0123457
NODE_144226_length_319_cov_2.800000	25	106	58	1	81	0.0123457
NODE_144226_length_319_cov_2.800000	25	106	61	1	81	0.0123457
NODE_144226_length_319_cov_2.800000	25	106	65	2	81	0.0246914
NODE_144226_length_319_cov_2.800000	25	106	67	2	81	0.0246914
NODE_144226_length_319_cov_2.800000	25	106	71	1	81	0.0123457
NODE_144226_length_319_cov_2.800000	25	106	72	4	81	0.0493827
NODE_144226_length_319_cov_2.800000	25	106	80	1	81	0.0123457
NODE_144226_length_319_cov_2.800000	25	106	81	1	81	0.0123457
NODE_144226_length_319_cov_2.800000	25	106	83	1	81	0.0123457
NODE_144226_length_319_cov_2.800000	25	106	95	1	81	0.0123457
NODE_144226_length_319_cov_2.800000	25	106	103	2	81	0.0246914
NODE_144226_length_319_cov_2.800000	25	106	104	2	81	0.0246914
NODE_144226_length_319_cov_2.800000	25	106	116	1	81	0.0123457
NODE_144226_length_319_cov_2.800000	25	106	138	4	81	0.0493827
NODE_144226_length_319_cov_2.800000	25	106	143	3	81	0.0370370
NODE_144226_length_319_cov_2.800000	25	106	149	2	81	0.0246914
NODE_144226_length_319_cov_2.800000	25	106	151	1	81	0.0123457
NODE_144226_length_319_cov_2.800000	25	106	152	1	81	0.0123457
NODE_144226_length_319_cov_2.800000	25	106	154	4	81	0.0493827
NODE_144226_length_319_cov_2.800000	25	106	160	2	81	0.0246914
NODE_144226_length_319_cov_2.800000	25	106	164	1	81	0.0123457
NODE_144226_length_319_cov_2.800000	25	106	166	1	81	0.0123457
NODE_144226_length_319_cov_2.800000	25	106	168	1	81	0.0123457
NODE_144226_length_319_cov_2.800000	25	106	172	1	81	0.0123457
NODE_144226_length_319_cov_2.800000	25	106	176	1	81	0.0123457
NODE_144226_length_319_cov_2.800000	25	106	186	1	81	0.0123457
NODE_144226_length_319_cov_2.800000	25	106	188	2	81	0.0246914
NODE_144226_length_319_cov_2.800000	25	106	190	3	81	0.0370370
NODE_144226_length_319_cov_2.800000	25	106	192	4	81	0.0493827
NODE_144226_length_319_cov_2.800000	25	106	195	5	81	0.0617284
NODE_144226_length_319_cov_2.800000	79	158	152	1	79	0.0126582
NODE_144226_length_319_cov_2.800000	79	158	154	4	79	0.0506329
NODE_144226_length_319_cov_2.800000	79	158	160	2	79	0.0253165
NODE_144226_length_319_cov_2.800000	79	158	164	1	79	0.0126582
NODE_144226_length_319_cov_2.800000	79	158	166	1	79	0.0126582
NODE_144226_length_319_cov_2.800000	79	158	168	1	79	0.0126582
NODE_144226_length_319_cov_2.800000	79	158	172	1	79	0.0126582
NODE_144226_length_319_cov_2.800000	79	158	176	1	79	0.0126582
NODE_144226_length_319_cov_2.800000	79	158	178	8	79	0.1012658
NODE_144226_length_319_cov_2.800000	79	158	180	2	79	0.0253165
NODE_144226_length_319_cov_2.800000	79	158	186	2	79	0.0253165
NODE_144226_length_319_cov_2.800000	79	158	188	6	79	0.0759494
NODE_144226_length_319_cov_2.800000	79	158	189	5	79	0.0632911
NODE_144226_length_319_cov_2.800000	79	158	190	3	79	0.0379747
NODE_144226_length_319_cov_2.800000	79	158	191	1	79	0.0126582
NODE_144226_length_319_cov_2.800000	79	158	192	16	79	0.2025317
NODE_144226_length_319_cov_2.800000	79	158	193	11	79	0.1392405
NODE_144226_length_319_cov_2.800000	79	158	195	13	79	0.1645570
NODE_144237_length_319_cov_2.740909	67	147	17	1	80	0.0125000
NODE_144237_length_319_cov_2.740909	67	147	30	1	80	0.0125000
NODE_144237_length_319_cov_2.740909	67	147	32	16	80	0.2000000
NODE_144237_length_319_cov_2.740909	67	147	34	2	80	0.0250000
NODE_144237_length_319_cov_2.740909	67	147	38	1	80	0.0125000
NODE_144237_length_319_cov_2.740909	67	147	39	1	80	0.0125000
NODE_144237_length_319_cov_2.740909	67	147	41	16	80	0.2000000
NODE_144237_length_319_cov_2.740909	67	147	42	11	80	0.1375000
NODE_144237_length_319_cov_2.740909	67	147	43	4	80	0.0500000
NODE_144237_length_319_cov_2.740909	67	147	44	20	80	0.2500000
NODE_144237_length_319_cov_2.740909	67	147	46	7	80	0.0875000
NODE_144252_length_319_cov_2.586364	247	319	0	1	72	0.0138889
NODE_144252_length_319_cov_2.586364	247	319	4	15	72	0.2083333
NODE_144252_length_319_cov_2.586364	247	319	6	56	72	0.7777778
NODE_144272_length_319_cov_2.463636	90	153	0	28	63	0.4444444
NODE_144272_length_319_cov_2.463636	90	153	2	35	63	0.5555556
NODE_144272_length_319_cov_2.463636	163	216	2	53	53	1.0000000
NODE_144316_length_319_cov_2.259091	146	212	0	34	66	0.5151515
NODE_144316_length_319_cov_2.259091	146	212	2	32	66	0.4848485
NODE_144340_length_319_cov_2.163636	213	275	0	62	62	1.0000000
NODE_144390_length_319_cov_1.968182	120	200	1	1	80	0.0125000
NODE_144390_length_319_cov_1.968182	120	200	2	15	80	0.1875000
NODE_144390_length_319_cov_1.968182	120	200	4	64	80	0.8000000
NODE_144616_length_319_cov_1.431818	111	157	0	46	46	1.0000000
NODE_144629_length_319_cov_1.395455	129	179	0	50	50	1.0000000
NODE_144788_length_319_cov_1.190909	119	182	0	36	63	0.5714286
NODE_144788_length_319_cov_1.190909	119	182	2	7	63	0.1111111
NODE_144788_length_319_cov_1.190909	119	182	4	20	63	0.3174603
NODE_144788_length_319_cov_1.190909	197	232	0	35	35	1.0000000
NODE_145289_length_318_cov_232.639269	169	198	528	1	29	0.0344828
NODE_145289_length_318_cov_232.639269	169	198	546	1	29	0.0344828
NODE_145289_length_318_cov_232.639269	169	198	557	2	29	0.0689655
NODE_145289_length_318_cov_232.639269	169	198	559	1	29	0.0344828
NODE_145289_length_318_cov_232.639269	169	198	572	1	29	0.0344828
NODE_145289_length_318_cov_232.639269	169	198	573	1	29	0.0344828
NODE_145289_length_318_cov_232.639269	169	198	594	1	29	0.0344828
NODE_145289_length_318_cov_232.639269	169	198	600	1	29	0.0344828
NODE_145289_length_318_cov_232.639269	169	198	614	1	29	0.0344828
NODE_145289_length_318_cov_232.639269	169	198	617	1	29	0.0344828
NODE_145289_length_318_cov_232.639269	169	198	618	1	29	0.0344828
NODE_145289_length_318_cov_232.639269	169	198	623	1	29	0.0344828
NODE_145289_length_318_cov_232.639269	169	198	625	1	29	0.0344828
NODE_145289_length_318_cov_232.639269	169	198	629	1	29	0.0344828
NODE_145289_length_318_cov_232.639269	169	198	631	1	29	0.0344828
NODE_145289_length_318_cov_232.639269	169	198	635	1	29	0.0344828
NODE_145289_length_318_cov_232.639269	169	198	637	3	29	0.1034483
NODE_145289_length_318_cov_232.639269	169	198	641	3	29	0.1034483
NODE_145289_length_318_cov_232.639269	169	198	649	1	29	0.0344828
NODE_145289_length_318_cov_232.639269	169	198	654	1	29	0.0344828
NODE_145289_length_318_cov_232.639269	169	198	657	1	29	0.0344828
NODE_145289_length_318_cov_232.639269	169	198	659	1	29	0.0344828
NODE_145289_length_318_cov_232.639269	169	198	661	1	29	0.0344828
NODE_145289_length_318_cov_232.639269	169	198	663	1	29	0.0344828
NODE_145289_length_318_cov_232.639269	171	246	496	1	75	0.0133333
NODE_145289_length_318_cov_232.639269	171	246	506	1	75	0.0133333
NODE_145289_length_318_cov_232.639269	171	246	507	2	75	0.0266667
NODE_145289_length_318_cov_232.639269	171	246	512	1	75	0.0133333
NODE_145289_length_318_cov_232.639269	171	246	513	1	75	0.0133333
NODE_145289_length_318_cov_232.639269	171	246	517	1	75	0.0133333
NODE_145289_length_318_cov_232.639269	171	246	528	1	75	0.0133333
NODE_145289_length_318_cov_232.639269	171	246	529	1	75	0.0133333
NODE_145289_length_318_cov_232.639269	171	246	533	1	75	0.0133333
NODE_145289_length_318_cov_232.639269	171	246	544	1	75	0.0133333
NODE_145289_length_318_cov_232.639269	171	246	550	2	75	0.0266667
NODE_145289_length_318_cov_232.639269	171	246	557	3	75	0.0400000
NODE_145289_length_318_cov_232.639269	171	246	559	1	75	0.0133333
NODE_145289_length_318_cov_232.639269	171	246	565	1	75	0.0133333
NODE_145289_length_318_cov_232.639269	171	246	567	1	75	0.0133333
NODE_145289_length_318_cov_232.639269	171	246	572	1	75	0.0133333
NODE_145289_length_318_cov_232.639269	171	246	573	1	75	0.0133333
NODE_145289_length_318_cov_232.639269	171	246	577	1	75	0.0133333
NODE_145289_length_318_cov_232.639269	171	246	581	1	75	0.0133333
NODE_145289_length_318_cov_232.639269	171	246	591	2	75	0.0266667
NODE_145289_length_318_cov_232.639269	171	246	594	1	75	0.0133333
NODE_145289_length_318_cov_232.639269	171	246	600	4	75	0.0533333
NODE_145289_length_318_cov_232.639269	171	246	606	1	75	0.0133333
NODE_145289_length_318_cov_232.639269	171	246	614	3	75	0.0400000
NODE_145289_length_318_cov_232.639269	171	246	617	1	75	0.0133333
NODE_145289_length_318_cov_232.639269	171	246	618	2	75	0.0266667
NODE_145289_length_318_cov_232.639269	171	246	622	1	75	0.0133333
NODE_145289_length_318_cov_232.639269	171	246	623	1	75	0.0133333
NODE_145289_length_318_cov_232.639269	171	246	624	1	75	0.0133333
NODE_145289_length_318_cov_232.639269	171	246	625	1	75	0.0133333
NODE_145289_length_318_cov_232.639269	171	246	629	1	75	0.0133333
NODE_145289_length_318_cov_232.639269	171	246	630	1	75	0.0133333
NODE_145289_length_318_cov_232.639269	171	246	631	1	75	0.0133333
NODE_145289_length_318_cov_232.639269	171	246	634	1	75	0.0133333
NODE_145289_length_318_cov_232.639269	171	246	635	2	75	0.0266667
NODE_145289_length_318_cov_232.639269	171	246	637	3	75	0.0400000
NODE_145289_length_318_cov_232.639269	171	246	638	1	75	0.0133333
NODE_145289_length_318_cov_232.639269	171	246	639	1	75	0.0133333
NODE_145289_length_318_cov_232.639269	171	246	641	3	75	0.0400000
NODE_145289_length_318_cov_232.639269	171	246	643	2	75	0.0266667
NODE_145289_length_318_cov_232.639269	171	246	647	1	75	0.0133333
NODE_145289_length_318_cov_232.639269	171	246	649	1	75	0.0133333
NODE_145289_length_318_cov_232.639269	171	246	651	2	75	0.0266667
NODE_145289_length_318_cov_232.639269	171	246	653	1	75	0.0133333
NODE_145289_length_318_cov_232.639269	171	246	654	1	75	0.0133333
NODE_145289_length_318_cov_232.639269	171	246	657	2	75	0.0266667
NODE_145289_length_318_cov_232.639269	171	246	659	3	75	0.0400000
NODE_145289_length_318_cov_232.639269	171	246	661	1	75	0.0133333
NODE_145289_length_318_cov_232.639269	171	246	663	4	75	0.0533333
NODE_145289_length_318_cov_232.639269	171	246	665	1	75	0.0133333
NODE_145289_length_318_cov_232.639269	171	246	667	1	75	0.0133333
NODE_145333_length_318_cov_4.237443	222	294	4	3	72	0.0416667
NODE_145333_length_318_cov_4.237443	222	294	6	12	72	0.1666667
NODE_145333_length_318_cov_4.237443	222	294	8	5	72	0.0694444
NODE_145333_length_318_cov_4.237443	222	294	10	5	72	0.0694444
NODE_145333_length_318_cov_4.237443	222	294	12	28	72	0.3888889
NODE_145333_length_318_cov_4.237443	222	294	14	19	72	0.2638889
NODE_145348_length_318_cov_3.721461	98	148	0	50	50	1.0000000
NODE_145362_length_318_cov_3.515982	60	129	0	14	69	0.2028985
NODE_145362_length_318_cov_3.515982	60	129	2	3	69	0.0434783
NODE_145362_length_318_cov_3.515982	60	129	6	52	69	0.7536232
NODE_145362_length_318_cov_3.515982	60	140	0	14	80	0.1750000
NODE_145362_length_318_cov_3.515982	60	140	2	3	80	0.0375000
NODE_145362_length_318_cov_3.515982	60	140	6	63	80	0.7875000
NODE_145362_length_318_cov_3.515982	60	140	0	14	80	0.1750000
NODE_145362_length_318_cov_3.515982	60	140	2	3	80	0.0375000
NODE_145362_length_318_cov_3.515982	60	140	6	63	80	0.7875000
NODE_145362_length_318_cov_3.515982	113	153	6	40	40	1.0000000
NODE_145362_length_318_cov_3.515982	122	153	6	31	31	1.0000000
NODE_145465_length_318_cov_2.557078	205	247	0	20	42	0.4761905
NODE_145465_length_318_cov_2.557078	205	247	2	1	42	0.0238095
NODE_145465_length_318_cov_2.557078	205	247	4	21	42	0.5000000
NODE_145551_length_318_cov_2.109589	70	150	6	67	80	0.8375000
NODE_145551_length_318_cov_2.109589	70	150	8	10	80	0.1250000
NODE_145551_length_318_cov_2.109589	70	150	10	3	80	0.0375000
NODE_145619_length_318_cov_1.945205	229	286	0	57	57	1.0000000
NODE_145709_length_318_cov_1.739726	242	308	0	66	66	1.0000000
NODE_145725_length_318_cov_1.684932	49	80	0	31	31	1.0000000
NODE_145787_length_318_cov_1.561644	99	158	4	20	59	0.3389831
NODE_145787_length_318_cov_1.561644	99	158	6	14	59	0.2372881
NODE_145787_length_318_cov_1.561644	99	158	8	25	59	0.4237288
NODE_145807_length_318_cov_1.493151	151	195	0	44	44	1.0000000
NODE_145807_length_318_cov_1.493151	199	258	0	59	59	1.0000000
NODE_145968_length_318_cov_1.301370	91	141	0	50	50	1.0000000
NODE_146017_length_318_cov_1.173516	83	150	2	7	67	0.1044776
NODE_146017_length_318_cov_1.173516	83	150	4	5	67	0.0746269
NODE_146017_length_318_cov_1.173516	83	150	6	8	67	0.1194030
NODE_146017_length_318_cov_1.173516	83	150	8	30	67	0.4477612
NODE_146017_length_318_cov_1.173516	83	150	10	17	67	0.2537313
NODE_146065_length_318_cov_1.127854	24	51	2	27	27	1.0000000
NODE_146065_length_318_cov_1.127854	24	60	2	36	36	1.0000000
NODE_146467_length_317_cov_55.467890	172	243	34	5	71	0.0704225
NODE_146467_length_317_cov_55.467890	172	243	38	2	71	0.0281690
NODE_146467_length_317_cov_55.467890	172	243	39	1	71	0.0140845
NODE_146467_length_317_cov_55.467890	172	243	44	2	71	0.0281690
NODE_146467_length_317_cov_55.467890	172	243	45	1	71	0.0140845
NODE_146467_length_317_cov_55.467890	172	243	47	5	71	0.0704225
NODE_146467_length_317_cov_55.467890	172	243	48	1	71	0.0140845
NODE_146467_length_317_cov_55.467890	172	243	50	2	71	0.0281690
NODE_146467_length_317_cov_55.467890	172	243	52	16	71	0.2253521
NODE_146467_length_317_cov_55.467890	172	243	53	2	71	0.0281690
NODE_146467_length_317_cov_55.467890	172	243	54	4	71	0.0563380
NODE_146467_length_317_cov_55.467890	172	243	55	3	71	0.0422535
NODE_146467_length_317_cov_55.467890	172	243	56	14	71	0.1971831
NODE_146467_length_317_cov_55.467890	172	243	58	13	71	0.1830986
NODE_146487_length_317_cov_5.252294	247	307	0	15	60	0.2500000
NODE_146487_length_317_cov_5.252294	247	307	2	45	60	0.7500000
NODE_146503_length_317_cov_4.467890	105	185	0	69	80	0.8625000
NODE_146503_length_317_cov_4.467890	105	185	2	11	80	0.1375000
NODE_146503_length_317_cov_4.467890	113	193	0	61	80	0.7625000
NODE_146503_length_317_cov_4.467890	113	193	2	19	80	0.2375000
NODE_146554_length_317_cov_3.298165	146	206	0	1	60	0.0166667
NODE_146554_length_317_cov_3.298165	146	206	2	59	60	0.9833333
NODE_146562_length_317_cov_3.266055	111	191	0	7	80	0.0875000
NODE_146562_length_317_cov_3.266055	111	191	2	11	80	0.1375000
NODE_146562_length_317_cov_3.266055	111	191	4	16	80	0.2000000
NODE_146562_length_317_cov_3.266055	111	191	6	7	80	0.0875000
NODE_146562_length_317_cov_3.266055	111	191	8	1	80	0.0125000
NODE_146562_length_317_cov_3.266055	111	191	10	30	80	0.3750000
NODE_146562_length_317_cov_3.266055	111	191	12	8	80	0.1000000
NODE_146562_length_317_cov_3.266055	164	244	0	60	80	0.7500000
NODE_146562_length_317_cov_3.266055	164	244	2	11	80	0.1375000
NODE_146562_length_317_cov_3.266055	164	244	4	9	80	0.1125000
NODE_146585_length_317_cov_3.036697	3	79	0	76	76	1.0000000
NODE_146601_length_317_cov_2.825688	14	94	0	26	80	0.3250000
NODE_146601_length_317_cov_2.825688	14	94	4	54	80	0.6750000
NODE_146601_length_317_cov_2.825688	67	147	0	13	80	0.1625000
NODE_146601_length_317_cov_2.825688	67	147	4	67	80	0.8375000
NODE_146602_length_317_cov_2.821101	142	208	2	66	66	1.0000000
NODE_146604_length_317_cov_2.816514	121	201	0	80	80	1.0000000
NODE_146612_length_317_cov_2.779817	67	138	2	34	71	0.4788733
NODE_146612_length_317_cov_2.779817	67	138	4	37	71	0.5211267
NODE_147046_length_317_cov_1.353211	166	239	2	3	73	0.0410959
NODE_147046_length_317_cov_1.353211	166	239	4	70	73	0.9589041
NODE_147046_length_317_cov_1.353211	212	292	0	23	80	0.2875000
NODE_147046_length_317_cov_1.353211	212	292	2	33	80	0.4125000
NODE_147046_length_317_cov_1.353211	212	292	4	24	80	0.3000000
NODE_147172_length_317_cov_1.160550	58	117	1	16	59	0.2711864
NODE_147172_length_317_cov_1.160550	58	117	2	34	59	0.5762712
NODE_147172_length_317_cov_1.160550	58	117	3	9	59	0.1525424
NODE_147172_length_317_cov_1.160550	90	170	1	16	80	0.2000000
NODE_147172_length_317_cov_1.160550	90	170	2	2	80	0.0250000
NODE_147172_length_317_cov_1.160550	90	170	3	10	80	0.1250000
NODE_147172_length_317_cov_1.160550	90	170	8	4	80	0.0500000
NODE_147172_length_317_cov_1.160550	90	170	10	3	80	0.0375000
NODE_147172_length_317_cov_1.160550	90	170	12	4	80	0.0500000
NODE_147172_length_317_cov_1.160550	90	170	14	12	80	0.1500000
NODE_147172_length_317_cov_1.160550	90	170	18	11	80	0.1375000
NODE_147172_length_317_cov_1.160550	90	170	20	1	80	0.0125000
NODE_147172_length_317_cov_1.160550	90	170	22	3	80	0.0375000
NODE_147172_length_317_cov_1.160550	90	170	26	3	80	0.0375000
NODE_147172_length_317_cov_1.160550	90	170	28	11	80	0.1375000
NODE_147187_length_317_cov_1.137615	245	313	0	43	68	0.6323529
NODE_147187_length_317_cov_1.137615	245	313	2	25	68	0.3676471
NODE_147259_length_317_cov_0.967890	170	211	0	41	41	1.0000000
NODE_147373_length_317_cov_0.926606	194	232	0	38	38	1.0000000
NODE_147383_length_317_cov_0.912844	186	244	0	58	58	1.0000000
NODE_147595_length_316_cov_31.502304	96	174	1	9	78	0.1153846
NODE_147595_length_316_cov_31.502304	96	174	2	1	78	0.0128205
NODE_147595_length_316_cov_31.502304	96	174	3	7	78	0.0897436
NODE_147595_length_316_cov_31.502304	96	174	7	3	78	0.0384615
NODE_147595_length_316_cov_31.502304	96	174	9	1	78	0.0128205
NODE_147595_length_316_cov_31.502304	96	174	11	4	78	0.0512821
NODE_147595_length_316_cov_31.502304	96	174	13	1	78	0.0128205
NODE_147595_length_316_cov_31.502304	96	174	17	3	78	0.0384615
NODE_147595_length_316_cov_31.502304	96	174	19	1	78	0.0128205
NODE_147595_length_316_cov_31.502304	96	174	21	2	78	0.0256410
NODE_147595_length_316_cov_31.502304	96	174	29	5	78	0.0641026
NODE_147595_length_316_cov_31.502304	96	174	30	4	78	0.0512821
NODE_147595_length_316_cov_31.502304	96	174	32	3	78	0.0384615
NODE_147595_length_316_cov_31.502304	96	174	35	1	78	0.0128205
NODE_147595_length_316_cov_31.502304	96	174	37	1	78	0.0128205
NODE_147595_length_316_cov_31.502304	96	174	45	2	78	0.0256410
NODE_147595_length_316_cov_31.502304	96	174	47	1	78	0.0128205
NODE_147595_length_316_cov_31.502304	96	174	50	3	78	0.0384615
NODE_147595_length_316_cov_31.502304	96	174	51	1	78	0.0128205
NODE_147595_length_316_cov_31.502304	96	174	53	3	78	0.0384615
NODE_147595_length_316_cov_31.502304	96	174	55	1	78	0.0128205
NODE_147595_length_316_cov_31.502304	96	174	57	2	78	0.0256410
NODE_147595_length_316_cov_31.502304	96	174	59	2	78	0.0256410
NODE_147595_length_316_cov_31.502304	96	174	63	2	78	0.0256410
NODE_147595_length_316_cov_31.502304	96	174	65	7	78	0.0897436
NODE_147595_length_316_cov_31.502304	96	174	69	1	78	0.0128205
NODE_147595_length_316_cov_31.502304	96	174	71	3	78	0.0384615
NODE_147595_length_316_cov_31.502304	96	174	74	2	78	0.0256410
NODE_147595_length_316_cov_31.502304	96	174	76	2	78	0.0256410
NODE_147595_length_316_cov_31.502304	96	121	1	9	25	0.3600000
NODE_147595_length_316_cov_31.502304	96	121	2	1	25	0.0400000
NODE_147595_length_316_cov_31.502304	96	121	3	7	25	0.2800000
NODE_147595_length_316_cov_31.502304	96	121	7	3	25	0.1200000
NODE_147595_length_316_cov_31.502304	96	121	9	1	25	0.0400000
NODE_147595_length_316_cov_31.502304	96	121	11	4	25	0.1600000
NODE_147609_length_316_cov_6.179724	225	278	0	53	53	1.0000000
NODE_147623_length_316_cov_5.539171	91	171	4	17	80	0.2125000
NODE_147623_length_316_cov_5.539171	91	171	5	54	80	0.6750000
NODE_147623_length_316_cov_5.539171	91	171	7	9	80	0.1125000
NODE_147668_length_316_cov_3.732719	128	208	0	30	80	0.3750000
NODE_147668_length_316_cov_3.732719	128	208	2	21	80	0.2625000
NODE_147668_length_316_cov_3.732719	128	208	6	29	80	0.3625000
NODE_147668_length_316_cov_3.732719	181	257	4	2	76	0.0263158
NODE_147668_length_316_cov_3.732719	181	257	6	74	76	0.9736842
NODE_147680_length_316_cov_3.589862	185	247	0	62	62	1.0000000
NODE_147684_length_316_cov_3.520737	101	143	0	42	42	1.0000000
NODE_147702_length_316_cov_3.221198	108	184	0	13	76	0.1710526
NODE_147702_length_316_cov_3.221198	108	184	9	4	76	0.0526316
NODE_147702_length_316_cov_3.221198	108	184	11	8	76	0.1052632
NODE_147702_length_316_cov_3.221198	108	184	13	12	76	0.1578947
NODE_147702_length_316_cov_3.221198	108	184	15	4	76	0.0526316
NODE_147702_length_316_cov_3.221198	108	184	16	8	76	0.1052632
NODE_147702_length_316_cov_3.221198	108	184	18	27	76	0.3552631
NODE_147734_length_316_cov_2.824885	274	311	0	37	37	1.0000000
NODE_147736_length_316_cov_2.820276	200	280	0	13	80	0.1625000
NODE_147736_length_316_cov_2.820276	200	280	2	10	80	0.1250000
NODE_147736_length_316_cov_2.820276	200	280	4	57	80	0.7125000
NODE_147757_length_316_cov_2.672811	23	80	4	57	57	1.0000000
NODE_147796_length_316_cov_2.456221	104	144	3	20	40	0.5000000
NODE_147796_length_316_cov_2.456221	104	144	4	13	40	0.3250000
NODE_147796_length_316_cov_2.456221	104	144	6	7	40	0.1750000
NODE_147985_length_316_cov_1.751152	73	122	4	31	49	0.6326531
NODE_147985_length_316_cov_1.751152	73	122	6	18	49	0.3673469
NODE_148030_length_316_cov_1.640553	218	300	0	82	82	1.0000000
NODE_148042_length_316_cov_1.631336	180	233	0	29	53	0.5471698
NODE_148042_length_316_cov_1.631336	180	233	2	24	53	0.4528302
NODE_148042_length_316_cov_1.631336	180	215	0	11	35	0.3142857
NODE_148042_length_316_cov_1.631336	180	215	2	24	35	0.6857143
NODE_148080_length_316_cov_1.520737	194	275	0	33	81	0.4074074
NODE_148080_length_316_cov_1.520737	194	275	2	48	81	0.5925926
NODE_148080_length_316_cov_1.520737	248	302	0	54	54	1.0000000
NODE_148086_length_316_cov_1.493088	64	144	0	15	80	0.1875000
NODE_148086_length_316_cov_1.493088	64	144	2	65	80	0.8125000
NODE_148193_length_316_cov_1.377880	22	64	0	42	42	1.0000000
NODE_148204_length_316_cov_1.350230	74	117	8	2	43	0.0465116
NODE_148204_length_316_cov_1.350230	74	117	10	41	43	0.9534883
NODE_148204_length_316_cov_1.350230	90	140	5	1	50	0.0200000
NODE_148204_length_316_cov_1.350230	90	140	7	2	50	0.0400000
NODE_148204_length_316_cov_1.350230	90	140	8	22	50	0.4400000
NODE_148204_length_316_cov_1.350230	90	140	10	25	50	0.5000000
NODE_148533_length_316_cov_0.940092	104	180	0	35	76	0.4605263
NODE_148533_length_316_cov_0.940092	104	180	2	41	76	0.5394737
NODE_148533_length_316_cov_0.940092	155	234	0	18	79	0.2278481
NODE_148533_length_316_cov_0.940092	155	234	2	61	79	0.7721519
NODE_148693_length_316_cov_0.695853	232	267	4	1	35	0.0285714
NODE_148693_length_316_cov_0.695853	232	267	6	34	35	0.9714286
NODE_148778_length_315_cov_6.967593	127	191	11	2	64	0.0312500
NODE_148778_length_315_cov_6.967593	127	191	17	62	64	0.9687500
NODE_148786_length_315_cov_6.300926	67	147	0	80	80	1.0000000
NODE_148786_length_315_cov_6.300926	120	200	0	80	80	1.0000000
NODE_148812_length_315_cov_4.449074	125	205	0	52	80	0.6500000
NODE_148812_length_315_cov_4.449074	125	205	1	28	80	0.3500000
NODE_148812_length_315_cov_4.449074	178	225	0	47	47	1.0000000
NODE_148834_length_315_cov_4.009259	0	61	0	61	61	1.0000000
NODE_148834_length_315_cov_4.009259	42	61	0	19	19	1.0000000
NODE_148872_length_315_cov_3.421296	37	120	11	3	83	0.0361446
NODE_148872_length_315_cov_3.421296	37	120	14	2	83	0.0240964
NODE_148872_length_315_cov_3.421296	37	120	15	2	83	0.0240964
NODE_148872_length_315_cov_3.421296	37	120	17	38	83	0.4578313
NODE_148872_length_315_cov_3.421296	37	120	18	19	83	0.2289157
NODE_148872_length_315_cov_3.421296	37	120	20	19	83	0.2289157
NODE_148915_length_315_cov_2.847222	0	74	0	74	74	1.0000000
NODE_148915_length_315_cov_2.847222	47	127	0	80	80	1.0000000
NODE_148921_length_315_cov_2.833333	186	253	0	15	67	0.2238806
NODE_148921_length_315_cov_2.833333	186	253	2	52	67	0.7761194
NODE_148921_length_315_cov_2.833333	186	253	0	15	67	0.2238806
NODE_148921_length_315_cov_2.833333	186	253	2	52	67	0.7761194
NODE_148991_length_315_cov_2.416667	44	117	37	11	73	0.1506849
NODE_148991_length_315_cov_2.416667	44	117	43	4	73	0.0547945
NODE_148991_length_315_cov_2.416667	44	117	46	1	73	0.0136986
NODE_148991_length_315_cov_2.416667	44	117	47	2	73	0.0273973
NODE_148991_length_315_cov_2.416667	44	117	48	1	73	0.0136986
NODE_148991_length_315_cov_2.416667	44	117	52	1	73	0.0136986
NODE_148991_length_315_cov_2.416667	44	117	53	3	73	0.0410959
NODE_148991_length_315_cov_2.416667	44	117	59	1	73	0.0136986
NODE_148991_length_315_cov_2.416667	44	117	63	1	73	0.0136986
NODE_148991_length_315_cov_2.416667	44	117	65	1	73	0.0136986
NODE_148991_length_315_cov_2.416667	44	117	68	6	73	0.0821918
NODE_148991_length_315_cov_2.416667	44	117	69	1	73	0.0136986
NODE_148991_length_315_cov_2.416667	44	117	75	3	73	0.0410959
NODE_148991_length_315_cov_2.416667	44	117	78	2	73	0.0273973
NODE_148991_length_315_cov_2.416667	44	117	81	2	73	0.0273973
NODE_148991_length_315_cov_2.416667	44	117	82	2	73	0.0273973
NODE_148991_length_315_cov_2.416667	44	117	84	3	73	0.0410959
NODE_148991_length_315_cov_2.416667	44	117	99	1	73	0.0136986
NODE_148991_length_315_cov_2.416667	44	117	100	1	73	0.0136986
NODE_148991_length_315_cov_2.416667	44	117	101	6	73	0.0821918
NODE_148991_length_315_cov_2.416667	44	117	103	1	73	0.0136986
NODE_148991_length_315_cov_2.416667	44	117	107	1	73	0.0136986
NODE_148991_length_315_cov_2.416667	44	117	111	1	73	0.0136986
NODE_148991_length_315_cov_2.416667	44	117	114	6	73	0.0821918
NODE_148991_length_315_cov_2.416667	44	117	115	1	73	0.0136986
NODE_148991_length_315_cov_2.416667	44	117	116	2	73	0.0273973
NODE_148991_length_315_cov_2.416667	44	117	117	2	73	0.0273973
NODE_148991_length_315_cov_2.416667	44	117	119	2	73	0.0273973
NODE_148991_length_315_cov_2.416667	44	117	121	3	73	0.0410959
NODE_148991_length_315_cov_2.416667	44	117	135	1	73	0.0136986
NODE_149074_length_315_cov_2.115741	128	193	0	19	65	0.2923077
NODE_149074_length_315_cov_2.115741	128	193	2	46	65	0.7076923
NODE_149095_length_315_cov_2.004630	270	315	0	45	45	1.0000000
NODE_149201_length_315_cov_1.731481	125	202	0	22	77	0.2857143
NODE_149201_length_315_cov_1.731481	125	202	1	11	77	0.1428571
NODE_149201_length_315_cov_1.731481	125	202	5	24	77	0.3116883
NODE_149201_length_315_cov_1.731481	125	202	6	20	77	0.2597403
NODE_149391_length_315_cov_1.384259	183	233	0	50	50	1.0000000
NODE_149935_length_315_cov_0.430556	125	145	0	20	20	1.0000000
NODE_149943_length_314_cov_108.139535	151	213	0	22	62	0.3548387
NODE_149943_length_314_cov_108.139535	151	213	2	5	62	0.0806452
NODE_149943_length_314_cov_108.139535	151	213	3	35	62	0.5645161
NODE_149943_length_314_cov_108.139535	160	213	0	22	53	0.4150943
NODE_149943_length_314_cov_108.139535	160	213	2	5	53	0.0943396
NODE_149943_length_314_cov_108.139535	160	213	3	26	53	0.4905660
NODE_149944_length_314_cov_48.134884	245	314	0	69	69	1.0000000
NODE_149946_length_314_cov_9.097674	149	206	0	7	57	0.1228070
NODE_149946_length_314_cov_9.097674	149	206	2	50	57	0.8771930
NODE_149967_length_314_cov_4.897674	109	189	4	64	80	0.8000000
NODE_149967_length_314_cov_4.897674	109	189	6	16	80	0.2000000
NODE_150004_length_314_cov_3.823256	119	199	0	65	80	0.8125000
NODE_150004_length_314_cov_3.823256	119	199	2	13	80	0.1625000
NODE_150004_length_314_cov_3.823256	119	199	4	1	80	0.0125000
NODE_150004_length_314_cov_3.823256	119	199	6	1	80	0.0125000
NODE_150020_length_314_cov_3.558140	32	92	14	1	60	0.0166667
NODE_150020_length_314_cov_3.558140	32	92	18	6	60	0.1000000
NODE_150020_length_314_cov_3.558140	32	92	20	8	60	0.1333333
NODE_150020_length_314_cov_3.558140	32	92	22	28	60	0.4666667
NODE_150020_length_314_cov_3.558140	32	92	24	17	60	0.2833333
NODE_150035_length_314_cov_3.316279	84	126	15	10	42	0.2380952
NODE_150035_length_314_cov_3.316279	84	126	17	2	42	0.0476190
NODE_150035_length_314_cov_3.316279	84	126	19	8	42	0.1904762
NODE_150035_length_314_cov_3.316279	84	126	21	1	42	0.0238095
NODE_150035_length_314_cov_3.316279	84	126	22	14	42	0.3333333
NODE_150035_length_314_cov_3.316279	84	126	23	7	42	0.1666667
NODE_150035_length_314_cov_3.316279	127	180	1	1	53	0.0188679
NODE_150035_length_314_cov_3.316279	127	180	2	13	53	0.2452830
NODE_150035_length_314_cov_3.316279	127	180	4	18	53	0.3396226
NODE_150035_length_314_cov_3.316279	127	180	6	1	53	0.0188679
NODE_150035_length_314_cov_3.316279	127	180	7	1	53	0.0188679
NODE_150035_length_314_cov_3.316279	127	180	9	7	53	0.1320755
NODE_150035_length_314_cov_3.316279	127	180	11	6	53	0.1132075
NODE_150035_length_314_cov_3.316279	127	180	13	1	53	0.0188679
NODE_150035_length_314_cov_3.316279	127	180	15	5	53	0.0943396
NODE_150035_length_314_cov_3.316279	128	148	6	1	20	0.0500000
NODE_150035_length_314_cov_3.316279	128	148	7	1	20	0.0500000
NODE_150035_length_314_cov_3.316279	128	148	9	7	20	0.3500000
NODE_150035_length_314_cov_3.316279	128	148	11	6	20	0.3000000
NODE_150035_length_314_cov_3.316279	128	148	13	1	20	0.0500000
NODE_150035_length_314_cov_3.316279	128	148	15	4	20	0.2000000
NODE_150066_length_314_cov_3.032558	252	308	0	14	56	0.2500000
NODE_150066_length_314_cov_3.032558	252	308	2	8	56	0.1428571
NODE_150066_length_314_cov_3.032558	252	308	4	5	56	0.0892857
NODE_150066_length_314_cov_3.032558	252	308	5	29	56	0.5178571
NODE_150141_length_314_cov_2.520930	0	61	0	61	61	1.0000000
NODE_150141_length_314_cov_2.520930	34	93	0	59	59	1.0000000
NODE_150153_length_314_cov_2.441860	48	84	0	9	36	0.2500000
NODE_150153_length_314_cov_2.441860	48	84	2	27	36	0.7500000
NODE_150159_length_314_cov_2.395349	62	112	2	13	50	0.2600000
NODE_150159_length_314_cov_2.395349	62	112	6	37	50	0.7400000
NODE_150200_length_314_cov_2.265116	7	53	0	6	46	0.1304348
NODE_150200_length_314_cov_2.265116	7	53	2	33	46	0.7173913
NODE_150200_length_314_cov_2.265116	7	53	4	6	46	0.1304348
NODE_150200_length_314_cov_2.265116	7	53	6	1	46	0.0217391
NODE_150220_length_314_cov_2.144186	224	264	0	40	40	1.0000000
NODE_150257_length_314_cov_2.004651	68	148	0	40	80	0.5000000
NODE_150257_length_314_cov_2.004651	68	148	2	40	80	0.5000000
NODE_150257_length_314_cov_2.004651	121	201	2	72	80	0.9000000
NODE_150257_length_314_cov_2.004651	121	201	4	8	80	0.1000000
NODE_150385_length_314_cov_1.665116	204	242	0	38	38	1.0000000
NODE_150385_length_314_cov_1.665116	215	295	0	80	80	1.0000000
NODE_150647_length_314_cov_1.223256	7	87	0	2	80	0.0250000
NODE_150647_length_314_cov_1.223256	7	87	2	10	80	0.1250000
NODE_150647_length_314_cov_1.223256	7	87	4	8	80	0.1000000
NODE_150647_length_314_cov_1.223256	7	87	6	6	80	0.0750000
NODE_150647_length_314_cov_1.223256	7	87	8	54	80	0.6750000
NODE_150709_length_314_cov_1.167442	1	69	0	45	68	0.6617647
NODE_150709_length_314_cov_1.167442	1	69	2	23	68	0.3382353
NODE_151193_length_313_cov_156.051402	177	254	6	13	77	0.1688312
NODE_151193_length_313_cov_156.051402	177	254	8	64	77	0.8311688
NODE_151193_length_313_cov_156.051402	177	254	6	13	77	0.1688312
NODE_151193_length_313_cov_156.051402	177	254	8	64	77	0.8311688
NODE_151214_length_313_cov_5.359813	135	196	0	15	61	0.2459016
NODE_151214_length_313_cov_5.359813	135	196	2	46	61	0.7540984
NODE_151214_length_313_cov_5.359813	169	241	0	17	72	0.2361111
NODE_151214_length_313_cov_5.359813	169	241	2	55	72	0.7638889
NODE_151230_length_313_cov_4.794393	126	206	0	36	80	0.4500000
NODE_151230_length_313_cov_4.794393	126	206	6	28	80	0.3500000
NODE_151230_length_313_cov_4.794393	126	206	8	16	80	0.2000000
NODE_151230_length_313_cov_4.794393	179	259	2	1	80	0.0125000
NODE_151230_length_313_cov_4.794393	179	259	6	11	80	0.1375000
NODE_151230_length_313_cov_4.794393	179	259	7	2	80	0.0250000
NODE_151230_length_313_cov_4.794393	179	259	8	66	80	0.8250000
NODE_151232_length_313_cov_4.761682	104	162	0	23	58	0.3965517
NODE_151232_length_313_cov_4.761682	104	162	14	35	58	0.6034483
NODE_151232_length_313_cov_4.761682	135	215	14	28	80	0.3500000
NODE_151232_length_313_cov_4.761682	135	215	16	52	80	0.6500000
NODE_151277_length_313_cov_3.560748	106	186	6	1	80	0.0125000
NODE_151277_length_313_cov_3.560748	106	186	8	79	80	0.9875000
NODE_151331_length_313_cov_2.953271	92	153	2	34	61	0.5573770
NODE_151331_length_313_cov_2.953271	92	153	4	18	61	0.2950820
NODE_151331_length_313_cov_2.953271	92	153	6	9	61	0.1475410
NODE_151364_length_313_cov_2.640187	110	182	0	72	72	1.0000000
NODE_151364_length_313_cov_2.640187	113	184	0	71	71	1.0000000
NODE_151409_length_313_cov_2.383178	58	137	0	79	79	1.0000000
NODE_151409_length_313_cov_2.383178	110	190	0	72	80	0.9000000
NODE_151409_length_313_cov_2.383178	110	190	2	5	80	0.0625000
NODE_151409_length_313_cov_2.383178	110	190	3	1	80	0.0125000
NODE_151409_length_313_cov_2.383178	110	190	10	2	80	0.0250000
NODE_151474_length_313_cov_2.107477	153	221	2	8	68	0.1176471
NODE_151474_length_313_cov_2.107477	153	221	4	1	68	0.0147059
NODE_151474_length_313_cov_2.107477	153	221	6	2	68	0.0294118
NODE_151474_length_313_cov_2.107477	153	221	8	12	68	0.1764706
NODE_151474_length_313_cov_2.107477	153	221	12	5	68	0.0735294
NODE_151474_length_313_cov_2.107477	153	221	14	10	68	0.1470588
NODE_151474_length_313_cov_2.107477	153	221	16	25	68	0.3676471
NODE_151474_length_313_cov_2.107477	153	221	18	5	68	0.0735294
NODE_151510_length_313_cov_1.934579	107	187	0	14	80	0.1750000
NODE_151510_length_313_cov_1.934579	107	187	2	15	80	0.1875000
NODE_151510_length_313_cov_1.934579	107	187	4	2	80	0.0250000
NODE_151510_length_313_cov_1.934579	107	187	7	1	80	0.0125000
NODE_151510_length_313_cov_1.934579	107	187	9	1	80	0.0125000
NODE_151510_length_313_cov_1.934579	107	187	11	3	80	0.0375000
NODE_151510_length_313_cov_1.934579	107	187	13	3	80	0.0375000
NODE_151510_length_313_cov_1.934579	107	187	16	6	80	0.0750000
NODE_151510_length_313_cov_1.934579	107	187	18	1	80	0.0125000
NODE_151510_length_313_cov_1.934579	107	187	20	2	80	0.0250000
NODE_151510_length_313_cov_1.934579	107	187	22	1	80	0.0125000
NODE_151510_length_313_cov_1.934579	107	187	24	4	80	0.0500000
NODE_151510_length_313_cov_1.934579	107	187	26	1	80	0.0125000
NODE_151510_length_313_cov_1.934579	107	187	28	10	80	0.1250000
NODE_151510_length_313_cov_1.934579	107	187	30	4	80	0.0500000
NODE_151510_length_313_cov_1.934579	107	187	32	1	80	0.0125000
NODE_151510_length_313_cov_1.934579	107	187	36	4	80	0.0500000
NODE_151510_length_313_cov_1.934579	107	187	38	4	80	0.0500000
NODE_151510_length_313_cov_1.934579	107	187	40	3	80	0.0375000
NODE_151510_length_313_cov_1.934579	160	240	26	1	80	0.0125000
NODE_151510_length_313_cov_1.934579	160	240	28	10	80	0.1250000
NODE_151510_length_313_cov_1.934579	160	240	30	4	80	0.0500000
NODE_151510_length_313_cov_1.934579	160	240	32	1	80	0.0125000
NODE_151510_length_313_cov_1.934579	160	240	36	4	80	0.0500000
NODE_151510_length_313_cov_1.934579	160	240	37	5	80	0.0625000
NODE_151510_length_313_cov_1.934579	160	240	38	4	80	0.0500000
NODE_151510_length_313_cov_1.934579	160	240	39	10	80	0.1250000
NODE_151510_length_313_cov_1.934579	160	240	40	15	80	0.1875000
NODE_151510_length_313_cov_1.934579	160	240	41	1	80	0.0125000
NODE_151510_length_313_cov_1.934579	160	240	42	10	80	0.1250000
NODE_151510_length_313_cov_1.934579	160	240	43	2	80	0.0250000
NODE_151510_length_313_cov_1.934579	160	240	45	3	80	0.0375000
NODE_151510_length_313_cov_1.934579	160	240	46	10	80	0.1250000
NODE_151576_length_313_cov_1.780374	236	296	0	60	60	1.0000000
NODE_151623_length_313_cov_1.663551	58	135	0	77	77	1.0000000
NODE_151703_length_313_cov_1.439252	0	64	0	64	64	1.0000000
NODE_151703_length_313_cov_1.439252	37	82	0	45	45	1.0000000
NODE_151753_length_313_cov_1.429907	74	111	0	18	37	0.4864865
NODE_151753_length_313_cov_1.429907	74	111	2	19	37	0.5135135
NODE_151753_length_313_cov_1.429907	109	172	0	6	63	0.0952381
NODE_151753_length_313_cov_1.429907	109	172	2	57	63	0.9047619
NODE_151953_length_313_cov_1.172897	106	161	0	55	55	1.0000000
NODE_151953_length_313_cov_1.172897	149	214	0	37	65	0.5692308
NODE_151953_length_313_cov_1.172897	149	214	4	28	65	0.4307692
NODE_152525_length_312_cov_3.723005	178	238	12	60	60	1.0000000
NODE_152525_length_312_cov_3.723005	231	291	6	5	60	0.0833333
NODE_152525_length_312_cov_3.723005	231	291	8	40	60	0.6666667
NODE_152525_length_312_cov_3.723005	231	291	10	7	60	0.1166667
NODE_152525_length_312_cov_3.723005	231	291	12	8	60	0.1333333
NODE_152609_length_312_cov_2.723005	34	96	0	62	62	1.0000000
NODE_152609_length_312_cov_2.723005	87	149	0	62	62	1.0000000
NODE_152680_length_312_cov_2.333333	6	70	0	64	64	1.0000000
NODE_152680_length_312_cov_2.333333	43	123	0	80	80	1.0000000
NODE_152686_length_312_cov_2.267606	176	208	4	5	32	0.1562500
NODE_152686_length_312_cov_2.267606	176	208	6	8	32	0.2500000
NODE_152686_length_312_cov_2.267606	176	208	8	19	32	0.5937500
NODE_152697_length_312_cov_2.234742	108	169	0	57	61	0.9344262
NODE_152697_length_312_cov_2.234742	108	169	2	1	61	0.0163934
NODE_152697_length_312_cov_2.234742	108	169	4	3	61	0.0491803
NODE_152751_length_312_cov_2.014085	141	205	0	64	64	1.0000000
NODE_152751_length_312_cov_2.014085	178	258	0	80	80	1.0000000
NODE_152827_length_312_cov_1.835681	176	221	0	45	45	1.0000000
NODE_152827_length_312_cov_1.835681	194	269	0	75	75	1.0000000
NODE_153222_length_312_cov_1.173709	87	133	3	4	46	0.0869565
NODE_153222_length_312_cov_1.173709	87	133	4	6	46	0.1304348
NODE_153222_length_312_cov_1.173709	87	133	6	3	46	0.0652174
NODE_153222_length_312_cov_1.173709	87	133	7	1	46	0.0217391
NODE_153222_length_312_cov_1.173709	87	133	9	1	46	0.0217391
NODE_153222_length_312_cov_1.173709	87	133	11	1	46	0.0217391
NODE_153222_length_312_cov_1.173709	87	133	12	1	46	0.0217391
NODE_153222_length_312_cov_1.173709	87	133	14	4	46	0.0869565
NODE_153222_length_312_cov_1.173709	87	133	15	1	46	0.0217391
NODE_153222_length_312_cov_1.173709	87	133	24	1	46	0.0217391
NODE_153222_length_312_cov_1.173709	87	133	25	10	46	0.2173913
NODE_153222_length_312_cov_1.173709	87	133	26	5	46	0.1086956
NODE_153222_length_312_cov_1.173709	87	133	27	1	46	0.0217391
NODE_153222_length_312_cov_1.173709	87	133	28	1	46	0.0217391
NODE_153222_length_312_cov_1.173709	87	133	29	3	46	0.0652174
NODE_153222_length_312_cov_1.173709	87	133	31	1	46	0.0217391
NODE_153222_length_312_cov_1.173709	87	133	32	2	46	0.0434783
NODE_153222_length_312_cov_1.173709	150	217	50	4	67	0.0597015
NODE_153222_length_312_cov_1.173709	150	217	53	4	67	0.0597015
NODE_153222_length_312_cov_1.173709	150	217	54	2	67	0.0298507
NODE_153222_length_312_cov_1.173709	150	217	58	2	67	0.0298507
NODE_153222_length_312_cov_1.173709	150	217	60	2	67	0.0298507
NODE_153222_length_312_cov_1.173709	150	217	62	12	67	0.1791045
NODE_153222_length_312_cov_1.173709	150	217	64	17	67	0.2537313
NODE_153222_length_312_cov_1.173709	150	217	66	3	67	0.0447761
NODE_153222_length_312_cov_1.173709	150	217	68	20	67	0.2985075
NODE_153222_length_312_cov_1.173709	150	217	70	1	67	0.0149254
NODE_153532_length_312_cov_0.788732	49	110	0	61	61	1.0000000
NODE_153532_length_312_cov_0.788732	102	163	0	19	61	0.3114754
NODE_153532_length_312_cov_0.788732	102	163	2	27	61	0.4426230
NODE_153532_length_312_cov_0.788732	102	163	4	15	61	0.2459016
NODE_153708_length_311_cov_5.179245	155	235	6	42	80	0.5250000
NODE_153708_length_311_cov_5.179245	155	235	8	38	80	0.4750000
NODE_153721_length_311_cov_4.589623	133	200	0	67	67	1.0000000
NODE_153730_length_311_cov_4.358491	199	263	0	64	64	1.0000000
NODE_153743_length_311_cov_3.929245	91	127	0	36	36	1.0000000
NODE_153755_length_311_cov_3.825472	224	304	0	1	80	0.0125000
NODE_153755_length_311_cov_3.825472	224	304	4	11	80	0.1375000
NODE_153755_length_311_cov_3.825472	224	304	6	1	80	0.0125000
NODE_153755_length_311_cov_3.825472	224	304	11	2	80	0.0250000
NODE_153755_length_311_cov_3.825472	224	304	12	2	80	0.0250000
NODE_153755_length_311_cov_3.825472	224	304	16	16	80	0.2000000
NODE_153755_length_311_cov_3.825472	224	304	18	6	80	0.0750000
NODE_153755_length_311_cov_3.825472	224	304	20	2	80	0.0250000
NODE_153755_length_311_cov_3.825472	224	304	33	9	80	0.1125000
NODE_153755_length_311_cov_3.825472	224	304	36	8	80	0.1000000
NODE_153755_length_311_cov_3.825472	224	304	40	10	80	0.1250000
NODE_153755_length_311_cov_3.825472	224	304	42	12	80	0.1500000
NODE_153773_length_311_cov_3.466981	106	186	0	80	80	1.0000000
NODE_153796_length_311_cov_3.188679	39	96	0	57	57	1.0000000
NODE_153846_length_311_cov_2.702830	144	193	0	28	49	0.5714286
NODE_153846_length_311_cov_2.702830	144	193	2	17	49	0.3469388
NODE_153846_length_311_cov_2.702830	144	193	4	4	49	0.0816327
NODE_153850_length_311_cov_2.665094	43	113	0	12	70	0.1714286
NODE_153850_length_311_cov_2.665094	43	113	2	11	70	0.1571429
NODE_153850_length_311_cov_2.665094	43	113	4	47	70	0.6714286
NODE_153859_length_311_cov_2.617925	206	284	0	78	78	1.0000000
NODE_153859_length_311_cov_2.617925	257	301	0	44	44	1.0000000
NODE_153913_length_311_cov_2.349057	177	204	0	13	27	0.4814815
NODE_153913_length_311_cov_2.349057	177	204	2	14	27	0.5185185
NODE_153919_length_311_cov_2.325472	74	138	0	64	64	1.0000000
NODE_153947_length_311_cov_2.188679	21	92	0	71	71	1.0000000
NODE_154014_length_311_cov_1.924528	46	65	1	1	19	0.0526316
NODE_154014_length_311_cov_1.924528	46	65	2	1	19	0.0526316
NODE_154014_length_311_cov_1.924528	46	65	3	17	19	0.8947368
NODE_154056_length_311_cov_1.891509	122	180	2	5	58	0.0862069
NODE_154056_length_311_cov_1.891509	122	180	4	19	58	0.3275862
NODE_154056_length_311_cov_1.891509	122	180	6	34	58	0.5862069
NODE_154188_length_311_cov_1.594340	0	35	0	35	35	1.0000000
NODE_154190_length_311_cov_1.589623	96	151	0	18	55	0.3272727
NODE_154190_length_311_cov_1.589623	96	151	1	17	55	0.3090909
NODE_154190_length_311_cov_1.589623	96	151	2	1	55	0.0181818
NODE_154190_length_311_cov_1.589623	96	151	3	1	55	0.0181818
NODE_154190_length_311_cov_1.589623	96	151	4	9	55	0.1636364
NODE_154190_length_311_cov_1.589623	96	151	6	2	55	0.0363636
NODE_154190_length_311_cov_1.589623	96	151	10	7	55	0.1272727
NODE_154194_length_311_cov_1.570755	125	145	0	12	20	0.6000000
NODE_154194_length_311_cov_1.570755	125	145	2	8	20	0.4000000
NODE_154957_length_311_cov_0.613208	136	216	0	80	80	1.0000000
NODE_154957_length_311_cov_0.613208	189	264	0	75	75	1.0000000
NODE_154996_length_310_cov_96.995261	211	249	122	3	38	0.0789474
NODE_154996_length_310_cov_96.995261	211	249	128	1	38	0.0263158
NODE_154996_length_310_cov_96.995261	211	249	129	2	38	0.0526316
NODE_154996_length_310_cov_96.995261	211	249	131	1	38	0.0263158
NODE_154996_length_310_cov_96.995261	211	249	133	1	38	0.0263158
NODE_154996_length_310_cov_96.995261	211	249	139	1	38	0.0263158
NODE_154996_length_310_cov_96.995261	211	249	141	4	38	0.1052632
NODE_154996_length_310_cov_96.995261	211	249	143	1	38	0.0263158
NODE_154996_length_310_cov_96.995261	211	249	145	1	38	0.0263158
NODE_154996_length_310_cov_96.995261	211	249	146	3	38	0.0789474
NODE_154996_length_310_cov_96.995261	211	249	147	3	38	0.0789474
NODE_154996_length_310_cov_96.995261	211	249	150	4	38	0.1052632
NODE_154996_length_310_cov_96.995261	211	249	152	1	38	0.0263158
NODE_154996_length_310_cov_96.995261	211	249	154	3	38	0.0789474
NODE_154996_length_310_cov_96.995261	211	249	156	2	38	0.0526316
NODE_154996_length_310_cov_96.995261	211	249	159	1	38	0.0263158
NODE_154996_length_310_cov_96.995261	211	249	161	3	38	0.0789474
NODE_154996_length_310_cov_96.995261	211	249	162	2	38	0.0526316
NODE_154996_length_310_cov_96.995261	211	249	164	1	38	0.0263158
NODE_155001_length_310_cov_7.767773	80	151	0	71	71	1.0000000
NODE_155001_length_310_cov_7.767773	134	189	0	55	55	1.0000000
NODE_155017_length_310_cov_5.914692	84	134	0	46	50	0.9200000
NODE_155017_length_310_cov_5.914692	84	134	6	3	50	0.0600000
NODE_155017_length_310_cov_5.914692	84	134	10	1	50	0.0200000
NODE_155017_length_310_cov_5.914692	113	134	0	21	21	1.0000000
NODE_155017_length_310_cov_5.914692	113	188	0	60	75	0.8000000
NODE_155017_length_310_cov_5.914692	113	188	4	15	75	0.2000000
NODE_155066_length_310_cov_3.777251	146	226	2	80	80	1.0000000
NODE_155115_length_310_cov_3.180095	137	211	8	19	74	0.2567568
NODE_155115_length_310_cov_3.180095	137	211	10	26	74	0.3513514
NODE_155115_length_310_cov_3.180095	137	211	12	18	74	0.2432432
NODE_155115_length_310_cov_3.180095	137	211	14	1	74	0.0135135
NODE_155115_length_310_cov_3.180095	137	211	16	4	74	0.0540541
NODE_155115_length_310_cov_3.180095	137	211	18	6	74	0.0810811
NODE_155179_length_310_cov_2.630332	122	174	0	52	52	1.0000000
NODE_155179_length_310_cov_2.630332	175	222	0	47	47	1.0000000
NODE_155180_length_310_cov_2.625592	258	301	0	43	43	1.0000000
NODE_155195_length_310_cov_2.563981	149	196	0	21	47	0.4468085
NODE_155195_length_310_cov_2.563981	149	196	2	17	47	0.3617021
NODE_155195_length_310_cov_2.563981	149	196	4	2	47	0.0425532
NODE_155195_length_310_cov_2.563981	149	196	6	1	47	0.0212766
NODE_155195_length_310_cov_2.563981	149	196	7	1	47	0.0212766
NODE_155195_length_310_cov_2.563981	149	196	8	5	47	0.1063830
NODE_155195_length_310_cov_2.563981	169	249	0	74	80	0.9250000
NODE_155195_length_310_cov_2.563981	169	249	2	6	80	0.0750000
NODE_155261_length_310_cov_2.298578	213	259	6	46	46	1.0000000
NODE_155334_length_310_cov_2.009479	223	303	0	80	80	1.0000000
NODE_155439_length_310_cov_1.729858	53	91	0	38	38	1.0000000
NODE_155768_length_310_cov_1.222749	181	244	0	49	63	0.7777778
NODE_155768_length_310_cov_1.222749	181	244	2	14	63	0.2222222
NODE_155864_length_310_cov_1.142180	65	135	0	1	70	0.0142857
NODE_155864_length_310_cov_1.142180	65	135	12	1	70	0.0142857
NODE_155864_length_310_cov_1.142180	65	135	14	2	70	0.0285714
NODE_155864_length_310_cov_1.142180	65	135	16	4	70	0.0571429
NODE_155864_length_310_cov_1.142180	65	135	18	3	70	0.0428571
NODE_155864_length_310_cov_1.142180	65	135	22	6	70	0.0857143
NODE_155864_length_310_cov_1.142180	65	135	24	8	70	0.1142857
NODE_155864_length_310_cov_1.142180	65	135	26	15	70	0.2142857
NODE_155864_length_310_cov_1.142180	65	135	28	6	70	0.0857143
NODE_155864_length_310_cov_1.142180	65	135	30	24	70	0.3428572
NODE_155937_length_310_cov_0.966825	131	212	0	70	81	0.8641976
NODE_155937_length_310_cov_0.966825	131	212	4	11	81	0.1358025
NODE_155937_length_310_cov_0.966825	193	256	0	8	63	0.1269841
NODE_155937_length_310_cov_0.966825	193	256	4	55	63	0.8730159
NODE_156078_length_310_cov_0.924171	180	222	2	42	42	1.0000000
NODE_156174_length_310_cov_0.739336	208	288	0	80	80	1.0000000
NODE_156332_length_309_cov_8.552381	154	234	0	80	80	1.0000000
NODE_156340_length_309_cov_6.147619	20	83	0	63	63	1.0000000
NODE_156349_length_309_cov_5.147619	213	291	0	78	78	1.0000000
NODE_156364_length_309_cov_4.585714	15	95	0	80	80	1.0000000
NODE_156472_length_309_cov_3.028571	0	47	0	19	47	0.4042553
NODE_156472_length_309_cov_3.028571	0	47	2	28	47	0.5957447
NODE_156472_length_309_cov_3.028571	20	101	2	81	81	1.0000000
NODE_156563_length_309_cov_2.304762	179	218	2	5	39	0.1282051
NODE_156563_length_309_cov_2.304762	179	218	6	11	39	0.2820513
NODE_156563_length_309_cov_2.304762	179	218	10	23	39	0.5897436
NODE_156615_length_309_cov_2.095238	55	85	0	30	30	1.0000000
NODE_156678_length_309_cov_1.938095	2	73	0	71	71	1.0000000
NODE_156950_length_309_cov_1.414286	189	231	0	42	42	1.0000000
NODE_156978_length_309_cov_1.376190	94	168	2	74	74	1.0000000
NODE_157334_length_309_cov_0.966667	134	153	0	19	19	1.0000000
NODE_157469_length_309_cov_0.738095	150	215	13	1	65	0.0153846
NODE_157469_length_309_cov_0.738095	150	215	15	23	65	0.3538462
NODE_157469_length_309_cov_0.738095	150	215	17	4	65	0.0615385
NODE_157469_length_309_cov_0.738095	150	215	19	1	65	0.0153846
NODE_157469_length_309_cov_0.738095	150	215	21	22	65	0.3384615
NODE_157469_length_309_cov_0.738095	150	215	23	14	65	0.2153846
NODE_157661_length_308_cov_4.775120	137	174	2	1	37	0.0270270
NODE_157661_length_308_cov_4.775120	137	174	6	36	37	0.9729730
NODE_157690_length_308_cov_3.966507	126	206	0	31	80	0.3875000
NODE_157690_length_308_cov_3.966507	126	206	2	49	80	0.6125000
NODE_157705_length_308_cov_3.665072	11	75	0	64	64	1.0000000
NODE_157819_length_308_cov_2.593301	137	193	0	50	56	0.8928571
NODE_157819_length_308_cov_2.593301	137	193	2	6	56	0.1071429
NODE_157852_length_308_cov_2.435407	14	58	0	44	44	1.0000000
NODE_157852_length_308_cov_2.435407	31	111	0	80	80	1.0000000
NODE_157898_length_308_cov_2.191388	14	80	0	66	66	1.0000000
NODE_157903_length_308_cov_2.191388	236	296	0	60	60	1.0000000
NODE_157969_length_308_cov_1.952153	251	296	0	45	45	1.0000000
NODE_158083_length_308_cov_1.708134	102	148	0	46	46	1.0000000
NODE_158276_length_308_cov_1.435407	196	276	2	80	80	1.0000000
NODE_158439_length_308_cov_1.162679	260	300	0	40	40	1.0000000
NODE_158439_length_308_cov_1.162679	273	307	0	34	34	1.0000000
NODE_158447_length_308_cov_1.148325	35	83	0	40	48	0.8333333
NODE_158447_length_308_cov_1.148325	35	83	4	8	48	0.1666667
NODE_158448_length_308_cov_1.148325	253	308	6	55	55	1.0000000
NODE_158510_length_308_cov_1.038278	147	202	2	38	55	0.6909091
NODE_158510_length_308_cov_1.038278	147	202	4	17	55	0.3090909
NODE_158811_length_308_cov_0.684211	196	275	0	62	79	0.7848101
NODE_158811_length_308_cov_0.684211	196	275	2	17	79	0.2151899
NODE_158821_length_308_cov_0.660287	109	157	0	14	48	0.2916667
NODE_158821_length_308_cov_0.660287	109	157	2	7	48	0.1458333
NODE_158821_length_308_cov_0.660287	109	157	4	5	48	0.1041667
NODE_158821_length_308_cov_0.660287	109	157	6	14	48	0.2916667
NODE_158821_length_308_cov_0.660287	109	157	8	8	48	0.1666667
NODE_158821_length_308_cov_0.660287	130	210	4	5	80	0.0625000
NODE_158821_length_308_cov_0.660287	130	210	6	14	80	0.1750000
NODE_158821_length_308_cov_0.660287	130	210	8	61	80	0.7625000
NODE_158905_length_307_cov_30.725962	0	73	0	73	73	1.0000000
NODE_158905_length_307_cov_30.725962	46	99	0	53	53	1.0000000
NODE_158906_length_307_cov_25.096154	84	164	0	80	80	1.0000000
NODE_158906_length_307_cov_25.096154	137	217	0	80	80	1.0000000
NODE_158933_length_307_cov_5.524038	150	221	0	57	71	0.8028169
NODE_158933_length_307_cov_5.524038	150	221	2	14	71	0.1971831
NODE_158983_length_307_cov_3.730769	172	252	0	80	80	1.0000000
NODE_158983_length_307_cov_3.730769	225	305	0	80	80	1.0000000
NODE_158999_length_307_cov_3.322115	20	100	2	24	80	0.3000000
NODE_158999_length_307_cov_3.322115	20	100	4	9	80	0.1125000
NODE_158999_length_307_cov_3.322115	20	100	6	4	80	0.0500000
NODE_158999_length_307_cov_3.322115	20	100	10	39	80	0.4875000
NODE_158999_length_307_cov_3.322115	20	100	12	4	80	0.0500000
NODE_158999_length_307_cov_3.322115	78	153	8	6	75	0.0800000
NODE_158999_length_307_cov_3.322115	78	153	10	29	75	0.3866667
NODE_158999_length_307_cov_3.322115	78	153	12	37	75	0.4933333
NODE_158999_length_307_cov_3.322115	78	153	14	3	75	0.0400000
NODE_159000_length_307_cov_3.317308	12	94	0	26	82	0.3170732
NODE_159000_length_307_cov_3.317308	12	94	2	21	82	0.2560976
NODE_159000_length_307_cov_3.317308	12	94	4	35	82	0.4268293
NODE_159000_length_307_cov_3.317308	76	134	4	58	58	1.0000000
NODE_159053_length_307_cov_2.870192	43	108	0	65	65	1.0000000
NODE_159084_length_307_cov_2.653846	117	177	10	1	60	0.0166667
NODE_159084_length_307_cov_2.653846	117	177	16	27	60	0.4500000
NODE_159084_length_307_cov_2.653846	117	177	18	32	60	0.5333334
NODE_159142_length_307_cov_2.346154	54	105	0	51	51	1.0000000
NODE_159351_length_307_cov_1.716346	124	165	0	18	41	0.4390244
NODE_159351_length_307_cov_1.716346	124	165	2	23	41	0.5609756
NODE_159362_length_307_cov_1.716346	30	93	4	17	63	0.2698413
NODE_159362_length_307_cov_1.716346	30	93	6	7	63	0.1111111
NODE_159362_length_307_cov_1.716346	30	93	10	6	63	0.0952381
NODE_159362_length_307_cov_1.716346	30	93	12	31	63	0.4920635
NODE_159362_length_307_cov_1.716346	30	93	14	2	63	0.0317460
NODE_159407_length_307_cov_1.600962	221	269	0	48	48	1.0000000
NODE_159407_length_307_cov_1.600962	242	307	0	65	65	1.0000000
NODE_159447_length_307_cov_1.475962	252	307	0	55	55	1.0000000
NODE_159585_length_307_cov_1.326923	96	142	0	8	46	0.1739130
NODE_159585_length_307_cov_1.326923	96	142	4	38	46	0.8260869
NODE_159585_length_307_cov_1.326923	115	195	4	80	80	1.0000000
NODE_159618_length_307_cov_1.264423	13	61	0	45	48	0.9375000
NODE_159618_length_307_cov_1.264423	13	61	4	3	48	0.0625000
NODE_159618_length_307_cov_1.264423	23	54	0	31	31	1.0000000
NODE_159696_length_307_cov_1.197115	92	121	2	29	29	1.0000000
NODE_159787_length_307_cov_1.000000	132	168	0	36	36	1.0000000
NODE_160213_length_306_cov_74.526570	68	136	4	3	68	0.0441176
NODE_160213_length_306_cov_74.526570	68	136	6	22	68	0.3235294
NODE_160213_length_306_cov_74.526570	68	136	8	43	68	0.6323529
NODE_160213_length_306_cov_74.526570	68	148	2	11	80	0.1375000
NODE_160213_length_306_cov_74.526570	68	148	4	4	80	0.0500000
NODE_160213_length_306_cov_74.526570	68	148	6	22	80	0.2750000
NODE_160213_length_306_cov_74.526570	68	148	8	43	80	0.5375000
NODE_160213_length_306_cov_74.526570	121	201	2	23	80	0.2875000
NODE_160213_length_306_cov_74.526570	121	201	4	2	80	0.0250000
NODE_160213_length_306_cov_74.526570	121	201	6	15	80	0.1875000
NODE_160213_length_306_cov_74.526570	121	201	8	11	80	0.1375000
NODE_160213_length_306_cov_74.526570	121	201	23	1	80	0.0125000
NODE_160213_length_306_cov_74.526570	121	201	24	28	80	0.3500000
NODE_160213_length_306_cov_74.526570	121	201	2	23	80	0.2875000
NODE_160213_length_306_cov_74.526570	121	201	4	2	80	0.0250000
NODE_160213_length_306_cov_74.526570	121	201	6	15	80	0.1875000
NODE_160213_length_306_cov_74.526570	121	201	8	11	80	0.1375000
NODE_160213_length_306_cov_74.526570	121	201	23	1	80	0.0125000
NODE_160213_length_306_cov_74.526570	121	201	24	28	80	0.3500000
NODE_160213_length_306_cov_74.526570	197	277	24	6	80	0.0750000
NODE_160213_length_306_cov_74.526570	197	277	26	7	80	0.0875000
NODE_160213_length_306_cov_74.526570	197	277	28	2	80	0.0250000
NODE_160213_length_306_cov_74.526570	197	277	32	56	80	0.7000000
NODE_160213_length_306_cov_74.526570	197	277	34	9	80	0.1125000
NODE_160213_length_306_cov_74.526570	197	277	24	6	80	0.0750000
NODE_160213_length_306_cov_74.526570	197	277	26	7	80	0.0875000
NODE_160213_length_306_cov_74.526570	197	277	28	2	80	0.0250000
NODE_160213_length_306_cov_74.526570	197	277	32	56	80	0.7000000
NODE_160213_length_306_cov_74.526570	197	277	34	9	80	0.1125000
NODE_160213_length_306_cov_74.526570	197	277	24	6	80	0.0750000
NODE_160213_length_306_cov_74.526570	197	277	26	7	80	0.0875000
NODE_160213_length_306_cov_74.526570	197	277	28	2	80	0.0250000
NODE_160213_length_306_cov_74.526570	197	277	32	56	80	0.7000000
NODE_160213_length_306_cov_74.526570	197	277	34	9	80	0.1125000
NODE_160213_length_306_cov_74.526570	250	299	0	11	49	0.2244898
NODE_160213_length_306_cov_74.526570	250	299	10	4	49	0.0816327
NODE_160213_length_306_cov_74.526570	250	299	26	14	49	0.2857143
NODE_160213_length_306_cov_74.526570	250	299	28	2	49	0.0408163
NODE_160213_length_306_cov_74.526570	250	299	32	18	49	0.3673469
NODE_160213_length_306_cov_74.526570	250	306	0	18	56	0.3214286
NODE_160213_length_306_cov_74.526570	250	306	10	4	56	0.0714286
NODE_160213_length_306_cov_74.526570	250	306	26	14	56	0.2500000
NODE_160213_length_306_cov_74.526570	250	306	28	2	56	0.0357143
NODE_160213_length_306_cov_74.526570	250	306	32	18	56	0.3214286
NODE_160213_length_306_cov_74.526570	255	306	0	18	51	0.3529412
NODE_160213_length_306_cov_74.526570	255	306	10	4	51	0.0784314
NODE_160213_length_306_cov_74.526570	255	306	26	14	51	0.2745098
NODE_160213_length_306_cov_74.526570	255	306	28	2	51	0.0392157
NODE_160213_length_306_cov_74.526570	255	306	32	13	51	0.2549020
NODE_160217_length_306_cov_7.396135	23	117	0	94	94	1.0000000
NODE_160217_length_306_cov_7.396135	90	170	0	80	80	1.0000000
NODE_160261_length_306_cov_4.275362	67	147	0	80	80	1.0000000
NODE_160275_length_306_cov_3.937198	104	176	6	20	72	0.2777778
NODE_160275_length_306_cov_3.937198	104	176	8	21	72	0.2916667
NODE_160275_length_306_cov_3.937198	104	176	10	10	72	0.1388889
NODE_160275_length_306_cov_3.937198	104	176	12	21	72	0.2916667
NODE_160300_length_306_cov_3.444444	130	206	0	76	76	1.0000000
NODE_160323_length_306_cov_3.217391	198	278	0	4	80	0.0500000
NODE_160323_length_306_cov_3.217391	198	278	6	76	80	0.9500000
NODE_160333_length_306_cov_3.043478	90	171	0	15	81	0.1851852
NODE_160333_length_306_cov_3.043478	90	171	2	12	81	0.1481481
NODE_160333_length_306_cov_3.043478	90	171	6	25	81	0.3086420
NODE_160333_length_306_cov_3.043478	90	171	8	29	81	0.3580247
NODE_160333_length_306_cov_3.043478	144	202	4	6	58	0.1034483
NODE_160333_length_306_cov_3.043478	144	202	8	52	58	0.8965517
NODE_160340_length_306_cov_2.956522	242	273	4	6	31	0.1935484
NODE_160340_length_306_cov_2.956522	242	273	6	9	31	0.2903226
NODE_160340_length_306_cov_2.956522	242	273	7	16	31	0.5161290
NODE_160355_length_306_cov_2.884058	173	243	2	29	70	0.4142857
NODE_160355_length_306_cov_2.884058	173	243	4	41	70	0.5857143
NODE_160403_length_306_cov_2.574879	122	203	0	6	81	0.0740741
NODE_160403_length_306_cov_2.574879	122	203	2	69	81	0.8518519
NODE_160403_length_306_cov_2.574879	122	203	4	3	81	0.0370370
NODE_160403_length_306_cov_2.574879	122	203	6	3	81	0.0370370
NODE_160403_length_306_cov_2.574879	176	254	2	24	78	0.3076923
NODE_160403_length_306_cov_2.574879	176	254	4	46	78	0.5897436
NODE_160403_length_306_cov_2.574879	176	254	6	8	78	0.1025641
NODE_160475_length_306_cov_2.265700	223	278	4	23	55	0.4181818
NODE_160475_length_306_cov_2.265700	223	278	6	32	55	0.5818182
NODE_160512_length_306_cov_2.106280	73	149	2	19	76	0.2500000
NODE_160512_length_306_cov_2.106280	73	149	4	23	76	0.3026316
NODE_160512_length_306_cov_2.106280	73	149	6	34	76	0.4473684
NODE_160512_length_306_cov_2.106280	125	205	2	6	80	0.0750000
NODE_160512_length_306_cov_2.106280	125	205	4	43	80	0.5375000
NODE_160512_length_306_cov_2.106280	125	205	8	11	80	0.1375000
NODE_160512_length_306_cov_2.106280	125	205	10	20	80	0.2500000
NODE_160608_length_306_cov_1.879227	165	196	6	31	31	1.0000000
NODE_160752_length_306_cov_1.478261	206	237	8	19	31	0.6129032
NODE_160752_length_306_cov_1.478261	206	237	10	12	31	0.3870968
NODE_160761_length_306_cov_1.478261	157	220	0	63	63	1.0000000
NODE_160833_length_306_cov_1.434783	40	88	0	41	48	0.8541667
NODE_160833_length_306_cov_1.434783	40	88	4	7	48	0.1458333
NODE_160875_length_306_cov_1.357488	128	171	0	10	43	0.2325581
NODE_160875_length_306_cov_1.357488	128	171	2	33	43	0.7674419
NODE_160992_length_306_cov_1.222222	216	252	0	36	36	1.0000000
NODE_160992_length_306_cov_1.222222	230	305	0	75	75	1.0000000
NODE_161018_length_306_cov_1.188406	79	159	0	80	80	1.0000000
NODE_161042_length_306_cov_1.130435	122	202	2	80	80	1.0000000
NODE_161042_length_306_cov_1.130435	175	255	0	25	80	0.3125000
NODE_161042_length_306_cov_1.130435	175	255	2	55	80	0.6875000
NODE_161078_length_306_cov_1.067633	156	188	0	32	32	1.0000000
NODE_161234_length_306_cov_0.975845	219	247	0	28	28	1.0000000
NODE_161246_length_306_cov_0.956522	206	284	2	31	78	0.3974359
NODE_161246_length_306_cov_0.956522	206	284	4	4	78	0.0512821
NODE_161246_length_306_cov_0.956522	206	284	6	43	78	0.5512820
NODE_161550_length_305_cov_5.718447	177	243	0	66	66	1.0000000
NODE_161566_length_305_cov_4.854369	55	135	0	79	80	0.9875000
NODE_161566_length_305_cov_4.854369	55	135	4	1	80	0.0125000
NODE_161584_length_305_cov_4.266990	186	266	0	80	80	1.0000000
NODE_161723_length_305_cov_2.616505	220	263	0	43	43	1.0000000
NODE_161723_length_305_cov_2.616505	236	305	0	69	69	1.0000000
NODE_161726_length_305_cov_2.597087	171	256	44	3	85	0.0352941
NODE_161726_length_305_cov_2.597087	171	256	48	6	85	0.0705882
NODE_161726_length_305_cov_2.597087	171	256	51	5	85	0.0588235
NODE_161726_length_305_cov_2.597087	171	256	53	1	85	0.0117647
NODE_161726_length_305_cov_2.597087	171	256	55	3	85	0.0352941
NODE_161726_length_305_cov_2.597087	171	256	59	2	85	0.0235294
NODE_161726_length_305_cov_2.597087	171	256	63	2	85	0.0235294
NODE_161726_length_305_cov_2.597087	171	256	69	3	85	0.0352941
NODE_161726_length_305_cov_2.597087	171	256	80	1	85	0.0117647
NODE_161726_length_305_cov_2.597087	171	256	87	2	85	0.0235294
NODE_161726_length_305_cov_2.597087	171	256	88	3	85	0.0352941
NODE_161726_length_305_cov_2.597087	171	256	92	2	85	0.0235294
NODE_161726_length_305_cov_2.597087	171	256	95	1	85	0.0117647
NODE_161726_length_305_cov_2.597087	171	256	97	1	85	0.0117647
NODE_161726_length_305_cov_2.597087	171	256	99	1	85	0.0117647
NODE_161726_length_305_cov_2.597087	171	256	100	6	85	0.0705882
NODE_161726_length_305_cov_2.597087	171	256	102	1	85	0.0117647
NODE_161726_length_305_cov_2.597087	171	256	104	1	85	0.0117647
NODE_161726_length_305_cov_2.597087	171	256	105	2	85	0.0235294
NODE_161726_length_305_cov_2.597087	171	256	113	1	85	0.0117647
NODE_161726_length_305_cov_2.597087	171	256	114	4	85	0.0470588
NODE_161726_length_305_cov_2.597087	171	256	116	1	85	0.0117647
NODE_161726_length_305_cov_2.597087	171	256	117	1	85	0.0117647
NODE_161726_length_305_cov_2.597087	171	256	120	20	85	0.2352941
NODE_161726_length_305_cov_2.597087	171	256	122	5	85	0.0588235
NODE_161726_length_305_cov_2.597087	171	256	123	2	85	0.0235294
NODE_161726_length_305_cov_2.597087	171	256	124	5	85	0.0588235
NODE_161732_length_305_cov_2.533981	3	57	0	54	54	1.0000000
NODE_161775_length_305_cov_2.339806	149	237	29	1	88	0.0113636
NODE_161775_length_305_cov_2.339806	149	237	30	2	88	0.0227273
NODE_161775_length_305_cov_2.339806	149	237	31	1	88	0.0113636
NODE_161775_length_305_cov_2.339806	149	237	36	3	88	0.0340909
NODE_161775_length_305_cov_2.339806	149	237	38	2	88	0.0227273
NODE_161775_length_305_cov_2.339806	149	237	39	7	88	0.0795455
NODE_161775_length_305_cov_2.339806	149	237	41	2	88	0.0227273
NODE_161775_length_305_cov_2.339806	149	237	43	6	88	0.0681818
NODE_161775_length_305_cov_2.339806	149	237	45	26	88	0.2954545
NODE_161775_length_305_cov_2.339806	149	237	47	32	88	0.3636364
NODE_161775_length_305_cov_2.339806	149	237	49	6	88	0.0681818
NODE_161795_length_305_cov_2.228155	194	274	0	46	80	0.5750000
NODE_161795_length_305_cov_2.228155	194	274	2	34	80	0.4250000
NODE_161795_length_305_cov_2.228155	247	300	0	53	53	1.0000000
NODE_161877_length_305_cov_1.975728	44	116	4	4	72	0.0555556
NODE_161877_length_305_cov_1.975728	44	116	6	42	72	0.5833333
NODE_161877_length_305_cov_1.975728	44	116	8	4	72	0.0555556
NODE_161877_length_305_cov_1.975728	44	116	10	22	72	0.3055556
NODE_161908_length_305_cov_1.883495	135	172	52	1	37	0.0270270
NODE_161908_length_305_cov_1.883495	135	172	54	1	37	0.0270270
NODE_161908_length_305_cov_1.883495	135	172	55	6	37	0.1621622
NODE_161908_length_305_cov_1.883495	135	172	57	3	37	0.0810811
NODE_161908_length_305_cov_1.883495	135	172	59	6	37	0.1621622
NODE_161908_length_305_cov_1.883495	135	172	67	2	37	0.0540541
NODE_161908_length_305_cov_1.883495	135	172	68	2	37	0.0540541
NODE_161908_length_305_cov_1.883495	135	172	69	2	37	0.0540541
NODE_161908_length_305_cov_1.883495	135	172	71	1	37	0.0270270
NODE_161908_length_305_cov_1.883495	135	172	73	1	37	0.0270270
NODE_161908_length_305_cov_1.883495	135	172	77	2	37	0.0540541
NODE_161908_length_305_cov_1.883495	135	172	80	3	37	0.0810811
NODE_161908_length_305_cov_1.883495	135	172	82	2	37	0.0540541
NODE_161908_length_305_cov_1.883495	135	172	86	4	37	0.1081081
NODE_161908_length_305_cov_1.883495	135	172	88	1	37	0.0270270
NODE_161990_length_305_cov_1.674757	14	80	0	3	66	0.0454545
NODE_161990_length_305_cov_1.674757	14	80	2	45	66	0.6818182
NODE_161990_length_305_cov_1.674757	14	80	4	18	66	0.2727273
NODE_161990_length_305_cov_1.674757	53	133	2	9	80	0.1125000
NODE_161990_length_305_cov_1.674757	53	133	4	31	80	0.3875000
NODE_161990_length_305_cov_1.674757	53	133	6	13	80	0.1625000
NODE_161990_length_305_cov_1.674757	53	133	8	20	80	0.2500000
NODE_161990_length_305_cov_1.674757	53	133	10	7	80	0.0875000
NODE_161996_length_305_cov_1.655340	110	179	8	4	69	0.0579710
NODE_161996_length_305_cov_1.655340	110	179	10	25	69	0.3623188
NODE_161996_length_305_cov_1.655340	110	179	12	40	69	0.5797101
NODE_162123_length_305_cov_1.466019	153	238	40	2	85	0.0235294
NODE_162123_length_305_cov_1.466019	153	238	41	1	85	0.0117647
NODE_162123_length_305_cov_1.466019	153	238	42	5	85	0.0588235
NODE_162123_length_305_cov_1.466019	153	238	44	1	85	0.0117647
NODE_162123_length_305_cov_1.466019	153	238	46	3	85	0.0352941
NODE_162123_length_305_cov_1.466019	153	238	48	3	85	0.0352941
NODE_162123_length_305_cov_1.466019	153	238	52	3	85	0.0352941
NODE_162123_length_305_cov_1.466019	153	238	54	6	85	0.0705882
NODE_162123_length_305_cov_1.466019	153	238	56	4	85	0.0470588
NODE_162123_length_305_cov_1.466019	153	238	58	3	85	0.0352941
NODE_162123_length_305_cov_1.466019	153	238	60	2	85	0.0235294
NODE_162123_length_305_cov_1.466019	153	238	62	1	85	0.0117647
NODE_162123_length_305_cov_1.466019	153	238	64	1	85	0.0117647
NODE_162123_length_305_cov_1.466019	153	238	66	15	85	0.1764706
NODE_162123_length_305_cov_1.466019	153	238	68	6	85	0.0705882
NODE_162123_length_305_cov_1.466019	153	238	70	10	85	0.1176471
NODE_162123_length_305_cov_1.466019	153	238	72	3	85	0.0352941
NODE_162123_length_305_cov_1.466019	153	238	76	2	85	0.0235294
NODE_162123_length_305_cov_1.466019	153	238	78	1	85	0.0117647
NODE_162123_length_305_cov_1.466019	153	238	80	7	85	0.0823529
NODE_162123_length_305_cov_1.466019	153	238	86	3	85	0.0352941
NODE_162123_length_305_cov_1.466019	153	238	87	3	85	0.0352941
NODE_162123_length_305_cov_1.466019	222	284	50	1	62	0.0161290
NODE_162123_length_305_cov_1.466019	222	284	52	3	62	0.0483871
NODE_162123_length_305_cov_1.466019	222	284	56	1	62	0.0161290
NODE_162123_length_305_cov_1.466019	222	284	68	9	62	0.1451613
NODE_162123_length_305_cov_1.466019	222	284	70	3	62	0.0483871
NODE_162123_length_305_cov_1.466019	222	284	76	3	62	0.0483871
NODE_162123_length_305_cov_1.466019	222	284	78	1	62	0.0161290
NODE_162123_length_305_cov_1.466019	222	284	80	7	62	0.1129032
NODE_162123_length_305_cov_1.466019	222	284	81	4	62	0.0645161
NODE_162123_length_305_cov_1.466019	222	284	82	1	62	0.0161290
NODE_162123_length_305_cov_1.466019	222	284	83	3	62	0.0483871
NODE_162123_length_305_cov_1.466019	222	284	86	3	62	0.0483871
NODE_162123_length_305_cov_1.466019	222	284	87	6	62	0.0967742
NODE_162123_length_305_cov_1.466019	222	284	89	17	62	0.2741936
NODE_162169_length_305_cov_1.398058	28	75	0	5	47	0.1063830
NODE_162169_length_305_cov_1.398058	28	75	2	42	47	0.8936170
NODE_162198_length_305_cov_1.330097	212	292	22	4	80	0.0500000
NODE_162198_length_305_cov_1.330097	212	292	25	2	80	0.0250000
NODE_162198_length_305_cov_1.330097	212	292	28	1	80	0.0125000
NODE_162198_length_305_cov_1.330097	212	292	31	2	80	0.0250000
NODE_162198_length_305_cov_1.330097	212	292	33	2	80	0.0250000
NODE_162198_length_305_cov_1.330097	212	292	35	5	80	0.0625000
NODE_162198_length_305_cov_1.330097	212	292	37	1	80	0.0125000
NODE_162198_length_305_cov_1.330097	212	292	39	1	80	0.0125000
NODE_162198_length_305_cov_1.330097	212	292	46	2	80	0.0250000
NODE_162198_length_305_cov_1.330097	212	292	48	2	80	0.0250000
NODE_162198_length_305_cov_1.330097	212	292	50	8	80	0.1000000
NODE_162198_length_305_cov_1.330097	212	292	52	4	80	0.0500000
NODE_162198_length_305_cov_1.330097	212	292	54	2	80	0.0250000
NODE_162198_length_305_cov_1.330097	212	292	56	5	80	0.0625000
NODE_162198_length_305_cov_1.330097	212	292	60	1	80	0.0125000
NODE_162198_length_305_cov_1.330097	212	292	62	1	80	0.0125000
NODE_162198_length_305_cov_1.330097	212	292	64	1	80	0.0125000
NODE_162198_length_305_cov_1.330097	212	292	66	4	80	0.0500000
NODE_162198_length_305_cov_1.330097	212	292	70	1	80	0.0125000
NODE_162198_length_305_cov_1.330097	212	292	72	4	80	0.0500000
NODE_162198_length_305_cov_1.330097	212	292	74	1	80	0.0125000
NODE_162198_length_305_cov_1.330097	212	292	76	11	80	0.1375000
NODE_162198_length_305_cov_1.330097	212	292	80	10	80	0.1250000
NODE_162198_length_305_cov_1.330097	212	292	82	5	80	0.0625000
NODE_162198_length_305_cov_1.330097	265	305	7	3	40	0.0750000
NODE_162198_length_305_cov_1.330097	265	305	10	1	40	0.0250000
NODE_162198_length_305_cov_1.330097	265	305	11	2	40	0.0500000
NODE_162198_length_305_cov_1.330097	265	305	14	3	40	0.0750000
NODE_162198_length_305_cov_1.330097	265	305	17	1	40	0.0250000
NODE_162198_length_305_cov_1.330097	265	305	20	1	40	0.0250000
NODE_162198_length_305_cov_1.330097	265	305	21	2	40	0.0500000
NODE_162198_length_305_cov_1.330097	265	305	22	4	40	0.1000000
NODE_162198_length_305_cov_1.330097	265	305	25	2	40	0.0500000
NODE_162198_length_305_cov_1.330097	265	305	28	1	40	0.0250000
NODE_162198_length_305_cov_1.330097	265	305	31	2	40	0.0500000
NODE_162198_length_305_cov_1.330097	265	305	33	2	40	0.0500000
NODE_162198_length_305_cov_1.330097	265	305	35	5	40	0.1250000
NODE_162198_length_305_cov_1.330097	265	305	37	1	40	0.0250000
NODE_162198_length_305_cov_1.330097	265	305	39	1	40	0.0250000
NODE_162198_length_305_cov_1.330097	265	305	46	2	40	0.0500000
NODE_162198_length_305_cov_1.330097	265	305	48	2	40	0.0500000
NODE_162198_length_305_cov_1.330097	265	305	50	5	40	0.1250000
NODE_162359_length_305_cov_1.111650	245	275	0	30	30	1.0000000
NODE_162411_length_305_cov_0.990291	46	126	0	35	80	0.4375000
NODE_162411_length_305_cov_0.990291	46	126	1	1	80	0.0125000
NODE_162411_length_305_cov_0.990291	46	126	3	1	80	0.0125000
NODE_162411_length_305_cov_0.990291	46	126	4	11	80	0.1375000
NODE_162411_length_305_cov_0.990291	46	126	5	1	80	0.0125000
NODE_162411_length_305_cov_0.990291	46	126	6	31	80	0.3875000
NODE_162593_length_305_cov_0.873786	73	109	0	36	36	1.0000000
NODE_162782_length_305_cov_0.631068	86	166	0	80	80	1.0000000
NODE_162782_length_305_cov_0.631068	139	186	0	43	47	0.9148936
NODE_162782_length_305_cov_0.631068	139	186	2	4	47	0.0851064
NODE_162854_length_304_cov_44.482927	61	102	97	2	41	0.0487805
NODE_162854_length_304_cov_44.482927	61	102	99	2	41	0.0487805
NODE_162854_length_304_cov_44.482927	61	102	103	5	41	0.1219512
NODE_162854_length_304_cov_44.482927	61	102	109	5	41	0.1219512
NODE_162854_length_304_cov_44.482927	61	102	117	5	41	0.1219512
NODE_162854_length_304_cov_44.482927	61	102	119	8	41	0.1951219
NODE_162854_length_304_cov_44.482927	61	102	121	11	41	0.2682927
NODE_162854_length_304_cov_44.482927	61	102	125	3	41	0.0731707
NODE_162855_length_304_cov_30.678049	205	281	0	76	76	1.0000000
NODE_162855_length_304_cov_30.678049	254	304	0	50	50	1.0000000
NODE_162886_length_304_cov_4.956098	72	152	0	80	80	1.0000000
NODE_162919_length_304_cov_3.980488	46	126	0	80	80	1.0000000
NODE_162919_length_304_cov_3.980488	99	179	0	80	80	1.0000000
NODE_162932_length_304_cov_3.809756	108	156	2	48	48	1.0000000
NODE_162955_length_304_cov_3.424390	67	129	1	10	62	0.1612903
NODE_162955_length_304_cov_3.424390	67	129	2	52	62	0.8387097
NODE_162955_length_304_cov_3.424390	120	182	2	62	62	1.0000000
NODE_162997_length_304_cov_2.980488	105	126	2	16	21	0.7619048
NODE_162997_length_304_cov_2.980488	105	126	4	5	21	0.2380952
NODE_163048_length_304_cov_2.629268	106	186	13	6	80	0.0750000
NODE_163048_length_304_cov_2.629268	106	186	14	9	80	0.1125000
NODE_163048_length_304_cov_2.629268	106	186	16	14	80	0.1750000
NODE_163048_length_304_cov_2.629268	106	186	18	13	80	0.1625000
NODE_163048_length_304_cov_2.629268	106	186	19	2	80	0.0250000
NODE_163048_length_304_cov_2.629268	106	186	20	23	80	0.2875000
NODE_163048_length_304_cov_2.629268	106	186	22	13	80	0.1625000
NODE_163048_length_304_cov_2.629268	159	209	12	7	50	0.1400000
NODE_163048_length_304_cov_2.629268	159	209	14	20	50	0.4000000
NODE_163048_length_304_cov_2.629268	159	209	16	4	50	0.0800000
NODE_163048_length_304_cov_2.629268	159	209	20	6	50	0.1200000
NODE_163048_length_304_cov_2.629268	159	209	22	13	50	0.2600000
NODE_163116_length_304_cov_2.239024	57	137	0	1	80	0.0125000
NODE_163116_length_304_cov_2.239024	57	137	2	5	80	0.0625000
NODE_163116_length_304_cov_2.239024	57	137	4	74	80	0.9250000
NODE_163116_length_304_cov_2.239024	110	152	0	16	42	0.3809524
NODE_163116_length_304_cov_2.239024	110	152	2	5	42	0.1190476
NODE_163116_length_304_cov_2.239024	110	152	4	21	42	0.5000000
NODE_163148_length_304_cov_2.170732	112	145	2	10	33	0.3030303
NODE_163148_length_304_cov_2.170732	112	145	5	5	33	0.1515152
NODE_163148_length_304_cov_2.170732	112	145	7	2	33	0.0606061
NODE_163148_length_304_cov_2.170732	112	145	10	10	33	0.3030303
NODE_163148_length_304_cov_2.170732	112	145	12	3	33	0.0909091
NODE_163148_length_304_cov_2.170732	112	145	14	2	33	0.0606061
NODE_163148_length_304_cov_2.170732	112	145	16	1	33	0.0303030
NODE_163148_length_304_cov_2.170732	146	198	14	11	52	0.2115385
NODE_163148_length_304_cov_2.170732	146	198	16	41	52	0.7884616
NODE_163333_length_304_cov_1.687805	219	288	0	64	69	0.9275362
NODE_163333_length_304_cov_1.687805	219	288	4	3	69	0.0434783
NODE_163333_length_304_cov_1.687805	219	288	6	2	69	0.0289855
NODE_163432_length_304_cov_1.492683	190	238	0	10	48	0.2083333
NODE_163432_length_304_cov_1.492683	190	238	1	1	48	0.0208333
NODE_163432_length_304_cov_1.492683	190	238	2	18	48	0.3750000
NODE_163432_length_304_cov_1.492683	190	238	4	19	48	0.3958333
NODE_163559_length_304_cov_1.287805	99	165	0	44	66	0.6666667
NODE_163559_length_304_cov_1.287805	99	165	3	22	66	0.3333333
NODE_163670_length_304_cov_1.175610	0	30	0	30	30	1.0000000
NODE_163895_length_304_cov_0.951220	70	150	2	1	80	0.0125000
NODE_163895_length_304_cov_0.951220	70	150	4	40	80	0.5000000
NODE_163895_length_304_cov_0.951220	70	150	6	8	80	0.1000000
NODE_163895_length_304_cov_0.951220	70	150	7	1	80	0.0125000
NODE_163895_length_304_cov_0.951220	70	150	8	30	80	0.3750000
NODE_164171_length_303_cov_30.843137	46	97	0	51	51	1.0000000
NODE_164194_length_303_cov_5.401961	33	79	0	46	46	1.0000000
NODE_164224_length_303_cov_4.210784	136	205	8	12	69	0.1739130
NODE_164224_length_303_cov_4.210784	136	205	10	5	69	0.0724638
NODE_164224_length_303_cov_4.210784	136	205	11	1	69	0.0144928
NODE_164224_length_303_cov_4.210784	136	205	12	3	69	0.0434783
NODE_164224_length_303_cov_4.210784	136	205	14	48	69	0.6956522
NODE_164224_length_303_cov_4.210784	178	259	4	49	81	0.6049383
NODE_164224_length_303_cov_4.210784	178	259	6	5	81	0.0617284
NODE_164224_length_303_cov_4.210784	178	259	8	12	81	0.1481481
NODE_164224_length_303_cov_4.210784	178	259	10	5	81	0.0617284
NODE_164224_length_303_cov_4.210784	178	259	11	1	81	0.0123457
NODE_164224_length_303_cov_4.210784	178	259	12	3	81	0.0370370
NODE_164224_length_303_cov_4.210784	178	259	14	6	81	0.0740741
NODE_164251_length_303_cov_3.671569	9	75	0	60	66	0.9090909
NODE_164251_length_303_cov_3.671569	9	75	2	6	66	0.0909091
NODE_164251_length_303_cov_3.671569	48	128	0	21	80	0.2625000
NODE_164251_length_303_cov_3.671569	48	128	2	59	80	0.7375000
NODE_164251_length_303_cov_3.671569	48	128	0	21	80	0.2625000
NODE_164251_length_303_cov_3.671569	48	128	2	59	80	0.7375000
NODE_164251_length_303_cov_3.671569	220	300	4	80	80	1.0000000
NODE_164267_length_303_cov_3.500000	55	123	0	29	68	0.4264706
NODE_164267_length_303_cov_3.500000	55	123	2	15	68	0.2205882
NODE_164267_length_303_cov_3.500000	55	123	4	7	68	0.1029412
NODE_164267_length_303_cov_3.500000	55	123	6	17	68	0.2500000
NODE_164272_length_303_cov_3.460784	0	67	0	4	67	0.0597015
NODE_164272_length_303_cov_3.460784	0	67	2	18	67	0.2686567
NODE_164272_length_303_cov_3.460784	0	67	6	3	67	0.0447761
NODE_164272_length_303_cov_3.460784	0	67	8	4	67	0.0597015
NODE_164272_length_303_cov_3.460784	0	67	12	2	67	0.0298507
NODE_164272_length_303_cov_3.460784	0	67	26	1	67	0.0149254
NODE_164272_length_303_cov_3.460784	0	67	38	1	67	0.0149254
NODE_164272_length_303_cov_3.460784	0	67	44	1	67	0.0149254
NODE_164272_length_303_cov_3.460784	0	67	46	3	67	0.0447761
NODE_164272_length_303_cov_3.460784	0	67	48	1	67	0.0149254
NODE_164272_length_303_cov_3.460784	0	67	52	1	67	0.0149254
NODE_164272_length_303_cov_3.460784	0	67	64	4	67	0.0597015
NODE_164272_length_303_cov_3.460784	0	67	70	1	67	0.0149254
NODE_164272_length_303_cov_3.460784	0	67	74	1	67	0.0149254
NODE_164272_length_303_cov_3.460784	0	67	81	3	67	0.0447761
NODE_164272_length_303_cov_3.460784	0	67	83	2	67	0.0298507
NODE_164272_length_303_cov_3.460784	0	67	86	3	67	0.0447761
NODE_164272_length_303_cov_3.460784	0	67	88	1	67	0.0149254
NODE_164272_length_303_cov_3.460784	0	67	94	1	67	0.0149254
NODE_164272_length_303_cov_3.460784	0	67	101	1	67	0.0149254
NODE_164272_length_303_cov_3.460784	0	67	108	1	67	0.0149254
NODE_164272_length_303_cov_3.460784	0	67	120	1	67	0.0149254
NODE_164272_length_303_cov_3.460784	0	67	127	1	67	0.0149254
NODE_164272_length_303_cov_3.460784	0	67	131	1	67	0.0149254
NODE_164272_length_303_cov_3.460784	0	67	133	1	67	0.0149254
NODE_164272_length_303_cov_3.460784	0	67	137	1	67	0.0149254
NODE_164272_length_303_cov_3.460784	0	67	144	1	67	0.0149254
NODE_164272_length_303_cov_3.460784	0	67	149	1	67	0.0149254
NODE_164272_length_303_cov_3.460784	0	67	150	1	67	0.0149254
NODE_164272_length_303_cov_3.460784	0	67	152	2	67	0.0298507
NODE_164272_length_303_cov_3.460784	98	178	366	1	80	0.0125000
NODE_164272_length_303_cov_3.460784	98	178	403	1	80	0.0125000
NODE_164272_length_303_cov_3.460784	98	178	414	1	80	0.0125000
NODE_164272_length_303_cov_3.460784	98	178	437	1	80	0.0125000
NODE_164272_length_303_cov_3.460784	98	178	453	1	80	0.0125000
NODE_164272_length_303_cov_3.460784	98	178	479	1	80	0.0125000
NODE_164272_length_303_cov_3.460784	98	178	487	1	80	0.0125000
NODE_164272_length_303_cov_3.460784	98	178	496	1	80	0.0125000
NODE_164272_length_303_cov_3.460784	98	178	510	1	80	0.0125000
NODE_164272_length_303_cov_3.460784	98	178	517	1	80	0.0125000
NODE_164272_length_303_cov_3.460784	98	178	529	1	80	0.0125000
NODE_164272_length_303_cov_3.460784	98	178	531	1	80	0.0125000
NODE_164272_length_303_cov_3.460784	98	178	554	1	80	0.0125000
NODE_164272_length_303_cov_3.460784	98	178	558	1	80	0.0125000
NODE_164272_length_303_cov_3.460784	98	178	566	1	80	0.0125000
NODE_164272_length_303_cov_3.460784	98	178	574	1	80	0.0125000
NODE_164272_length_303_cov_3.460784	98	178	581	1	80	0.0125000
NODE_164272_length_303_cov_3.460784	98	178	588	1	80	0.0125000
NODE_164272_length_303_cov_3.460784	98	178	590	1	80	0.0125000
NODE_164272_length_303_cov_3.460784	98	178	597	1	80	0.0125000
NODE_164272_length_303_cov_3.460784	98	178	598	2	80	0.0250000
NODE_164272_length_303_cov_3.460784	98	178	601	1	80	0.0125000
NODE_164272_length_303_cov_3.460784	98	178	602	2	80	0.0250000
NODE_164272_length_303_cov_3.460784	98	178	603	1	80	0.0125000
NODE_164272_length_303_cov_3.460784	98	178	608	1	80	0.0125000
NODE_164272_length_303_cov_3.460784	98	178	609	1	80	0.0125000
NODE_164272_length_303_cov_3.460784	98	178	611	1	80	0.0125000
NODE_164272_length_303_cov_3.460784	98	178	612	2	80	0.0250000
NODE_164272_length_303_cov_3.460784	98	178	615	1	80	0.0125000
NODE_164272_length_303_cov_3.460784	98	178	627	1	80	0.0125000
NODE_164272_length_303_cov_3.460784	98	178	644	1	80	0.0125000
NODE_164272_length_303_cov_3.460784	98	178	648	1	80	0.0125000
NODE_164272_length_303_cov_3.460784	98	178	650	1	80	0.0125000
NODE_164272_length_303_cov_3.460784	98	178	652	1	80	0.0125000
NODE_164272_length_303_cov_3.460784	98	178	658	1	80	0.0125000
NODE_164272_length_303_cov_3.460784	98	178	668	1	80	0.0125000
NODE_164272_length_303_cov_3.460784	98	178	683	1	80	0.0125000
NODE_164272_length_303_cov_3.460784	98	178	685	1	80	0.0125000
NODE_164272_length_303_cov_3.460784	98	178	702	1	80	0.0125000
NODE_164272_length_303_cov_3.460784	98	178	703	1	80	0.0125000
NODE_164272_length_303_cov_3.460784	98	178	706	1	80	0.0125000
NODE_164272_length_303_cov_3.460784	98	178	707	1	80	0.0125000
NODE_164272_length_303_cov_3.460784	98	178	708	1	80	0.0125000
NODE_164272_length_303_cov_3.460784	98	178	709	1	80	0.0125000
NODE_164272_length_303_cov_3.460784	98	178	713	1	80	0.0125000
NODE_164272_length_303_cov_3.460784	98	178	714	1	80	0.0125000
NODE_164272_length_303_cov_3.460784	98	178	716	2	80	0.0250000
NODE_164272_length_303_cov_3.460784	98	178	719	1	80	0.0125000
NODE_164272_length_303_cov_3.460784	98	178	720	2	80	0.0250000
NODE_164272_length_303_cov_3.460784	98	178	721	2	80	0.0250000
NODE_164272_length_303_cov_3.460784	98	178	722	2	80	0.0250000
NODE_164272_length_303_cov_3.460784	98	178	728	1	80	0.0125000
NODE_164272_length_303_cov_3.460784	98	178	729	2	80	0.0250000
NODE_164272_length_303_cov_3.460784	98	178	732	1	80	0.0125000
NODE_164272_length_303_cov_3.460784	98	178	733	4	80	0.0500000
NODE_164272_length_303_cov_3.460784	98	178	735	1	80	0.0125000
NODE_164272_length_303_cov_3.460784	98	178	738	1	80	0.0125000
NODE_164272_length_303_cov_3.460784	98	178	739	3	80	0.0375000
NODE_164272_length_303_cov_3.460784	98	178	740	1	80	0.0125000
NODE_164272_length_303_cov_3.460784	98	178	753	1	80	0.0125000
NODE_164272_length_303_cov_3.460784	98	178	779	1	80	0.0125000
NODE_164272_length_303_cov_3.460784	98	178	783	1	80	0.0125000
NODE_164272_length_303_cov_3.460784	98	178	798	1	80	0.0125000
NODE_164272_length_303_cov_3.460784	98	178	801	1	80	0.0125000
NODE_164272_length_303_cov_3.460784	98	178	810	1	80	0.0125000
NODE_164272_length_303_cov_3.460784	98	178	828	1	80	0.0125000
NODE_164272_length_303_cov_3.460784	98	178	832	1	80	0.0125000
NODE_164272_length_303_cov_3.460784	151	191	703	1	40	0.0250000
NODE_164272_length_303_cov_3.460784	151	191	706	1	40	0.0250000
NODE_164272_length_303_cov_3.460784	151	191	709	1	40	0.0250000
NODE_164272_length_303_cov_3.460784	151	191	713	1	40	0.0250000
NODE_164272_length_303_cov_3.460784	151	191	714	1	40	0.0250000
NODE_164272_length_303_cov_3.460784	151	191	716	2	40	0.0500000
NODE_164272_length_303_cov_3.460784	151	191	721	1	40	0.0250000
NODE_164272_length_303_cov_3.460784	151	191	729	2	40	0.0500000
NODE_164272_length_303_cov_3.460784	151	191	732	1	40	0.0250000
NODE_164272_length_303_cov_3.460784	151	191	733	4	40	0.1000000
NODE_164272_length_303_cov_3.460784	151	191	735	1	40	0.0250000
NODE_164272_length_303_cov_3.460784	151	191	738	1	40	0.0250000
NODE_164272_length_303_cov_3.460784	151	191	739	2	40	0.0500000
NODE_164272_length_303_cov_3.460784	151	191	753	1	40	0.0250000
NODE_164272_length_303_cov_3.460784	151	191	779	1	40	0.0250000
NODE_164272_length_303_cov_3.460784	151	191	783	1	40	0.0250000
NODE_164272_length_303_cov_3.460784	151	191	798	1	40	0.0250000
NODE_164272_length_303_cov_3.460784	151	191	801	1	40	0.0250000
NODE_164272_length_303_cov_3.460784	151	191	810	1	40	0.0250000
NODE_164272_length_303_cov_3.460784	151	191	828	3	40	0.0750000
NODE_164272_length_303_cov_3.460784	151	191	830	1	40	0.0250000
NODE_164272_length_303_cov_3.460784	151	191	832	1	40	0.0250000
NODE_164272_length_303_cov_3.460784	151	191	845	1	40	0.0250000
NODE_164272_length_303_cov_3.460784	151	191	847	1	40	0.0250000
NODE_164272_length_303_cov_3.460784	151	191	857	1	40	0.0250000
NODE_164272_length_303_cov_3.460784	151	191	859	1	40	0.0250000
NODE_164272_length_303_cov_3.460784	151	191	861	1	40	0.0250000
NODE_164272_length_303_cov_3.460784	151	191	879	1	40	0.0250000
NODE_164272_length_303_cov_3.460784	151	191	881	1	40	0.0250000
NODE_164272_length_303_cov_3.460784	151	191	889	1	40	0.0250000
NODE_164272_length_303_cov_3.460784	151	191	891	1	40	0.0250000
NODE_164272_length_303_cov_3.460784	151	191	897	1	40	0.0250000
NODE_164283_length_303_cov_3.352941	77	146	2	54	69	0.7826087
NODE_164283_length_303_cov_3.352941	77	146	4	15	69	0.2173913
NODE_164433_length_303_cov_2.284314	78	158	4	5	80	0.0625000
NODE_164433_length_303_cov_2.284314	78	158	6	65	80	0.8125000
NODE_164433_length_303_cov_2.284314	78	158	8	10	80	0.1250000
NODE_164433_length_303_cov_2.284314	215	295	0	29	80	0.3625000
NODE_164433_length_303_cov_2.284314	215	295	2	20	80	0.2500000
NODE_164433_length_303_cov_2.284314	215	295	4	31	80	0.3875000
NODE_164581_length_303_cov_1.848039	90	170	0	80	80	1.0000000
NODE_164581_length_303_cov_1.848039	143	223	0	80	80	1.0000000
NODE_164581_length_303_cov_1.848039	212	235	0	23	23	1.0000000
NODE_164668_length_303_cov_1.686275	62	88	0	26	26	1.0000000
NODE_164695_length_303_cov_1.583333	206	270	0	64	64	1.0000000
NODE_164800_length_303_cov_1.475490	155	221	0	66	66	1.0000000
NODE_164846_length_303_cov_1.392157	135	213	16	61	78	0.7820513
NODE_164846_length_303_cov_1.392157	135	213	18	3	78	0.0384615
NODE_164846_length_303_cov_1.392157	135	213	22	14	78	0.1794872
NODE_164878_length_303_cov_1.318627	0	75	0	25	75	0.3333333
NODE_164878_length_303_cov_1.318627	0	75	2	50	75	0.6666667
NODE_164974_length_303_cov_1.215686	278	297	0	19	19	1.0000000
NODE_165498_length_302_cov_10.852217	266	300	0	34	34	1.0000000
NODE_165502_length_302_cov_7.896552	46	131	0	85	85	1.0000000
NODE_165502_length_302_cov_7.896552	104	160	0	56	56	1.0000000
NODE_165505_length_302_cov_7.266010	135	191	0	2	56	0.0357143
NODE_165505_length_302_cov_7.266010	135	191	4	3	56	0.0535714
NODE_165505_length_302_cov_7.266010	135	191	6	1	56	0.0178571
NODE_165505_length_302_cov_7.266010	135	191	8	6	56	0.1071429
NODE_165505_length_302_cov_7.266010	135	191	12	44	56	0.7857143
NODE_165507_length_302_cov_7.216749	93	149	2	56	56	1.0000000
NODE_165507_length_302_cov_7.216749	155	226	0	57	71	0.8028169
NODE_165507_length_302_cov_7.216749	155	226	2	14	71	0.1971831
NODE_165517_length_302_cov_6.172414	179	243	2	64	64	1.0000000
NODE_165517_length_302_cov_6.172414	232	287	0	41	55	0.7454545
NODE_165517_length_302_cov_6.172414	232	287	2	14	55	0.2545455
NODE_165528_length_302_cov_5.586207	221	293	0	3	72	0.0416667
NODE_165528_length_302_cov_5.586207	221	293	4	20	72	0.2777778
NODE_165528_length_302_cov_5.586207	221	293	6	1	72	0.0138889
NODE_165528_length_302_cov_5.586207	221	293	10	9	72	0.1250000
NODE_165528_length_302_cov_5.586207	221	293	12	7	72	0.0972222
NODE_165528_length_302_cov_5.586207	221	293	16	12	72	0.1666667
NODE_165528_length_302_cov_5.586207	221	293	22	15	72	0.2083333
NODE_165528_length_302_cov_5.586207	221	293	24	3	72	0.0416667
NODE_165528_length_302_cov_5.586207	221	293	26	2	72	0.0277778
NODE_165641_length_302_cov_2.985222	104	186	13	8	82	0.0975610
NODE_165641_length_302_cov_2.985222	104	186	16	1	82	0.0121951
NODE_165641_length_302_cov_2.985222	104	186	18	3	82	0.0365854
NODE_165641_length_302_cov_2.985222	104	186	22	6	82	0.0731707
NODE_165641_length_302_cov_2.985222	104	186	23	2	82	0.0243902
NODE_165641_length_302_cov_2.985222	104	186	24	41	82	0.5000000
NODE_165641_length_302_cov_2.985222	104	186	25	18	82	0.2195122
NODE_165641_length_302_cov_2.985222	104	186	26	3	82	0.0365854
NODE_165848_length_302_cov_2.009852	12	34	0	22	22	1.0000000
NODE_165934_length_302_cov_1.758621	98	152	3	24	54	0.4444444
NODE_165934_length_302_cov_1.758621	98	152	4	30	54	0.5555556
NODE_165945_length_302_cov_1.758621	230	294	0	11	64	0.1718750
NODE_165945_length_302_cov_1.758621	230	294	2	53	64	0.8281250
NODE_166007_length_302_cov_1.620690	172	232	4	2	60	0.0333333
NODE_166007_length_302_cov_1.620690	172	232	6	2	60	0.0333333
NODE_166007_length_302_cov_1.620690	172	232	7	15	60	0.2500000
NODE_166007_length_302_cov_1.620690	172	232	8	1	60	0.0166667
NODE_166007_length_302_cov_1.620690	172	232	10	33	60	0.5500000
NODE_166007_length_302_cov_1.620690	172	232	14	1	60	0.0166667
NODE_166007_length_302_cov_1.620690	172	232	18	1	60	0.0166667
NODE_166007_length_302_cov_1.620690	172	232	20	1	60	0.0166667
NODE_166007_length_302_cov_1.620690	172	232	22	4	60	0.0666667
NODE_166007_length_302_cov_1.620690	225	277	0	17	52	0.3269231
NODE_166007_length_302_cov_1.620690	225	277	2	19	52	0.3653846
NODE_166007_length_302_cov_1.620690	225	277	4	11	52	0.2115385
NODE_166007_length_302_cov_1.620690	225	277	6	2	52	0.0384615
NODE_166007_length_302_cov_1.620690	225	277	7	3	52	0.0576923
NODE_166320_length_302_cov_1.172414	34	103	0	69	69	1.0000000
NODE_166381_length_302_cov_1.044335	54	130	0	48	76	0.6315789
NODE_166381_length_302_cov_1.044335	54	130	2	28	76	0.3684210
NODE_166617_length_302_cov_0.847291	94	172	0	78	78	1.0000000
NODE_166617_length_302_cov_0.847291	94	172	0	78	78	1.0000000
NODE_166617_length_302_cov_0.847291	103	172	0	69	69	1.0000000
NODE_166638_length_302_cov_0.807882	97	177	0	80	80	1.0000000
NODE_166819_length_301_cov_6.960396	268	299	0	31	31	1.0000000
NODE_166827_length_301_cov_6.148515	214	283	0	69	69	1.0000000
NODE_166889_length_301_cov_3.747525	116	196	10	14	80	0.1750000
NODE_166889_length_301_cov_3.747525	116	196	16	1	80	0.0125000
NODE_166889_length_301_cov_3.747525	116	196	18	29	80	0.3625000
NODE_166889_length_301_cov_3.747525	116	196	22	36	80	0.4500000
NODE_166904_length_301_cov_3.509901	217	277	4	10	60	0.1666667
NODE_166904_length_301_cov_3.509901	217	277	8	1	60	0.0166667
NODE_166904_length_301_cov_3.509901	217	277	10	1	60	0.0166667
NODE_166904_length_301_cov_3.509901	217	277	14	1	60	0.0166667
NODE_166904_length_301_cov_3.509901	217	277	15	1	60	0.0166667
NODE_166904_length_301_cov_3.509901	217	277	17	1	60	0.0166667
NODE_166904_length_301_cov_3.509901	217	277	20	1	60	0.0166667
NODE_166904_length_301_cov_3.509901	217	277	23	3	60	0.0500000
NODE_166904_length_301_cov_3.509901	217	277	25	1	60	0.0166667
NODE_166904_length_301_cov_3.509901	217	277	27	2	60	0.0333333
NODE_166904_length_301_cov_3.509901	217	277	34	1	60	0.0166667
NODE_166904_length_301_cov_3.509901	217	277	38	1	60	0.0166667
NODE_166904_length_301_cov_3.509901	217	277	39	1	60	0.0166667
NODE_166904_length_301_cov_3.509901	217	277	42	1	60	0.0166667
NODE_166904_length_301_cov_3.509901	217	277	45	1	60	0.0166667
NODE_166904_length_301_cov_3.509901	217	277	51	1	60	0.0166667
NODE_166904_length_301_cov_3.509901	217	277	53	1	60	0.0166667
NODE_166904_length_301_cov_3.509901	217	277	54	1	60	0.0166667
NODE_166904_length_301_cov_3.509901	217	277	56	3	60	0.0500000
NODE_166904_length_301_cov_3.509901	217	277	57	4	60	0.0666667
NODE_166904_length_301_cov_3.509901	217	277	61	2	60	0.0333333
NODE_166904_length_301_cov_3.509901	217	277	63	1	60	0.0166667
NODE_166904_length_301_cov_3.509901	217	277	64	1	60	0.0166667
NODE_166904_length_301_cov_3.509901	217	277	66	3	60	0.0500000
NODE_166904_length_301_cov_3.509901	217	277	70	1	60	0.0166667
NODE_166904_length_301_cov_3.509901	217	277	72	1	60	0.0166667
NODE_166904_length_301_cov_3.509901	217	277	76	1	60	0.0166667
NODE_166904_length_301_cov_3.509901	217	277	78	1	60	0.0166667
NODE_166904_length_301_cov_3.509901	217	277	82	2	60	0.0333333
NODE_166904_length_301_cov_3.509901	217	277	84	1	60	0.0166667
NODE_166904_length_301_cov_3.509901	217	277	86	1	60	0.0166667
NODE_166904_length_301_cov_3.509901	217	277	88	1	60	0.0166667
NODE_166904_length_301_cov_3.509901	217	277	94	2	60	0.0333333
NODE_166904_length_301_cov_3.509901	217	277	96	1	60	0.0166667
NODE_166904_length_301_cov_3.509901	217	277	98	3	60	0.0500000
NODE_166904_length_301_cov_3.509901	217	277	102	1	60	0.0166667
NODE_166993_length_301_cov_2.653465	133	213	0	54	80	0.6750000
NODE_166993_length_301_cov_2.653465	133	213	2	26	80	0.3250000
NODE_167126_length_301_cov_2.084158	178	258	30	4	80	0.0500000
NODE_167126_length_301_cov_2.084158	178	258	38	1	80	0.0125000
NODE_167126_length_301_cov_2.084158	178	258	40	2	80	0.0250000
NODE_167126_length_301_cov_2.084158	178	258	48	1	80	0.0125000
NODE_167126_length_301_cov_2.084158	178	258	50	2	80	0.0250000
NODE_167126_length_301_cov_2.084158	178	258	52	5	80	0.0625000
NODE_167126_length_301_cov_2.084158	178	258	54	1	80	0.0125000
NODE_167126_length_301_cov_2.084158	178	258	56	1	80	0.0125000
NODE_167126_length_301_cov_2.084158	178	258	58	4	80	0.0500000
NODE_167126_length_301_cov_2.084158	178	258	60	1	80	0.0125000
NODE_167126_length_301_cov_2.084158	178	258	64	1	80	0.0125000
NODE_167126_length_301_cov_2.084158	178	258	66	5	80	0.0625000
NODE_167126_length_301_cov_2.084158	178	258	68	2	80	0.0250000
NODE_167126_length_301_cov_2.084158	178	258	70	1	80	0.0125000
NODE_167126_length_301_cov_2.084158	178	258	72	41	80	0.5125000
NODE_167126_length_301_cov_2.084158	178	258	74	8	80	0.1000000
NODE_167215_length_301_cov_1.831683	111	175	0	64	64	1.0000000
NODE_167215_length_301_cov_1.831683	164	228	0	35	64	0.5468750
NODE_167215_length_301_cov_1.831683	164	228	2	23	64	0.3593750
NODE_167215_length_301_cov_1.831683	164	228	4	6	64	0.0937500
NODE_167308_length_301_cov_1.603960	173	233	6	19	60	0.3166667
NODE_167308_length_301_cov_1.603960	173	233	8	1	60	0.0166667
NODE_167308_length_301_cov_1.603960	173	233	10	40	60	0.6666667
NODE_167313_length_301_cov_1.584158	30	108	0	78	78	1.0000000
NODE_167434_length_301_cov_1.470297	90	165	0	75	75	1.0000000
NODE_167508_length_301_cov_1.326733	175	247	4	5	72	0.0694444
NODE_167508_length_301_cov_1.326733	175	247	6	23	72	0.3194444
NODE_167508_length_301_cov_1.326733	175	247	8	33	72	0.4583333
NODE_167508_length_301_cov_1.326733	175	247	10	11	72	0.1527778
NODE_167612_length_301_cov_1.247525	29	73	0	44	44	1.0000000
NODE_167642_length_301_cov_1.183168	123	203	0	8	80	0.1000000
NODE_167642_length_301_cov_1.183168	123	203	2	1	80	0.0125000
NODE_167642_length_301_cov_1.183168	123	203	4	16	80	0.2000000
NODE_167642_length_301_cov_1.183168	123	203	6	12	80	0.1500000
NODE_167642_length_301_cov_1.183168	123	203	8	7	80	0.0875000
NODE_167642_length_301_cov_1.183168	123	203	11	7	80	0.0875000
NODE_167642_length_301_cov_1.183168	123	203	13	3	80	0.0375000
NODE_167642_length_301_cov_1.183168	123	203	14	1	80	0.0125000
NODE_167642_length_301_cov_1.183168	123	203	16	1	80	0.0125000
NODE_167642_length_301_cov_1.183168	123	203	20	5	80	0.0625000
NODE_167642_length_301_cov_1.183168	123	203	24	1	80	0.0125000
NODE_167642_length_301_cov_1.183168	123	203	28	13	80	0.1625000
NODE_167642_length_301_cov_1.183168	123	203	30	5	80	0.0625000
NODE_167659_length_301_cov_1.163366	10	83	0	73	73	1.0000000
NODE_167659_length_301_cov_1.163366	91	121	0	30	30	1.0000000
NODE_167668_length_301_cov_1.148515	161	209	0	48	48	1.0000000
NODE_167880_length_301_cov_0.980198	242	297	0	55	55	1.0000000
NODE_167891_length_301_cov_0.960396	22	63	0	41	41	1.0000000
NODE_168253_length_300_cov_3.402985	44	124	8	80	80	1.0000000
NODE_168253_length_300_cov_3.402985	97	177	4	32	80	0.4000000
NODE_168253_length_300_cov_3.402985	97	177	7	17	80	0.2125000
NODE_168253_length_300_cov_3.402985	97	177	8	29	80	0.3625000
NODE_168253_length_300_cov_3.402985	97	177	11	2	80	0.0250000
NODE_168253_length_300_cov_3.402985	173	254	4	6	81	0.0740741
NODE_168253_length_300_cov_3.402985	173	254	6	14	81	0.1728395
NODE_168253_length_300_cov_3.402985	173	254	8	2	81	0.0246914
NODE_168253_length_300_cov_3.402985	173	254	10	14	81	0.1728395
NODE_168253_length_300_cov_3.402985	173	254	12	12	81	0.1481481
NODE_168253_length_300_cov_3.402985	173	254	13	3	81	0.0370370
NODE_168253_length_300_cov_3.402985	173	254	14	30	81	0.3703704
NODE_168253_length_300_cov_3.402985	233	300	0	5	67	0.0746269
NODE_168253_length_300_cov_3.402985	233	300	2	1	67	0.0149254
NODE_168253_length_300_cov_3.402985	233	300	4	1	67	0.0149254
NODE_168253_length_300_cov_3.402985	233	300	6	1	67	0.0149254
NODE_168253_length_300_cov_3.402985	233	300	7	2	67	0.0298507
NODE_168253_length_300_cov_3.402985	233	300	9	2	67	0.0298507
NODE_168253_length_300_cov_3.402985	233	300	10	47	67	0.7014925
NODE_168253_length_300_cov_3.402985	233	300	13	3	67	0.0447761
NODE_168253_length_300_cov_3.402985	233	300	14	5	67	0.0746269
NODE_168265_length_300_cov_3.298507	18	98	6	80	80	1.0000000
NODE_168360_length_300_cov_2.597015	110	182	6	12	72	0.1666667
NODE_168360_length_300_cov_2.597015	110	182	8	60	72	0.8333333
NODE_168363_length_300_cov_2.572139	28	102	0	33	74	0.4459459
NODE_168363_length_300_cov_2.572139	28	102	2	4	74	0.0540541
NODE_168363_length_300_cov_2.572139	28	102	6	10	74	0.1351351
NODE_168363_length_300_cov_2.572139	28	102	8	5	74	0.0675676
NODE_168363_length_300_cov_2.572139	28	102	10	2	74	0.0270270
NODE_168363_length_300_cov_2.572139	28	102	14	2	74	0.0270270
NODE_168363_length_300_cov_2.572139	28	102	18	2	74	0.0270270
NODE_168363_length_300_cov_2.572139	28	102	22	1	74	0.0135135
NODE_168363_length_300_cov_2.572139	28	102	24	4	74	0.0540541
NODE_168363_length_300_cov_2.572139	28	102	27	1	74	0.0135135
NODE_168363_length_300_cov_2.572139	28	102	28	10	74	0.1351351
NODE_168363_length_300_cov_2.572139	75	141	8	5	66	0.0757576
NODE_168363_length_300_cov_2.572139	75	141	10	2	66	0.0303030
NODE_168363_length_300_cov_2.572139	75	141	14	2	66	0.0303030
NODE_168363_length_300_cov_2.572139	75	141	18	2	66	0.0303030
NODE_168363_length_300_cov_2.572139	75	141	22	1	66	0.0151515
NODE_168363_length_300_cov_2.572139	75	141	24	4	66	0.0606061
NODE_168363_length_300_cov_2.572139	75	141	27	1	66	0.0151515
NODE_168363_length_300_cov_2.572139	75	141	28	10	66	0.1515152
NODE_168363_length_300_cov_2.572139	75	141	30	5	66	0.0757576
NODE_168363_length_300_cov_2.572139	75	141	34	1	66	0.0151515
NODE_168363_length_300_cov_2.572139	75	141	36	1	66	0.0151515
NODE_168363_length_300_cov_2.572139	75	141	38	32	66	0.4848485
NODE_168402_length_300_cov_2.417910	0	44	0	44	44	1.0000000
NODE_168459_length_300_cov_2.174129	117	197	0	80	80	1.0000000
NODE_168459_length_300_cov_2.174129	170	250	0	41	80	0.5125000
NODE_168459_length_300_cov_2.174129	170	250	2	1	80	0.0125000
NODE_168459_length_300_cov_2.174129	170	250	4	1	80	0.0125000
NODE_168459_length_300_cov_2.174129	170	250	10	1	80	0.0125000
NODE_168459_length_300_cov_2.174129	170	250	12	1	80	0.0125000
NODE_168459_length_300_cov_2.174129	170	250	50	1	80	0.0125000
NODE_168459_length_300_cov_2.174129	170	250	55	1	80	0.0125000
NODE_168459_length_300_cov_2.174129	170	250	62	1	80	0.0125000
NODE_168459_length_300_cov_2.174129	170	250	64	1	80	0.0125000
NODE_168459_length_300_cov_2.174129	170	250	74	1	80	0.0125000
NODE_168459_length_300_cov_2.174129	170	250	84	1	80	0.0125000
NODE_168459_length_300_cov_2.174129	170	250	94	1	80	0.0125000
NODE_168459_length_300_cov_2.174129	170	250	100	1	80	0.0125000
NODE_168459_length_300_cov_2.174129	170	250	102	3	80	0.0375000
NODE_168459_length_300_cov_2.174129	170	250	116	4	80	0.0500000
NODE_168459_length_300_cov_2.174129	170	250	118	1	80	0.0125000
NODE_168459_length_300_cov_2.174129	170	250	120	19	80	0.2375000
NODE_168459_length_300_cov_2.174129	216	296	55	1	80	0.0125000
NODE_168459_length_300_cov_2.174129	216	296	62	1	80	0.0125000
NODE_168459_length_300_cov_2.174129	216	296	64	1	80	0.0125000
NODE_168459_length_300_cov_2.174129	216	296	74	1	80	0.0125000
NODE_168459_length_300_cov_2.174129	216	296	84	1	80	0.0125000
NODE_168459_length_300_cov_2.174129	216	296	86	1	80	0.0125000
NODE_168459_length_300_cov_2.174129	216	296	92	1	80	0.0125000
NODE_168459_length_300_cov_2.174129	216	296	94	1	80	0.0125000
NODE_168459_length_300_cov_2.174129	216	296	100	1	80	0.0125000
NODE_168459_length_300_cov_2.174129	216	296	102	3	80	0.0375000
NODE_168459_length_300_cov_2.174129	216	296	110	3	80	0.0375000
NODE_168459_length_300_cov_2.174129	216	296	112	2	80	0.0250000
NODE_168459_length_300_cov_2.174129	216	296	116	5	80	0.0625000
NODE_168459_length_300_cov_2.174129	216	296	118	5	80	0.0625000
NODE_168459_length_300_cov_2.174129	216	296	120	53	80	0.6625000
NODE_168462_length_300_cov_2.164179	122	141	0	15	19	0.7894737
NODE_168462_length_300_cov_2.164179	122	141	2	2	19	0.1052632
NODE_168462_length_300_cov_2.164179	122	141	3	2	19	0.1052632
NODE_168479_length_300_cov_2.079602	127	207	0	8	80	0.1000000
NODE_168479_length_300_cov_2.079602	127	207	2	72	80	0.9000000
NODE_168479_length_300_cov_2.079602	203	273	0	70	70	1.0000000
NODE_168541_length_300_cov_1.965174	15	86	0	25	71	0.3521127
NODE_168541_length_300_cov_1.965174	15	86	2	46	71	0.6478873
NODE_168656_length_300_cov_1.731343	31	88	10	2	57	0.0350877
NODE_168656_length_300_cov_1.731343	31	88	12	2	57	0.0350877
NODE_168656_length_300_cov_1.731343	31	88	14	3	57	0.0526316
NODE_168656_length_300_cov_1.731343	31	88	16	7	57	0.1228070
NODE_168656_length_300_cov_1.731343	31	88	18	10	57	0.1754386
NODE_168656_length_300_cov_1.731343	31	88	20	33	57	0.5789474
NODE_168906_length_300_cov_1.268657	62	98	0	36	36	1.0000000
NODE_168906_length_300_cov_1.268657	151	186	0	35	35	1.0000000
NODE_169014_length_300_cov_1.104478	86	165	18	5	79	0.0632911
NODE_169014_length_300_cov_1.104478	86	165	19	4	79	0.0506329
NODE_169014_length_300_cov_1.104478	86	165	21	18	79	0.2278481
NODE_169014_length_300_cov_1.104478	86	165	22	52	79	0.6582279
NODE_169053_length_300_cov_1.029851	110	177	0	16	67	0.2388060
NODE_169053_length_300_cov_1.029851	110	177	2	16	67	0.2388060
NODE_169053_length_300_cov_1.029851	110	177	10	23	67	0.3432836
NODE_169053_length_300_cov_1.029851	110	177	12	12	67	0.1791045
NODE_169053_length_300_cov_1.029851	120	177	0	16	57	0.2807018
NODE_169053_length_300_cov_1.029851	120	177	2	16	57	0.2807018
NODE_169053_length_300_cov_1.029851	120	177	10	23	57	0.4035088
NODE_169053_length_300_cov_1.029851	120	177	12	2	57	0.0350877
NODE_169378_length_300_cov_0.716418	191	210	0	19	19	1.0000000
NODE_169528_length_299_cov_4.435000	48	128	2	80	80	1.0000000
NODE_169528_length_299_cov_4.435000	101	167	1	16	66	0.2424242
NODE_169528_length_299_cov_4.435000	101	167	2	50	66	0.7575758
NODE_169567_length_299_cov_3.780000	114	181	0	67	67	1.0000000
NODE_169631_length_299_cov_3.095000	0	73	0	73	73	1.0000000
NODE_169631_length_299_cov_3.095000	0	20	0	20	20	1.0000000
NODE_169725_length_299_cov_2.495000	46	126	4	2	80	0.0250000
NODE_169725_length_299_cov_2.495000	46	126	6	46	80	0.5750000
NODE_169725_length_299_cov_2.495000	46	126	10	32	80	0.4000000
NODE_169725_length_299_cov_2.495000	99	179	6	10	80	0.1250000
NODE_169725_length_299_cov_2.495000	99	179	8	35	80	0.4375000
NODE_169725_length_299_cov_2.495000	99	179	10	35	80	0.4375000
NODE_169769_length_299_cov_2.275000	127	192	14	2	65	0.0307692
NODE_169769_length_299_cov_2.275000	127	192	16	3	65	0.0461538
NODE_169769_length_299_cov_2.275000	127	192	17	4	65	0.0615385
NODE_169769_length_299_cov_2.275000	127	192	18	51	65	0.7846154
NODE_169769_length_299_cov_2.275000	127	192	20	5	65	0.0769231
NODE_169781_length_299_cov_2.250000	72	135	0	63	63	1.0000000
NODE_169781_length_299_cov_2.250000	108	188	0	80	80	1.0000000
NODE_169811_length_299_cov_2.090000	25	105	0	80	80	1.0000000
NODE_169888_length_299_cov_1.955000	173	214	21	3	41	0.0731707
NODE_169888_length_299_cov_1.955000	173	214	22	6	41	0.1463415
NODE_169888_length_299_cov_1.955000	173	214	24	7	41	0.1707317
NODE_169888_length_299_cov_1.955000	173	214	26	3	41	0.0731707
NODE_169888_length_299_cov_1.955000	173	214	28	4	41	0.0975610
NODE_169888_length_299_cov_1.955000	173	214	30	2	41	0.0487805
NODE_169888_length_299_cov_1.955000	173	214	32	5	41	0.1219512
NODE_169888_length_299_cov_1.955000	173	214	34	3	41	0.0731707
NODE_169888_length_299_cov_1.955000	173	214	38	3	41	0.0731707
NODE_169888_length_299_cov_1.955000	173	214	40	3	41	0.0731707
NODE_169888_length_299_cov_1.955000	173	214	46	1	41	0.0243902
NODE_169888_length_299_cov_1.955000	173	214	48	1	41	0.0243902
NODE_169888_length_299_cov_1.955000	187	227	24	3	40	0.0750000
NODE_169888_length_299_cov_1.955000	187	227	26	2	40	0.0500000
NODE_169888_length_299_cov_1.955000	187	227	28	4	40	0.1000000
NODE_169888_length_299_cov_1.955000	187	227	30	2	40	0.0500000
NODE_169888_length_299_cov_1.955000	187	227	32	5	40	0.1250000
NODE_169888_length_299_cov_1.955000	187	227	34	3	40	0.0750000
NODE_169888_length_299_cov_1.955000	187	227	38	3	40	0.0750000
NODE_169888_length_299_cov_1.955000	187	227	40	3	40	0.0750000
NODE_169888_length_299_cov_1.955000	187	227	46	6	40	0.1500000
NODE_169888_length_299_cov_1.955000	187	227	48	3	40	0.0750000
NODE_169888_length_299_cov_1.955000	187	227	50	1	40	0.0250000
NODE_169888_length_299_cov_1.955000	187	227	52	5	40	0.1250000
NODE_169916_length_299_cov_1.885000	29	109	4	7	80	0.0875000
NODE_169916_length_299_cov_1.885000	29	109	8	1	80	0.0125000
NODE_169916_length_299_cov_1.885000	29	109	10	3	80	0.0375000
NODE_169916_length_299_cov_1.885000	29	109	12	33	80	0.4125000
NODE_169916_length_299_cov_1.885000	29	109	14	36	80	0.4500000
NODE_169920_length_299_cov_1.880000	204	236	0	32	32	1.0000000
NODE_169938_length_299_cov_1.840000	154	190	0	36	36	1.0000000
NODE_169995_length_299_cov_1.710000	211	291	0	80	80	1.0000000
NODE_170048_length_299_cov_1.550000	174	205	0	31	31	1.0000000
NODE_170501_length_299_cov_1.020000	42	115	0	4	73	0.0547945
NODE_170501_length_299_cov_1.020000	42	115	2	69	73	0.9452055
NODE_170546_length_299_cov_1.020000	132	175	2	6	43	0.1395349
NODE_170546_length_299_cov_1.020000	132	175	4	37	43	0.8604651
NODE_170620_length_299_cov_0.935000	173	216	10	10	43	0.2325581
NODE_170620_length_299_cov_0.935000	173	216	12	33	43	0.7674419
NODE_170691_length_299_cov_0.765000	86	128	0	25	42	0.5952381
NODE_170691_length_299_cov_0.765000	86	128	4	17	42	0.4047619
NODE_170887_length_298_cov_20.894472	70	150	0	80	80	1.0000000
NODE_170887_length_298_cov_20.894472	123	203	0	80	80	1.0000000
NODE_170888_length_298_cov_13.859296	228	298	4	2	70	0.0285714
NODE_170888_length_298_cov_13.859296	228	298	6	16	70	0.2285714
NODE_170888_length_298_cov_13.859296	228	298	8	1	70	0.0142857
NODE_170888_length_298_cov_13.859296	228	298	10	1	70	0.0142857
NODE_170888_length_298_cov_13.859296	228	298	14	4	70	0.0571429
NODE_170888_length_298_cov_13.859296	228	298	16	4	70	0.0571429
NODE_170888_length_298_cov_13.859296	228	298	17	1	70	0.0142857
NODE_170888_length_298_cov_13.859296	228	298	18	6	70	0.0857143
NODE_170888_length_298_cov_13.859296	228	298	20	5	70	0.0714286
NODE_170888_length_298_cov_13.859296	228	298	22	1	70	0.0142857
NODE_170888_length_298_cov_13.859296	228	298	24	4	70	0.0571429
NODE_170888_length_298_cov_13.859296	228	298	26	3	70	0.0428571
NODE_170888_length_298_cov_13.859296	228	298	30	22	70	0.3142857
NODE_170909_length_298_cov_5.859296	1	65	0	2	64	0.0312500
NODE_170909_length_298_cov_5.859296	1	65	2	1	64	0.0156250
NODE_170909_length_298_cov_5.859296	1	65	3	3	64	0.0468750
NODE_170909_length_298_cov_5.859296	1	65	5	2	64	0.0312500
NODE_170909_length_298_cov_5.859296	1	65	7	4	64	0.0625000
NODE_170909_length_298_cov_5.859296	1	65	9	20	64	0.3125000
NODE_170909_length_298_cov_5.859296	1	65	11	11	64	0.1718750
NODE_170909_length_298_cov_5.859296	1	65	13	21	64	0.3281250
NODE_170909_length_298_cov_5.859296	38	118	11	13	80	0.1625000
NODE_170909_length_298_cov_5.859296	38	118	12	7	80	0.0875000
NODE_170909_length_298_cov_5.859296	38	118	13	23	80	0.2875000
NODE_170909_length_298_cov_5.859296	38	118	15	22	80	0.2750000
NODE_170909_length_298_cov_5.859296	38	118	17	15	80	0.1875000
NODE_170909_length_298_cov_5.859296	114	194	2	7	80	0.0875000
NODE_170909_length_298_cov_5.859296	114	194	4	32	80	0.4000000
NODE_170909_length_298_cov_5.859296	114	194	6	21	80	0.2625000
NODE_170909_length_298_cov_5.859296	114	194	8	2	80	0.0250000
NODE_170909_length_298_cov_5.859296	114	194	10	6	80	0.0750000
NODE_170909_length_298_cov_5.859296	114	194	12	12	80	0.1500000
NODE_170909_length_298_cov_5.859296	167	238	2	3	71	0.0422535
NODE_170909_length_298_cov_5.859296	167	238	4	34	71	0.4788733
NODE_170909_length_298_cov_5.859296	167	238	6	34	71	0.4788733
NODE_170964_length_298_cov_3.829146	80	160	53	4	80	0.0500000
NODE_170964_length_298_cov_3.829146	80	160	55	10	80	0.1250000
NODE_170964_length_298_cov_3.829146	80	160	58	22	80	0.2750000
NODE_170964_length_298_cov_3.829146	80	160	59	3	80	0.0375000
NODE_170964_length_298_cov_3.829146	80	160	60	11	80	0.1375000
NODE_170964_length_298_cov_3.829146	80	160	62	1	80	0.0125000
NODE_170964_length_298_cov_3.829146	80	160	64	4	80	0.0500000
NODE_170964_length_298_cov_3.829146	80	160	66	12	80	0.1500000
NODE_170964_length_298_cov_3.829146	80	160	68	13	80	0.1625000
NODE_170964_length_298_cov_3.829146	133	213	31	7	80	0.0875000
NODE_170964_length_298_cov_3.829146	133	213	33	1	80	0.0125000
NODE_170964_length_298_cov_3.829146	133	213	34	1	80	0.0125000
NODE_170964_length_298_cov_3.829146	133	213	35	3	80	0.0375000
NODE_170964_length_298_cov_3.829146	133	213	39	4	80	0.0500000
NODE_170964_length_298_cov_3.829146	133	213	41	3	80	0.0375000
NODE_170964_length_298_cov_3.829146	133	213	43	8	80	0.1000000
NODE_170964_length_298_cov_3.829146	133	213	45	2	80	0.0250000
NODE_170964_length_298_cov_3.829146	133	213	46	2	80	0.0250000
NODE_170964_length_298_cov_3.829146	133	213	51	1	80	0.0125000
NODE_170964_length_298_cov_3.829146	133	213	55	8	80	0.1000000
NODE_170964_length_298_cov_3.829146	133	213	56	1	80	0.0125000
NODE_170964_length_298_cov_3.829146	133	213	57	3	80	0.0375000
NODE_170964_length_298_cov_3.829146	133	213	58	16	80	0.2000000
NODE_170964_length_298_cov_3.829146	133	213	59	6	80	0.0750000
NODE_170964_length_298_cov_3.829146	133	213	60	11	80	0.1375000
NODE_170964_length_298_cov_3.829146	133	213	61	3	80	0.0375000
NODE_170968_length_298_cov_3.733668	203	283	0	80	80	1.0000000
NODE_170972_length_298_cov_3.673367	117	175	0	4	58	0.0689655
NODE_170972_length_298_cov_3.673367	117	175	2	26	58	0.4482759
NODE_170972_length_298_cov_3.673367	117	175	6	28	58	0.4827586
NODE_171043_length_298_cov_2.924623	159	239	10	3	80	0.0375000
NODE_171043_length_298_cov_2.924623	159	239	12	10	80	0.1250000
NODE_171043_length_298_cov_2.924623	159	239	14	34	80	0.4250000
NODE_171043_length_298_cov_2.924623	159	239	15	2	80	0.0250000
NODE_171043_length_298_cov_2.924623	159	239	16	23	80	0.2875000
NODE_171043_length_298_cov_2.924623	159	239	18	4	80	0.0500000
NODE_171043_length_298_cov_2.924623	159	239	22	1	80	0.0125000
NODE_171043_length_298_cov_2.924623	159	239	24	2	80	0.0250000
NODE_171043_length_298_cov_2.924623	159	239	26	1	80	0.0125000
NODE_171043_length_298_cov_2.924623	212	265	2	3	53	0.0566038
NODE_171043_length_298_cov_2.924623	212	265	4	2	53	0.0377358
NODE_171043_length_298_cov_2.924623	212	265	6	1	53	0.0188679
NODE_171043_length_298_cov_2.924623	212	265	8	7	53	0.1320755
NODE_171043_length_298_cov_2.924623	212	265	12	15	53	0.2830189
NODE_171043_length_298_cov_2.924623	212	265	14	25	53	0.4716981
NODE_171047_length_298_cov_2.854271	50	120	0	70	70	1.0000000
NODE_171082_length_298_cov_2.663317	87	167	0	30	80	0.3750000
NODE_171082_length_298_cov_2.663317	87	167	2	1	80	0.0125000
NODE_171082_length_298_cov_2.663317	87	167	4	2	80	0.0250000
NODE_171082_length_298_cov_2.663317	87	167	6	47	80	0.5875000
NODE_171082_length_298_cov_2.663317	140	192	0	52	52	1.0000000
NODE_171191_length_298_cov_2.201005	112	166	0	54	54	1.0000000
NODE_171210_length_298_cov_2.120603	135	166	0	1	31	0.0322581
NODE_171210_length_298_cov_2.120603	135	166	4	30	31	0.9677419
NODE_171226_length_298_cov_2.055276	69	132	2	63	63	1.0000000
NODE_171286_length_298_cov_2.025126	21	92	0	71	71	1.0000000
NODE_171356_length_298_cov_1.798995	0	67	1	2	67	0.0298507
NODE_171356_length_298_cov_1.798995	0	67	2	65	67	0.9701493
NODE_171356_length_298_cov_1.798995	40	106	0	1	66	0.0151515
NODE_171356_length_298_cov_1.798995	40	106	2	65	66	0.9848485
NODE_171391_length_298_cov_1.788945	140	197	2	7	57	0.1228070
NODE_171391_length_298_cov_1.788945	140	197	4	15	57	0.2631579
NODE_171391_length_298_cov_1.788945	140	197	6	35	57	0.6140351
NODE_171415_length_298_cov_1.733668	56	91	20	6	35	0.1714286
NODE_171415_length_298_cov_1.733668	56	91	22	9	35	0.2571429
NODE_171415_length_298_cov_1.733668	56	91	28	8	35	0.2285714
NODE_171415_length_298_cov_1.733668	56	91	30	10	35	0.2857143
NODE_171415_length_298_cov_1.733668	56	91	32	2	35	0.0571429
NODE_171415_length_298_cov_1.733668	118	172	4	6	54	0.1111111
NODE_171415_length_298_cov_1.733668	118	172	5	6	54	0.1111111
NODE_171415_length_298_cov_1.733668	118	172	9	3	54	0.0555556
NODE_171415_length_298_cov_1.733668	118	172	13	4	54	0.0740741
NODE_171415_length_298_cov_1.733668	118	172	17	3	54	0.0555556
NODE_171415_length_298_cov_1.733668	118	172	18	11	54	0.2037037
NODE_171415_length_298_cov_1.733668	118	172	20	16	54	0.2962963
NODE_171415_length_298_cov_1.733668	118	172	24	5	54	0.0925926
NODE_171505_length_298_cov_1.537688	101	154	0	53	53	1.0000000
NODE_172083_length_298_cov_0.829146	34	96	0	62	62	1.0000000
NODE_172330_length_297_cov_6.525253	100	122	0	22	22	1.0000000
NODE_172352_length_297_cov_4.888889	150	218	2	4	68	0.0588235
NODE_172352_length_297_cov_4.888889	150	218	4	8	68	0.1176471
NODE_172352_length_297_cov_4.888889	150	218	6	56	68	0.8235294
NODE_172356_length_297_cov_4.671717	56	120	0	64	64	1.0000000
NODE_172422_length_297_cov_3.338384	96	176	0	7	80	0.0875000
NODE_172422_length_297_cov_3.338384	96	176	2	72	80	0.9000000
NODE_172422_length_297_cov_3.338384	96	176	3	1	80	0.0125000
NODE_172422_length_297_cov_3.338384	149	198	0	28	49	0.5714286
NODE_172422_length_297_cov_3.338384	149	198	2	21	49	0.4285714
NODE_172447_length_297_cov_3.040404	0	55	0	11	55	0.2000000
NODE_172447_length_297_cov_3.040404	0	55	2	44	55	0.8000000
NODE_172447_length_297_cov_3.040404	14	55	2	41	41	1.0000000
NODE_172447_length_297_cov_3.040404	65	119	0	21	54	0.3888889
NODE_172447_length_297_cov_3.040404	65	119	1	3	54	0.0555556
NODE_172447_length_297_cov_3.040404	65	119	2	30	54	0.5555556
NODE_172574_length_297_cov_2.308081	8	70	0	62	62	1.0000000
NODE_172606_length_297_cov_2.196970	219	259	106	1	40	0.0250000
NODE_172606_length_297_cov_2.196970	219	259	114	1	40	0.0250000
NODE_172606_length_297_cov_2.196970	219	259	122	1	40	0.0250000
NODE_172606_length_297_cov_2.196970	219	259	125	1	40	0.0250000
NODE_172606_length_297_cov_2.196970	219	259	126	1	40	0.0250000
NODE_172606_length_297_cov_2.196970	219	259	128	1	40	0.0250000
NODE_172606_length_297_cov_2.196970	219	259	132	1	40	0.0250000
NODE_172606_length_297_cov_2.196970	219	259	136	1	40	0.0250000
NODE_172606_length_297_cov_2.196970	219	259	143	1	40	0.0250000
NODE_172606_length_297_cov_2.196970	219	259	147	2	40	0.0500000
NODE_172606_length_297_cov_2.196970	219	259	152	1	40	0.0250000
NODE_172606_length_297_cov_2.196970	219	259	160	1	40	0.0250000
NODE_172606_length_297_cov_2.196970	219	259	164	2	40	0.0500000
NODE_172606_length_297_cov_2.196970	219	259	168	1	40	0.0250000
NODE_172606_length_297_cov_2.196970	219	259	170	1	40	0.0250000
NODE_172606_length_297_cov_2.196970	219	259	176	1	40	0.0250000
NODE_172606_length_297_cov_2.196970	219	259	182	1	40	0.0250000
NODE_172606_length_297_cov_2.196970	219	259	184	1	40	0.0250000
NODE_172606_length_297_cov_2.196970	219	259	188	2	40	0.0500000
NODE_172606_length_297_cov_2.196970	219	259	192	2	40	0.0500000
NODE_172606_length_297_cov_2.196970	219	259	193	3	40	0.0750000
NODE_172606_length_297_cov_2.196970	219	259	195	2	40	0.0500000
NODE_172606_length_297_cov_2.196970	219	259	197	1	40	0.0250000
NODE_172606_length_297_cov_2.196970	219	259	199	2	40	0.0500000
NODE_172606_length_297_cov_2.196970	219	259	201	2	40	0.0500000
NODE_172606_length_297_cov_2.196970	219	259	202	2	40	0.0500000
NODE_172606_length_297_cov_2.196970	219	259	204	2	40	0.0500000
NODE_172606_length_297_cov_2.196970	219	259	206	2	40	0.0500000
NODE_172629_length_297_cov_2.106061	81	161	0	3	80	0.0375000
NODE_172629_length_297_cov_2.106061	81	161	2	3	80	0.0375000
NODE_172629_length_297_cov_2.106061	81	161	4	21	80	0.2625000
NODE_172629_length_297_cov_2.106061	81	161	6	19	80	0.2375000
NODE_172629_length_297_cov_2.106061	81	161	10	16	80	0.2000000
NODE_172629_length_297_cov_2.106061	81	161	12	18	80	0.2250000
NODE_172629_length_297_cov_2.106061	134	178	10	14	44	0.3181818
NODE_172629_length_297_cov_2.106061	134	178	12	28	44	0.6363636
NODE_172629_length_297_cov_2.106061	134	178	14	2	44	0.0454545
NODE_172668_length_297_cov_2.060606	46	76	0	30	30	1.0000000
NODE_172697_length_297_cov_2.010101	9	85	2	8	76	0.1052632
NODE_172697_length_297_cov_2.010101	9	85	4	8	76	0.1052632
NODE_172697_length_297_cov_2.010101	9	85	6	21	76	0.2763158
NODE_172697_length_297_cov_2.010101	9	85	10	39	76	0.5131579
NODE_172783_length_297_cov_1.777778	168	208	8	1	40	0.0250000
NODE_172783_length_297_cov_1.777778	168	208	9	1	40	0.0250000
NODE_172783_length_297_cov_1.777778	168	208	12	5	40	0.1250000
NODE_172783_length_297_cov_1.777778	168	208	13	3	40	0.0750000
NODE_172783_length_297_cov_1.777778	168	208	17	7	40	0.1750000
NODE_172783_length_297_cov_1.777778	168	208	19	3	40	0.0750000
NODE_172783_length_297_cov_1.777778	168	208	22	7	40	0.1750000
NODE_172783_length_297_cov_1.777778	168	208	24	13	40	0.3250000
NODE_172855_length_297_cov_1.595960	175	255	6	15	80	0.1875000
NODE_172855_length_297_cov_1.595960	175	255	8	1	80	0.0125000
NODE_172855_length_297_cov_1.595960	175	255	14	14	80	0.1750000
NODE_172855_length_297_cov_1.595960	175	255	18	3	80	0.0375000
NODE_172855_length_297_cov_1.595960	175	255	20	2	80	0.0250000
NODE_172855_length_297_cov_1.595960	175	255	22	12	80	0.1500000
NODE_172855_length_297_cov_1.595960	175	255	24	1	80	0.0125000
NODE_172855_length_297_cov_1.595960	175	255	26	32	80	0.4000000
NODE_172862_length_297_cov_1.570707	100	177	0	77	77	1.0000000
NODE_172863_length_297_cov_1.570707	194	275	2	81	81	1.0000000
NODE_173063_length_297_cov_1.338384	140	199	0	28	59	0.4745763
NODE_173063_length_297_cov_1.338384	140	199	2	31	59	0.5254237
NODE_173136_length_297_cov_1.277778	39	115	0	76	76	1.0000000
NODE_173176_length_297_cov_1.196970	7	87	0	75	80	0.9375000
NODE_173176_length_297_cov_1.196970	7	87	2	5	80	0.0625000
NODE_173176_length_297_cov_1.196970	60	116	0	22	56	0.3928571
NODE_173176_length_297_cov_1.196970	60	116	2	34	56	0.6071429
NODE_173345_length_297_cov_1.030303	0	33	0	33	33	1.0000000
NODE_173467_length_297_cov_0.888889	109	172	0	42	63	0.6666667
NODE_173467_length_297_cov_0.888889	109	172	2	21	63	0.3333333
NODE_173520_length_297_cov_0.782828	24	104	0	80	80	1.0000000
NODE_173708_length_296_cov_41.390863	189	260	4	8	71	0.1126761
NODE_173708_length_296_cov_41.390863	189	260	6	63	71	0.8873239
NODE_173709_length_296_cov_34.776650	214	294	0	80	80	1.0000000
NODE_173758_length_296_cov_4.243655	14	54	0	40	40	1.0000000
NODE_173773_length_296_cov_3.954315	120	200	0	80	80	1.0000000
NODE_173787_length_296_cov_3.736041	6	46	0	40	40	1.0000000
NODE_173797_length_296_cov_3.619289	193	251	0	33	58	0.5689655
NODE_173797_length_296_cov_3.619289	193	251	2	25	58	0.4310345
NODE_173797_length_296_cov_3.619289	246	296	0	50	50	1.0000000
NODE_173859_length_296_cov_3.015228	177	257	0	49	80	0.6125000
NODE_173859_length_296_cov_3.015228	177	257	10	31	80	0.3875000
NODE_173992_length_296_cov_2.309645	5	77	4	2	72	0.0277778
NODE_173992_length_296_cov_2.309645	5	77	9	4	72	0.0555556
NODE_173992_length_296_cov_2.309645	5	77	11	2	72	0.0277778
NODE_173992_length_296_cov_2.309645	5	77	13	5	72	0.0694444
NODE_173992_length_296_cov_2.309645	5	77	17	12	72	0.1666667
NODE_173992_length_296_cov_2.309645	5	77	21	1	72	0.0138889
NODE_173992_length_296_cov_2.309645	5	77	23	13	72	0.1805556
NODE_173992_length_296_cov_2.309645	5	77	25	1	72	0.0138889
NODE_173992_length_296_cov_2.309645	5	77	29	7	72	0.0972222
NODE_173992_length_296_cov_2.309645	5	77	33	3	72	0.0416667
NODE_173992_length_296_cov_2.309645	5	77	35	9	72	0.1250000
NODE_173992_length_296_cov_2.309645	5	77	39	1	72	0.0138889
NODE_173992_length_296_cov_2.309645	5	77	41	4	72	0.0555556
NODE_173992_length_296_cov_2.309645	5	77	45	3	72	0.0416667
NODE_173992_length_296_cov_2.309645	5	77	47	4	72	0.0555556
NODE_173992_length_296_cov_2.309645	5	77	49	1	72	0.0138889
NODE_173992_length_296_cov_2.309645	50	130	29	2	80	0.0250000
NODE_173992_length_296_cov_2.309645	50	130	33	3	80	0.0375000
NODE_173992_length_296_cov_2.309645	50	130	35	9	80	0.1125000
NODE_173992_length_296_cov_2.309645	50	130	39	1	80	0.0125000
NODE_173992_length_296_cov_2.309645	50	130	41	4	80	0.0500000
NODE_173992_length_296_cov_2.309645	50	130	45	3	80	0.0375000
NODE_173992_length_296_cov_2.309645	50	130	47	4	80	0.0500000
NODE_173992_length_296_cov_2.309645	50	130	49	1	80	0.0125000
NODE_173992_length_296_cov_2.309645	50	130	53	7	80	0.0875000
NODE_173992_length_296_cov_2.309645	50	130	54	1	80	0.0125000
NODE_173992_length_296_cov_2.309645	50	130	56	1	80	0.0125000
NODE_173992_length_296_cov_2.309645	50	130	58	8	80	0.1000000
NODE_173992_length_296_cov_2.309645	50	130	60	14	80	0.1750000
NODE_173992_length_296_cov_2.309645	50	130	62	3	80	0.0375000
NODE_173992_length_296_cov_2.309645	50	130	65	10	80	0.1250000
NODE_173992_length_296_cov_2.309645	50	130	67	1	80	0.0125000
NODE_173992_length_296_cov_2.309645	50	130	68	5	80	0.0625000
NODE_173992_length_296_cov_2.309645	50	130	70	3	80	0.0375000
NODE_174040_length_296_cov_2.081218	90	139	0	49	49	1.0000000
NODE_174167_length_296_cov_1.807107	199	246	0	47	47	1.0000000
NODE_174167_length_296_cov_1.807107	219	296	0	77	77	1.0000000
NODE_174213_length_296_cov_1.670051	28	103	6	75	75	1.0000000
NODE_174274_length_296_cov_1.553299	102	179	0	3	77	0.0389610
NODE_174274_length_296_cov_1.553299	102	179	2	52	77	0.6753247
NODE_174274_length_296_cov_1.553299	102	179	4	22	77	0.2857143
NODE_174274_length_296_cov_1.553299	160	179	0	3	19	0.1578947
NODE_174274_length_296_cov_1.553299	160	179	2	16	19	0.8421053
NODE_174438_length_296_cov_1.319797	82	162	0	24	80	0.3000000
NODE_174438_length_296_cov_1.319797	82	162	2	9	80	0.1125000
NODE_174438_length_296_cov_1.319797	82	162	4	29	80	0.3625000
NODE_174438_length_296_cov_1.319797	82	162	8	18	80	0.2250000
NODE_174438_length_296_cov_1.319797	135	205	4	9	70	0.1285714
NODE_174438_length_296_cov_1.319797	135	205	8	61	70	0.8714285
NODE_174545_length_296_cov_1.258883	222	280	0	58	58	1.0000000
NODE_174554_length_296_cov_1.238579	90	147	8	47	57	0.8245614
NODE_174554_length_296_cov_1.238579	90	147	10	4	57	0.0701754
NODE_174554_length_296_cov_1.238579	90	147	11	1	57	0.0175439
NODE_174554_length_296_cov_1.238579	90	147	12	5	57	0.0877193
NODE_174614_length_296_cov_1.116751	130	169	0	2	39	0.0512821
NODE_174614_length_296_cov_1.116751	130	169	6	2	39	0.0512821
NODE_174614_length_296_cov_1.116751	130	169	8	1	39	0.0256410
NODE_174614_length_296_cov_1.116751	130	169	9	1	39	0.0256410
NODE_174614_length_296_cov_1.116751	130	169	11	8	39	0.2051282
NODE_174614_length_296_cov_1.116751	130	169	13	16	39	0.4102564
NODE_174614_length_296_cov_1.116751	130	169	15	9	39	0.2307692
NODE_175210_length_295_cov_4.290816	2	70	0	68	68	1.0000000
NODE_175210_length_295_cov_4.290816	55	123	0	68	68	1.0000000
NODE_175220_length_295_cov_4.040816	119	165	6	6	46	0.1304348
NODE_175220_length_295_cov_4.040816	119	165	8	4	46	0.0869565
NODE_175220_length_295_cov_4.040816	119	165	10	20	46	0.4347826
NODE_175220_length_295_cov_4.040816	119	165	12	16	46	0.3478261
NODE_175258_length_295_cov_3.576531	130	198	0	68	68	1.0000000
NODE_175324_length_295_cov_2.918367	0	77	0	77	77	1.0000000
NODE_175416_length_295_cov_2.454082	216	277	4	2	61	0.0327869
NODE_175416_length_295_cov_2.454082	216	277	6	10	61	0.1639344
NODE_175416_length_295_cov_2.454082	216	277	12	49	61	0.8032787
NODE_175475_length_295_cov_2.224490	11	91	2	12	80	0.1500000
NODE_175475_length_295_cov_2.224490	11	91	4	9	80	0.1125000
NODE_175475_length_295_cov_2.224490	11	91	6	59	80	0.7375000
NODE_175483_length_295_cov_2.183673	93	151	7	1	58	0.0172414
NODE_175483_length_295_cov_2.183673	93	151	12	12	58	0.2068966
NODE_175483_length_295_cov_2.183673	93	151	13	1	58	0.0172414
NODE_175483_length_295_cov_2.183673	93	151	14	1	58	0.0172414
NODE_175483_length_295_cov_2.183673	93	151	16	5	58	0.0862069
NODE_175483_length_295_cov_2.183673	93	151	18	1	58	0.0172414
NODE_175483_length_295_cov_2.183673	93	151	24	1	58	0.0172414
NODE_175483_length_295_cov_2.183673	93	151	26	1	58	0.0172414
NODE_175483_length_295_cov_2.183673	93	151	34	3	58	0.0517241
NODE_175483_length_295_cov_2.183673	93	151	38	4	58	0.0689655
NODE_175483_length_295_cov_2.183673	93	151	39	3	58	0.0517241
NODE_175483_length_295_cov_2.183673	93	151	40	9	58	0.1551724
NODE_175483_length_295_cov_2.183673	93	151	42	16	58	0.2758621
NODE_175483_length_295_cov_2.183673	124	204	30	7	80	0.0875000
NODE_175483_length_295_cov_2.183673	124	204	31	7	80	0.0875000
NODE_175483_length_295_cov_2.183673	124	204	33	4	80	0.0500000
NODE_175483_length_295_cov_2.183673	124	204	35	2	80	0.0250000
NODE_175483_length_295_cov_2.183673	124	204	39	4	80	0.0500000
NODE_175483_length_295_cov_2.183673	124	204	40	9	80	0.1125000
NODE_175483_length_295_cov_2.183673	124	204	41	26	80	0.3250000
NODE_175483_length_295_cov_2.183673	124	204	42	21	80	0.2625000
NODE_175597_length_295_cov_1.867347	191	239	4	4	48	0.0833333
NODE_175597_length_295_cov_1.867347	191	239	6	44	48	0.9166667
NODE_175598_length_295_cov_1.862245	225	285	0	60	60	1.0000000
NODE_175721_length_295_cov_1.596939	173	254	0	49	81	0.6049383
NODE_175721_length_295_cov_1.596939	173	254	2	16	81	0.1975309
NODE_175721_length_295_cov_1.596939	173	254	4	16	81	0.1975309
NODE_175804_length_295_cov_1.520408	217	282	1	9	65	0.1384615
NODE_175804_length_295_cov_1.520408	217	282	2	23	65	0.3538462
NODE_175804_length_295_cov_1.520408	217	282	4	20	65	0.3076923
NODE_175804_length_295_cov_1.520408	217	282	6	13	65	0.2000000
NODE_175930_length_295_cov_1.301020	99	121	0	22	22	1.0000000
NODE_176250_length_295_cov_0.938776	200	247	0	47	47	1.0000000
NODE_176367_length_295_cov_0.780612	24	44	0	20	20	1.0000000
NODE_176436_length_295_cov_0.724490	6	87	0	81	81	1.0000000
NODE_176436_length_295_cov_0.724490	83	163	0	7	80	0.0875000
NODE_176436_length_295_cov_0.724490	83	163	2	73	80	0.9125000
NODE_176436_length_295_cov_0.724490	136	216	0	44	80	0.5500000
NODE_176436_length_295_cov_0.724490	136	216	2	36	80	0.4500000
NODE_176547_length_294_cov_83.882051	143	173	0	30	30	1.0000000
NODE_176547_length_294_cov_83.882051	209	239	0	30	30	1.0000000
NODE_176549_length_294_cov_50.589744	187	258	10	4	71	0.0563380
NODE_176549_length_294_cov_50.589744	187	258	11	14	71	0.1971831
NODE_176549_length_294_cov_50.589744	187	258	12	3	71	0.0422535
NODE_176549_length_294_cov_50.589744	187	258	14	10	71	0.1408451
NODE_176549_length_294_cov_50.589744	187	258	18	40	71	0.5633803
NODE_176561_length_294_cov_6.676923	61	138	0	42	77	0.5454546
NODE_176561_length_294_cov_6.676923	61	138	6	35	77	0.4545455
NODE_176596_length_294_cov_4.538462	127	214	2	6	87	0.0689655
NODE_176596_length_294_cov_4.538462	127	214	4	28	87	0.3218391
NODE_176596_length_294_cov_4.538462	127	214	6	53	87	0.6091954
NODE_176598_length_294_cov_4.512821	218	248	0	30	30	1.0000000
NODE_176600_length_294_cov_4.497436	159	200	0	41	41	1.0000000
NODE_176697_length_294_cov_2.953846	114	194	0	32	80	0.4000000
NODE_176697_length_294_cov_2.953846	114	194	2	48	80	0.6000000
NODE_176727_length_294_cov_2.764103	103	183	0	71	80	0.8875000
NODE_176727_length_294_cov_2.764103	103	183	2	9	80	0.1125000
NODE_176727_length_294_cov_2.764103	156	236	0	18	80	0.2250000
NODE_176727_length_294_cov_2.764103	156	236	2	62	80	0.7750000
NODE_176728_length_294_cov_2.764103	224	282	0	14	58	0.2413793
NODE_176728_length_294_cov_2.764103	224	282	2	37	58	0.6379310
NODE_176728_length_294_cov_2.764103	224	282	4	1	58	0.0172414
NODE_176728_length_294_cov_2.764103	224	282	6	2	58	0.0344828
NODE_176728_length_294_cov_2.764103	224	282	9	1	58	0.0172414
NODE_176728_length_294_cov_2.764103	224	282	11	3	58	0.0517241
NODE_176728_length_294_cov_2.764103	225	277	0	9	52	0.1730769
NODE_176728_length_294_cov_2.764103	225	277	2	37	52	0.7115384
NODE_176728_length_294_cov_2.764103	225	277	4	1	52	0.0192308
NODE_176728_length_294_cov_2.764103	225	277	6	2	52	0.0384615
NODE_176728_length_294_cov_2.764103	225	277	9	1	52	0.0192308
NODE_176728_length_294_cov_2.764103	225	277	11	2	52	0.0384615
NODE_176735_length_294_cov_2.697436	204	261	12	57	57	1.0000000
NODE_176735_length_294_cov_2.697436	234	294	8	1	60	0.0166667
NODE_176735_length_294_cov_2.697436	234	294	10	3	60	0.0500000
NODE_176735_length_294_cov_2.697436	234	294	12	56	60	0.9333333
NODE_176779_length_294_cov_2.517949	23	85	2	62	62	1.0000000
NODE_176816_length_294_cov_2.353846	129	167	14	14	38	0.3684210
NODE_176816_length_294_cov_2.353846	129	167	16	24	38	0.6315789
NODE_176833_length_294_cov_2.338462	133	213	2	22	80	0.2750000
NODE_176833_length_294_cov_2.338462	133	213	4	15	80	0.1875000
NODE_176833_length_294_cov_2.338462	133	213	6	11	80	0.1375000
NODE_176833_length_294_cov_2.338462	133	213	8	13	80	0.1625000
NODE_176833_length_294_cov_2.338462	133	213	10	14	80	0.1750000
NODE_176833_length_294_cov_2.338462	133	213	12	5	80	0.0625000
NODE_176943_length_294_cov_2.046154	219	269	0	50	50	1.0000000
NODE_176957_length_294_cov_2.010256	191	235	0	1	44	0.0227273
NODE_176957_length_294_cov_2.010256	191	235	4	43	44	0.9772727
NODE_176999_length_294_cov_1.902564	52	83	0	31	31	1.0000000
NODE_177102_length_294_cov_1.692308	46	112	0	66	66	1.0000000
NODE_177187_length_294_cov_1.569231	49	95	6	3	46	0.0652174
NODE_177187_length_294_cov_1.569231	49	95	8	15	46	0.3260870
NODE_177187_length_294_cov_1.569231	49	95	10	28	46	0.6086956
NODE_177252_length_294_cov_1.482051	28	108	4	7	80	0.0875000
NODE_177252_length_294_cov_1.482051	28	108	6	4	80	0.0500000
NODE_177252_length_294_cov_1.482051	28	108	8	69	80	0.8625000
NODE_177252_length_294_cov_1.482051	201	281	0	16	80	0.2000000
NODE_177252_length_294_cov_1.482051	201	281	2	64	80	0.8000000
NODE_177252_length_294_cov_1.482051	201	281	0	16	80	0.2000000
NODE_177252_length_294_cov_1.482051	201	281	2	64	80	0.8000000
NODE_177298_length_294_cov_1.420513	216	262	0	46	46	1.0000000
NODE_177298_length_294_cov_1.420513	235	294	0	59	59	1.0000000
NODE_177972_length_294_cov_0.666667	245	293	0	48	48	1.0000000
NODE_178066_length_293_cov_6.257732	167	247	0	80	80	1.0000000
NODE_178161_length_293_cov_3.567010	50	130	4	5	80	0.0625000
NODE_178161_length_293_cov_3.567010	50	130	6	75	80	0.9375000
NODE_178226_length_293_cov_2.907216	218	281	0	3	63	0.0476190
NODE_178226_length_293_cov_2.907216	218	281	2	60	63	0.9523810
NODE_178246_length_293_cov_2.768041	95	175	0	80	80	1.0000000
NODE_178246_length_293_cov_2.768041	148	228	0	80	80	1.0000000
NODE_178268_length_293_cov_2.628866	207	266	12	23	59	0.3898305
NODE_178268_length_293_cov_2.628866	207	266	14	22	59	0.3728814
NODE_178268_length_293_cov_2.628866	207	266	18	14	59	0.2372881
NODE_178277_length_293_cov_2.623711	182	223	10	22	41	0.5365854
NODE_178277_length_293_cov_2.623711	182	223	12	19	41	0.4634146
NODE_178299_length_293_cov_2.561856	139	192	0	11	53	0.2075472
NODE_178299_length_293_cov_2.561856	139	192	1	32	53	0.6037736
NODE_178299_length_293_cov_2.561856	139	192	3	2	53	0.0377358
NODE_178299_length_293_cov_2.561856	139	192	4	8	53	0.1509434
NODE_178299_length_293_cov_2.561856	177	223	1	5	46	0.1086956
NODE_178299_length_293_cov_2.561856	177	223	3	4	46	0.0869565
NODE_178299_length_293_cov_2.561856	177	223	4	37	46	0.8043478
NODE_178317_length_293_cov_2.448454	98	158	0	37	60	0.6166667
NODE_178317_length_293_cov_2.448454	98	158	2	23	60	0.3833333
NODE_178351_length_293_cov_2.335052	62	91	0	29	29	1.0000000
NODE_178357_length_293_cov_2.314433	35	89	0	54	54	1.0000000
NODE_178523_length_293_cov_1.840206	27	107	0	3	80	0.0375000
NODE_178523_length_293_cov_1.840206	27	107	2	19	80	0.2375000
NODE_178523_length_293_cov_1.840206	27	107	4	58	80	0.7250000
NODE_178523_length_293_cov_1.840206	80	160	0	56	80	0.7000000
NODE_178523_length_293_cov_1.840206	80	160	2	19	80	0.2375000
NODE_178523_length_293_cov_1.840206	80	160	4	5	80	0.0625000
NODE_178560_length_293_cov_1.804124	144	173	10	6	29	0.2068966
NODE_178560_length_293_cov_1.804124	144	173	14	5	29	0.1724138
NODE_178560_length_293_cov_1.804124	144	173	16	2	29	0.0689655
NODE_178560_length_293_cov_1.804124	144	173	18	13	29	0.4482759
NODE_178560_length_293_cov_1.804124	144	173	20	3	29	0.1034483
NODE_178570_length_293_cov_1.778351	224	258	0	34	34	1.0000000
NODE_178646_length_293_cov_1.577320	158	177	0	19	19	1.0000000
NODE_178692_length_293_cov_1.577320	161	225	0	37	64	0.5781250
NODE_178692_length_293_cov_1.577320	161	225	2	27	64	0.4218750
NODE_178693_length_293_cov_1.577320	15	55	0	38	40	0.9500000
NODE_178693_length_293_cov_1.577320	15	55	4	2	40	0.0500000
NODE_178788_length_293_cov_1.402062	3	72	0	69	69	1.0000000
NODE_178822_length_293_cov_1.319588	202	268	0	66	66	1.0000000
NODE_178927_length_293_cov_1.226804	84	141	0	57	57	1.0000000
NODE_179542_length_292_cov_4.523316	240	290	0	46	50	0.9200000
NODE_179542_length_292_cov_4.523316	240	290	2	4	50	0.0800000
NODE_179552_length_292_cov_4.145078	106	186	0	80	80	1.0000000
NODE_179604_length_292_cov_3.502591	129	205	4	6	76	0.0789474
NODE_179604_length_292_cov_3.502591	129	205	6	8	76	0.1052632
NODE_179604_length_292_cov_3.502591	129	205	8	2	76	0.0263158
NODE_179604_length_292_cov_3.502591	129	205	12	10	76	0.1315790
NODE_179604_length_292_cov_3.502591	129	205	14	2	76	0.0263158
NODE_179604_length_292_cov_3.502591	129	205	16	3	76	0.0394737
NODE_179604_length_292_cov_3.502591	129	205	18	14	76	0.1842105
NODE_179604_length_292_cov_3.502591	129	205	20	31	76	0.4078947
NODE_179613_length_292_cov_3.435233	176	200	0	24	24	1.0000000
NODE_179621_length_292_cov_3.341969	70	150	2	1	80	0.0125000
NODE_179621_length_292_cov_3.341969	70	150	4	24	80	0.3000000
NODE_179621_length_292_cov_3.341969	70	150	6	7	80	0.0875000
NODE_179621_length_292_cov_3.341969	70	150	8	48	80	0.6000000
NODE_179621_length_292_cov_3.341969	118	175	6	23	57	0.4035088
NODE_179621_length_292_cov_3.341969	118	175	8	34	57	0.5964912
NODE_179627_length_292_cov_3.222798	47	127	0	80	80	1.0000000
NODE_179627_length_292_cov_3.222798	100	129	0	29	29	1.0000000
NODE_179819_length_292_cov_2.238342	211	290	2	1	79	0.0126582
NODE_179819_length_292_cov_2.238342	211	290	8	78	79	0.9873418
NODE_179943_length_292_cov_1.865285	34	114	94	3	80	0.0375000
NODE_179943_length_292_cov_1.865285	34	114	103	1	80	0.0125000
NODE_179943_length_292_cov_1.865285	34	114	107	3	80	0.0375000
NODE_179943_length_292_cov_1.865285	34	114	111	2	80	0.0250000
NODE_179943_length_292_cov_1.865285	34	114	113	4	80	0.0500000
NODE_179943_length_292_cov_1.865285	34	114	115	2	80	0.0250000
NODE_179943_length_292_cov_1.865285	34	114	119	13	80	0.1625000
NODE_179943_length_292_cov_1.865285	34	114	121	1	80	0.0125000
NODE_179943_length_292_cov_1.865285	34	114	125	9	80	0.1125000
NODE_179943_length_292_cov_1.865285	34	114	127	6	80	0.0750000
NODE_179943_length_292_cov_1.865285	34	114	129	16	80	0.2000000
NODE_179943_length_292_cov_1.865285	34	114	130	9	80	0.1125000
NODE_179943_length_292_cov_1.865285	34	114	131	11	80	0.1375000
NODE_179943_length_292_cov_1.865285	87	167	5	2	80	0.0250000
NODE_179943_length_292_cov_1.865285	87	167	8	10	80	0.1250000
NODE_179943_length_292_cov_1.865285	87	167	9	6	80	0.0750000
NODE_179943_length_292_cov_1.865285	87	167	11	1	80	0.0125000
NODE_179943_length_292_cov_1.865285	87	167	12	3	80	0.0375000
NODE_179943_length_292_cov_1.865285	87	167	16	2	80	0.0250000
NODE_179943_length_292_cov_1.865285	87	167	23	1	80	0.0125000
NODE_179943_length_292_cov_1.865285	87	167	31	2	80	0.0250000
NODE_179943_length_292_cov_1.865285	87	167	35	2	80	0.0250000
NODE_179943_length_292_cov_1.865285	87	167	39	2	80	0.0250000
NODE_179943_length_292_cov_1.865285	87	167	43	1	80	0.0125000
NODE_179943_length_292_cov_1.865285	87	167	51	4	80	0.0500000
NODE_179943_length_292_cov_1.865285	87	167	55	1	80	0.0125000
NODE_179943_length_292_cov_1.865285	87	167	59	3	80	0.0375000
NODE_179943_length_292_cov_1.865285	87	167	61	1	80	0.0125000
NODE_179943_length_292_cov_1.865285	87	167	65	2	80	0.0250000
NODE_179943_length_292_cov_1.865285	87	167	69	1	80	0.0125000
NODE_179943_length_292_cov_1.865285	87	167	78	4	80	0.0500000
NODE_179943_length_292_cov_1.865285	87	167	80	4	80	0.0500000
NODE_179943_length_292_cov_1.865285	87	167	94	4	80	0.0500000
NODE_179943_length_292_cov_1.865285	87	167	103	1	80	0.0125000
NODE_179943_length_292_cov_1.865285	87	167	107	3	80	0.0375000
NODE_179943_length_292_cov_1.865285	87	167	111	2	80	0.0250000
NODE_179943_length_292_cov_1.865285	87	167	113	4	80	0.0500000
NODE_179943_length_292_cov_1.865285	87	167	115	2	80	0.0250000
NODE_179943_length_292_cov_1.865285	87	167	119	12	80	0.1500000
NODE_180013_length_292_cov_1.761658	174	254	0	80	80	1.0000000
NODE_180029_length_292_cov_1.699482	0	80	0	57	80	0.7125000
NODE_180029_length_292_cov_1.699482	0	80	2	17	80	0.2125000
NODE_180029_length_292_cov_1.699482	0	80	4	6	80	0.0750000
NODE_180068_length_292_cov_1.611399	89	157	0	68	68	1.0000000
NODE_180210_length_292_cov_1.455959	72	115	6	43	43	1.0000000
NODE_180210_length_292_cov_1.455959	203	265	6	35	62	0.5645161
NODE_180210_length_292_cov_1.455959	203	265	8	9	62	0.1451613
NODE_180210_length_292_cov_1.455959	203	265	10	18	62	0.2903226
NODE_180302_length_292_cov_1.321244	102	182	4	7	80	0.0875000
NODE_180302_length_292_cov_1.321244	102	182	6	23	80	0.2875000
NODE_180302_length_292_cov_1.321244	102	182	8	8	80	0.1000000
NODE_180302_length_292_cov_1.321244	102	182	10	2	80	0.0250000
NODE_180302_length_292_cov_1.321244	102	182	11	7	80	0.0875000
NODE_180302_length_292_cov_1.321244	102	182	12	1	80	0.0125000
NODE_180302_length_292_cov_1.321244	102	182	13	1	80	0.0125000
NODE_180302_length_292_cov_1.321244	102	182	14	31	80	0.3875000
NODE_180302_length_292_cov_1.321244	155	217	2	3	62	0.0483871
NODE_180302_length_292_cov_1.321244	155	217	4	39	62	0.6290323
NODE_180302_length_292_cov_1.321244	155	217	6	20	62	0.3225806
NODE_180968_length_291_cov_45.031250	71	145	0	74	74	1.0000000
NODE_180968_length_291_cov_45.031250	71	145	0	74	74	1.0000000
NODE_180968_length_291_cov_45.031250	118	184	0	66	66	1.0000000
NODE_180969_length_291_cov_14.791667	125	205	0	80	80	1.0000000
NODE_180969_length_291_cov_14.791667	178	258	0	80	80	1.0000000
NODE_180983_length_291_cov_5.536458	97	169	0	72	72	1.0000000
NODE_180986_length_291_cov_5.401042	77	130	0	5	53	0.0943396
NODE_180986_length_291_cov_5.401042	77	130	2	48	53	0.9056604
NODE_180998_length_291_cov_4.859375	185	257	2	72	72	1.0000000
NODE_181043_length_291_cov_3.723958	196	276	0	80	80	1.0000000
NODE_181057_length_291_cov_3.531250	129	152	0	19	23	0.8260869
NODE_181057_length_291_cov_3.531250	129	152	2	4	23	0.1739130
NODE_181191_length_291_cov_2.390625	18	80	0	61	62	0.9838710
NODE_181191_length_291_cov_2.390625	18	80	2	1	62	0.0161290
NODE_181272_length_291_cov_2.125000	70	117	0	47	47	1.0000000
NODE_181391_length_291_cov_1.859375	197	228	0	31	31	1.0000000
NODE_181497_length_291_cov_1.593750	144	175	0	31	31	1.0000000
NODE_181530_length_291_cov_1.593750	206	281	0	26	75	0.3466667
NODE_181530_length_291_cov_1.593750	206	281	2	17	75	0.2266667
NODE_181530_length_291_cov_1.593750	206	281	4	32	75	0.4266667
NODE_181599_length_291_cov_1.552083	189	269	2	3	80	0.0375000
NODE_181599_length_291_cov_1.552083	189	269	4	8	80	0.1000000
NODE_181599_length_291_cov_1.552083	189	269	6	17	80	0.2125000
NODE_181599_length_291_cov_1.552083	189	269	7	15	80	0.1875000
NODE_181599_length_291_cov_1.552083	189	269	8	37	80	0.4625000
NODE_181615_length_291_cov_1.520833	180	258	0	63	78	0.8076923
NODE_181615_length_291_cov_1.520833	180	258	2	15	78	0.1923077
NODE_181623_length_291_cov_1.510417	245	291	0	46	46	1.0000000
NODE_181696_length_291_cov_1.385417	80	120	4	40	40	1.0000000
NODE_181791_length_291_cov_1.322917	70	96	2	3	26	0.1153846
NODE_181791_length_291_cov_1.322917	70	96	4	23	26	0.8846154
NODE_181799_length_291_cov_1.307292	108	188	2	3	80	0.0375000
NODE_181799_length_291_cov_1.307292	108	188	3	7	80	0.0875000
NODE_181799_length_291_cov_1.307292	108	188	4	1	80	0.0125000
NODE_181799_length_291_cov_1.307292	108	188	5	25	80	0.3125000
NODE_181799_length_291_cov_1.307292	108	188	6	1	80	0.0125000
NODE_181799_length_291_cov_1.307292	108	188	8	8	80	0.1000000
NODE_181799_length_291_cov_1.307292	108	188	9	4	80	0.0500000
NODE_181799_length_291_cov_1.307292	108	188	10	1	80	0.0125000
NODE_181799_length_291_cov_1.307292	108	188	11	2	80	0.0250000
NODE_181799_length_291_cov_1.307292	108	188	15	24	80	0.3000000
NODE_181799_length_291_cov_1.307292	108	188	17	4	80	0.0500000
NODE_181907_length_291_cov_1.114583	79	174	14	3	95	0.0315789
NODE_181907_length_291_cov_1.114583	79	174	18	2	95	0.0210526
NODE_181907_length_291_cov_1.114583	79	174	20	4	95	0.0421053
NODE_181907_length_291_cov_1.114583	79	174	24	1	95	0.0105263
NODE_181907_length_291_cov_1.114583	79	174	26	1	95	0.0105263
NODE_181907_length_291_cov_1.114583	79	174	27	2	95	0.0210526
NODE_181907_length_291_cov_1.114583	79	174	28	7	95	0.0736842
NODE_181907_length_291_cov_1.114583	79	174	29	2	95	0.0210526
NODE_181907_length_291_cov_1.114583	79	174	30	2	95	0.0210526
NODE_181907_length_291_cov_1.114583	79	174	31	10	95	0.1052632
NODE_181907_length_291_cov_1.114583	79	174	32	10	95	0.1052632
NODE_181907_length_291_cov_1.114583	79	174	33	9	95	0.0947368
NODE_181907_length_291_cov_1.114583	79	174	34	6	95	0.0631579
NODE_181907_length_291_cov_1.114583	79	174	35	36	95	0.3789474
NODE_181930_length_291_cov_1.078125	4	85	0	42	81	0.5185185
NODE_181930_length_291_cov_1.078125	4	85	2	10	81	0.1234568
NODE_181930_length_291_cov_1.078125	4	85	4	16	81	0.1975309
NODE_181930_length_291_cov_1.078125	4	85	6	10	81	0.1234568
NODE_181930_length_291_cov_1.078125	4	85	8	3	81	0.0370370
NODE_182112_length_291_cov_1.031250	5	50	0	45	45	1.0000000
NODE_182205_length_291_cov_0.890625	0	55	0	55	55	1.0000000
NODE_182252_length_291_cov_0.802083	80	160	0	8	80	0.1000000
NODE_182252_length_291_cov_0.802083	80	160	2	22	80	0.2750000
NODE_182252_length_291_cov_0.802083	80	160	4	6	80	0.0750000
NODE_182252_length_291_cov_0.802083	80	160	6	15	80	0.1875000
NODE_182252_length_291_cov_0.802083	80	160	8	29	80	0.3625000
NODE_182491_length_290_cov_96.963351	44	124	0	47	80	0.5875000
NODE_182491_length_290_cov_96.963351	44	124	2	33	80	0.4125000
NODE_182491_length_290_cov_96.963351	97	177	2	46	80	0.5750000
NODE_182491_length_290_cov_96.963351	97	177	4	34	80	0.4250000
NODE_182512_length_290_cov_5.968586	89	150	0	29	61	0.4754098
NODE_182512_length_290_cov_5.968586	89	150	2	11	61	0.1803279
NODE_182512_length_290_cov_5.968586	89	150	4	7	61	0.1147541
NODE_182512_length_290_cov_5.968586	89	150	7	1	61	0.0163934
NODE_182512_length_290_cov_5.968586	89	150	8	6	61	0.0983607
NODE_182512_length_290_cov_5.968586	89	150	9	4	61	0.0655738
NODE_182512_length_290_cov_5.968586	89	150	11	3	61	0.0491803
NODE_182512_length_290_cov_5.968586	142	203	8	1	61	0.0163934
NODE_182512_length_290_cov_5.968586	142	203	9	4	61	0.0655738
NODE_182512_length_290_cov_5.968586	142	203	11	25	61	0.4098361
NODE_182512_length_290_cov_5.968586	142	203	15	1	61	0.0163934
NODE_182512_length_290_cov_5.968586	142	203	21	10	61	0.1639344
NODE_182512_length_290_cov_5.968586	142	203	23	20	61	0.3278688
NODE_182535_length_290_cov_4.968586	32	52	0	11	20	0.5500000
NODE_182535_length_290_cov_4.968586	32	52	2	9	20	0.4500000
NODE_182535_length_290_cov_4.968586	73	93	2	20	20	1.0000000
NODE_182547_length_290_cov_4.670157	63	139	0	10	76	0.1315790
NODE_182547_length_290_cov_4.670157	63	139	4	66	76	0.8684211
NODE_182550_length_290_cov_4.575916	110	153	2	43	43	1.0000000
NODE_182589_length_290_cov_3.816754	113	186	0	37	73	0.5068493
NODE_182589_length_290_cov_3.816754	113	186	2	36	73	0.4931507
NODE_182607_length_290_cov_3.612565	114	181	0	5	67	0.0746269
NODE_182607_length_290_cov_3.612565	114	181	1	25	67	0.3731343
NODE_182607_length_290_cov_3.612565	114	181	2	37	67	0.5522388
NODE_182622_length_290_cov_3.445026	91	150	0	59	59	1.0000000
NODE_182772_length_290_cov_2.596859	189	218	4	12	29	0.4137931
NODE_182772_length_290_cov_2.596859	189	218	8	17	29	0.5862069
NODE_182844_length_290_cov_2.319372	45	74	0	29	29	1.0000000
NODE_182973_length_290_cov_2.041885	59	139	0	6	80	0.0750000
NODE_182973_length_290_cov_2.041885	59	139	2	74	80	0.9250000
NODE_182995_length_290_cov_1.979058	229	271	14	6	42	0.1428571
NODE_182995_length_290_cov_1.979058	229	271	16	16	42	0.3809524
NODE_182995_length_290_cov_1.979058	229	271	17	1	42	0.0238095
NODE_182995_length_290_cov_1.979058	229	271	19	5	42	0.1190476
NODE_182995_length_290_cov_1.979058	229	271	20	6	42	0.1428571
NODE_182995_length_290_cov_1.979058	229	271	22	2	42	0.0476190
NODE_182995_length_290_cov_1.979058	229	271	24	3	42	0.0714286
NODE_182995_length_290_cov_1.979058	229	271	25	3	42	0.0714286
NODE_183288_length_290_cov_1.602094	16	68	0	52	52	1.0000000
NODE_183347_length_290_cov_1.575916	173	250	0	77	77	1.0000000
NODE_183373_length_290_cov_1.544503	151	203	2	17	52	0.3269231
NODE_183373_length_290_cov_1.544503	151	203	3	6	52	0.1153846
NODE_183373_length_290_cov_1.544503	151	203	6	29	52	0.5576923
NODE_183403_length_290_cov_1.513089	22	107	0	85	85	1.0000000
NODE_183436_length_290_cov_1.460733	11	91	2	1	80	0.0125000
NODE_183436_length_290_cov_1.460733	11	91	4	34	80	0.4250000
NODE_183436_length_290_cov_1.460733	11	91	6	45	80	0.5625000
NODE_183546_length_290_cov_1.335079	91	163	0	40	72	0.5555556
NODE_183546_length_290_cov_1.335079	91	163	2	32	72	0.4444444
NODE_183546_length_290_cov_1.335079	144	216	0	15	72	0.2083333
NODE_183546_length_290_cov_1.335079	144	216	2	57	72	0.7916667
NODE_183642_length_290_cov_1.314136	0	80	0	80	80	1.0000000
NODE_183663_length_290_cov_1.287958	17	97	0	80	80	1.0000000
NODE_183946_length_290_cov_1.068063	0	60	0	60	60	1.0000000
NODE_183946_length_290_cov_1.068063	33	113	0	80	80	1.0000000
NODE_184119_length_290_cov_1.000000	198	254	2	56	56	1.0000000
NODE_184326_length_290_cov_0.832461	154	236	0	82	82	1.0000000
NODE_184585_length_290_cov_0.701571	201	281	0	80	80	1.0000000
NODE_184716_length_289_cov_554.947368	45	125	761	1	80	0.0125000
NODE_184716_length_289_cov_554.947368	45	125	786	1	80	0.0125000
NODE_184716_length_289_cov_554.947368	45	125	793	1	80	0.0125000
NODE_184716_length_289_cov_554.947368	45	125	797	1	80	0.0125000
NODE_184716_length_289_cov_554.947368	45	125	823	1	80	0.0125000
NODE_184716_length_289_cov_554.947368	45	125	841	1	80	0.0125000
NODE_184716_length_289_cov_554.947368	45	125	854	1	80	0.0125000
NODE_184716_length_289_cov_554.947368	45	125	857	1	80	0.0125000
NODE_184716_length_289_cov_554.947368	45	125	861	1	80	0.0125000
NODE_184716_length_289_cov_554.947368	45	125	873	1	80	0.0125000
NODE_184716_length_289_cov_554.947368	45	125	877	1	80	0.0125000
NODE_184716_length_289_cov_554.947368	45	125	879	2	80	0.0250000
NODE_184716_length_289_cov_554.947368	45	125	880	1	80	0.0125000
NODE_184716_length_289_cov_554.947368	45	125	881	1	80	0.0125000
NODE_184716_length_289_cov_554.947368	45	125	884	1	80	0.0125000
NODE_184716_length_289_cov_554.947368	45	125	894	1	80	0.0125000
NODE_184716_length_289_cov_554.947368	45	125	896	1	80	0.0125000
NODE_184716_length_289_cov_554.947368	45	125	897	1	80	0.0125000
NODE_184716_length_289_cov_554.947368	45	125	903	2	80	0.0250000
NODE_184716_length_289_cov_554.947368	45	125	909	1	80	0.0125000
NODE_184716_length_289_cov_554.947368	45	125	912	1	80	0.0125000
NODE_184716_length_289_cov_554.947368	45	125	914	1	80	0.0125000
NODE_184716_length_289_cov_554.947368	45	125	916	1	80	0.0125000
NODE_184716_length_289_cov_554.947368	45	125	924	1	80	0.0125000
NODE_184716_length_289_cov_554.947368	45	125	925	1	80	0.0125000
NODE_184716_length_289_cov_554.947368	45	125	926	1	80	0.0125000
NODE_184716_length_289_cov_554.947368	45	125	934	1	80	0.0125000
NODE_184716_length_289_cov_554.947368	45	125	935	1	80	0.0125000
NODE_184716_length_289_cov_554.947368	45	125	936	2	80	0.0250000
NODE_184716_length_289_cov_554.947368	45	125	939	1	80	0.0125000
NODE_184716_length_289_cov_554.947368	45	125	949	2	80	0.0250000
NODE_184716_length_289_cov_554.947368	45	125	951	1	80	0.0125000
NODE_184716_length_289_cov_554.947368	45	125	952	1	80	0.0125000
NODE_184716_length_289_cov_554.947368	45	125	954	2	80	0.0250000
NODE_184716_length_289_cov_554.947368	45	125	958	1	80	0.0125000
NODE_184716_length_289_cov_554.947368	45	125	959	3	80	0.0375000
NODE_184716_length_289_cov_554.947368	45	125	961	2	80	0.0250000
NODE_184716_length_289_cov_554.947368	45	125	970	4	80	0.0500000
NODE_184716_length_289_cov_554.947368	45	125	971	1	80	0.0125000
NODE_184716_length_289_cov_554.947368	45	125	972	1	80	0.0125000
NODE_184716_length_289_cov_554.947368	45	125	974	6	80	0.0750000
NODE_184716_length_289_cov_554.947368	45	125	976	3	80	0.0375000
NODE_184716_length_289_cov_554.947368	45	125	980	1	80	0.0125000
NODE_184716_length_289_cov_554.947368	45	125	982	1	80	0.0125000
NODE_184716_length_289_cov_554.947368	45	125	986	1	80	0.0125000
NODE_184716_length_289_cov_554.947368	45	125	988	5	80	0.0625000
NODE_184716_length_289_cov_554.947368	45	125	991	3	80	0.0375000
NODE_184716_length_289_cov_554.947368	45	125	993	1	80	0.0125000
NODE_184716_length_289_cov_554.947368	45	125	995	3	80	0.0375000
NODE_184716_length_289_cov_554.947368	45	125	997	2	80	0.0250000
NODE_184716_length_289_cov_554.947368	45	125	998	1	80	0.0125000
NODE_184716_length_289_cov_554.947368	45	125	999	1	80	0.0125000
NODE_184716_length_289_cov_554.947368	45	125	1000	1	80	0.0125000
NODE_184729_length_289_cov_7.436842	181	229	6	48	48	1.0000000
NODE_184745_length_289_cov_5.789474	35	100	2	65	65	1.0000000
NODE_184745_length_289_cov_5.789474	85	153	0	11	68	0.1617647
NODE_184745_length_289_cov_5.789474	85	153	2	57	68	0.8382353
NODE_184745_length_289_cov_5.789474	146	181	0	34	35	0.9714286
NODE_184745_length_289_cov_5.789474	146	181	2	1	35	0.0285714
NODE_184781_length_289_cov_4.515789	192	254	0	62	62	1.0000000
NODE_184806_length_289_cov_4.136842	101	148	0	47	47	1.0000000
NODE_184892_length_289_cov_2.973684	38	83	0	45	45	1.0000000
NODE_184960_length_289_cov_2.678947	105	168	4	6	63	0.0952381
NODE_184960_length_289_cov_2.678947	105	168	6	11	63	0.1746032
NODE_184960_length_289_cov_2.678947	105	168	8	3	63	0.0476190
NODE_184960_length_289_cov_2.678947	105	168	12	25	63	0.3968254
NODE_184960_length_289_cov_2.678947	105	168	13	12	63	0.1904762
NODE_184960_length_289_cov_2.678947	105	168	14	6	63	0.0952381
NODE_184960_length_289_cov_2.678947	158	204	12	38	46	0.8260869
NODE_184960_length_289_cov_2.678947	158	204	14	8	46	0.1739130
NODE_184963_length_289_cov_2.673684	216	263	0	47	47	1.0000000
NODE_185036_length_289_cov_2.378947	233	289	0	56	56	1.0000000
NODE_185152_length_289_cov_2.089474	26	91	0	65	65	1.0000000
NODE_185213_length_289_cov_1.921053	0	54	2	54	54	1.0000000
NODE_185383_length_289_cov_1.642105	58	123	0	65	65	1.0000000
NODE_185570_length_289_cov_1.547368	81	124	0	43	43	1.0000000
NODE_185617_length_289_cov_1.489474	192	274	0	13	82	0.1585366
NODE_185617_length_289_cov_1.489474	192	274	2	69	82	0.8414634
NODE_185622_length_289_cov_1.484211	50	69	0	19	19	1.0000000
NODE_185708_length_289_cov_1.357895	31	74	0	41	43	0.9534883
NODE_185708_length_289_cov_1.357895	31	74	2	2	43	0.0465116
NODE_185852_length_289_cov_1.278947	239	270	0	31	31	1.0000000
NODE_185864_length_289_cov_1.252632	23	66	2	43	43	1.0000000
NODE_185926_length_289_cov_1.168421	40	100	0	60	60	1.0000000
NODE_185937_length_289_cov_1.152632	0	50	0	50	50	1.0000000
NODE_185937_length_289_cov_1.152632	41	103	0	62	62	1.0000000
NODE_186095_length_289_cov_1.073684	152	198	4	7	46	0.1521739
NODE_186095_length_289_cov_1.073684	152	198	6	12	46	0.2608696
NODE_186095_length_289_cov_1.073684	152	198	8	27	46	0.5869565
NODE_186491_length_289_cov_0.878947	113	193	0	1	80	0.0125000
NODE_186491_length_289_cov_0.878947	113	193	4	6	80	0.0750000
NODE_186491_length_289_cov_0.878947	113	193	6	11	80	0.1375000
NODE_186491_length_289_cov_0.878947	113	193	8	12	80	0.1500000
NODE_186491_length_289_cov_0.878947	113	193	10	2	80	0.0250000
NODE_186491_length_289_cov_0.878947	113	193	12	48	80	0.6000000
NODE_186491_length_289_cov_0.878947	166	246	0	13	80	0.1625000
NODE_186491_length_289_cov_0.878947	166	246	1	1	80	0.0125000
NODE_186491_length_289_cov_0.878947	166	246	5	1	80	0.0125000
NODE_186491_length_289_cov_0.878947	166	246	6	1	80	0.0125000
NODE_186491_length_289_cov_0.878947	166	246	8	1	80	0.0125000
NODE_186491_length_289_cov_0.878947	166	246	10	5	80	0.0625000
NODE_186491_length_289_cov_0.878947	166	246	12	58	80	0.7250000
NODE_186507_length_289_cov_0.863158	116	211	0	8	95	0.0842105
NODE_186507_length_289_cov_0.863158	116	211	2	1	95	0.0105263
NODE_186507_length_289_cov_0.863158	116	211	4	7	95	0.0736842
NODE_186507_length_289_cov_0.863158	116	211	6	10	95	0.1052632
NODE_186507_length_289_cov_0.863158	116	211	8	10	95	0.1052632
NODE_186507_length_289_cov_0.863158	116	211	10	12	95	0.1263158
NODE_186507_length_289_cov_0.863158	116	211	12	23	95	0.2421053
NODE_186507_length_289_cov_0.863158	116	211	14	4	95	0.0421053
NODE_186507_length_289_cov_0.863158	116	211	16	20	95	0.2105263
NODE_186515_length_289_cov_0.857895	6	75	0	69	69	1.0000000
NODE_186547_length_289_cov_0.831579	230	289	0	1	59	0.0169492
NODE_186547_length_289_cov_0.831579	230	289	1	6	59	0.1016949
NODE_186547_length_289_cov_0.831579	230	289	3	8	59	0.1355932
NODE_186547_length_289_cov_0.831579	230	289	4	12	59	0.2033898
NODE_186547_length_289_cov_0.831579	230	289	5	9	59	0.1525424
NODE_186547_length_289_cov_0.831579	230	289	7	16	59	0.2711864
NODE_186547_length_289_cov_0.831579	230	289	8	2	59	0.0338983
NODE_186547_length_289_cov_0.831579	230	289	10	2	59	0.0338983
NODE_186547_length_289_cov_0.831579	230	289	11	2	59	0.0338983
NODE_186547_length_289_cov_0.831579	230	289	15	1	59	0.0169492
NODE_186631_length_289_cov_0.805263	98	159	0	61	61	1.0000000
NODE_186865_length_289_cov_0.568421	141	213	0	72	72	1.0000000
NODE_186934_length_288_cov_11.089947	135	195	6	4	60	0.0666667
NODE_186934_length_288_cov_11.089947	135	195	14	4	60	0.0666667
NODE_186934_length_288_cov_11.089947	135	195	18	35	60	0.5833333
NODE_186934_length_288_cov_11.089947	135	195	20	17	60	0.2833333
NODE_187025_length_288_cov_3.587302	108	188	0	5	80	0.0625000
NODE_187025_length_288_cov_3.587302	108	188	2	16	80	0.2000000
NODE_187025_length_288_cov_3.587302	108	188	3	12	80	0.1500000
NODE_187025_length_288_cov_3.587302	108	188	4	47	80	0.5875000
NODE_187049_length_288_cov_3.296296	61	125	0	32	64	0.5000000
NODE_187049_length_288_cov_3.296296	61	125	2	32	64	0.5000000
NODE_187049_length_288_cov_3.296296	102	178	0	2	76	0.0263158
NODE_187049_length_288_cov_3.296296	102	178	2	74	76	0.9736842
NODE_187062_length_288_cov_3.206349	149	202	2	53	53	1.0000000
NODE_187170_length_288_cov_2.539683	4	68	2	64	64	1.0000000
NODE_187187_length_288_cov_2.465608	137	182	0	38	45	0.8444445
NODE_187187_length_288_cov_2.465608	137	182	1	7	45	0.1555556
NODE_187191_length_288_cov_2.449735	216	278	0	5	62	0.0806452
NODE_187191_length_288_cov_2.449735	216	278	2	57	62	0.9193549
NODE_187191_length_288_cov_2.449735	237	273	2	36	36	1.0000000
NODE_187248_length_288_cov_2.275132	10	46	14	36	36	1.0000000
NODE_187248_length_288_cov_2.275132	13	86	14	73	73	1.0000000
NODE_187248_length_288_cov_2.275132	47	100	0	1	53	0.0188679
NODE_187248_length_288_cov_2.275132	47	100	2	2	53	0.0377358
NODE_187248_length_288_cov_2.275132	47	100	6	5	53	0.0943396
NODE_187248_length_288_cov_2.275132	47	100	10	1	53	0.0188679
NODE_187248_length_288_cov_2.275132	47	100	14	44	53	0.8301887
NODE_187318_length_288_cov_2.153439	50	81	0	31	31	1.0000000
NODE_187431_length_288_cov_1.915344	0	75	0	75	75	1.0000000
NODE_187443_length_288_cov_1.888889	49	125	2	39	76	0.5131579
NODE_187443_length_288_cov_1.888889	49	125	4	23	76	0.3026316
NODE_187443_length_288_cov_1.888889	49	125	8	14	76	0.1842105
NODE_187484_length_288_cov_1.878307	0	42	0	42	42	1.0000000
NODE_187484_length_288_cov_1.878307	15	63	0	48	48	1.0000000
NODE_187810_length_288_cov_1.492063	0	42	0	42	42	1.0000000
NODE_188135_length_288_cov_1.158730	213	288	0	75	75	1.0000000
NODE_188161_length_288_cov_1.100529	256	288	0	28	32	0.8750000
NODE_188161_length_288_cov_1.100529	256	288	2	4	32	0.1250000
NODE_188169_length_288_cov_1.079365	10	74	0	52	64	0.8125000
NODE_188169_length_288_cov_1.079365	10	74	2	12	64	0.1875000
NODE_188169_length_288_cov_1.079365	65	110	2	45	45	1.0000000
NODE_188760_length_288_cov_0.809524	141	170	2	29	29	1.0000000
NODE_189068_length_287_cov_7.632979	117	184	40	1	67	0.0149254
NODE_189068_length_287_cov_7.632979	117	184	42	2	67	0.0298507
NODE_189068_length_287_cov_7.632979	117	184	44	2	67	0.0298507
NODE_189068_length_287_cov_7.632979	117	184	46	9	67	0.1343284
NODE_189068_length_287_cov_7.632979	117	184	48	53	67	0.7910448
NODE_189079_length_287_cov_6.510638	20	100	0	80	80	1.0000000
NODE_189097_length_287_cov_5.781915	164	246	0	82	82	1.0000000
NODE_189182_length_287_cov_3.590426	114	194	0	80	80	1.0000000
NODE_189192_length_287_cov_3.452128	0	52	2	52	52	1.0000000
NODE_189208_length_287_cov_3.281915	263	286	2	23	23	1.0000000
NODE_189266_length_287_cov_2.936170	41	110	2	69	69	1.0000000
NODE_189266_length_287_cov_2.936170	41	111	2	70	70	1.0000000
NODE_189266_length_287_cov_2.936170	94	167	0	56	73	0.7671233
NODE_189266_length_287_cov_2.936170	94	167	2	17	73	0.2328767
NODE_189266_length_287_cov_2.936170	156	179	0	23	23	1.0000000
NODE_189330_length_287_cov_2.638298	22	86	2	64	64	1.0000000
NODE_189381_length_287_cov_2.436170	182	262	0	80	80	1.0000000
NODE_189582_length_287_cov_1.984043	137	166	16	19	29	0.6551724
NODE_189582_length_287_cov_1.984043	137	166	18	10	29	0.3448276
NODE_189594_length_287_cov_1.941489	56	123	0	53	67	0.7910448
NODE_189594_length_287_cov_1.941489	56	123	2	14	67	0.2089552
NODE_189614_length_287_cov_1.904255	8	51	0	43	43	1.0000000
NODE_189710_length_287_cov_1.803191	146	217	0	71	71	1.0000000
NODE_189843_length_287_cov_1.627660	113	175	31	1	62	0.0161290
NODE_189843_length_287_cov_1.627660	113	175	32	3	62	0.0483871
NODE_189843_length_287_cov_1.627660	113	175	34	23	62	0.3709677
NODE_189843_length_287_cov_1.627660	113	175	36	4	62	0.0645161
NODE_189843_length_287_cov_1.627660	113	175	38	14	62	0.2258064
NODE_189843_length_287_cov_1.627660	113	175	40	6	62	0.0967742
NODE_189843_length_287_cov_1.627660	113	175	42	7	62	0.1129032
NODE_189843_length_287_cov_1.627660	113	175	43	2	62	0.0322581
NODE_189843_length_287_cov_1.627660	113	175	44	2	62	0.0322581
NODE_189843_length_287_cov_1.627660	148	228	32	44	80	0.5500000
NODE_189843_length_287_cov_1.627660	148	228	34	11	80	0.1375000
NODE_189843_length_287_cov_1.627660	148	228	38	17	80	0.2125000
NODE_189843_length_287_cov_1.627660	148	228	40	3	80	0.0375000
NODE_189843_length_287_cov_1.627660	148	228	42	5	80	0.0625000
NODE_189864_length_287_cov_1.627660	14	59	0	45	45	1.0000000
NODE_189864_length_287_cov_1.627660	41	112	0	71	71	1.0000000
NODE_189949_length_287_cov_1.574468	150	220	4	11	70	0.1571429
NODE_189949_length_287_cov_1.574468	150	220	6	1	70	0.0142857
NODE_189949_length_287_cov_1.574468	150	220	8	58	70	0.8285714
NODE_189985_length_287_cov_1.531915	123	154	0	31	31	1.0000000
NODE_190122_length_287_cov_1.356383	93	147	0	54	54	1.0000000
NODE_190142_length_287_cov_1.356383	135	199	0	9	64	0.1406250
NODE_190142_length_287_cov_1.356383	135	199	2	55	64	0.8593750
NODE_190189_length_287_cov_1.335106	149	201	0	52	52	1.0000000
NODE_190654_length_287_cov_1.037234	23	44	0	21	21	1.0000000
NODE_190701_length_287_cov_0.994681	206	225	0	19	19	1.0000000
NODE_190802_length_287_cov_0.898936	0	57	0	1	57	0.0175439
NODE_190802_length_287_cov_0.898936	0	57	2	17	57	0.2982456
NODE_190802_length_287_cov_0.898936	0	57	3	5	57	0.0877193
NODE_190802_length_287_cov_0.898936	0	57	5	3	57	0.0526316
NODE_190802_length_287_cov_0.898936	0	57	8	3	57	0.0526316
NODE_190802_length_287_cov_0.898936	0	57	9	1	57	0.0175439
NODE_190802_length_287_cov_0.898936	0	57	10	5	57	0.0877193
NODE_190802_length_287_cov_0.898936	0	57	12	11	57	0.1929825
NODE_190802_length_287_cov_0.898936	0	57	16	2	57	0.0350877
NODE_190802_length_287_cov_0.898936	0	57	20	4	57	0.0701754
NODE_190802_length_287_cov_0.898936	0	57	22	3	57	0.0526316
NODE_190802_length_287_cov_0.898936	0	57	24	2	57	0.0350877
NODE_190873_length_287_cov_0.840426	46	121	0	75	75	1.0000000
NODE_191306_length_286_cov_141.540107	4	63	0	59	59	1.0000000
NODE_191389_length_286_cov_3.935829	79	123	0	44	44	1.0000000
NODE_191391_length_286_cov_3.871658	45	121	1	13	76	0.1710526
NODE_191391_length_286_cov_3.871658	45	121	2	15	76	0.1973684
NODE_191391_length_286_cov_3.871658	45	121	3	48	76	0.6315789
NODE_191391_length_286_cov_3.871658	102	169	1	59	67	0.8805970
NODE_191391_length_286_cov_3.871658	102	169	3	8	67	0.1194030
NODE_191393_length_286_cov_3.812834	62	142	6	3	80	0.0375000
NODE_191393_length_286_cov_3.812834	62	142	8	77	80	0.9625000
NODE_191430_length_286_cov_3.352941	63	143	0	80	80	1.0000000
NODE_191430_length_286_cov_3.352941	116	196	0	80	80	1.0000000
NODE_191466_length_286_cov_3.101604	217	271	4	54	54	1.0000000
NODE_191509_length_286_cov_2.823529	56	122	12	4	66	0.0606061
NODE_191509_length_286_cov_2.823529	56	122	14	5	66	0.0757576
NODE_191509_length_286_cov_2.823529	56	122	17	1	66	0.0151515
NODE_191509_length_286_cov_2.823529	56	122	19	3	66	0.0454545
NODE_191509_length_286_cov_2.823529	56	122	23	1	66	0.0151515
NODE_191509_length_286_cov_2.823529	56	122	25	4	66	0.0606061
NODE_191509_length_286_cov_2.823529	56	122	27	2	66	0.0303030
NODE_191509_length_286_cov_2.823529	56	122	31	1	66	0.0151515
NODE_191509_length_286_cov_2.823529	56	122	44	1	66	0.0151515
NODE_191509_length_286_cov_2.823529	56	122	47	1	66	0.0151515
NODE_191509_length_286_cov_2.823529	56	122	49	1	66	0.0151515
NODE_191509_length_286_cov_2.823529	56	122	54	1	66	0.0151515
NODE_191509_length_286_cov_2.823529	56	122	61	1	66	0.0151515
NODE_191509_length_286_cov_2.823529	56	122	69	1	66	0.0151515
NODE_191509_length_286_cov_2.823529	56	122	71	2	66	0.0303030
NODE_191509_length_286_cov_2.823529	56	122	75	1	66	0.0151515
NODE_191509_length_286_cov_2.823529	56	122	79	2	66	0.0303030
NODE_191509_length_286_cov_2.823529	56	122	83	1	66	0.0151515
NODE_191509_length_286_cov_2.823529	56	122	85	2	66	0.0303030
NODE_191509_length_286_cov_2.823529	56	122	89	5	66	0.0757576
NODE_191509_length_286_cov_2.823529	56	122	99	2	66	0.0303030
NODE_191509_length_286_cov_2.823529	56	122	103	6	66	0.0909091
NODE_191509_length_286_cov_2.823529	56	122	109	1	66	0.0151515
NODE_191509_length_286_cov_2.823529	56	122	111	3	66	0.0454545
NODE_191509_length_286_cov_2.823529	56	122	115	1	66	0.0151515
NODE_191509_length_286_cov_2.823529	56	122	117	1	66	0.0151515
NODE_191509_length_286_cov_2.823529	56	122	125	5	66	0.0757576
NODE_191509_length_286_cov_2.823529	56	122	127	6	66	0.0909091
NODE_191509_length_286_cov_2.823529	56	122	129	1	66	0.0151515
NODE_191598_length_286_cov_2.438503	151	218	0	45	67	0.6716418
NODE_191598_length_286_cov_2.438503	151	218	2	22	67	0.3283582
NODE_191754_length_286_cov_2.037433	57	138	0	1	81	0.0123457
NODE_191754_length_286_cov_2.037433	57	138	2	1	81	0.0123457
NODE_191754_length_286_cov_2.037433	57	138	5	3	81	0.0370370
NODE_191754_length_286_cov_2.037433	57	138	7	3	81	0.0370370
NODE_191754_length_286_cov_2.037433	57	138	8	4	81	0.0493827
NODE_191754_length_286_cov_2.037433	57	138	9	2	81	0.0246914
NODE_191754_length_286_cov_2.037433	57	138	10	67	81	0.8271605
NODE_191892_length_286_cov_1.807487	186	232	2	14	46	0.3043478
NODE_191892_length_286_cov_1.807487	186	232	4	32	46	0.6956522
NODE_191892_length_286_cov_1.807487	239	285	2	41	46	0.8913044
NODE_191892_length_286_cov_1.807487	239	285	4	5	46	0.1086956
NODE_192100_length_286_cov_1.566845	112	160	0	5	48	0.1041667
NODE_192100_length_286_cov_1.566845	112	160	1	43	48	0.8958333
NODE_192100_length_286_cov_1.566845	165	213	1	48	48	1.0000000
NODE_192150_length_286_cov_1.497326	107	160	0	53	53	1.0000000
NODE_192233_length_286_cov_1.363636	20	87	4	11	67	0.1641791
NODE_192233_length_286_cov_1.363636	20	87	6	51	67	0.7611941
NODE_192233_length_286_cov_1.363636	20	87	8	5	67	0.0746269
NODE_192302_length_286_cov_1.358289	218	262	0	44	44	1.0000000
NODE_192357_length_286_cov_1.304813	147	205	0	58	58	1.0000000
NODE_192427_length_286_cov_1.203209	30	76	2	46	46	1.0000000
NODE_192427_length_286_cov_1.203209	49	129	0	53	80	0.6625000
NODE_192427_length_286_cov_1.203209	49	129	2	27	80	0.3375000
NODE_192757_length_286_cov_1.074866	160	220	0	60	60	1.0000000
NODE_193023_length_286_cov_0.871658	218	279	0	61	61	1.0000000
NODE_193038_length_286_cov_0.855615	224	281	0	18	57	0.3157895
NODE_193038_length_286_cov_0.855615	224	281	1	18	57	0.3157895
NODE_193038_length_286_cov_0.855615	224	281	2	18	57	0.3157895
NODE_193038_length_286_cov_0.855615	224	281	4	3	57	0.0526316
NODE_193362_length_286_cov_0.625668	110	190	0	80	80	1.0000000
NODE_193362_length_286_cov_0.625668	163	240	0	77	77	1.0000000
NODE_193481_length_285_cov_7.392473	91	152	0	61	61	1.0000000
NODE_193481_length_285_cov_7.392473	150	184	0	34	34	1.0000000
NODE_193513_length_285_cov_4.650538	0	74	0	74	74	1.0000000
NODE_193513_length_285_cov_4.650538	47	127	0	80	80	1.0000000
NODE_193513_length_285_cov_4.650538	123	203	0	80	80	1.0000000
NODE_193513_length_285_cov_4.650538	176	256	0	80	80	1.0000000
NODE_193532_length_285_cov_4.091398	91	154	1	6	63	0.0952381
NODE_193532_length_285_cov_4.091398	91	154	3	5	63	0.0793651
NODE_193532_length_285_cov_4.091398	91	154	5	52	63	0.8253968
NODE_193538_length_285_cov_4.010753	120	201	0	62	81	0.7654321
NODE_193538_length_285_cov_4.010753	120	201	2	19	81	0.2345679
NODE_193547_length_285_cov_3.854839	97	151	0	54	54	1.0000000
NODE_193547_length_285_cov_3.854839	106	153	0	47	47	1.0000000
NODE_193566_length_285_cov_3.607527	197	258	0	26	61	0.4262295
NODE_193566_length_285_cov_3.607527	197	258	1	9	61	0.1475410
NODE_193566_length_285_cov_3.607527	197	258	2	2	61	0.0327869
NODE_193566_length_285_cov_3.607527	197	258	6	1	61	0.0163934
NODE_193566_length_285_cov_3.607527	197	258	11	2	61	0.0327869
NODE_193566_length_285_cov_3.607527	197	258	19	4	61	0.0655738
NODE_193566_length_285_cov_3.607527	197	258	23	2	61	0.0327869
NODE_193566_length_285_cov_3.607527	197	258	24	3	61	0.0491803
NODE_193566_length_285_cov_3.607527	197	258	26	1	61	0.0163934
NODE_193566_length_285_cov_3.607527	197	258	28	1	61	0.0163934
NODE_193566_length_285_cov_3.607527	197	258	30	5	61	0.0819672
NODE_193566_length_285_cov_3.607527	197	258	32	2	61	0.0327869
NODE_193566_length_285_cov_3.607527	197	258	34	3	61	0.0491803
NODE_193624_length_285_cov_3.037634	190	272	0	82	82	1.0000000
NODE_193660_length_285_cov_2.806452	215	279	0	64	64	1.0000000
NODE_193688_length_285_cov_2.736559	106	173	0	9	67	0.1343284
NODE_193688_length_285_cov_2.736559	106	173	2	58	67	0.8656716
NODE_193784_length_285_cov_2.311828	220	262	0	42	42	1.0000000
NODE_193883_length_285_cov_2.043011	77	150	0	15	73	0.2054795
NODE_193883_length_285_cov_2.043011	77	150	4	58	73	0.7945206
NODE_193883_length_285_cov_2.043011	155	197	4	42	42	1.0000000
NODE_193978_length_285_cov_1.876344	67	110	0	43	43	1.0000000
NODE_194150_length_285_cov_1.645161	112	160	0	48	48	1.0000000
NODE_194260_length_285_cov_1.548387	124	172	0	48	48	1.0000000
NODE_194332_length_285_cov_1.456989	210	277	2	31	67	0.4626866
NODE_194332_length_285_cov_1.456989	210	277	6	36	67	0.5373135
NODE_194499_length_285_cov_1.327957	114	191	0	31	77	0.4025974
NODE_194499_length_285_cov_1.327957	114	191	4	3	77	0.0389610
NODE_194499_length_285_cov_1.327957	114	191	6	43	77	0.5584416
NODE_194865_length_285_cov_1.096774	175	229	0	54	54	1.0000000
NODE_194865_length_285_cov_1.096774	230	271	0	41	41	1.0000000
NODE_195109_length_285_cov_0.924731	128	208	0	4	80	0.0500000
NODE_195109_length_285_cov_0.924731	128	208	2	38	80	0.4750000
NODE_195109_length_285_cov_0.924731	128	208	4	38	80	0.4750000
NODE_195115_length_285_cov_0.919355	5	65	0	60	60	1.0000000
NODE_195124_length_285_cov_0.913978	6	80	0	74	74	1.0000000
NODE_195124_length_285_cov_0.913978	58	133	0	75	75	1.0000000
NODE_195642_length_284_cov_7.967568	143	207	14	9	64	0.1406250
NODE_195642_length_284_cov_7.967568	143	207	20	6	64	0.0937500
NODE_195642_length_284_cov_7.967568	143	207	24	14	64	0.2187500
NODE_195642_length_284_cov_7.967568	143	207	26	15	64	0.2343750
NODE_195642_length_284_cov_7.967568	143	207	28	3	64	0.0468750
NODE_195642_length_284_cov_7.967568	143	207	30	17	64	0.2656250
NODE_195667_length_284_cov_5.016216	115	169	0	6	54	0.1111111
NODE_195667_length_284_cov_5.016216	115	169	4	48	54	0.8888889
NODE_195715_length_284_cov_3.913514	26	82	0	56	56	1.0000000
NODE_195760_length_284_cov_3.405405	209	283	0	74	74	1.0000000
NODE_195863_length_284_cov_2.718919	138	162	0	15	24	0.6250000
NODE_195863_length_284_cov_2.718919	138	162	2	9	24	0.3750000
NODE_195863_length_284_cov_2.718919	138	215	0	15	77	0.1948052
NODE_195863_length_284_cov_2.718919	138	215	2	62	77	0.8051948
NODE_196090_length_284_cov_2.097297	46	122	0	7	76	0.0921053
NODE_196090_length_284_cov_2.097297	46	122	2	69	76	0.9078947
NODE_196253_length_284_cov_1.756757	27	100	2	15	73	0.2054795
NODE_196253_length_284_cov_1.756757	27	100	4	3	73	0.0410959
NODE_196253_length_284_cov_1.756757	27	100	7	7	73	0.0958904
NODE_196253_length_284_cov_1.756757	27	100	9	18	73	0.2465753
NODE_196253_length_284_cov_1.756757	27	100	10	8	73	0.1095890
NODE_196253_length_284_cov_1.756757	27	100	12	22	73	0.3013699
NODE_196253_length_284_cov_1.756757	97	153	8	3	56	0.0535714
NODE_196253_length_284_cov_1.756757	97	153	10	21	56	0.3750000
NODE_196253_length_284_cov_1.756757	97	153	12	32	56	0.5714286
NODE_196273_length_284_cov_1.713514	24	59	0	35	35	1.0000000
NODE_196372_length_284_cov_1.654054	207	251	0	44	44	1.0000000
NODE_196426_length_284_cov_1.643243	180	239	0	59	59	1.0000000
NODE_196505_length_284_cov_1.540541	148	186	33	2	38	0.0526316
NODE_196505_length_284_cov_1.540541	148	186	34	4	38	0.1052632
NODE_196505_length_284_cov_1.540541	148	186	36	2	38	0.0526316
NODE_196505_length_284_cov_1.540541	148	186	38	8	38	0.2105263
NODE_196505_length_284_cov_1.540541	148	186	40	4	38	0.1052632
NODE_196505_length_284_cov_1.540541	148	186	42	1	38	0.0263158
NODE_196505_length_284_cov_1.540541	148	186	44	11	38	0.2894737
NODE_196505_length_284_cov_1.540541	148	186	46	6	38	0.1578947
NODE_196670_length_284_cov_1.378378	65	145	0	10	80	0.1250000
NODE_196670_length_284_cov_1.378378	65	145	2	59	80	0.7375000
NODE_196670_length_284_cov_1.378378	65	145	4	4	80	0.0500000
NODE_196670_length_284_cov_1.378378	65	145	6	5	80	0.0625000
NODE_196670_length_284_cov_1.378378	65	145	8	2	80	0.0250000
NODE_196670_length_284_cov_1.378378	118	165	2	16	47	0.3404255
NODE_196670_length_284_cov_1.378378	118	165	4	4	47	0.0851064
NODE_196670_length_284_cov_1.378378	118	165	6	16	47	0.3404255
NODE_196670_length_284_cov_1.378378	118	165	8	11	47	0.2340426
NODE_196733_length_284_cov_1.329730	114	170	0	56	56	1.0000000
NODE_197755_length_284_cov_0.686486	13	94	0	81	81	1.0000000
NODE_197755_length_284_cov_0.686486	13	94	0	81	81	1.0000000
NODE_197755_length_284_cov_0.686486	13	94	0	81	81	1.0000000
NODE_197835_length_284_cov_0.551351	167	219	0	52	52	1.0000000
NODE_197936_length_283_cov_4.434783	81	137	12	11	56	0.1964286
NODE_197936_length_283_cov_4.434783	81	137	14	5	56	0.0892857
NODE_197936_length_283_cov_4.434783	81	137	16	3	56	0.0535714
NODE_197936_length_283_cov_4.434783	81	137	17	1	56	0.0178571
NODE_197936_length_283_cov_4.434783	81	137	24	20	56	0.3571429
NODE_197936_length_283_cov_4.434783	81	137	26	7	56	0.1250000
NODE_197936_length_283_cov_4.434783	81	137	30	9	56	0.1607143
NODE_197936_length_283_cov_4.434783	114	190	0	1	76	0.0131579
NODE_197936_length_283_cov_4.434783	114	190	2	4	76	0.0526316
NODE_197936_length_283_cov_4.434783	114	190	4	4	76	0.0526316
NODE_197936_length_283_cov_4.434783	114	190	5	5	76	0.0657895
NODE_197936_length_283_cov_4.434783	114	190	7	2	76	0.0263158
NODE_197936_length_283_cov_4.434783	114	190	9	3	76	0.0394737
NODE_197936_length_283_cov_4.434783	114	190	10	8	76	0.1052632
NODE_197936_length_283_cov_4.434783	114	190	11	1	76	0.0131579
NODE_197936_length_283_cov_4.434783	114	190	12	36	76	0.4736842
NODE_197936_length_283_cov_4.434783	114	190	14	5	76	0.0657895
NODE_197936_length_283_cov_4.434783	114	190	16	3	76	0.0394737
NODE_197936_length_283_cov_4.434783	114	190	17	1	76	0.0131579
NODE_197936_length_283_cov_4.434783	114	190	24	3	76	0.0394737
NODE_197936_length_283_cov_4.434783	190	270	0	6	80	0.0750000
NODE_197936_length_283_cov_4.434783	190	270	2	3	80	0.0375000
NODE_197936_length_283_cov_4.434783	190	270	4	1	80	0.0125000
NODE_197936_length_283_cov_4.434783	190	270	8	8	80	0.1000000
NODE_197936_length_283_cov_4.434783	190	270	10	62	80	0.7750000
NODE_197937_length_283_cov_4.429348	104	168	8	5	64	0.0781250
NODE_197937_length_283_cov_4.429348	104	168	10	2	64	0.0312500
NODE_197937_length_283_cov_4.429348	104	168	12	1	64	0.0156250
NODE_197937_length_283_cov_4.429348	104	168	13	1	64	0.0156250
NODE_197937_length_283_cov_4.429348	104	168	14	4	64	0.0625000
NODE_197937_length_283_cov_4.429348	104	168	16	51	64	0.7968750
NODE_197937_length_283_cov_4.429348	104	168	8	5	64	0.0781250
NODE_197937_length_283_cov_4.429348	104	168	10	2	64	0.0312500
NODE_197937_length_283_cov_4.429348	104	168	12	1	64	0.0156250
NODE_197937_length_283_cov_4.429348	104	168	13	1	64	0.0156250
NODE_197937_length_283_cov_4.429348	104	168	14	4	64	0.0625000
NODE_197937_length_283_cov_4.429348	104	168	16	51	64	0.7968750
NODE_197937_length_283_cov_4.429348	141	207	2	19	66	0.2878788
NODE_197937_length_283_cov_4.429348	141	207	4	20	66	0.3030303
NODE_197937_length_283_cov_4.429348	141	207	8	5	66	0.0757576
NODE_197937_length_283_cov_4.429348	141	207	10	2	66	0.0303030
NODE_197937_length_283_cov_4.429348	141	207	12	1	66	0.0151515
NODE_197937_length_283_cov_4.429348	141	207	13	1	66	0.0151515
NODE_197937_length_283_cov_4.429348	141	207	14	4	66	0.0606061
NODE_197937_length_283_cov_4.429348	141	207	16	14	66	0.2121212
NODE_197937_length_283_cov_4.429348	141	221	2	33	80	0.4125000
NODE_197937_length_283_cov_4.429348	141	221	4	20	80	0.2500000
NODE_197937_length_283_cov_4.429348	141	221	8	5	80	0.0625000
NODE_197937_length_283_cov_4.429348	141	221	10	2	80	0.0250000
NODE_197937_length_283_cov_4.429348	141	221	12	1	80	0.0125000
NODE_197937_length_283_cov_4.429348	141	221	13	1	80	0.0125000
NODE_197937_length_283_cov_4.429348	141	221	14	4	80	0.0500000
NODE_197937_length_283_cov_4.429348	141	221	16	14	80	0.1750000
NODE_198007_length_283_cov_3.369565	0	35	0	35	35	1.0000000
NODE_198022_length_283_cov_3.309783	47	91	0	44	44	1.0000000
NODE_198081_length_283_cov_2.923913	95	137	2	6	42	0.1428571
NODE_198081_length_283_cov_2.923913	95	137	4	7	42	0.1666667
NODE_198081_length_283_cov_2.923913	95	137	5	6	42	0.1428571
NODE_198081_length_283_cov_2.923913	95	137	7	2	42	0.0476190
NODE_198081_length_283_cov_2.923913	95	137	9	11	42	0.2619048
NODE_198081_length_283_cov_2.923913	95	137	13	2	42	0.0476190
NODE_198081_length_283_cov_2.923913	95	137	15	8	42	0.1904762
NODE_198081_length_283_cov_2.923913	110	190	5	4	80	0.0500000
NODE_198081_length_283_cov_2.923913	110	190	7	2	80	0.0250000
NODE_198081_length_283_cov_2.923913	110	190	9	11	80	0.1375000
NODE_198081_length_283_cov_2.923913	110	190	13	2	80	0.0250000
NODE_198081_length_283_cov_2.923913	110	190	15	8	80	0.1000000
NODE_198081_length_283_cov_2.923913	110	190	16	43	80	0.5375000
NODE_198081_length_283_cov_2.923913	110	190	18	10	80	0.1250000
NODE_198098_length_283_cov_2.782609	120	200	6	29	80	0.3625000
NODE_198098_length_283_cov_2.782609	120	200	8	51	80	0.6375000
NODE_198109_length_283_cov_2.771739	29	72	0	43	43	1.0000000
NODE_198171_length_283_cov_2.494565	186	229	0	43	43	1.0000000
NODE_198176_length_283_cov_2.494565	181	238	0	57	57	1.0000000
NODE_198271_length_283_cov_2.217391	222	281	0	59	59	1.0000000
NODE_198518_length_283_cov_1.777174	40	120	0	80	80	1.0000000
NODE_198745_length_283_cov_1.543478	125	161	6	5	36	0.1388889
NODE_198745_length_283_cov_1.543478	125	161	12	1	36	0.0277778
NODE_198745_length_283_cov_1.543478	125	161	16	2	36	0.0555556
NODE_198745_length_283_cov_1.543478	125	161	20	1	36	0.0277778
NODE_198745_length_283_cov_1.543478	125	161	22	4	36	0.1111111
NODE_198745_length_283_cov_1.543478	125	161	25	1	36	0.0277778
NODE_198745_length_283_cov_1.543478	125	161	26	1	36	0.0277778
NODE_198745_length_283_cov_1.543478	125	161	28	1	36	0.0277778
NODE_198745_length_283_cov_1.543478	125	161	30	10	36	0.2777778
NODE_198745_length_283_cov_1.543478	125	161	32	1	36	0.0277778
NODE_198745_length_283_cov_1.543478	125	161	34	2	36	0.0555556
NODE_198745_length_283_cov_1.543478	125	161	38	2	36	0.0555556
NODE_198745_length_283_cov_1.543478	125	161	40	5	36	0.1388889
NODE_198751_length_283_cov_1.538043	182	203	0	21	21	1.0000000
NODE_198986_length_283_cov_1.304348	208	270	0	1	62	0.0161290
NODE_198986_length_283_cov_1.304348	208	270	2	61	62	0.9838710
NODE_199042_length_283_cov_1.211957	157	234	2	77	77	1.0000000
NODE_199070_length_283_cov_1.168478	183	250	10	67	67	1.0000000
NODE_199606_length_283_cov_0.918478	146	226	0	3	80	0.0375000
NODE_199606_length_283_cov_0.918478	146	226	3	7	80	0.0875000
NODE_199606_length_283_cov_0.918478	146	226	4	70	80	0.8750000
NODE_199606_length_283_cov_0.918478	199	279	0	56	80	0.7000000
NODE_199606_length_283_cov_0.918478	199	279	4	24	80	0.3000000
NODE_199641_length_283_cov_0.885870	143	205	2	62	62	1.0000000
NODE_199958_length_283_cov_0.706522	119	159	13	16	40	0.4000000
NODE_199958_length_283_cov_0.706522	119	159	14	24	40	0.6000000
NODE_200085_length_282_cov_51.027322	219	280	0	61	61	1.0000000
NODE_200085_length_282_cov_51.027322	219	282	0	63	63	1.0000000
NODE_200166_length_282_cov_3.901639	38	118	0	80	80	1.0000000
NODE_200166_length_282_cov_3.901639	91	171	0	80	80	1.0000000
NODE_200171_length_282_cov_3.874317	96	116	2	20	20	1.0000000
NODE_200201_length_282_cov_3.562842	224	279	0	14	55	0.2545455
NODE_200201_length_282_cov_3.562842	224	279	1	41	55	0.7454545
NODE_200270_length_282_cov_2.890710	41	123	0	82	82	1.0000000
NODE_200276_length_282_cov_2.846995	26	47	0	21	21	1.0000000
NODE_200304_length_282_cov_2.770492	145	225	2	58	80	0.7250000
NODE_200304_length_282_cov_2.770492	145	225	4	22	80	0.2750000
NODE_200304_length_282_cov_2.770492	198	278	2	38	80	0.4750000
NODE_200304_length_282_cov_2.770492	198	278	4	42	80	0.5250000
NODE_200329_length_282_cov_2.655738	46	119	2	26	73	0.3561644
NODE_200329_length_282_cov_2.655738	46	119	3	3	73	0.0410959
NODE_200329_length_282_cov_2.655738	46	119	4	3	73	0.0410959
NODE_200329_length_282_cov_2.655738	46	119	5	41	73	0.5616438
NODE_200329_length_282_cov_2.655738	100	159	2	3	59	0.0508475
NODE_200329_length_282_cov_2.655738	100	159	3	18	59	0.3050847
NODE_200329_length_282_cov_2.655738	100	159	4	22	59	0.3728814
NODE_200329_length_282_cov_2.655738	100	159	5	16	59	0.2711864
NODE_200335_length_282_cov_2.622951	0	36	2	29	36	0.8055556
NODE_200335_length_282_cov_2.622951	0	36	4	7	36	0.1944444
NODE_200335_length_282_cov_2.622951	9	89	2	20	80	0.2500000
NODE_200335_length_282_cov_2.622951	9	89	4	21	80	0.2625000
NODE_200335_length_282_cov_2.622951	9	89	6	3	80	0.0375000
NODE_200335_length_282_cov_2.622951	9	89	7	1	80	0.0125000
NODE_200335_length_282_cov_2.622951	9	89	8	19	80	0.2375000
NODE_200335_length_282_cov_2.622951	9	89	10	12	80	0.1500000
NODE_200335_length_282_cov_2.622951	9	89	12	4	80	0.0500000
NODE_200336_length_282_cov_2.622951	38	111	0	40	73	0.5479452
NODE_200336_length_282_cov_2.622951	38	111	2	33	73	0.4520548
NODE_200336_length_282_cov_2.622951	98	144	2	46	46	1.0000000
NODE_200367_length_282_cov_2.508197	138	186	0	48	48	1.0000000
NODE_200367_length_282_cov_2.508197	191	234	0	43	43	1.0000000
NODE_200425_length_282_cov_2.289617	68	137	0	15	69	0.2173913
NODE_200425_length_282_cov_2.289617	68	137	2	54	69	0.7826087
NODE_200443_length_282_cov_2.229508	169	249	0	80	80	1.0000000
NODE_200501_length_282_cov_2.163934	138	192	0	54	54	1.0000000
NODE_200634_length_282_cov_1.901639	149	216	6	22	67	0.3283582
NODE_200634_length_282_cov_1.901639	149	216	8	45	67	0.6716418
NODE_200924_length_282_cov_1.612022	123	162	0	39	39	1.0000000
NODE_201084_length_282_cov_1.393443	158	225	2	30	67	0.4477612
NODE_201084_length_282_cov_1.393443	158	225	4	37	67	0.5522388
NODE_201219_length_282_cov_1.273224	91	140	0	49	49	1.0000000
NODE_201413_length_282_cov_1.114754	5	53	0	20	48	0.4166667
NODE_201413_length_282_cov_1.114754	5	53	2	28	48	0.5833333
NODE_202284_length_281_cov_7.895604	165	210	21	1	45	0.0222222
NODE_202284_length_281_cov_7.895604	165	210	29	1	45	0.0222222
NODE_202284_length_281_cov_7.895604	165	210	30	1	45	0.0222222
NODE_202284_length_281_cov_7.895604	165	210	36	1	45	0.0222222
NODE_202284_length_281_cov_7.895604	165	210	38	7	45	0.1555556
NODE_202284_length_281_cov_7.895604	165	210	39	1	45	0.0222222
NODE_202284_length_281_cov_7.895604	165	210	40	32	45	0.7111111
NODE_202284_length_281_cov_7.895604	165	210	44	1	45	0.0222222
NODE_202284_length_281_cov_7.895604	183	263	22	3	80	0.0375000
NODE_202284_length_281_cov_7.895604	183	263	24	3	80	0.0375000
NODE_202284_length_281_cov_7.895604	183	263	26	1	80	0.0125000
NODE_202284_length_281_cov_7.895604	183	263	28	2	80	0.0250000
NODE_202284_length_281_cov_7.895604	183	263	32	4	80	0.0500000
NODE_202284_length_281_cov_7.895604	183	263	34	16	80	0.2000000
NODE_202284_length_281_cov_7.895604	183	263	38	4	80	0.0500000
NODE_202284_length_281_cov_7.895604	183	263	40	47	80	0.5875000
NODE_202294_length_281_cov_6.379121	151	231	0	80	80	1.0000000
NODE_202333_length_281_cov_4.565934	71	127	8	56	56	1.0000000
NODE_202337_length_281_cov_4.494505	211	261	2	50	50	1.0000000
NODE_202356_length_281_cov_4.219780	85	135	0	50	50	1.0000000
NODE_202356_length_281_cov_4.219780	145	188	0	43	43	1.0000000
NODE_202401_length_281_cov_3.620879	245	281	0	36	36	1.0000000
NODE_202421_length_281_cov_3.324176	104	161	2	19	57	0.3333333
NODE_202421_length_281_cov_3.324176	104	161	4	8	57	0.1403509
NODE_202421_length_281_cov_3.324176	104	161	6	30	57	0.5263158
NODE_202421_length_281_cov_3.324176	112	192	2	30	80	0.3750000
NODE_202421_length_281_cov_3.324176	112	192	4	20	80	0.2500000
NODE_202421_length_281_cov_3.324176	112	192	6	30	80	0.3750000
NODE_202436_length_281_cov_3.197802	6	80	0	74	74	1.0000000
NODE_202473_length_281_cov_2.923077	92	150	0	58	58	1.0000000
NODE_202650_length_281_cov_2.241758	5	58	0	53	53	1.0000000
NODE_202712_length_281_cov_2.120879	56	136	0	8	80	0.1000000
NODE_202712_length_281_cov_2.120879	56	136	4	72	80	0.9000000
NODE_202788_length_281_cov_1.961538	199	270	0	4	71	0.0563380
NODE_202788_length_281_cov_1.961538	199	270	2	67	71	0.9436620
NODE_203008_length_281_cov_1.675824	147	199	2	3	52	0.0576923
NODE_203008_length_281_cov_1.675824	147	199	4	3	52	0.0576923
NODE_203008_length_281_cov_1.675824	147	199	6	10	52	0.1923077
NODE_203008_length_281_cov_1.675824	147	199	8	36	52	0.6923077
NODE_203008_length_281_cov_1.675824	178	198	8	20	20	1.0000000
NODE_203008_length_281_cov_1.675824	200	241	2	13	41	0.3170732
NODE_203008_length_281_cov_1.675824	200	241	6	13	41	0.3170732
NODE_203008_length_281_cov_1.675824	200	241	8	15	41	0.3658537
NODE_203065_length_281_cov_1.653846	29	65	0	36	36	1.0000000
NODE_203168_length_281_cov_1.483516	85	135	0	50	50	1.0000000
NODE_203168_length_281_cov_1.483516	86	166	0	80	80	1.0000000
NODE_203168_length_281_cov_1.483516	139	184	0	45	45	1.0000000
NODE_203183_length_281_cov_1.461538	223	276	0	53	53	1.0000000
NODE_203262_length_281_cov_1.401099	237	281	0	44	44	1.0000000
NODE_203281_length_281_cov_1.401099	150	214	4	21	64	0.3281250
NODE_203281_length_281_cov_1.401099	150	214	6	40	64	0.6250000
NODE_203281_length_281_cov_1.401099	150	214	8	1	64	0.0156250
NODE_203281_length_281_cov_1.401099	150	214	10	2	64	0.0312500
NODE_203281_length_281_cov_1.401099	187	267	4	74	80	0.9250000
NODE_203281_length_281_cov_1.401099	187	267	6	3	80	0.0375000
NODE_203281_length_281_cov_1.401099	187	267	8	1	80	0.0125000
NODE_203281_length_281_cov_1.401099	187	267	10	2	80	0.0250000
NODE_203292_length_281_cov_1.401099	31	111	0	20	80	0.2500000
NODE_203292_length_281_cov_1.401099	31	111	2	60	80	0.7500000
NODE_203440_length_281_cov_1.186813	0	79	0	23	79	0.2911392
NODE_203440_length_281_cov_1.186813	0	79	1	9	79	0.1139240
NODE_203440_length_281_cov_1.186813	0	79	3	19	79	0.2405063
NODE_203440_length_281_cov_1.186813	0	79	4	4	79	0.0506329
NODE_203440_length_281_cov_1.186813	0	79	8	2	79	0.0253165
NODE_203440_length_281_cov_1.186813	0	79	9	11	79	0.1392405
NODE_203440_length_281_cov_1.186813	0	79	10	2	79	0.0253165
NODE_203440_length_281_cov_1.186813	0	79	12	1	79	0.0126582
NODE_203440_length_281_cov_1.186813	0	79	13	8	79	0.1012658
NODE_203440_length_281_cov_1.186813	52	132	4	3	80	0.0375000
NODE_203440_length_281_cov_1.186813	52	132	8	2	80	0.0250000
NODE_203440_length_281_cov_1.186813	52	132	9	11	80	0.1375000
NODE_203440_length_281_cov_1.186813	52	132	10	2	80	0.0250000
NODE_203440_length_281_cov_1.186813	52	132	12	1	80	0.0125000
NODE_203440_length_281_cov_1.186813	52	132	13	13	80	0.1625000
NODE_203440_length_281_cov_1.186813	52	132	15	2	80	0.0250000
NODE_203440_length_281_cov_1.186813	52	132	21	4	80	0.0500000
NODE_203440_length_281_cov_1.186813	52	132	23	13	80	0.1625000
NODE_203440_length_281_cov_1.186813	52	132	25	29	80	0.3625000
NODE_203516_length_281_cov_1.120879	47	82	0	35	35	1.0000000
NODE_203534_length_281_cov_1.120879	243	276	0	33	33	1.0000000
NODE_203544_length_281_cov_1.120879	216	281	2	14	65	0.2153846
NODE_203544_length_281_cov_1.120879	216	281	4	1	65	0.0153846
NODE_203544_length_281_cov_1.120879	216	281	6	50	65	0.7692308
NODE_203785_length_281_cov_1.060440	139	179	25	4	40	0.1000000
NODE_203785_length_281_cov_1.060440	139	179	27	8	40	0.2000000
NODE_203785_length_281_cov_1.060440	139	179	31	21	40	0.5250000
NODE_203785_length_281_cov_1.060440	139	179	33	7	40	0.1750000
NODE_204094_length_281_cov_0.840659	72	138	0	66	66	1.0000000
NODE_204094_length_281_cov_0.840659	111	191	0	80	80	1.0000000
NODE_204467_length_280_cov_39.320442	118	198	0	80	80	1.0000000
NODE_204467_length_280_cov_39.320442	181	251	0	70	70	1.0000000
NODE_204468_length_280_cov_34.259669	97	137	0	2	40	0.0500000
NODE_204468_length_280_cov_34.259669	97	137	2	22	40	0.5500000
NODE_204468_length_280_cov_34.259669	97	137	4	15	40	0.3750000
NODE_204468_length_280_cov_34.259669	97	137	6	1	40	0.0250000
NODE_204532_length_280_cov_4.287293	53	100	0	6	47	0.1276596
NODE_204532_length_280_cov_4.287293	53	100	2	29	47	0.6170213
NODE_204532_length_280_cov_4.287293	53	100	4	12	47	0.2553191
NODE_204532_length_280_cov_4.287293	129	186	2	31	57	0.5438597
NODE_204532_length_280_cov_4.287293	129	186	4	26	57	0.4561403
NODE_204596_length_280_cov_3.436464	34	103	22	2	69	0.0289855
NODE_204596_length_280_cov_3.436464	34	103	24	1	69	0.0144928
NODE_204596_length_280_cov_3.436464	34	103	25	1	69	0.0144928
NODE_204596_length_280_cov_3.436464	34	103	28	2	69	0.0289855
NODE_204596_length_280_cov_3.436464	34	103	30	2	69	0.0289855
NODE_204596_length_280_cov_3.436464	34	103	32	5	69	0.0724638
NODE_204596_length_280_cov_3.436464	34	103	34	1	69	0.0144928
NODE_204596_length_280_cov_3.436464	34	103	36	1	69	0.0144928
NODE_204596_length_280_cov_3.436464	34	103	38	8	69	0.1159420
NODE_204596_length_280_cov_3.436464	34	103	40	2	69	0.0289855
NODE_204596_length_280_cov_3.436464	34	103	42	1	69	0.0144928
NODE_204596_length_280_cov_3.436464	34	103	44	7	69	0.1014493
NODE_204596_length_280_cov_3.436464	34	103	46	36	69	0.5217391
NODE_204597_length_280_cov_3.430939	17	97	0	49	80	0.6125000
NODE_204597_length_280_cov_3.430939	17	97	4	31	80	0.3875000
NODE_204597_length_280_cov_3.430939	27	97	0	39	70	0.5571429
NODE_204597_length_280_cov_3.430939	27	97	4	31	70	0.4428571
NODE_204674_length_280_cov_2.988950	118	164	2	46	46	1.0000000
NODE_204938_length_280_cov_2.165746	2	48	0	15	46	0.3260870
NODE_204938_length_280_cov_2.165746	2	48	2	31	46	0.6739131
NODE_204938_length_280_cov_2.165746	6	48	0	11	42	0.2619048
NODE_204938_length_280_cov_2.165746	6	48	2	31	42	0.7380952
NODE_204938_length_280_cov_2.165746	21	101	2	48	80	0.6000000
NODE_204938_length_280_cov_2.165746	21	101	4	32	80	0.4000000
NODE_204938_length_280_cov_2.165746	22	101	2	47	79	0.5949367
NODE_204938_length_280_cov_2.165746	22	101	4	32	79	0.4050633
NODE_204938_length_280_cov_2.165746	32	101	2	37	69	0.5362319
NODE_204938_length_280_cov_2.165746	32	101	4	32	69	0.4637681
NODE_204976_length_280_cov_2.022099	105	148	0	43	43	1.0000000
NODE_204976_length_280_cov_2.022099	121	148	0	27	27	1.0000000
NODE_205044_length_280_cov_1.889503	50	132	0	11	82	0.1341463
NODE_205044_length_280_cov_1.889503	50	132	2	3	82	0.0365854
NODE_205044_length_280_cov_1.889503	50	132	7	1	82	0.0121951
NODE_205044_length_280_cov_1.889503	50	132	8	4	82	0.0487805
NODE_205044_length_280_cov_1.889503	50	132	10	19	82	0.2317073
NODE_205044_length_280_cov_1.889503	50	132	12	44	82	0.5365854
NODE_205062_length_280_cov_1.828729	45	75	4	30	30	1.0000000
NODE_205410_length_280_cov_1.425414	17	50	2	8	33	0.2424242
NODE_205410_length_280_cov_1.425414	17	50	4	1	33	0.0303030
NODE_205410_length_280_cov_1.425414	17	50	6	24	33	0.7272727
NODE_205410_length_280_cov_1.425414	70	112	4	7	42	0.1666667
NODE_205410_length_280_cov_1.425414	70	112	5	21	42	0.5000000
NODE_205410_length_280_cov_1.425414	70	112	6	14	42	0.3333333
NODE_205416_length_280_cov_1.414365	37	97	0	3	60	0.0500000
NODE_205416_length_280_cov_1.414365	37	97	2	3	60	0.0500000
NODE_205416_length_280_cov_1.414365	37	97	4	1	60	0.0166667
NODE_205416_length_280_cov_1.414365	37	97	6	53	60	0.8833333
NODE_205633_length_280_cov_1.187845	56	136	0	80	80	1.0000000
NODE_205635_length_280_cov_1.182320	154	234	0	1	80	0.0125000
NODE_205635_length_280_cov_1.182320	154	234	2	3	80	0.0375000
NODE_205635_length_280_cov_1.182320	154	234	4	8	80	0.1000000
NODE_205635_length_280_cov_1.182320	154	234	6	12	80	0.1500000
NODE_205635_length_280_cov_1.182320	154	234	8	15	80	0.1875000
NODE_205635_length_280_cov_1.182320	154	234	10	34	80	0.4250000
NODE_205635_length_280_cov_1.182320	154	234	12	7	80	0.0875000
NODE_205635_length_280_cov_1.182320	207	280	0	47	73	0.6438356
NODE_205635_length_280_cov_1.182320	207	280	2	3	73	0.0410959
NODE_205635_length_280_cov_1.182320	207	280	4	8	73	0.1095890
NODE_205635_length_280_cov_1.182320	207	280	6	12	73	0.1643836
NODE_205635_length_280_cov_1.182320	207	280	8	3	73	0.0410959
NODE_205701_length_280_cov_1.127072	204	265	0	1	61	0.0163934
NODE_205701_length_280_cov_1.127072	204	265	4	9	61	0.1475410
NODE_205701_length_280_cov_1.127072	204	265	6	22	61	0.3606557
NODE_205701_length_280_cov_1.127072	204	265	8	6	61	0.0983607
NODE_205701_length_280_cov_1.127072	204	265	10	23	61	0.3770492
NODE_205794_length_280_cov_1.127072	0	39	2	39	39	1.0000000
NODE_205801_length_280_cov_1.127072	218	253	0	35	35	1.0000000
NODE_205894_length_280_cov_1.127072	0	59	0	59	59	1.0000000
NODE_206211_length_280_cov_0.911602	176	256	0	80	80	1.0000000
NODE_206211_length_280_cov_0.911602	229	280	0	51	51	1.0000000
NODE_206319_length_280_cov_0.845304	211	268	0	57	57	1.0000000
NODE_206531_length_280_cov_0.779006	129	203	8	1	74	0.0135135
NODE_206531_length_280_cov_0.779006	129	203	9	3	74	0.0405405
NODE_206531_length_280_cov_0.779006	129	203	11	7	74	0.0945946
NODE_206531_length_280_cov_0.779006	129	203	13	9	74	0.1216216
NODE_206531_length_280_cov_0.779006	129	203	14	54	74	0.7297297
NODE_206721_length_279_cov_50.005556	51	130	50	1	79	0.0126582
NODE_206721_length_279_cov_50.005556	51	130	51	3	79	0.0379747
NODE_206721_length_279_cov_50.005556	51	130	55	2	79	0.0253165
NODE_206721_length_279_cov_50.005556	51	130	56	1	79	0.0126582
NODE_206721_length_279_cov_50.005556	51	130	60	2	79	0.0253165
NODE_206721_length_279_cov_50.005556	51	130	62	2	79	0.0253165
NODE_206721_length_279_cov_50.005556	51	130	64	3	79	0.0379747
NODE_206721_length_279_cov_50.005556	51	130	66	1	79	0.0126582
NODE_206721_length_279_cov_50.005556	51	130	68	5	79	0.0632911
NODE_206721_length_279_cov_50.005556	51	130	76	12	79	0.1518987
NODE_206721_length_279_cov_50.005556	51	130	78	4	79	0.0506329
NODE_206721_length_279_cov_50.005556	51	130	80	3	79	0.0379747
NODE_206721_length_279_cov_50.005556	51	130	82	5	79	0.0632911
NODE_206721_length_279_cov_50.005556	51	130	84	14	79	0.1772152
NODE_206721_length_279_cov_50.005556	51	130	88	5	79	0.0632911
NODE_206721_length_279_cov_50.005556	51	130	90	16	79	0.2025317
NODE_206721_length_279_cov_50.005556	103	179	10	4	76	0.0526316
NODE_206721_length_279_cov_50.005556	103	179	13	3	76	0.0394737
NODE_206721_length_279_cov_50.005556	103	179	15	3	76	0.0394737
NODE_206721_length_279_cov_50.005556	103	179	17	1	76	0.0131579
NODE_206721_length_279_cov_50.005556	103	179	19	2	76	0.0263158
NODE_206721_length_279_cov_50.005556	103	179	23	1	76	0.0131579
NODE_206721_length_279_cov_50.005556	103	179	31	1	76	0.0131579
NODE_206721_length_279_cov_50.005556	103	179	35	9	76	0.1184211
NODE_206721_length_279_cov_50.005556	103	179	39	6	76	0.0789474
NODE_206721_length_279_cov_50.005556	103	179	41	5	76	0.0657895
NODE_206721_length_279_cov_50.005556	103	179	43	1	76	0.0131579
NODE_206721_length_279_cov_50.005556	103	179	55	6	76	0.0789474
NODE_206721_length_279_cov_50.005556	103	179	59	2	76	0.0263158
NODE_206721_length_279_cov_50.005556	103	179	60	7	76	0.0921053
NODE_206721_length_279_cov_50.005556	103	179	62	1	76	0.0131579
NODE_206721_length_279_cov_50.005556	103	179	64	1	76	0.0131579
NODE_206721_length_279_cov_50.005556	103	179	66	1	76	0.0131579
NODE_206721_length_279_cov_50.005556	103	179	68	2	76	0.0263158
NODE_206721_length_279_cov_50.005556	103	179	76	5	76	0.0657895
NODE_206721_length_279_cov_50.005556	103	179	78	1	76	0.0131579
NODE_206721_length_279_cov_50.005556	103	179	80	3	76	0.0394737
NODE_206721_length_279_cov_50.005556	103	179	82	1	76	0.0131579
NODE_206721_length_279_cov_50.005556	103	179	84	1	76	0.0131579
NODE_206721_length_279_cov_50.005556	103	179	88	5	76	0.0657895
NODE_206721_length_279_cov_50.005556	103	179	90	4	76	0.0526316
NODE_206744_length_279_cov_6.055556	196	228	0	7	32	0.2187500
NODE_206744_length_279_cov_6.055556	196	228	8	25	32	0.7812500
NODE_206762_length_279_cov_5.166667	197	277	0	80	80	1.0000000
NODE_206788_length_279_cov_4.427778	107	187	4	7	80	0.0875000
NODE_206788_length_279_cov_4.427778	107	187	6	27	80	0.3375000
NODE_206788_length_279_cov_4.427778	107	187	8	30	80	0.3750000
NODE_206788_length_279_cov_4.427778	107	187	10	16	80	0.2000000
NODE_206879_length_279_cov_3.200000	205	225	0	20	20	1.0000000
NODE_206886_length_279_cov_3.116667	115	195	0	80	80	1.0000000
NODE_206886_length_279_cov_3.116667	168	248	0	80	80	1.0000000
NODE_206972_length_279_cov_2.600000	67	147	0	80	80	1.0000000
NODE_206972_length_279_cov_2.600000	120	199	0	79	79	1.0000000
NODE_207023_length_279_cov_2.427778	155	199	0	44	44	1.0000000
NODE_207052_length_279_cov_2.283333	168	240	2	72	72	1.0000000
NODE_207054_length_279_cov_2.277778	190	265	0	75	75	1.0000000
NODE_207086_length_279_cov_2.266667	66	109	2	43	43	1.0000000
NODE_207115_length_279_cov_2.255556	115	176	0	61	61	1.0000000
NODE_207115_length_279_cov_2.255556	168	222	0	54	54	1.0000000
NODE_207155_length_279_cov_2.200000	57	104	0	10	47	0.2127660
NODE_207155_length_279_cov_2.200000	57	104	2	2	47	0.0425532
NODE_207155_length_279_cov_2.200000	57	104	6	2	47	0.0425532
NODE_207155_length_279_cov_2.200000	57	104	8	33	47	0.7021276
NODE_207269_length_279_cov_1.977778	0	62	0	62	62	1.0000000
NODE_207293_length_279_cov_1.944444	63	105	0	42	42	1.0000000
NODE_207306_length_279_cov_1.916667	182	262	0	80	80	1.0000000
NODE_207318_length_279_cov_1.866667	63	143	0	21	80	0.2625000
NODE_207318_length_279_cov_1.866667	63	143	1	4	80	0.0500000
NODE_207318_length_279_cov_1.866667	63	143	3	2	80	0.0250000
NODE_207318_length_279_cov_1.866667	63	143	5	9	80	0.1125000
NODE_207318_length_279_cov_1.866667	63	143	7	3	80	0.0375000
NODE_207318_length_279_cov_1.866667	63	143	8	1	80	0.0125000
NODE_207318_length_279_cov_1.866667	63	143	9	40	80	0.5000000
NODE_207387_length_279_cov_1.700000	8	37	0	21	29	0.7241379
NODE_207387_length_279_cov_1.700000	8	37	2	6	29	0.2068966
NODE_207387_length_279_cov_1.700000	8	37	4	2	29	0.0689655
NODE_207389_length_279_cov_1.700000	10	42	0	32	32	1.0000000
NODE_207534_length_279_cov_1.672222	103	183	0	80	80	1.0000000
NODE_207641_length_279_cov_1.433333	51	110	2	30	59	0.5084746
NODE_207641_length_279_cov_1.433333	51	110	4	29	59	0.4915254
NODE_207641_length_279_cov_1.433333	83	119	4	36	36	1.0000000
NODE_207929_length_279_cov_1.144444	146	211	0	14	65	0.2153846
NODE_207929_length_279_cov_1.144444	146	211	2	51	65	0.7846154
NODE_207929_length_279_cov_1.144444	184	266	0	4	82	0.0487805
NODE_207929_length_279_cov_1.144444	184	266	2	78	82	0.9512195
NODE_207931_length_279_cov_1.138889	125	188	151	1	63	0.0158730
NODE_207931_length_279_cov_1.138889	125	188	170	1	63	0.0158730
NODE_207931_length_279_cov_1.138889	125	188	173	1	63	0.0158730
NODE_207931_length_279_cov_1.138889	125	188	176	1	63	0.0158730
NODE_207931_length_279_cov_1.138889	125	188	184	1	63	0.0158730
NODE_207931_length_279_cov_1.138889	125	188	192	1	63	0.0158730
NODE_207931_length_279_cov_1.138889	125	188	194	1	63	0.0158730
NODE_207931_length_279_cov_1.138889	125	188	196	2	63	0.0317460
NODE_207931_length_279_cov_1.138889	125	188	197	1	63	0.0158730
NODE_207931_length_279_cov_1.138889	125	188	203	1	63	0.0158730
NODE_207931_length_279_cov_1.138889	125	188	204	2	63	0.0317460
NODE_207931_length_279_cov_1.138889	125	188	207	1	63	0.0158730
NODE_207931_length_279_cov_1.138889	125	188	216	1	63	0.0158730
NODE_207931_length_279_cov_1.138889	125	188	218	1	63	0.0158730
NODE_207931_length_279_cov_1.138889	125	188	220	1	63	0.0158730
NODE_207931_length_279_cov_1.138889	125	188	221	2	63	0.0317460
NODE_207931_length_279_cov_1.138889	125	188	225	2	63	0.0317460
NODE_207931_length_279_cov_1.138889	125	188	226	2	63	0.0317460
NODE_207931_length_279_cov_1.138889	125	188	227	1	63	0.0158730
NODE_207931_length_279_cov_1.138889	125	188	231	1	63	0.0158730
NODE_207931_length_279_cov_1.138889	125	188	232	1	63	0.0158730
NODE_207931_length_279_cov_1.138889	125	188	233	3	63	0.0476190
NODE_207931_length_279_cov_1.138889	125	188	234	1	63	0.0158730
NODE_207931_length_279_cov_1.138889	125	188	236	1	63	0.0158730
NODE_207931_length_279_cov_1.138889	125	188	238	1	63	0.0158730
NODE_207931_length_279_cov_1.138889	125	188	240	1	63	0.0158730
NODE_207931_length_279_cov_1.138889	125	188	242	2	63	0.0317460
NODE_207931_length_279_cov_1.138889	125	188	243	1	63	0.0158730
NODE_207931_length_279_cov_1.138889	125	188	244	1	63	0.0158730
NODE_207931_length_279_cov_1.138889	125	188	246	2	63	0.0317460
NODE_207931_length_279_cov_1.138889	125	188	249	2	63	0.0317460
NODE_207931_length_279_cov_1.138889	125	188	250	4	63	0.0634921
NODE_207931_length_279_cov_1.138889	125	188	251	1	63	0.0158730
NODE_207931_length_279_cov_1.138889	125	188	252	3	63	0.0476190
NODE_207931_length_279_cov_1.138889	125	188	254	3	63	0.0476190
NODE_207931_length_279_cov_1.138889	125	188	255	1	63	0.0158730
NODE_207931_length_279_cov_1.138889	125	188	256	4	63	0.0634921
NODE_207931_length_279_cov_1.138889	125	188	257	3	63	0.0476190
NODE_207931_length_279_cov_1.138889	125	188	258	1	63	0.0158730
NODE_207931_length_279_cov_1.138889	125	188	261	1	63	0.0158730
NODE_207931_length_279_cov_1.138889	125	188	262	1	63	0.0158730
NODE_207932_length_279_cov_1.138889	111	191	0	80	80	1.0000000
NODE_207948_length_279_cov_1.133333	231	271	0	40	40	1.0000000
NODE_208183_length_279_cov_1.116667	15	92	2	77	77	1.0000000
NODE_208334_length_279_cov_0.988889	181	261	2	3	80	0.0375000
NODE_208334_length_279_cov_0.988889	181	261	4	77	80	0.9625000
NODE_208410_length_279_cov_0.927778	50	69	0	19	19	1.0000000
NODE_208410_length_279_cov_0.927778	50	69	0	19	19	1.0000000
NODE_208664_length_279_cov_0.844444	35	70	2	35	35	1.0000000
NODE_209293_length_278_cov_44.882682	158	210	18	4	52	0.0769231
NODE_209293_length_278_cov_44.882682	158	210	20	9	52	0.1730769
NODE_209293_length_278_cov_44.882682	158	210	24	1	52	0.0192308
NODE_209293_length_278_cov_44.882682	158	210	26	12	52	0.2307692
NODE_209293_length_278_cov_44.882682	158	210	28	11	52	0.2115385
NODE_209293_length_278_cov_44.882682	158	210	30	3	52	0.0576923
NODE_209293_length_278_cov_44.882682	158	210	32	1	52	0.0192308
NODE_209293_length_278_cov_44.882682	158	210	43	7	52	0.1346154
NODE_209293_length_278_cov_44.882682	158	210	45	2	52	0.0384615
NODE_209293_length_278_cov_44.882682	158	210	47	2	52	0.0384615
NODE_209293_length_278_cov_44.882682	206	232	14	7	26	0.2692308
NODE_209293_length_278_cov_44.882682	206	232	16	7	26	0.2692308
NODE_209293_length_278_cov_44.882682	206	232	18	12	26	0.4615385
NODE_209293_length_278_cov_44.882682	206	265	1	7	59	0.1186441
NODE_209293_length_278_cov_44.882682	206	265	2	3	59	0.0508475
NODE_209293_length_278_cov_44.882682	206	265	6	3	59	0.0508475
NODE_209293_length_278_cov_44.882682	206	265	8	5	59	0.0847458
NODE_209293_length_278_cov_44.882682	206	265	10	7	59	0.1186441
NODE_209293_length_278_cov_44.882682	206	265	12	8	59	0.1355932
NODE_209293_length_278_cov_44.882682	206	265	14	7	59	0.1186441
NODE_209293_length_278_cov_44.882682	206	265	16	7	59	0.1186441
NODE_209293_length_278_cov_44.882682	206	265	18	12	59	0.2033898
NODE_209294_length_278_cov_37.474860	0	52	0	52	52	1.0000000
NODE_209294_length_278_cov_37.474860	48	128	0	35	80	0.4375000
NODE_209294_length_278_cov_37.474860	48	128	4	45	80	0.5625000
NODE_209294_length_278_cov_37.474860	101	181	0	33	80	0.4125000
NODE_209294_length_278_cov_37.474860	101	181	4	47	80	0.5875000
NODE_209295_length_278_cov_21.340782	84	164	0	73	80	0.9125000
NODE_209295_length_278_cov_21.340782	84	164	2	7	80	0.0875000
NODE_209295_length_278_cov_21.340782	137	217	0	20	80	0.2500000
NODE_209295_length_278_cov_21.340782	137	217	2	60	80	0.7500000
NODE_209360_length_278_cov_4.156425	132	210	2	32	78	0.4102564
NODE_209360_length_278_cov_4.156425	132	210	4	15	78	0.1923077
NODE_209360_length_278_cov_4.156425	132	210	6	6	78	0.0769231
NODE_209360_length_278_cov_4.156425	132	210	8	2	78	0.0256410
NODE_209360_length_278_cov_4.156425	132	210	10	15	78	0.1923077
NODE_209360_length_278_cov_4.156425	132	210	12	8	78	0.1025641
NODE_209360_length_278_cov_4.156425	193	263	0	51	70	0.7285714
NODE_209360_length_278_cov_4.156425	193	263	2	19	70	0.2714286
NODE_209372_length_278_cov_3.977654	142	221	0	44	79	0.5569620
NODE_209372_length_278_cov_3.977654	142	221	2	3	79	0.0379747
NODE_209372_length_278_cov_3.977654	142	221	4	32	79	0.4050633
NODE_209378_length_278_cov_3.865922	168	210	0	42	42	1.0000000
NODE_209552_length_278_cov_2.558659	93	123	0	30	30	1.0000000
NODE_209565_length_278_cov_2.513966	54	106	0	52	52	1.0000000
NODE_209565_length_278_cov_2.513966	79	158	0	66	79	0.8354430
NODE_209565_length_278_cov_2.513966	79	158	2	13	79	0.1645570
NODE_209605_length_278_cov_2.296089	127	207	6	11	80	0.1375000
NODE_209605_length_278_cov_2.296089	127	207	10	19	80	0.2375000
NODE_209605_length_278_cov_2.296089	127	207	12	25	80	0.3125000
NODE_209605_length_278_cov_2.296089	127	207	13	4	80	0.0500000
NODE_209605_length_278_cov_2.296089	127	207	14	7	80	0.0875000
NODE_209605_length_278_cov_2.296089	127	207	15	14	80	0.1750000
NODE_209883_length_278_cov_1.731844	145	194	26	1	49	0.0204082
NODE_209883_length_278_cov_1.731844	145	194	30	4	49	0.0816327
NODE_209883_length_278_cov_1.731844	145	194	32	4	49	0.0816327
NODE_209883_length_278_cov_1.731844	145	194	34	2	49	0.0408163
NODE_209883_length_278_cov_1.731844	145	194	36	1	49	0.0204082
NODE_209883_length_278_cov_1.731844	145	194	38	2	49	0.0408163
NODE_209883_length_278_cov_1.731844	145	194	39	1	49	0.0204082
NODE_209883_length_278_cov_1.731844	145	194	41	3	49	0.0612245
NODE_209883_length_278_cov_1.731844	145	194	42	3	49	0.0612245
NODE_209883_length_278_cov_1.731844	145	194	43	1	49	0.0204082
NODE_209883_length_278_cov_1.731844	145	194	45	14	49	0.2857143
NODE_209883_length_278_cov_1.731844	145	194	47	1	49	0.0204082
NODE_209883_length_278_cov_1.731844	145	194	48	12	49	0.2448980
NODE_210038_length_278_cov_1.681564	129	184	0	34	55	0.6181818
NODE_210038_length_278_cov_1.681564	129	184	2	8	55	0.1454545
NODE_210038_length_278_cov_1.681564	129	184	4	9	55	0.1636364
NODE_210038_length_278_cov_1.681564	129	184	6	4	55	0.0727273
NODE_210068_length_278_cov_1.636872	13	41	13	2	28	0.0714286
NODE_210068_length_278_cov_1.636872	13	41	15	1	28	0.0357143
NODE_210068_length_278_cov_1.636872	13	41	17	1	28	0.0357143
NODE_210068_length_278_cov_1.636872	13	41	19	1	28	0.0357143
NODE_210068_length_278_cov_1.636872	13	41	21	1	28	0.0357143
NODE_210068_length_278_cov_1.636872	13	41	25	22	28	0.7857143
NODE_210373_length_278_cov_1.290503	3	67	6	6	64	0.0937500
NODE_210373_length_278_cov_1.290503	3	67	12	1	64	0.0156250
NODE_210373_length_278_cov_1.290503	3	67	13	1	64	0.0156250
NODE_210373_length_278_cov_1.290503	3	67	18	1	64	0.0156250
NODE_210373_length_278_cov_1.290503	3	67	20	1	64	0.0156250
NODE_210373_length_278_cov_1.290503	3	67	27	4	64	0.0625000
NODE_210373_length_278_cov_1.290503	3	67	38	3	64	0.0468750
NODE_210373_length_278_cov_1.290503	3	67	46	1	64	0.0156250
NODE_210373_length_278_cov_1.290503	3	67	47	2	64	0.0312500
NODE_210373_length_278_cov_1.290503	3	67	55	2	64	0.0312500
NODE_210373_length_278_cov_1.290503	3	67	66	1	64	0.0156250
NODE_210373_length_278_cov_1.290503	3	67	68	6	64	0.0937500
NODE_210373_length_278_cov_1.290503	3	67	71	7	64	0.1093750
NODE_210373_length_278_cov_1.290503	3	67	74	3	64	0.0468750
NODE_210373_length_278_cov_1.290503	3	67	76	7	64	0.1093750
NODE_210373_length_278_cov_1.290503	3	67	78	2	64	0.0312500
NODE_210373_length_278_cov_1.290503	3	67	80	3	64	0.0468750
NODE_210373_length_278_cov_1.290503	3	67	81	5	64	0.0781250
NODE_210373_length_278_cov_1.290503	3	67	82	3	64	0.0468750
NODE_210373_length_278_cov_1.290503	3	67	83	3	64	0.0468750
NODE_210373_length_278_cov_1.290503	3	67	85	1	64	0.0156250
NODE_210373_length_278_cov_1.290503	3	67	86	1	64	0.0156250
NODE_210373_length_278_cov_1.290503	3	67	6	6	64	0.0937500
NODE_210373_length_278_cov_1.290503	3	67	12	1	64	0.0156250
NODE_210373_length_278_cov_1.290503	3	67	13	1	64	0.0156250
NODE_210373_length_278_cov_1.290503	3	67	18	1	64	0.0156250
NODE_210373_length_278_cov_1.290503	3	67	20	1	64	0.0156250
NODE_210373_length_278_cov_1.290503	3	67	27	4	64	0.0625000
NODE_210373_length_278_cov_1.290503	3	67	38	3	64	0.0468750
NODE_210373_length_278_cov_1.290503	3	67	46	1	64	0.0156250
NODE_210373_length_278_cov_1.290503	3	67	47	2	64	0.0312500
NODE_210373_length_278_cov_1.290503	3	67	55	2	64	0.0312500
NODE_210373_length_278_cov_1.290503	3	67	66	1	64	0.0156250
NODE_210373_length_278_cov_1.290503	3	67	68	6	64	0.0937500
NODE_210373_length_278_cov_1.290503	3	67	71	7	64	0.1093750
NODE_210373_length_278_cov_1.290503	3	67	74	3	64	0.0468750
NODE_210373_length_278_cov_1.290503	3	67	76	7	64	0.1093750
NODE_210373_length_278_cov_1.290503	3	67	78	2	64	0.0312500
NODE_210373_length_278_cov_1.290503	3	67	80	3	64	0.0468750
NODE_210373_length_278_cov_1.290503	3	67	81	5	64	0.0781250
NODE_210373_length_278_cov_1.290503	3	67	82	3	64	0.0468750
NODE_210373_length_278_cov_1.290503	3	67	83	3	64	0.0468750
NODE_210373_length_278_cov_1.290503	3	67	85	1	64	0.0156250
NODE_210373_length_278_cov_1.290503	3	67	86	1	64	0.0156250
NODE_210373_length_278_cov_1.290503	3	67	6	6	64	0.0937500
NODE_210373_length_278_cov_1.290503	3	67	12	1	64	0.0156250
NODE_210373_length_278_cov_1.290503	3	67	13	1	64	0.0156250
NODE_210373_length_278_cov_1.290503	3	67	18	1	64	0.0156250
NODE_210373_length_278_cov_1.290503	3	67	20	1	64	0.0156250
NODE_210373_length_278_cov_1.290503	3	67	27	4	64	0.0625000
NODE_210373_length_278_cov_1.290503	3	67	38	3	64	0.0468750
NODE_210373_length_278_cov_1.290503	3	67	46	1	64	0.0156250
NODE_210373_length_278_cov_1.290503	3	67	47	2	64	0.0312500
NODE_210373_length_278_cov_1.290503	3	67	55	2	64	0.0312500
NODE_210373_length_278_cov_1.290503	3	67	66	1	64	0.0156250
NODE_210373_length_278_cov_1.290503	3	67	68	6	64	0.0937500
NODE_210373_length_278_cov_1.290503	3	67	71	7	64	0.1093750
NODE_210373_length_278_cov_1.290503	3	67	74	3	64	0.0468750
NODE_210373_length_278_cov_1.290503	3	67	76	7	64	0.1093750
NODE_210373_length_278_cov_1.290503	3	67	78	2	64	0.0312500
NODE_210373_length_278_cov_1.290503	3	67	80	3	64	0.0468750
NODE_210373_length_278_cov_1.290503	3	67	81	5	64	0.0781250
NODE_210373_length_278_cov_1.290503	3	67	82	3	64	0.0468750
NODE_210373_length_278_cov_1.290503	3	67	83	3	64	0.0468750
NODE_210373_length_278_cov_1.290503	3	67	85	1	64	0.0156250
NODE_210373_length_278_cov_1.290503	3	67	86	1	64	0.0156250
NODE_210463_length_278_cov_1.150838	52	76	4	24	24	1.0000000
NODE_210463_length_278_cov_1.150838	58	84	4	26	26	1.0000000
NODE_210559_length_278_cov_1.139665	108	187	0	2	79	0.0253165
NODE_210559_length_278_cov_1.139665	108	187	2	37	79	0.4683544
NODE_210559_length_278_cov_1.139665	108	187	4	1	79	0.0126582
NODE_210559_length_278_cov_1.139665	108	187	6	1	79	0.0126582
NODE_210559_length_278_cov_1.139665	108	187	8	4	79	0.0506329
NODE_210559_length_278_cov_1.139665	108	187	9	14	79	0.1772152
NODE_210559_length_278_cov_1.139665	108	187	10	20	79	0.2531646
NODE_210612_length_278_cov_1.139665	232	278	0	46	46	1.0000000
NODE_210691_length_278_cov_1.139665	210	278	0	6	68	0.0882353
NODE_210691_length_278_cov_1.139665	210	278	5	1	68	0.0147059
NODE_210691_length_278_cov_1.139665	210	278	6	25	68	0.3676471
NODE_210691_length_278_cov_1.139665	210	278	7	4	68	0.0588235
NODE_210691_length_278_cov_1.139665	210	278	8	2	68	0.0294118
NODE_210691_length_278_cov_1.139665	210	278	9	21	68	0.3088235
NODE_210691_length_278_cov_1.139665	210	278	10	9	68	0.1323529
NODE_212166_length_277_cov_2.691011	0	60	0	60	60	1.0000000
NODE_212166_length_277_cov_2.691011	33	113	0	80	80	1.0000000
NODE_212175_length_277_cov_2.617978	85	127	0	42	42	1.0000000
NODE_212233_length_277_cov_2.438202	137	218	4	8	81	0.0987654
NODE_212233_length_277_cov_2.438202	137	218	6	27	81	0.3333333
NODE_212233_length_277_cov_2.438202	137	218	10	23	81	0.2839506
NODE_212233_length_277_cov_2.438202	137	218	12	3	81	0.0370370
NODE_212233_length_277_cov_2.438202	137	218	14	20	81	0.2469136
NODE_212357_length_277_cov_2.140449	234	276	0	42	42	1.0000000
NODE_212377_length_277_cov_2.095506	41	114	0	73	73	1.0000000
NODE_212377_length_277_cov_2.095506	41	114	0	73	73	1.0000000
NODE_212377_length_277_cov_2.095506	94	161	0	67	67	1.0000000
NODE_212525_length_277_cov_1.837079	92	172	2	34	80	0.4250000
NODE_212525_length_277_cov_1.837079	92	172	4	46	80	0.5750000
NODE_212558_length_277_cov_1.764045	115	155	0	13	40	0.3250000
NODE_212558_length_277_cov_1.764045	115	155	2	13	40	0.3250000
NODE_212558_length_277_cov_1.764045	115	155	4	6	40	0.1500000
NODE_212558_length_277_cov_1.764045	115	155	8	1	40	0.0250000
NODE_212558_length_277_cov_1.764045	115	155	10	7	40	0.1750000
NODE_212605_length_277_cov_1.719101	150	215	0	65	65	1.0000000
NODE_212845_length_277_cov_1.505618	0	47	0	47	47	1.0000000
NODE_212845_length_277_cov_1.505618	20	100	0	80	80	1.0000000
NODE_212970_length_277_cov_1.426966	113	191	0	54	78	0.6923077
NODE_212970_length_277_cov_1.426966	113	191	2	24	78	0.3076923
NODE_213057_length_277_cov_1.314607	127	176	7	4	49	0.0816327
NODE_213057_length_277_cov_1.314607	127	176	8	12	49	0.2448980
NODE_213057_length_277_cov_1.314607	127	176	9	31	49	0.6326531
NODE_213057_length_277_cov_1.314607	127	176	11	2	49	0.0408163
NODE_213091_length_277_cov_1.258427	141	222	0	55	81	0.6790124
NODE_213091_length_277_cov_1.258427	141	222	2	26	81	0.3209876
NODE_213223_length_277_cov_1.146067	19	95	0	3	76	0.0394737
NODE_213223_length_277_cov_1.146067	19	95	1	10	76	0.1315790
NODE_213223_length_277_cov_1.146067	19	95	2	2	76	0.0263158
NODE_213223_length_277_cov_1.146067	19	95	4	13	76	0.1710526
NODE_213223_length_277_cov_1.146067	19	95	8	1	76	0.0131579
NODE_213223_length_277_cov_1.146067	19	95	10	7	76	0.0921053
NODE_213223_length_277_cov_1.146067	19	95	12	3	76	0.0394737
NODE_213223_length_277_cov_1.146067	19	95	14	7	76	0.0921053
NODE_213223_length_277_cov_1.146067	19	95	16	13	76	0.1710526
NODE_213223_length_277_cov_1.146067	19	95	17	3	76	0.0394737
NODE_213223_length_277_cov_1.146067	19	95	20	9	76	0.1184211
NODE_213223_length_277_cov_1.146067	19	95	21	5	76	0.0657895
NODE_213490_length_277_cov_1.061798	67	105	0	38	38	1.0000000
NODE_213505_length_277_cov_1.044944	19	77	0	58	58	1.0000000
NODE_214572_length_276_cov_31.774011	91	153	12	4	62	0.0645161
NODE_214572_length_276_cov_31.774011	91	153	14	1	62	0.0161290
NODE_214572_length_276_cov_31.774011	91	153	16	3	62	0.0483871
NODE_214572_length_276_cov_31.774011	91	153	19	1	62	0.0161290
NODE_214572_length_276_cov_31.774011	91	153	20	3	62	0.0483871
NODE_214572_length_276_cov_31.774011	91	153	23	1	62	0.0161290
NODE_214572_length_276_cov_31.774011	91	153	24	1	62	0.0161290
NODE_214572_length_276_cov_31.774011	91	153	26	8	62	0.1290323
NODE_214572_length_276_cov_31.774011	91	153	28	1	62	0.0161290
NODE_214572_length_276_cov_31.774011	91	153	30	1	62	0.0161290
NODE_214572_length_276_cov_31.774011	91	153	33	2	62	0.0322581
NODE_214572_length_276_cov_31.774011	91	153	35	1	62	0.0161290
NODE_214572_length_276_cov_31.774011	91	153	36	1	62	0.0161290
NODE_214572_length_276_cov_31.774011	91	153	37	1	62	0.0161290
NODE_214572_length_276_cov_31.774011	91	153	47	1	62	0.0161290
NODE_214572_length_276_cov_31.774011	91	153	50	1	62	0.0161290
NODE_214572_length_276_cov_31.774011	91	153	53	1	62	0.0161290
NODE_214572_length_276_cov_31.774011	91	153	57	1	62	0.0161290
NODE_214572_length_276_cov_31.774011	91	153	62	1	62	0.0161290
NODE_214572_length_276_cov_31.774011	91	153	65	1	62	0.0161290
NODE_214572_length_276_cov_31.774011	91	153	67	1	62	0.0161290
NODE_214572_length_276_cov_31.774011	91	153	69	1	62	0.0161290
NODE_214572_length_276_cov_31.774011	91	153	71	2	62	0.0322581
NODE_214572_length_276_cov_31.774011	91	153	73	1	62	0.0161290
NODE_214572_length_276_cov_31.774011	91	153	75	1	62	0.0161290
NODE_214572_length_276_cov_31.774011	91	153	76	3	62	0.0483871
NODE_214572_length_276_cov_31.774011	91	153	77	2	62	0.0322581
NODE_214572_length_276_cov_31.774011	91	153	79	1	62	0.0161290
NODE_214572_length_276_cov_31.774011	91	153	81	1	62	0.0161290
NODE_214572_length_276_cov_31.774011	91	153	83	2	62	0.0322581
NODE_214572_length_276_cov_31.774011	91	153	85	4	62	0.0645161
NODE_214572_length_276_cov_31.774011	91	153	87	1	62	0.0161290
NODE_214572_length_276_cov_31.774011	91	153	91	5	62	0.0806452
NODE_214572_length_276_cov_31.774011	91	153	95	1	62	0.0161290
NODE_214572_length_276_cov_31.774011	91	153	96	1	62	0.0161290
NODE_214576_length_276_cov_10.056497	66	146	0	8	80	0.1000000
NODE_214576_length_276_cov_10.056497	66	146	4	36	80	0.4500000
NODE_214576_length_276_cov_10.056497	66	146	6	36	80	0.4500000
NODE_214698_length_276_cov_3.564972	176	256	0	7	80	0.0875000
NODE_214698_length_276_cov_3.564972	176	256	2	11	80	0.1375000
NODE_214698_length_276_cov_3.564972	176	256	4	45	80	0.5625000
NODE_214698_length_276_cov_3.564972	176	256	6	17	80	0.2125000
NODE_214785_length_276_cov_2.920904	203	260	0	57	57	1.0000000
NODE_214785_length_276_cov_2.920904	233	276	0	43	43	1.0000000
NODE_214883_length_276_cov_2.542373	164	204	10	2	40	0.0500000
NODE_214883_length_276_cov_2.542373	164	204	12	4	40	0.1000000
NODE_214883_length_276_cov_2.542373	164	204	14	2	40	0.0500000
NODE_214883_length_276_cov_2.542373	164	204	16	13	40	0.3250000
NODE_214883_length_276_cov_2.542373	164	204	18	13	40	0.3250000
NODE_214883_length_276_cov_2.542373	164	204	20	6	40	0.1500000
NODE_215016_length_276_cov_2.197740	64	144	2	33	80	0.4125000
NODE_215016_length_276_cov_2.197740	64	144	4	12	80	0.1500000
NODE_215016_length_276_cov_2.197740	64	144	6	35	80	0.4375000
NODE_215086_length_276_cov_2.022599	136	193	0	14	57	0.2456140
NODE_215086_length_276_cov_2.022599	136	193	2	26	57	0.4561403
NODE_215086_length_276_cov_2.022599	136	193	4	10	57	0.1754386
NODE_215086_length_276_cov_2.022599	136	193	6	7	57	0.1228070
NODE_215105_length_276_cov_2.016949	97	138	0	16	41	0.3902439
NODE_215105_length_276_cov_2.016949	97	138	2	25	41	0.6097561
NODE_215139_length_276_cov_2.005650	82	153	2	71	71	1.0000000
NODE_215234_length_276_cov_1.734463	102	182	24	5	80	0.0625000
NODE_215234_length_276_cov_1.734463	102	182	26	2	80	0.0250000
NODE_215234_length_276_cov_1.734463	102	182	30	1	80	0.0125000
NODE_215234_length_276_cov_1.734463	102	182	32	1	80	0.0125000
NODE_215234_length_276_cov_1.734463	102	182	36	2	80	0.0250000
NODE_215234_length_276_cov_1.734463	102	182	40	1	80	0.0125000
NODE_215234_length_276_cov_1.734463	102	182	44	1	80	0.0125000
NODE_215234_length_276_cov_1.734463	102	182	48	3	80	0.0375000
NODE_215234_length_276_cov_1.734463	102	182	50	3	80	0.0375000
NODE_215234_length_276_cov_1.734463	102	182	54	1	80	0.0125000
NODE_215234_length_276_cov_1.734463	102	182	56	1	80	0.0125000
NODE_215234_length_276_cov_1.734463	102	182	58	4	80	0.0500000
NODE_215234_length_276_cov_1.734463	102	182	60	3	80	0.0375000
NODE_215234_length_276_cov_1.734463	102	182	66	1	80	0.0125000
NODE_215234_length_276_cov_1.734463	102	182	68	4	80	0.0500000
NODE_215234_length_276_cov_1.734463	102	182	70	1	80	0.0125000
NODE_215234_length_276_cov_1.734463	102	182	72	2	80	0.0250000
NODE_215234_length_276_cov_1.734463	102	182	74	1	80	0.0125000
NODE_215234_length_276_cov_1.734463	102	182	76	1	80	0.0125000
NODE_215234_length_276_cov_1.734463	102	182	78	7	80	0.0875000
NODE_215234_length_276_cov_1.734463	102	182	80	1	80	0.0125000
NODE_215234_length_276_cov_1.734463	102	182	82	1	80	0.0125000
NODE_215234_length_276_cov_1.734463	102	182	84	4	80	0.0500000
NODE_215234_length_276_cov_1.734463	102	182	86	10	80	0.1250000
NODE_215234_length_276_cov_1.734463	102	182	88	3	80	0.0375000
NODE_215234_length_276_cov_1.734463	102	182	90	1	80	0.0125000
NODE_215234_length_276_cov_1.734463	102	182	92	2	80	0.0250000
NODE_215234_length_276_cov_1.734463	102	182	96	5	80	0.0625000
NODE_215234_length_276_cov_1.734463	102	182	97	1	80	0.0125000
NODE_215234_length_276_cov_1.734463	102	182	98	7	80	0.0875000
NODE_215516_length_276_cov_1.525424	70	116	0	8	46	0.1739130
NODE_215516_length_276_cov_1.525424	70	116	2	6	46	0.1304348
NODE_215516_length_276_cov_1.525424	70	116	4	32	46	0.6956522
NODE_215516_length_276_cov_1.525424	123	169	0	1	46	0.0217391
NODE_215516_length_276_cov_1.525424	123	169	2	2	46	0.0434783
NODE_215516_length_276_cov_1.525424	123	169	4	43	46	0.9347826
NODE_215519_length_276_cov_1.514124	115	155	24	40	40	1.0000000
NODE_215748_length_276_cov_1.288136	114	154	16	16	40	0.4000000
NODE_215748_length_276_cov_1.288136	114	154	18	8	40	0.2000000
NODE_215748_length_276_cov_1.288136	114	154	20	16	40	0.4000000
NODE_216141_length_276_cov_1.124294	122	170	2	48	48	1.0000000
NODE_216141_length_276_cov_1.124294	132	163	2	31	31	1.0000000
NODE_216220_length_276_cov_1.039548	7	68	8	61	61	1.0000000
NODE_216220_length_276_cov_1.039548	7	70	8	63	63	1.0000000
NODE_216220_length_276_cov_1.039548	7	70	8	63	63	1.0000000
NODE_216220_length_276_cov_1.039548	7	70	8	63	63	1.0000000
NODE_216269_length_276_cov_1.000000	48	89	10	41	41	1.0000000
NODE_216269_length_276_cov_1.000000	62	106	10	44	44	1.0000000
NODE_216414_length_276_cov_0.898305	54	105	0	51	51	1.0000000
NODE_217265_length_275_cov_85.085227	94	174	0	12	80	0.1500000
NODE_217265_length_275_cov_85.085227	94	174	4	16	80	0.2000000
NODE_217265_length_275_cov_85.085227	94	174	8	36	80	0.4500000
NODE_217265_length_275_cov_85.085227	94	174	10	16	80	0.2000000
NODE_217265_length_275_cov_85.085227	147	227	0	65	80	0.8125000
NODE_217265_length_275_cov_85.085227	147	227	4	15	80	0.1875000
NODE_217287_length_275_cov_5.818182	0	44	0	44	44	1.0000000
NODE_217355_length_275_cov_3.857955	0	67	0	67	67	1.0000000
NODE_217396_length_275_cov_3.306818	199	275	0	22	76	0.2894737
NODE_217396_length_275_cov_3.306818	199	275	2	54	76	0.7105263
NODE_217402_length_275_cov_3.284091	127	175	0	48	48	1.0000000
NODE_217433_length_275_cov_2.977273	95	145	12	1	50	0.0200000
NODE_217433_length_275_cov_2.977273	95	145	14	11	50	0.2200000
NODE_217433_length_275_cov_2.977273	95	145	16	31	50	0.6200000
NODE_217433_length_275_cov_2.977273	95	145	18	7	50	0.1400000
NODE_217531_length_275_cov_2.585227	85	122	57	9	37	0.2432432
NODE_217531_length_275_cov_2.585227	85	122	58	3	37	0.0810811
NODE_217531_length_275_cov_2.585227	85	122	60	4	37	0.1081081
NODE_217531_length_275_cov_2.585227	85	122	62	3	37	0.0810811
NODE_217531_length_275_cov_2.585227	85	122	64	9	37	0.2432432
NODE_217531_length_275_cov_2.585227	85	122	66	9	37	0.2432432
NODE_217714_length_275_cov_2.090909	0	47	0	20	47	0.4255319
NODE_217714_length_275_cov_2.090909	0	47	2	27	47	0.5744681
NODE_217714_length_275_cov_2.090909	20	91	2	71	71	1.0000000
NODE_217801_length_275_cov_1.960227	198	251	0	2	53	0.0377358
NODE_217801_length_275_cov_1.960227	198	251	1	1	53	0.0188679
NODE_217801_length_275_cov_1.960227	198	251	2	9	53	0.1698113
NODE_217801_length_275_cov_1.960227	198	251	12	41	53	0.7735849
NODE_217835_length_275_cov_1.875000	190	247	0	57	57	1.0000000
NODE_217839_length_275_cov_1.857955	52	119	2	4	67	0.0597015
NODE_217839_length_275_cov_1.857955	52	119	4	3	67	0.0447761
NODE_217839_length_275_cov_1.857955	52	119	8	15	67	0.2238806
NODE_217839_length_275_cov_1.857955	52	119	10	2	67	0.0298507
NODE_217839_length_275_cov_1.857955	52	119	12	25	67	0.3731343
NODE_217839_length_275_cov_1.857955	52	119	14	18	67	0.2686567
NODE_217839_length_275_cov_1.857955	136	182	4	7	46	0.1521739
NODE_217839_length_275_cov_1.857955	136	182	6	15	46	0.3260870
NODE_217839_length_275_cov_1.857955	136	182	10	11	46	0.2391304
NODE_217839_length_275_cov_1.857955	136	182	14	13	46	0.2826087
NODE_217885_length_275_cov_1.755682	21	76	2	26	55	0.4727273
NODE_217885_length_275_cov_1.755682	21	76	4	29	55	0.5272727
NODE_217912_length_275_cov_1.738636	225	256	0	31	31	1.0000000
NODE_217967_length_275_cov_1.738636	161	241	0	80	80	1.0000000
NODE_218257_length_275_cov_1.448864	123	155	8	13	32	0.4062500
NODE_218257_length_275_cov_1.448864	123	155	10	19	32	0.5937500
NODE_218402_length_275_cov_1.301136	132	196	0	64	64	1.0000000
NODE_218706_length_275_cov_1.159091	13	93	0	5	80	0.0625000
NODE_218706_length_275_cov_1.159091	13	93	2	18	80	0.2250000
NODE_218706_length_275_cov_1.159091	13	93	4	57	80	0.7125000
NODE_218734_length_275_cov_1.153409	11	91	0	8	80	0.1000000
NODE_218734_length_275_cov_1.153409	11	91	2	5	80	0.0625000
NODE_218734_length_275_cov_1.153409	11	91	4	67	80	0.8375000
NODE_219031_length_275_cov_0.937500	13	49	13	5	36	0.1388889
NODE_219031_length_275_cov_0.937500	13	49	17	3	36	0.0833333
NODE_219031_length_275_cov_0.937500	13	49	33	2	36	0.0555556
NODE_219031_length_275_cov_0.937500	13	49	35	3	36	0.0833333
NODE_219031_length_275_cov_0.937500	13	49	37	1	36	0.0277778
NODE_219031_length_275_cov_0.937500	13	49	38	5	36	0.1388889
NODE_219031_length_275_cov_0.937500	13	49	42	2	36	0.0555556
NODE_219031_length_275_cov_0.937500	13	49	44	6	36	0.1666667
NODE_219031_length_275_cov_0.937500	13	49	46	1	36	0.0277778
NODE_219031_length_275_cov_0.937500	13	49	48	1	36	0.0277778
NODE_219031_length_275_cov_0.937500	13	49	50	1	36	0.0277778
NODE_219031_length_275_cov_0.937500	13	49	54	1	36	0.0277778
NODE_219031_length_275_cov_0.937500	13	49	56	3	36	0.0833333
NODE_219031_length_275_cov_0.937500	13	49	60	1	36	0.0277778
NODE_219031_length_275_cov_0.937500	13	49	62	1	36	0.0277778
NODE_219031_length_275_cov_0.937500	22	86	33	1	64	0.0156250
NODE_219031_length_275_cov_0.937500	22	86	35	3	64	0.0468750
NODE_219031_length_275_cov_0.937500	22	86	37	1	64	0.0156250
NODE_219031_length_275_cov_0.937500	22	86	38	5	64	0.0781250
NODE_219031_length_275_cov_0.937500	22	86	42	2	64	0.0312500
NODE_219031_length_275_cov_0.937500	22	86	44	6	64	0.0937500
NODE_219031_length_275_cov_0.937500	22	86	46	1	64	0.0156250
NODE_219031_length_275_cov_0.937500	22	86	48	1	64	0.0156250
NODE_219031_length_275_cov_0.937500	22	86	50	1	64	0.0156250
NODE_219031_length_275_cov_0.937500	22	86	54	1	64	0.0156250
NODE_219031_length_275_cov_0.937500	22	86	56	3	64	0.0468750
NODE_219031_length_275_cov_0.937500	22	86	60	1	64	0.0156250
NODE_219031_length_275_cov_0.937500	22	86	62	5	64	0.0781250
NODE_219031_length_275_cov_0.937500	22	86	65	4	64	0.0625000
NODE_219031_length_275_cov_0.937500	22	86	67	1	64	0.0156250
NODE_219031_length_275_cov_0.937500	22	86	69	16	64	0.2500000
NODE_219031_length_275_cov_0.937500	22	86	73	4	64	0.0625000
NODE_219031_length_275_cov_0.937500	22	86	74	1	64	0.0156250
NODE_219031_length_275_cov_0.937500	22	86	80	1	64	0.0156250
NODE_219031_length_275_cov_0.937500	22	86	84	2	64	0.0312500
NODE_219031_length_275_cov_0.937500	22	86	88	1	64	0.0156250
NODE_219031_length_275_cov_0.937500	22	86	92	1	64	0.0156250
NODE_219031_length_275_cov_0.937500	22	86	98	2	64	0.0312500
NODE_219220_length_275_cov_0.869318	67	126	0	59	59	1.0000000
NODE_219655_length_275_cov_0.579545	40	70	0	30	30	1.0000000
NODE_220021_length_274_cov_6.074286	141	175	0	34	34	1.0000000
NODE_220047_length_274_cov_4.845714	48	105	0	57	57	1.0000000
NODE_220047_length_274_cov_4.845714	113	175	0	62	62	1.0000000
NODE_220078_length_274_cov_4.080000	210	274	0	64	64	1.0000000
NODE_220215_length_274_cov_2.988571	104	161	0	57	57	1.0000000
NODE_220221_length_274_cov_2.937143	199	234	0	35	35	1.0000000
NODE_220293_length_274_cov_2.622857	29	76	2	36	47	0.7659575
NODE_220293_length_274_cov_2.622857	29	76	6	11	47	0.2340426
NODE_220293_length_274_cov_2.622857	82	157	4	75	75	1.0000000
NODE_220413_length_274_cov_2.308571	51	130	5	1	79	0.0126582
NODE_220413_length_274_cov_2.308571	51	130	8	4	79	0.0506329
NODE_220413_length_274_cov_2.308571	51	130	12	2	79	0.0253165
NODE_220413_length_274_cov_2.308571	51	130	14	1	79	0.0126582
NODE_220413_length_274_cov_2.308571	51	130	18	8	79	0.1012658
NODE_220413_length_274_cov_2.308571	51	130	22	5	79	0.0632911
NODE_220413_length_274_cov_2.308571	51	130	24	7	79	0.0886076
NODE_220413_length_274_cov_2.308571	51	130	30	1	79	0.0126582
NODE_220413_length_274_cov_2.308571	51	130	32	1	79	0.0126582
NODE_220413_length_274_cov_2.308571	51	130	34	1	79	0.0126582
NODE_220413_length_274_cov_2.308571	51	130	40	3	79	0.0379747
NODE_220413_length_274_cov_2.308571	51	130	42	1	79	0.0126582
NODE_220413_length_274_cov_2.308571	51	130	46	1	79	0.0126582
NODE_220413_length_274_cov_2.308571	51	130	48	2	79	0.0253165
NODE_220413_length_274_cov_2.308571	51	130	50	4	79	0.0506329
NODE_220413_length_274_cov_2.308571	51	130	56	3	79	0.0379747
NODE_220413_length_274_cov_2.308571	51	130	58	2	79	0.0253165
NODE_220413_length_274_cov_2.308571	51	130	60	1	79	0.0126582
NODE_220413_length_274_cov_2.308571	51	130	62	2	79	0.0253165
NODE_220413_length_274_cov_2.308571	51	130	66	1	79	0.0126582
NODE_220413_length_274_cov_2.308571	51	130	72	2	79	0.0253165
NODE_220413_length_274_cov_2.308571	51	130	74	1	79	0.0126582
NODE_220413_length_274_cov_2.308571	51	130	78	3	79	0.0379747
NODE_220413_length_274_cov_2.308571	51	130	80	2	79	0.0253165
NODE_220413_length_274_cov_2.308571	51	130	81	1	79	0.0126582
NODE_220413_length_274_cov_2.308571	51	130	83	3	79	0.0379747
NODE_220413_length_274_cov_2.308571	51	130	85	7	79	0.0886076
NODE_220413_length_274_cov_2.308571	51	130	87	1	79	0.0126582
NODE_220413_length_274_cov_2.308571	51	130	88	7	79	0.0886076
NODE_220413_length_274_cov_2.308571	51	130	94	1	79	0.0126582
NODE_220504_length_274_cov_2.062857	172	242	0	70	70	1.0000000
NODE_220504_length_274_cov_2.062857	215	256	0	41	41	1.0000000
NODE_220662_length_274_cov_1.754286	219	259	0	40	40	1.0000000
NODE_220681_length_274_cov_1.748571	168	231	8	9	63	0.1428571
NODE_220681_length_274_cov_1.748571	168	231	12	7	63	0.1111111
NODE_220681_length_274_cov_1.748571	168	231	13	2	63	0.0317460
NODE_220681_length_274_cov_1.748571	168	231	14	45	63	0.7142857
NODE_220806_length_274_cov_1.737143	134	172	0	19	38	0.5000000
NODE_220806_length_274_cov_1.737143	134	172	2	19	38	0.5000000
NODE_220847_length_274_cov_1.685714	132	189	2	19	57	0.3333333
NODE_220847_length_274_cov_1.685714	132	189	4	38	57	0.6666667
NODE_220847_length_274_cov_1.685714	141	199	2	19	58	0.3275862
NODE_220847_length_274_cov_1.685714	141	199	4	39	58	0.6724138
NODE_220966_length_274_cov_1.502857	170	232	0	62	62	1.0000000
NODE_220966_length_274_cov_1.502857	223	274	0	51	51	1.0000000
NODE_221005_length_274_cov_1.457143	118	147	0	29	29	1.0000000
NODE_221101_length_274_cov_1.434286	25	69	0	44	44	1.0000000
NODE_221211_length_274_cov_1.285714	84	156	0	72	72	1.0000000
NODE_221612_length_274_cov_1.131429	205	251	0	44	46	0.9565217
NODE_221612_length_274_cov_1.131429	205	251	2	2	46	0.0434783
NODE_221764_length_274_cov_0.994286	219	260	0	41	41	1.0000000
NODE_222849_length_273_cov_4.948276	204	262	0	58	58	1.0000000
NODE_222849_length_273_cov_4.948276	204	258	0	54	54	1.0000000
NODE_222914_length_273_cov_3.712644	103	183	2	1	80	0.0125000
NODE_222914_length_273_cov_3.712644	103	183	5	1	80	0.0125000
NODE_222914_length_273_cov_3.712644	103	183	9	1	80	0.0125000
NODE_222914_length_273_cov_3.712644	103	183	13	1	80	0.0125000
NODE_222914_length_273_cov_3.712644	103	183	15	1	80	0.0125000
NODE_222914_length_273_cov_3.712644	103	183	17	2	80	0.0250000
NODE_222914_length_273_cov_3.712644	103	183	21	2	80	0.0250000
NODE_222914_length_273_cov_3.712644	103	183	23	1	80	0.0125000
NODE_222914_length_273_cov_3.712644	103	183	27	11	80	0.1375000
NODE_222914_length_273_cov_3.712644	103	183	31	1	80	0.0125000
NODE_222914_length_273_cov_3.712644	103	183	35	4	80	0.0500000
NODE_222914_length_273_cov_3.712644	103	183	36	10	80	0.1250000
NODE_222914_length_273_cov_3.712644	103	183	38	5	80	0.0625000
NODE_222914_length_273_cov_3.712644	103	183	40	39	80	0.4875000
NODE_222955_length_273_cov_3.298851	69	100	0	31	31	1.0000000
NODE_222955_length_273_cov_3.298851	73	153	0	80	80	1.0000000
NODE_222974_length_273_cov_3.195402	122	189	2	1	67	0.0149254
NODE_222974_length_273_cov_3.195402	122	189	4	52	67	0.7761194
NODE_222974_length_273_cov_3.195402	122	189	6	14	67	0.2089552
NODE_222991_length_273_cov_3.063218	76	151	28	3	75	0.0400000
NODE_222991_length_273_cov_3.063218	76	151	30	4	75	0.0533333
NODE_222991_length_273_cov_3.063218	76	151	32	8	75	0.1066667
NODE_222991_length_273_cov_3.063218	76	151	34	1	75	0.0133333
NODE_222991_length_273_cov_3.063218	76	151	38	1	75	0.0133333
NODE_222991_length_273_cov_3.063218	76	151	40	4	75	0.0533333
NODE_222991_length_273_cov_3.063218	76	151	44	5	75	0.0666667
NODE_222991_length_273_cov_3.063218	76	151	46	1	75	0.0133333
NODE_222991_length_273_cov_3.063218	76	151	48	5	75	0.0666667
NODE_222991_length_273_cov_3.063218	76	151	50	7	75	0.0933333
NODE_222991_length_273_cov_3.063218	76	151	52	3	75	0.0400000
NODE_222991_length_273_cov_3.063218	76	151	56	26	75	0.3466667
NODE_222991_length_273_cov_3.063218	76	151	58	7	75	0.0933333
NODE_222991_length_273_cov_3.063218	135	191	8	3	56	0.0535714
NODE_222991_length_273_cov_3.063218	135	191	10	1	56	0.0178571
NODE_222991_length_273_cov_3.063218	135	191	12	4	56	0.0714286
NODE_222991_length_273_cov_3.063218	135	191	18	1	56	0.0178571
NODE_222991_length_273_cov_3.063218	135	191	20	4	56	0.0714286
NODE_222991_length_273_cov_3.063218	135	191	23	11	56	0.1964286
NODE_222991_length_273_cov_3.063218	135	191	24	3	56	0.0535714
NODE_222991_length_273_cov_3.063218	135	191	26	5	56	0.0892857
NODE_222991_length_273_cov_3.063218	135	191	28	11	56	0.1964286
NODE_222991_length_273_cov_3.063218	135	191	30	4	56	0.0714286
NODE_222991_length_273_cov_3.063218	135	191	32	8	56	0.1428571
NODE_222991_length_273_cov_3.063218	135	191	34	1	56	0.0178571
NODE_223066_length_273_cov_2.706897	11	45	0	34	34	1.0000000
NODE_223203_length_273_cov_2.339080	69	145	2	14	76	0.1842105
NODE_223203_length_273_cov_2.339080	69	145	6	13	76	0.1710526
NODE_223203_length_273_cov_2.339080	69	145	7	1	76	0.0131579
NODE_223203_length_273_cov_2.339080	69	145	10	2	76	0.0263158
NODE_223203_length_273_cov_2.339080	69	145	12	2	76	0.0263158
NODE_223203_length_273_cov_2.339080	69	145	16	2	76	0.0263158
NODE_223203_length_273_cov_2.339080	69	145	20	21	76	0.2763158
NODE_223203_length_273_cov_2.339080	69	145	22	21	76	0.2763158
NODE_223353_length_273_cov_2.051724	31	74	0	43	43	1.0000000
NODE_223377_length_273_cov_2.034483	81	161	4	37	80	0.4625000
NODE_223377_length_273_cov_2.034483	81	161	6	4	80	0.0500000
NODE_223377_length_273_cov_2.034483	81	161	8	39	80	0.4875000
NODE_223377_length_273_cov_2.034483	213	263	0	4	50	0.0800000
NODE_223377_length_273_cov_2.034483	213	263	2	20	50	0.4000000
NODE_223377_length_273_cov_2.034483	213	263	4	26	50	0.5200000
NODE_223680_length_273_cov_1.706897	181	238	2	57	57	1.0000000
NODE_223913_length_273_cov_1.442529	5	47	0	5	42	0.1190476
NODE_223913_length_273_cov_1.442529	5	47	2	37	42	0.8809524
NODE_224023_length_273_cov_1.281609	167	247	0	70	80	0.8750000
NODE_224023_length_273_cov_1.281609	167	247	2	10	80	0.1250000
NODE_224082_length_273_cov_1.189655	120	156	0	36	36	1.0000000
NODE_224082_length_273_cov_1.189655	129	160	0	31	31	1.0000000
NODE_224165_length_273_cov_1.172414	94	130	2	36	36	1.0000000
NODE_224254_length_273_cov_1.172414	8	58	4	50	50	1.0000000
NODE_224367_length_273_cov_1.166667	74	93	3	19	19	1.0000000
NODE_224441_length_273_cov_1.091954	6	42	0	1	36	0.0277778
NODE_224441_length_273_cov_1.091954	6	42	6	5	36	0.1388889
NODE_224441_length_273_cov_1.091954	6	42	8	8	36	0.2222222
NODE_224441_length_273_cov_1.091954	6	42	10	22	36	0.6111111
NODE_224441_length_273_cov_1.091954	43	95	8	16	52	0.3076923
NODE_224441_length_273_cov_1.091954	43	95	10	36	52	0.6923077
NODE_224587_length_273_cov_0.971264	188	235	4	23	47	0.4893617
NODE_224587_length_273_cov_0.971264	188	235	6	24	47	0.5106383
NODE_225303_length_273_cov_0.586207	27	88	0	61	61	1.0000000
NODE_225344_length_273_cov_0.586207	24	79	0	12	55	0.2181818
NODE_225344_length_273_cov_0.586207	24	79	2	43	55	0.7818182
NODE_225344_length_273_cov_0.586207	81	113	2	9	32	0.2812500
NODE_225344_length_273_cov_0.586207	81	113	4	23	32	0.7187500
NODE_225592_length_272_cov_6.190751	172	236	0	64	64	1.0000000
NODE_225607_length_272_cov_5.335260	193	272	0	79	79	1.0000000
NODE_225633_length_272_cov_4.716763	228	257	0	29	29	1.0000000
NODE_225656_length_272_cov_4.219653	93	166	0	5	73	0.0684932
NODE_225656_length_272_cov_4.219653	93	166	2	23	73	0.3150685
NODE_225656_length_272_cov_4.219653	93	166	6	2	73	0.0273973
NODE_225656_length_272_cov_4.219653	93	166	7	1	73	0.0136986
NODE_225656_length_272_cov_4.219653	93	166	8	42	73	0.5753425
NODE_225656_length_272_cov_4.219653	146	219	6	6	73	0.0821918
NODE_225656_length_272_cov_4.219653	146	219	8	67	73	0.9178082
NODE_225658_length_272_cov_4.184971	75	128	16	9	53	0.1698113
NODE_225658_length_272_cov_4.184971	75	128	18	44	53	0.8301887
NODE_225739_length_272_cov_3.352601	154	199	2	45	45	1.0000000
NODE_225872_length_272_cov_2.664740	106	186	2	4	80	0.0500000
NODE_225872_length_272_cov_2.664740	106	186	4	24	80	0.3000000
NODE_225872_length_272_cov_2.664740	106	186	8	52	80	0.6500000
NODE_226010_length_272_cov_2.335260	33	103	0	70	70	1.0000000
NODE_226029_length_272_cov_2.277457	219	256	2	37	37	1.0000000
NODE_226045_length_272_cov_2.236994	104	184	4	24	80	0.3000000
NODE_226045_length_272_cov_2.236994	104	184	6	1	80	0.0125000
NODE_226045_length_272_cov_2.236994	104	184	8	10	80	0.1250000
NODE_226045_length_272_cov_2.236994	104	184	10	5	80	0.0625000
NODE_226045_length_272_cov_2.236994	104	184	12	6	80	0.0750000
NODE_226045_length_272_cov_2.236994	104	184	14	2	80	0.0250000
NODE_226045_length_272_cov_2.236994	104	184	16	26	80	0.3250000
NODE_226045_length_272_cov_2.236994	104	184	18	6	80	0.0750000
NODE_226169_length_272_cov_1.982659	172	252	0	80	80	1.0000000
NODE_226245_length_272_cov_1.780347	37	99	2	3	62	0.0483871
NODE_226245_length_272_cov_1.780347	37	99	4	1	62	0.0161290
NODE_226245_length_272_cov_1.780347	37	99	5	42	62	0.6774194
NODE_226245_length_272_cov_1.780347	37	99	6	16	62	0.2580645
NODE_226245_length_272_cov_1.780347	90	152	0	5	62	0.0806452
NODE_226245_length_272_cov_1.780347	90	152	2	7	62	0.1129032
NODE_226245_length_272_cov_1.780347	90	152	4	28	62	0.4516129
NODE_226245_length_272_cov_1.780347	90	152	5	22	62	0.3548387
NODE_226248_length_272_cov_1.768786	12	45	0	33	33	1.0000000
NODE_226461_length_272_cov_1.618497	97	160	6	3	63	0.0476190
NODE_226461_length_272_cov_1.618497	97	160	8	3	63	0.0476190
NODE_226461_length_272_cov_1.618497	97	160	12	1	63	0.0158730
NODE_226461_length_272_cov_1.618497	97	160	14	6	63	0.0952381
NODE_226461_length_272_cov_1.618497	97	160	16	2	63	0.0317460
NODE_226461_length_272_cov_1.618497	97	160	18	2	63	0.0317460
NODE_226461_length_272_cov_1.618497	97	160	19	1	63	0.0158730
NODE_226461_length_272_cov_1.618497	97	160	21	3	63	0.0476190
NODE_226461_length_272_cov_1.618497	97	160	26	6	63	0.0952381
NODE_226461_length_272_cov_1.618497	97	160	28	1	63	0.0158730
NODE_226461_length_272_cov_1.618497	97	160	29	2	63	0.0317460
NODE_226461_length_272_cov_1.618497	97	160	30	4	63	0.0634921
NODE_226461_length_272_cov_1.618497	97	160	31	9	63	0.1428571
NODE_226461_length_272_cov_1.618497	97	160	33	1	63	0.0158730
NODE_226461_length_272_cov_1.618497	97	160	35	5	63	0.0793651
NODE_226461_length_272_cov_1.618497	97	160	37	13	63	0.2063492
NODE_226461_length_272_cov_1.618497	97	160	41	1	63	0.0158730
NODE_226508_length_272_cov_1.543353	69	137	4	68	68	1.0000000
NODE_227037_length_272_cov_1.173410	147	203	6	53	56	0.9464286
NODE_227037_length_272_cov_1.173410	147	203	8	3	56	0.0535714
NODE_227265_length_272_cov_0.988439	169	215	0	46	46	1.0000000
NODE_227444_length_272_cov_0.884393	126	163	0	37	37	1.0000000
NODE_228332_length_271_cov_5.238372	103	183	0	80	80	1.0000000
NODE_228423_length_271_cov_3.546512	102	165	0	63	63	1.0000000
NODE_228429_length_271_cov_3.476744	62	93	0	31	31	1.0000000
NODE_228494_length_271_cov_2.959302	96	176	0	52	80	0.6500000
NODE_228494_length_271_cov_2.959302	96	176	2	3	80	0.0375000
NODE_228494_length_271_cov_2.959302	96	176	4	25	80	0.3125000
NODE_228494_length_271_cov_2.959302	149	229	2	4	80	0.0500000
NODE_228494_length_271_cov_2.959302	149	229	4	76	80	0.9500000
NODE_228554_length_271_cov_2.715116	160	241	0	81	81	1.0000000
NODE_228593_length_271_cov_2.622093	180	253	0	73	73	1.0000000
NODE_228623_length_271_cov_2.465116	45	75	0	30	30	1.0000000
NODE_228731_length_271_cov_2.284884	95	158	12	49	63	0.7777778
NODE_228731_length_271_cov_2.284884	95	158	14	14	63	0.2222222
NODE_228731_length_271_cov_2.284884	131	211	0	6	80	0.0750000
NODE_228731_length_271_cov_2.284884	131	211	2	21	80	0.2625000
NODE_228731_length_271_cov_2.284884	131	211	4	21	80	0.2625000
NODE_228731_length_271_cov_2.284884	131	211	6	5	80	0.0625000
NODE_228731_length_271_cov_2.284884	131	211	12	27	80	0.3375000
NODE_228737_length_271_cov_2.273256	163	219	0	56	56	1.0000000
NODE_228830_length_271_cov_2.069767	130	212	7	12	82	0.1463415
NODE_228830_length_271_cov_2.069767	130	212	8	2	82	0.0243902
NODE_228830_length_271_cov_2.069767	130	212	12	68	82	0.8292683
NODE_228932_length_271_cov_1.784884	135	183	0	1	48	0.0208333
NODE_228932_length_271_cov_1.784884	135	183	2	26	48	0.5416667
NODE_228932_length_271_cov_1.784884	135	183	4	21	48	0.4375000
NODE_228937_length_271_cov_1.779070	204	268	0	64	64	1.0000000
NODE_229085_length_271_cov_1.755814	119	199	0	45	80	0.5625000
NODE_229085_length_271_cov_1.755814	119	199	2	35	80	0.4375000
NODE_229242_length_271_cov_1.523256	122	183	0	61	61	1.0000000
NODE_229254_length_271_cov_1.511628	106	186	38	1	80	0.0125000
NODE_229254_length_271_cov_1.511628	106	186	39	1	80	0.0125000
NODE_229254_length_271_cov_1.511628	106	186	43	6	80	0.0750000
NODE_229254_length_271_cov_1.511628	106	186	45	3	80	0.0375000
NODE_229254_length_271_cov_1.511628	106	186	47	2	80	0.0250000
NODE_229254_length_271_cov_1.511628	106	186	49	5	80	0.0625000
NODE_229254_length_271_cov_1.511628	106	186	52	1	80	0.0125000
NODE_229254_length_271_cov_1.511628	106	186	56	1	80	0.0125000
NODE_229254_length_271_cov_1.511628	106	186	60	4	80	0.0500000
NODE_229254_length_271_cov_1.511628	106	186	63	7	80	0.0875000
NODE_229254_length_271_cov_1.511628	106	186	67	3	80	0.0375000
NODE_229254_length_271_cov_1.511628	106	186	71	2	80	0.0250000
NODE_229254_length_271_cov_1.511628	106	186	73	3	80	0.0375000
NODE_229254_length_271_cov_1.511628	106	186	75	2	80	0.0250000
NODE_229254_length_271_cov_1.511628	106	186	82	3	80	0.0375000
NODE_229254_length_271_cov_1.511628	106	186	90	4	80	0.0500000
NODE_229254_length_271_cov_1.511628	106	186	92	2	80	0.0250000
NODE_229254_length_271_cov_1.511628	106	186	98	3	80	0.0375000
NODE_229254_length_271_cov_1.511628	106	186	100	1	80	0.0125000
NODE_229254_length_271_cov_1.511628	106	186	101	1	80	0.0125000
NODE_229254_length_271_cov_1.511628	106	186	103	2	80	0.0250000
NODE_229254_length_271_cov_1.511628	106	186	104	1	80	0.0125000
NODE_229254_length_271_cov_1.511628	106	186	105	4	80	0.0500000
NODE_229254_length_271_cov_1.511628	106	186	107	3	80	0.0375000
NODE_229254_length_271_cov_1.511628	106	186	108	6	80	0.0750000
NODE_229254_length_271_cov_1.511628	106	186	109	4	80	0.0500000
NODE_229254_length_271_cov_1.511628	106	186	110	3	80	0.0375000
NODE_229254_length_271_cov_1.511628	106	186	112	1	80	0.0125000
NODE_229254_length_271_cov_1.511628	106	186	113	1	80	0.0125000
NODE_229525_length_271_cov_1.226744	119	184	4	65	65	1.0000000
NODE_229541_length_271_cov_1.197674	88	145	2	1	57	0.0175439
NODE_229541_length_271_cov_1.197674	88	145	4	12	57	0.2105263
NODE_229541_length_271_cov_1.197674	88	145	5	44	57	0.7719298
NODE_229541_length_271_cov_1.197674	118	192	0	5	74	0.0675676
NODE_229541_length_271_cov_1.197674	118	192	3	10	74	0.1351351
NODE_229541_length_271_cov_1.197674	118	192	5	59	74	0.7972973
NODE_230154_length_271_cov_0.918605	155	227	0	72	72	1.0000000
NODE_230255_length_271_cov_0.889535	101	148	0	46	47	0.9787234
NODE_230255_length_271_cov_0.889535	101	148	10	1	47	0.0212766
NODE_230318_length_271_cov_0.889535	127	188	0	22	61	0.3606557
NODE_230318_length_271_cov_0.889535	127	188	2	39	61	0.6393443
NODE_231165_length_270_cov_4.818713	72	118	0	46	46	1.0000000
NODE_231187_length_270_cov_4.327485	5	82	2	20	77	0.2597403
NODE_231187_length_270_cov_4.327485	5	82	4	57	77	0.7402598
NODE_231240_length_270_cov_3.666667	87	154	0	27	67	0.4029851
NODE_231240_length_270_cov_3.666667	87	154	2	40	67	0.5970149
NODE_231240_length_270_cov_3.666667	140	207	2	31	67	0.4626866
NODE_231240_length_270_cov_3.666667	140	207	4	36	67	0.5373135
NODE_231263_length_270_cov_3.491228	186	270	0	45	84	0.5357143
NODE_231263_length_270_cov_3.491228	186	270	4	39	84	0.4642857
NODE_231310_length_270_cov_3.105263	43	90	10	42	47	0.8936170
NODE_231310_length_270_cov_3.105263	43	90	12	5	47	0.1063830
NODE_231316_length_270_cov_3.046784	64	135	0	71	71	1.0000000
NODE_231439_length_270_cov_2.649123	210	270	2	8	60	0.1333333
NODE_231439_length_270_cov_2.649123	210	270	5	16	60	0.2666667
NODE_231439_length_270_cov_2.649123	210	270	7	1	60	0.0166667
NODE_231439_length_270_cov_2.649123	210	270	8	35	60	0.5833333
NODE_231655_length_270_cov_2.087719	16	55	0	1	39	0.0256410
NODE_231655_length_270_cov_2.087719	16	55	2	38	39	0.9743590
NODE_231655_length_270_cov_2.087719	78	108	0	14	30	0.4666667
NODE_231655_length_270_cov_2.087719	78	108	2	16	30	0.5333334
NODE_231714_length_270_cov_2.040936	103	159	19	1	56	0.0178571
NODE_231714_length_270_cov_2.040936	103	159	45	1	56	0.0178571
NODE_231714_length_270_cov_2.040936	103	159	47	2	56	0.0357143
NODE_231714_length_270_cov_2.040936	103	159	49	3	56	0.0535714
NODE_231714_length_270_cov_2.040936	103	159	53	1	56	0.0178571
NODE_231714_length_270_cov_2.040936	103	159	59	1	56	0.0178571
NODE_231714_length_270_cov_2.040936	103	159	63	1	56	0.0178571
NODE_231714_length_270_cov_2.040936	103	159	67	2	56	0.0357143
NODE_231714_length_270_cov_2.040936	103	159	69	1	56	0.0178571
NODE_231714_length_270_cov_2.040936	103	159	71	1	56	0.0178571
NODE_231714_length_270_cov_2.040936	103	159	79	1	56	0.0178571
NODE_231714_length_270_cov_2.040936	103	159	81	2	56	0.0357143
NODE_231714_length_270_cov_2.040936	103	159	83	1	56	0.0178571
NODE_231714_length_270_cov_2.040936	103	159	87	1	56	0.0178571
NODE_231714_length_270_cov_2.040936	103	159	91	4	56	0.0714286
NODE_231714_length_270_cov_2.040936	103	159	93	2	56	0.0357143
NODE_231714_length_270_cov_2.040936	103	159	95	1	56	0.0178571
NODE_231714_length_270_cov_2.040936	103	159	97	1	56	0.0178571
NODE_231714_length_270_cov_2.040936	103	159	99	1	56	0.0178571
NODE_231714_length_270_cov_2.040936	103	159	100	1	56	0.0178571
NODE_231714_length_270_cov_2.040936	103	159	101	1	56	0.0178571
NODE_231714_length_270_cov_2.040936	103	159	102	2	56	0.0357143
NODE_231714_length_270_cov_2.040936	103	159	108	2	56	0.0357143
NODE_231714_length_270_cov_2.040936	103	159	113	1	56	0.0178571
NODE_231714_length_270_cov_2.040936	103	159	115	4	56	0.0714286
NODE_231714_length_270_cov_2.040936	103	159	117	2	56	0.0357143
NODE_231714_length_270_cov_2.040936	103	159	123	1	56	0.0178571
NODE_231714_length_270_cov_2.040936	103	159	125	3	56	0.0535714
NODE_231714_length_270_cov_2.040936	103	159	129	11	56	0.1964286
NODE_231726_length_270_cov_2.017544	1	48	0	47	47	1.0000000
NODE_231820_length_270_cov_1.789474	146	228	0	38	82	0.4634146
NODE_231820_length_270_cov_1.789474	146	228	4	15	82	0.1829268
NODE_231820_length_270_cov_1.789474	146	228	8	29	82	0.3536585
NODE_232008_length_270_cov_1.678363	178	246	0	68	68	1.0000000
NODE_232021_length_270_cov_1.666667	127	191	45	1	64	0.0156250
NODE_232021_length_270_cov_1.666667	127	191	47	3	64	0.0468750
NODE_232021_length_270_cov_1.666667	127	191	49	6	64	0.0937500
NODE_232021_length_270_cov_1.666667	127	191	55	1	64	0.0156250
NODE_232021_length_270_cov_1.666667	127	191	57	4	64	0.0625000
NODE_232021_length_270_cov_1.666667	127	191	59	1	64	0.0156250
NODE_232021_length_270_cov_1.666667	127	191	61	2	64	0.0312500
NODE_232021_length_270_cov_1.666667	127	191	64	1	64	0.0156250
NODE_232021_length_270_cov_1.666667	127	191	67	1	64	0.0156250
NODE_232021_length_270_cov_1.666667	127	191	71	1	64	0.0156250
NODE_232021_length_270_cov_1.666667	127	191	73	3	64	0.0468750
NODE_232021_length_270_cov_1.666667	127	191	75	1	64	0.0156250
NODE_232021_length_270_cov_1.666667	127	191	79	1	64	0.0156250
NODE_232021_length_270_cov_1.666667	127	191	85	1	64	0.0156250
NODE_232021_length_270_cov_1.666667	127	191	87	2	64	0.0312500
NODE_232021_length_270_cov_1.666667	127	191	89	1	64	0.0156250
NODE_232021_length_270_cov_1.666667	127	191	91	1	64	0.0156250
NODE_232021_length_270_cov_1.666667	127	191	97	1	64	0.0156250
NODE_232021_length_270_cov_1.666667	127	191	103	3	64	0.0468750
NODE_232021_length_270_cov_1.666667	127	191	108	1	64	0.0156250
NODE_232021_length_270_cov_1.666667	127	191	110	9	64	0.1406250
NODE_232021_length_270_cov_1.666667	127	191	114	2	64	0.0312500
NODE_232021_length_270_cov_1.666667	127	191	118	1	64	0.0156250
NODE_232021_length_270_cov_1.666667	127	191	120	5	64	0.0781250
NODE_232021_length_270_cov_1.666667	127	191	127	1	64	0.0156250
NODE_232021_length_270_cov_1.666667	127	191	128	3	64	0.0468750
NODE_232021_length_270_cov_1.666667	127	191	130	1	64	0.0156250
NODE_232021_length_270_cov_1.666667	127	191	134	1	64	0.0156250
NODE_232021_length_270_cov_1.666667	127	191	135	3	64	0.0468750
NODE_232021_length_270_cov_1.666667	127	191	136	1	64	0.0156250
NODE_232021_length_270_cov_1.666667	127	191	140	1	64	0.0156250
NODE_232021_length_270_cov_1.666667	180	227	17	3	47	0.0638298
NODE_232021_length_270_cov_1.666667	180	227	23	2	47	0.0425532
NODE_232021_length_270_cov_1.666667	180	227	25	6	47	0.1276596
NODE_232021_length_270_cov_1.666667	180	227	29	4	47	0.0851064
NODE_232021_length_270_cov_1.666667	180	227	31	6	47	0.1276596
NODE_232021_length_270_cov_1.666667	180	227	35	1	47	0.0212766
NODE_232021_length_270_cov_1.666667	180	227	37	6	47	0.1276596
NODE_232021_length_270_cov_1.666667	180	227	41	2	47	0.0425532
NODE_232021_length_270_cov_1.666667	180	227	43	3	47	0.0638298
NODE_232021_length_270_cov_1.666667	180	227	45	4	47	0.0851064
NODE_232021_length_270_cov_1.666667	180	227	47	3	47	0.0638298
NODE_232021_length_270_cov_1.666667	180	227	49	6	47	0.1276596
NODE_232021_length_270_cov_1.666667	180	227	55	1	47	0.0212766
NODE_232087_length_270_cov_1.555556	138	218	0	12	80	0.1500000
NODE_232087_length_270_cov_1.555556	138	218	2	15	80	0.1875000
NODE_232087_length_270_cov_1.555556	138	218	4	2	80	0.0250000
NODE_232087_length_270_cov_1.555556	138	218	6	51	80	0.6375000
NODE_232331_length_270_cov_1.280702	4	75	2	63	71	0.8873239
NODE_232331_length_270_cov_1.280702	4	75	4	8	71	0.1126761
NODE_232331_length_270_cov_1.280702	57	137	2	10	80	0.1250000
NODE_232331_length_270_cov_1.280702	57	137	4	70	80	0.8750000
NODE_232331_length_270_cov_1.280702	65	120	2	2	55	0.0363636
NODE_232331_length_270_cov_1.280702	65	120	4	53	55	0.9636363
NODE_232331_length_270_cov_1.280702	125	198	1	11	73	0.1506849
NODE_232331_length_270_cov_1.280702	125	198	2	30	73	0.4109589
NODE_232331_length_270_cov_1.280702	125	198	3	20	73	0.2739726
NODE_232331_length_270_cov_1.280702	125	198	4	12	73	0.1643836
NODE_232440_length_270_cov_1.192982	146	194	0	48	48	1.0000000
NODE_232583_length_270_cov_1.192982	61	141	0	80	80	1.0000000
NODE_233290_length_270_cov_0.847953	53	128	0	2	75	0.0266667
NODE_233290_length_270_cov_0.847953	53	128	4	10	75	0.1333333
NODE_233290_length_270_cov_0.847953	53	128	6	2	75	0.0266667
NODE_233290_length_270_cov_0.847953	53	128	8	34	75	0.4533333
NODE_233290_length_270_cov_0.847953	53	128	10	9	75	0.1200000
NODE_233290_length_270_cov_0.847953	53	128	14	18	75	0.2400000
NODE_234072_length_269_cov_3.894118	30	110	2	28	80	0.3500000
NODE_234072_length_269_cov_3.894118	30	110	4	52	80	0.6500000
NODE_234072_length_269_cov_3.894118	83	163	2	28	80	0.3500000
NODE_234072_length_269_cov_3.894118	83	163	4	52	80	0.6500000
NODE_234100_length_269_cov_3.605882	175	205	0	30	30	1.0000000
NODE_234116_length_269_cov_3.523529	192	233	0	9	41	0.2195122
NODE_234116_length_269_cov_3.523529	192	233	2	2	41	0.0487805
NODE_234116_length_269_cov_3.523529	192	233	4	11	41	0.2682927
NODE_234116_length_269_cov_3.523529	192	233	6	6	41	0.1463415
NODE_234116_length_269_cov_3.523529	192	233	8	9	41	0.2195122
NODE_234116_length_269_cov_3.523529	192	233	10	2	41	0.0487805
NODE_234116_length_269_cov_3.523529	192	233	16	2	41	0.0487805
NODE_234116_length_269_cov_3.523529	206	268	0	44	62	0.7096774
NODE_234116_length_269_cov_3.523529	206	268	2	2	62	0.0322581
NODE_234116_length_269_cov_3.523529	206	268	4	11	62	0.1774193
NODE_234116_length_269_cov_3.523529	206	268	6	5	62	0.0806452
NODE_234118_length_269_cov_3.505882	13	93	0	80	80	1.0000000
NODE_234118_length_269_cov_3.505882	66	145	0	79	79	1.0000000
NODE_234162_length_269_cov_3.147059	134	174	0	40	40	1.0000000
NODE_234167_length_269_cov_3.111765	39	119	2	2	80	0.0250000
NODE_234167_length_269_cov_3.111765	39	119	4	4	80	0.0500000
NODE_234167_length_269_cov_3.111765	39	119	8	1	80	0.0125000
NODE_234167_length_269_cov_3.111765	39	119	10	9	80	0.1125000
NODE_234167_length_269_cov_3.111765	39	119	12	10	80	0.1250000
NODE_234167_length_269_cov_3.111765	39	119	14	9	80	0.1125000
NODE_234167_length_269_cov_3.111765	39	119	18	45	80	0.5625000
NODE_234167_length_269_cov_3.111765	92	169	0	26	77	0.3376623
NODE_234167_length_269_cov_3.111765	92	169	4	1	77	0.0129870
NODE_234167_length_269_cov_3.111765	92	169	6	1	77	0.0129870
NODE_234167_length_269_cov_3.111765	92	169	12	2	77	0.0259740
NODE_234167_length_269_cov_3.111765	92	169	16	1	77	0.0129870
NODE_234167_length_269_cov_3.111765	92	169	18	46	77	0.5974026
NODE_234178_length_269_cov_3.000000	166	233	0	39	67	0.5820895
NODE_234178_length_269_cov_3.000000	166	233	2	28	67	0.4179105
NODE_234205_length_269_cov_2.947059	55	123	0	19	68	0.2794118
NODE_234205_length_269_cov_2.947059	55	123	4	19	68	0.2794118
NODE_234205_length_269_cov_2.947059	55	123	6	30	68	0.4411765
NODE_234224_length_269_cov_2.858824	9	89	0	80	80	1.0000000
NODE_234224_length_269_cov_2.858824	62	91	0	29	29	1.0000000
NODE_234228_length_269_cov_2.823529	0	73	8	16	73	0.2191781
NODE_234228_length_269_cov_2.823529	0	73	10	11	73	0.1506849
NODE_234228_length_269_cov_2.823529	0	73	14	2	73	0.0273973
NODE_234228_length_269_cov_2.823529	0	73	16	6	73	0.0821918
NODE_234228_length_269_cov_2.823529	0	73	20	13	73	0.1780822
NODE_234228_length_269_cov_2.823529	0	73	22	25	73	0.3424658
NODE_234228_length_269_cov_2.823529	46	77	20	2	31	0.0645161
NODE_234228_length_269_cov_2.823529	46	77	22	29	31	0.9354839
NODE_234431_length_269_cov_2.311765	111	157	0	44	46	0.9565217
NODE_234431_length_269_cov_2.311765	111	157	2	2	46	0.0434783
NODE_234431_length_269_cov_2.311765	130	209	0	79	79	1.0000000
NODE_234606_length_269_cov_1.958824	176	248	2	29	72	0.4027778
NODE_234606_length_269_cov_1.958824	176	248	3	3	72	0.0416667
NODE_234606_length_269_cov_1.958824	176	248	4	40	72	0.5555556
NODE_234647_length_269_cov_1.847059	72	99	0	11	27	0.4074074
NODE_234647_length_269_cov_1.847059	72	99	2	16	27	0.5925926
NODE_234657_length_269_cov_1.823529	30	81	0	6	51	0.1176471
NODE_234657_length_269_cov_1.823529	30	81	6	6	51	0.1176471
NODE_234657_length_269_cov_1.823529	30	81	8	20	51	0.3921569
NODE_234657_length_269_cov_1.823529	30	81	10	3	51	0.0588235
NODE_234657_length_269_cov_1.823529	30	81	12	4	51	0.0784314
NODE_234657_length_269_cov_1.823529	30	81	16	3	51	0.0588235
NODE_234657_length_269_cov_1.823529	30	81	20	1	51	0.0196078
NODE_234657_length_269_cov_1.823529	30	81	22	8	51	0.1568628
NODE_234758_length_269_cov_1.800000	0	42	0	42	42	1.0000000
NODE_234978_length_269_cov_1.552941	90	170	0	1	80	0.0125000
NODE_234978_length_269_cov_1.552941	90	170	2	64	80	0.8000000
NODE_234978_length_269_cov_1.552941	90	170	4	15	80	0.1875000
NODE_235157_length_269_cov_1.400000	139	219	4	4	80	0.0500000
NODE_235157_length_269_cov_1.400000	139	219	6	4	80	0.0500000
NODE_235157_length_269_cov_1.400000	139	219	12	1	80	0.0125000
NODE_235157_length_269_cov_1.400000	139	219	14	1	80	0.0125000
NODE_235157_length_269_cov_1.400000	139	219	20	4	80	0.0500000
NODE_235157_length_269_cov_1.400000	139	219	22	9	80	0.1125000
NODE_235157_length_269_cov_1.400000	139	219	24	23	80	0.2875000
NODE_235157_length_269_cov_1.400000	139	219	26	13	80	0.1625000
NODE_235157_length_269_cov_1.400000	139	219	28	4	80	0.0500000
NODE_235157_length_269_cov_1.400000	139	219	30	1	80	0.0125000
NODE_235157_length_269_cov_1.400000	139	219	32	6	80	0.0750000
NODE_235157_length_269_cov_1.400000	139	219	34	9	80	0.1125000
NODE_235157_length_269_cov_1.400000	139	219	38	1	80	0.0125000
NODE_235168_length_269_cov_1.388235	185	252	0	67	67	1.0000000
NODE_235239_length_269_cov_1.288235	150	179	4	12	29	0.4137931
NODE_235239_length_269_cov_1.288235	150	179	6	17	29	0.5862069
NODE_235292_length_269_cov_1.217647	141	221	0	4	80	0.0500000
NODE_235292_length_269_cov_1.217647	141	221	2	76	80	0.9500000
NODE_235561_length_269_cov_1.194118	107	170	0	63	63	1.0000000
NODE_235561_length_269_cov_1.194118	143	221	0	78	78	1.0000000
NODE_235714_length_269_cov_1.094118	38	72	0	34	34	1.0000000
NODE_235780_length_269_cov_1.035294	6	36	0	30	30	1.0000000
NODE_235780_length_269_cov_1.035294	96	150	0	54	54	1.0000000
NODE_235930_length_269_cov_0.917647	4	79	0	75	75	1.0000000
NODE_235930_length_269_cov_0.917647	57	93	0	36	36	1.0000000
NODE_236243_length_269_cov_0.782353	2	52	0	50	50	1.0000000
NODE_236243_length_269_cov_0.782353	76	132	0	16	56	0.2857143
NODE_236243_length_269_cov_0.782353	76	132	2	9	56	0.1607143
NODE_236243_length_269_cov_0.782353	76	132	7	1	56	0.0178571
NODE_236243_length_269_cov_0.782353	76	132	8	12	56	0.2142857
NODE_236243_length_269_cov_0.782353	76	132	10	18	56	0.3214286
NODE_236856_length_268_cov_223.165680	161	188	2	22	27	0.8148148
NODE_236856_length_268_cov_223.165680	161	188	3	4	27	0.1481481
NODE_236856_length_268_cov_223.165680	161	188	4	1	27	0.0370370
NODE_236856_length_268_cov_223.165680	161	241	0	10	80	0.1250000
NODE_236856_length_268_cov_223.165680	161	241	2	65	80	0.8125000
NODE_236856_length_268_cov_223.165680	161	241	3	4	80	0.0500000
NODE_236856_length_268_cov_223.165680	161	241	4	1	80	0.0125000
NODE_236878_length_268_cov_6.266272	29	111	0	82	82	1.0000000
NODE_236909_length_268_cov_5.053254	137	217	1	80	80	1.0000000
NODE_236909_length_268_cov_5.053254	190	253	0	6	63	0.0952381
NODE_236909_length_268_cov_5.053254	190	253	1	57	63	0.9047619
NODE_236911_length_268_cov_4.994083	92	168	2	29	76	0.3815790
NODE_236911_length_268_cov_4.994083	92	168	4	47	76	0.6184211
NODE_236972_length_268_cov_3.905325	1	61	2	60	60	1.0000000
NODE_237107_length_268_cov_2.982249	95	175	18	10	80	0.1250000
NODE_237107_length_268_cov_2.982249	95	175	19	1	80	0.0125000
NODE_237107_length_268_cov_2.982249	95	175	20	3	80	0.0375000
NODE_237107_length_268_cov_2.982249	95	175	22	19	80	0.2375000
NODE_237107_length_268_cov_2.982249	95	175	23	9	80	0.1125000
NODE_237107_length_268_cov_2.982249	95	175	24	3	80	0.0375000
NODE_237107_length_268_cov_2.982249	95	175	25	17	80	0.2125000
NODE_237107_length_268_cov_2.982249	95	175	27	18	80	0.2250000
NODE_237115_length_268_cov_2.940828	28	97	0	35	69	0.5072464
NODE_237115_length_268_cov_2.940828	28	97	2	34	69	0.4927536
NODE_237185_length_268_cov_2.668639	57	110	0	53	53	1.0000000
NODE_237190_length_268_cov_2.621302	149	176	0	1	27	0.0370370
NODE_237190_length_268_cov_2.621302	149	176	2	22	27	0.8148148
NODE_237190_length_268_cov_2.621302	149	176	4	4	27	0.1481481
NODE_237325_length_268_cov_2.289941	87	127	407	2	40	0.0500000
NODE_237325_length_268_cov_2.289941	87	127	409	1	40	0.0250000
NODE_237325_length_268_cov_2.289941	87	127	423	1	40	0.0250000
NODE_237325_length_268_cov_2.289941	87	127	427	1	40	0.0250000
NODE_237325_length_268_cov_2.289941	87	127	440	1	40	0.0250000
NODE_237325_length_268_cov_2.289941	87	127	442	3	40	0.0750000
NODE_237325_length_268_cov_2.289941	87	127	450	2	40	0.0500000
NODE_237325_length_268_cov_2.289941	87	127	454	1	40	0.0250000
NODE_237325_length_268_cov_2.289941	87	127	456	1	40	0.0250000
NODE_237325_length_268_cov_2.289941	87	127	460	1	40	0.0250000
NODE_237325_length_268_cov_2.289941	87	127	468	1	40	0.0250000
NODE_237325_length_268_cov_2.289941	87	127	470	1	40	0.0250000
NODE_237325_length_268_cov_2.289941	87	127	477	1	40	0.0250000
NODE_237325_length_268_cov_2.289941	87	127	480	1	40	0.0250000
NODE_237325_length_268_cov_2.289941	87	127	490	1	40	0.0250000
NODE_237325_length_268_cov_2.289941	87	127	500	1	40	0.0250000
NODE_237325_length_268_cov_2.289941	87	127	520	1	40	0.0250000
NODE_237325_length_268_cov_2.289941	87	127	524	1	40	0.0250000
NODE_237325_length_268_cov_2.289941	87	127	526	1	40	0.0250000
NODE_237325_length_268_cov_2.289941	87	127	530	1	40	0.0250000
NODE_237325_length_268_cov_2.289941	87	127	536	1	40	0.0250000
NODE_237325_length_268_cov_2.289941	87	127	545	3	40	0.0750000
NODE_237325_length_268_cov_2.289941	87	127	547	2	40	0.0500000
NODE_237325_length_268_cov_2.289941	87	127	557	1	40	0.0250000
NODE_237325_length_268_cov_2.289941	87	127	561	1	40	0.0250000
NODE_237325_length_268_cov_2.289941	87	127	565	1	40	0.0250000
NODE_237325_length_268_cov_2.289941	87	127	567	1	40	0.0250000
NODE_237325_length_268_cov_2.289941	87	127	569	1	40	0.0250000
NODE_237325_length_268_cov_2.289941	87	127	579	1	40	0.0250000
NODE_237325_length_268_cov_2.289941	87	127	581	1	40	0.0250000
NODE_237325_length_268_cov_2.289941	87	127	591	1	40	0.0250000
NODE_237325_length_268_cov_2.289941	87	127	603	1	40	0.0250000
NODE_237325_length_268_cov_2.289941	87	127	605	1	40	0.0250000
NODE_237345_length_268_cov_2.224852	96	176	0	11	80	0.1375000
NODE_237345_length_268_cov_2.224852	96	176	3	7	80	0.0875000
NODE_237345_length_268_cov_2.224852	96	176	6	62	80	0.7750000
NODE_237345_length_268_cov_2.224852	149	229	6	80	80	1.0000000
NODE_237457_length_268_cov_2.005917	97	162	2	27	65	0.4153846
NODE_237457_length_268_cov_2.005917	97	162	4	37	65	0.5692308
NODE_237457_length_268_cov_2.005917	97	162	6	1	65	0.0153846
NODE_237502_length_268_cov_1.840237	80	155	2	1	75	0.0133333
NODE_237502_length_268_cov_1.840237	80	155	4	25	75	0.3333333
NODE_237502_length_268_cov_1.840237	80	155	6	46	75	0.6133333
NODE_237502_length_268_cov_1.840237	80	155	8	3	75	0.0400000
NODE_237572_length_268_cov_1.810651	8	84	0	76	76	1.0000000
NODE_237831_length_268_cov_1.532544	186	257	8	6	71	0.0845070
NODE_237831_length_268_cov_1.532544	186	257	10	1	71	0.0140845
NODE_237831_length_268_cov_1.532544	186	257	12	46	71	0.6478873
NODE_237831_length_268_cov_1.532544	186	257	13	18	71	0.2535211
NODE_237906_length_268_cov_1.508876	52	131	2	79	79	1.0000000
NODE_238009_length_268_cov_1.384615	0	46	0	46	46	1.0000000
NODE_238070_length_268_cov_1.278107	100	175	0	75	75	1.0000000
NODE_238153_length_268_cov_1.207101	187	209	0	22	22	1.0000000
NODE_238478_length_268_cov_1.153846	135	195	0	1	60	0.0166667
NODE_238478_length_268_cov_1.153846	135	195	2	59	60	0.9833333
NODE_239018_length_268_cov_0.852071	59	119	22	25	60	0.4166667
NODE_239018_length_268_cov_0.852071	59	119	24	35	60	0.5833333
NODE_239805_length_267_cov_4.297619	0	52	0	52	52	1.0000000
NODE_239817_length_267_cov_4.119048	41	87	0	14	46	0.3043478
NODE_239817_length_267_cov_4.119048	41	87	2	32	46	0.6956522
NODE_239845_length_267_cov_3.785714	96	163	0	5	67	0.0746269
NODE_239845_length_267_cov_3.785714	96	163	2	62	67	0.9253731
NODE_239845_length_267_cov_3.785714	136	178	0	20	42	0.4761905
NODE_239845_length_267_cov_3.785714	136	178	2	22	42	0.5238096
NODE_239873_length_267_cov_3.535714	40	101	0	9	61	0.1475410
NODE_239873_length_267_cov_3.535714	40	101	4	52	61	0.8524590
NODE_239873_length_267_cov_3.535714	74	154	0	18	80	0.2250000
NODE_239873_length_267_cov_3.535714	74	154	3	1	80	0.0125000
NODE_239873_length_267_cov_3.535714	74	154	4	61	80	0.7625000
NODE_239958_length_267_cov_3.005952	216	267	0	51	51	1.0000000
NODE_239959_length_267_cov_3.000000	87	144	0	2	57	0.0350877
NODE_239959_length_267_cov_3.000000	87	144	2	7	57	0.1228070
NODE_239959_length_267_cov_3.000000	87	144	4	3	57	0.0526316
NODE_239959_length_267_cov_3.000000	87	144	6	13	57	0.2280702
NODE_239959_length_267_cov_3.000000	87	144	8	1	57	0.0175439
NODE_239959_length_267_cov_3.000000	87	144	12	1	57	0.0175439
NODE_239959_length_267_cov_3.000000	87	144	18	6	57	0.1052632
NODE_239959_length_267_cov_3.000000	87	144	20	3	57	0.0526316
NODE_239959_length_267_cov_3.000000	87	144	22	21	57	0.3684210
NODE_240007_length_267_cov_2.726190	177	220	4	6	43	0.1395349
NODE_240007_length_267_cov_2.726190	177	220	6	7	43	0.1627907
NODE_240007_length_267_cov_2.726190	177	220	8	30	43	0.6976744
NODE_240024_length_267_cov_2.690476	117	170	6	3	53	0.0566038
NODE_240024_length_267_cov_2.690476	117	170	8	2	53	0.0377358
NODE_240024_length_267_cov_2.690476	117	170	10	22	53	0.4150943
NODE_240024_length_267_cov_2.690476	117	170	12	18	53	0.3396226
NODE_240024_length_267_cov_2.690476	117	170	14	8	53	0.1509434
NODE_240029_length_267_cov_2.666667	198	267	0	69	69	1.0000000
NODE_240114_length_267_cov_2.428571	189	254	43	1	65	0.0153846
NODE_240114_length_267_cov_2.428571	189	254	47	3	65	0.0461538
NODE_240114_length_267_cov_2.428571	189	254	51	2	65	0.0307692
NODE_240114_length_267_cov_2.428571	189	254	52	2	65	0.0307692
NODE_240114_length_267_cov_2.428571	189	254	57	1	65	0.0153846
NODE_240114_length_267_cov_2.428571	189	254	59	1	65	0.0153846
NODE_240114_length_267_cov_2.428571	189	254	60	6	65	0.0923077
NODE_240114_length_267_cov_2.428571	189	254	64	2	65	0.0307692
NODE_240114_length_267_cov_2.428571	189	254	66	1	65	0.0153846
NODE_240114_length_267_cov_2.428571	189	254	71	1	65	0.0153846
NODE_240114_length_267_cov_2.428571	189	254	76	1	65	0.0153846
NODE_240114_length_267_cov_2.428571	189	254	79	1	65	0.0153846
NODE_240114_length_267_cov_2.428571	189	254	83	1	65	0.0153846
NODE_240114_length_267_cov_2.428571	189	254	90	3	65	0.0461538
NODE_240114_length_267_cov_2.428571	189	254	92	1	65	0.0153846
NODE_240114_length_267_cov_2.428571	189	254	93	1	65	0.0153846
NODE_240114_length_267_cov_2.428571	189	254	96	1	65	0.0153846
NODE_240114_length_267_cov_2.428571	189	254	106	1	65	0.0153846
NODE_240114_length_267_cov_2.428571	189	254	110	1	65	0.0153846
NODE_240114_length_267_cov_2.428571	189	254	112	1	65	0.0153846
NODE_240114_length_267_cov_2.428571	189	254	114	2	65	0.0307692
NODE_240114_length_267_cov_2.428571	189	254	118	2	65	0.0307692
NODE_240114_length_267_cov_2.428571	189	254	119	1	65	0.0153846
NODE_240114_length_267_cov_2.428571	189	254	121	1	65	0.0153846
NODE_240114_length_267_cov_2.428571	189	254	122	1	65	0.0153846
NODE_240114_length_267_cov_2.428571	189	254	124	2	65	0.0307692
NODE_240114_length_267_cov_2.428571	189	254	126	2	65	0.0307692
NODE_240114_length_267_cov_2.428571	189	254	127	1	65	0.0153846
NODE_240114_length_267_cov_2.428571	189	254	128	2	65	0.0307692
NODE_240114_length_267_cov_2.428571	189	254	131	1	65	0.0153846
NODE_240114_length_267_cov_2.428571	189	254	132	1	65	0.0153846
NODE_240114_length_267_cov_2.428571	189	254	135	3	65	0.0461538
NODE_240114_length_267_cov_2.428571	189	254	137	1	65	0.0153846
NODE_240114_length_267_cov_2.428571	189	254	139	1	65	0.0153846
NODE_240114_length_267_cov_2.428571	189	254	140	1	65	0.0153846
NODE_240114_length_267_cov_2.428571	189	254	141	1	65	0.0153846
NODE_240114_length_267_cov_2.428571	189	254	142	1	65	0.0153846
NODE_240114_length_267_cov_2.428571	189	254	144	1	65	0.0153846
NODE_240114_length_267_cov_2.428571	189	254	146	1	65	0.0153846
NODE_240114_length_267_cov_2.428571	189	254	148	2	65	0.0307692
NODE_240114_length_267_cov_2.428571	189	254	149	1	65	0.0153846
NODE_240114_length_267_cov_2.428571	189	254	151	1	65	0.0153846
NODE_240114_length_267_cov_2.428571	189	254	153	1	65	0.0153846
NODE_240114_length_267_cov_2.428571	189	254	164	2	65	0.0307692
NODE_240207_length_267_cov_2.208333	45	103	6	1	58	0.0172414
NODE_240207_length_267_cov_2.208333	45	103	8	57	58	0.9827586
NODE_240246_length_267_cov_2.125000	124	175	2	51	51	1.0000000
NODE_240303_length_267_cov_2.077381	65	146	0	1	81	0.0123457
NODE_240303_length_267_cov_2.077381	65	146	2	3	81	0.0370370
NODE_240303_length_267_cov_2.077381	65	146	4	12	81	0.1481481
NODE_240303_length_267_cov_2.077381	65	146	6	65	81	0.8024691
NODE_240303_length_267_cov_2.077381	229	264	0	35	35	1.0000000
NODE_240331_length_267_cov_2.005952	147	228	0	57	81	0.7037037
NODE_240331_length_267_cov_2.005952	147	228	2	5	81	0.0617284
NODE_240331_length_267_cov_2.005952	147	228	4	5	81	0.0617284
NODE_240331_length_267_cov_2.005952	147	228	6	14	81	0.1728395
NODE_240331_length_267_cov_2.005952	201	267	0	66	66	1.0000000
NODE_240336_length_267_cov_1.988095	77	157	0	80	80	1.0000000
NODE_240336_length_267_cov_1.988095	130	210	0	80	80	1.0000000
NODE_240620_length_267_cov_1.755952	119	199	0	80	80	1.0000000
NODE_240624_length_267_cov_1.750000	23	104	28	1	81	0.0123457
NODE_240624_length_267_cov_1.750000	23	104	32	2	81	0.0246914
NODE_240624_length_267_cov_1.750000	23	104	34	7	81	0.0864198
NODE_240624_length_267_cov_1.750000	23	104	38	8	81	0.0987654
NODE_240624_length_267_cov_1.750000	23	104	40	10	81	0.1234568
NODE_240624_length_267_cov_1.750000	23	104	42	3	81	0.0370370
NODE_240624_length_267_cov_1.750000	23	104	44	2	81	0.0246914
NODE_240624_length_267_cov_1.750000	23	104	50	3	81	0.0370370
NODE_240624_length_267_cov_1.750000	23	104	52	6	81	0.0740741
NODE_240624_length_267_cov_1.750000	23	104	54	2	81	0.0246914
NODE_240624_length_267_cov_1.750000	23	104	56	4	81	0.0493827
NODE_240624_length_267_cov_1.750000	23	104	58	29	81	0.3580247
NODE_240624_length_267_cov_1.750000	23	104	60	4	81	0.0493827
NODE_240624_length_267_cov_1.750000	179	208	0	11	29	0.3793103
NODE_240624_length_267_cov_1.750000	179	208	2	7	29	0.2413793
NODE_240624_length_267_cov_1.750000	179	208	4	11	29	0.3793103
NODE_240653_length_267_cov_1.690476	18	90	0	72	72	1.0000000
NODE_240790_length_267_cov_1.517857	6	43	0	37	37	1.0000000
NODE_241075_length_267_cov_1.214286	37	91	4	3	54	0.0555556
NODE_241075_length_267_cov_1.214286	37	91	6	7	54	0.1296296
NODE_241075_length_267_cov_1.214286	37	91	8	44	54	0.8148148
NODE_241240_length_267_cov_1.214286	89	126	0	14	37	0.3783784
NODE_241240_length_267_cov_1.214286	89	126	2	23	37	0.6216216
NODE_241352_length_267_cov_1.208333	124	164	2	32	40	0.8000000
NODE_241352_length_267_cov_1.208333	124	164	4	8	40	0.2000000
NODE_241484_length_267_cov_1.125000	57	103	0	46	46	1.0000000
NODE_241512_length_267_cov_1.089286	119	196	0	20	77	0.2597403
NODE_241512_length_267_cov_1.089286	119	196	4	57	77	0.7402598
NODE_241512_length_267_cov_1.089286	169	249	0	73	80	0.9125000
NODE_241512_length_267_cov_1.089286	169	249	4	7	80	0.0875000
NODE_241517_length_267_cov_1.083333	133	152	4	1	19	0.0526316
NODE_241517_length_267_cov_1.083333	133	152	6	18	19	0.9473684
NODE_241517_length_267_cov_1.083333	183	264	0	14	81	0.1728395
NODE_241517_length_267_cov_1.083333	183	264	2	18	81	0.2222222
NODE_241517_length_267_cov_1.083333	183	264	4	17	81	0.2098765
NODE_241517_length_267_cov_1.083333	183	264	6	32	81	0.3950617
NODE_241588_length_267_cov_1.017857	205	267	0	62	62	1.0000000
NODE_241633_length_267_cov_0.982143	4	75	0	71	71	1.0000000
NODE_242999_length_266_cov_5.706587	120	199	0	79	79	1.0000000
NODE_242999_length_266_cov_5.706587	172	239	0	67	67	1.0000000
NODE_243010_length_266_cov_5.107784	68	150	0	14	82	0.1707317
NODE_243010_length_266_cov_5.107784	68	150	2	20	82	0.2439024
NODE_243010_length_266_cov_5.107784	68	150	4	28	82	0.3414634
NODE_243010_length_266_cov_5.107784	68	150	6	20	82	0.2439024
NODE_243064_length_266_cov_4.125749	99	168	4	9	69	0.1304348
NODE_243064_length_266_cov_4.125749	99	168	8	26	69	0.3768116
NODE_243064_length_266_cov_4.125749	99	168	10	1	69	0.0144928
NODE_243064_length_266_cov_4.125749	99	168	12	1	69	0.0144928
NODE_243064_length_266_cov_4.125749	99	168	14	32	69	0.4637681
NODE_243079_length_266_cov_3.958084	40	120	0	80	80	1.0000000
NODE_243079_length_266_cov_3.958084	93	159	0	66	66	1.0000000
NODE_243136_length_266_cov_3.419162	68	130	8	25	62	0.4032258
NODE_243136_length_266_cov_3.419162	68	130	10	37	62	0.5967742
NODE_243136_length_266_cov_3.419162	116	183	0	2	67	0.0298507
NODE_243136_length_266_cov_3.419162	116	183	2	5	67	0.0746269
NODE_243136_length_266_cov_3.419162	116	183	4	2	67	0.0298507
NODE_243136_length_266_cov_3.419162	116	183	6	23	67	0.3432836
NODE_243136_length_266_cov_3.419162	116	183	10	35	67	0.5223880
NODE_243168_length_266_cov_3.137725	6	86	0	80	80	1.0000000
NODE_243168_length_266_cov_3.137725	59	120	0	61	61	1.0000000
NODE_243174_length_266_cov_3.107784	166	232	10	8	66	0.1212121
NODE_243174_length_266_cov_3.107784	166	232	12	14	66	0.2121212
NODE_243174_length_266_cov_3.107784	166	232	17	8	66	0.1212121
NODE_243174_length_266_cov_3.107784	166	232	18	4	66	0.0606061
NODE_243174_length_266_cov_3.107784	166	232	19	2	66	0.0303030
NODE_243174_length_266_cov_3.107784	166	232	20	2	66	0.0303030
NODE_243174_length_266_cov_3.107784	166	232	22	2	66	0.0303030
NODE_243174_length_266_cov_3.107784	166	232	25	4	66	0.0606061
NODE_243174_length_266_cov_3.107784	166	232	27	8	66	0.1212121
NODE_243174_length_266_cov_3.107784	166	232	29	5	66	0.0757576
NODE_243174_length_266_cov_3.107784	166	232	33	1	66	0.0151515
NODE_243174_length_266_cov_3.107784	166	232	38	3	66	0.0454545
NODE_243174_length_266_cov_3.107784	166	232	39	1	66	0.0151515
NODE_243174_length_266_cov_3.107784	166	232	40	4	66	0.0606061
NODE_243475_length_266_cov_2.179641	110	191	10	2	81	0.0246914
NODE_243475_length_266_cov_2.179641	110	191	12	1	81	0.0123457
NODE_243475_length_266_cov_2.179641	110	191	16	1	81	0.0123457
NODE_243475_length_266_cov_2.179641	110	191	18	1	81	0.0123457
NODE_243475_length_266_cov_2.179641	110	191	20	19	81	0.2345679
NODE_243475_length_266_cov_2.179641	110	191	24	16	81	0.1975309
NODE_243475_length_266_cov_2.179641	110	191	28	1	81	0.0123457
NODE_243475_length_266_cov_2.179641	110	191	30	1	81	0.0123457
NODE_243475_length_266_cov_2.179641	110	191	32	15	81	0.1851852
NODE_243475_length_266_cov_2.179641	110	191	34	24	81	0.2962963
NODE_243497_length_266_cov_2.137725	156	236	4	8	80	0.1000000
NODE_243497_length_266_cov_2.137725	156	236	5	16	80	0.2000000
NODE_243497_length_266_cov_2.137725	156	236	6	4	80	0.0500000
NODE_243497_length_266_cov_2.137725	156	236	8	52	80	0.6500000
NODE_243570_length_266_cov_2.023952	47	123	0	76	76	1.0000000
NODE_243972_length_266_cov_1.532934	155	235	0	16	80	0.2000000
NODE_243972_length_266_cov_1.532934	155	235	1	7	80	0.0875000
NODE_243972_length_266_cov_1.532934	155	235	2	57	80	0.7125000
NODE_244681_length_266_cov_1.113772	70	97	0	27	27	1.0000000
NODE_244760_length_266_cov_1.023952	144	201	2	16	57	0.2807018
NODE_244760_length_266_cov_1.023952	144	201	4	41	57	0.7192982
NODE_244760_length_266_cov_1.023952	199	265	0	10	66	0.1515152
NODE_244760_length_266_cov_1.023952	199	265	2	56	66	0.8484849
NODE_245049_length_266_cov_0.916168	51	122	0	71	71	1.0000000
NODE_245280_length_266_cov_0.730539	132	158	0	26	26	1.0000000
NODE_245538_length_266_cov_0.610778	99	139	1	40	40	1.0000000
NODE_245538_length_266_cov_0.610778	112	156	1	44	44	1.0000000
NODE_246087_length_265_cov_7.843373	128	208	0	30	80	0.3750000
NODE_246087_length_265_cov_7.843373	128	208	3	18	80	0.2250000
NODE_246087_length_265_cov_7.843373	128	208	4	1	80	0.0125000
NODE_246087_length_265_cov_7.843373	128	208	5	4	80	0.0500000
NODE_246087_length_265_cov_7.843373	128	208	7	11	80	0.1375000
NODE_246087_length_265_cov_7.843373	128	208	10	5	80	0.0625000
NODE_246087_length_265_cov_7.843373	128	208	14	6	80	0.0750000
NODE_246087_length_265_cov_7.843373	128	208	16	1	80	0.0125000
NODE_246087_length_265_cov_7.843373	128	208	18	4	80	0.0500000
NODE_246192_length_265_cov_4.054217	65	145	0	80	80	1.0000000
NODE_246192_length_265_cov_4.054217	118	198	0	80	80	1.0000000
NODE_246198_length_265_cov_3.993976	195	231	0	36	36	1.0000000
NODE_246284_length_265_cov_3.150602	183	263	2	80	80	1.0000000
NODE_246374_length_265_cov_2.789157	177	238	0	61	61	1.0000000
NODE_246409_length_265_cov_2.734940	167	247	2	8	80	0.1000000
NODE_246409_length_265_cov_2.734940	167	247	3	9	80	0.1125000
NODE_246409_length_265_cov_2.734940	167	247	4	63	80	0.7875000
NODE_246432_length_265_cov_2.608434	188	259	0	71	71	1.0000000
NODE_246606_length_265_cov_2.156627	197	237	68	3	40	0.0750000
NODE_246606_length_265_cov_2.156627	197	237	70	5	40	0.1250000
NODE_246606_length_265_cov_2.156627	197	237	74	1	40	0.0250000
NODE_246606_length_265_cov_2.156627	197	237	86	1	40	0.0250000
NODE_246606_length_265_cov_2.156627	197	237	94	1	40	0.0250000
NODE_246606_length_265_cov_2.156627	197	237	104	1	40	0.0250000
NODE_246606_length_265_cov_2.156627	197	237	106	1	40	0.0250000
NODE_246606_length_265_cov_2.156627	197	237	110	1	40	0.0250000
NODE_246606_length_265_cov_2.156627	197	237	116	1	40	0.0250000
NODE_246606_length_265_cov_2.156627	197	237	118	1	40	0.0250000
NODE_246606_length_265_cov_2.156627	197	237	128	1	40	0.0250000
NODE_246606_length_265_cov_2.156627	197	237	130	2	40	0.0500000
NODE_246606_length_265_cov_2.156627	197	237	150	1	40	0.0250000
NODE_246606_length_265_cov_2.156627	197	237	159	1	40	0.0250000
NODE_246606_length_265_cov_2.156627	197	237	161	1	40	0.0250000
NODE_246606_length_265_cov_2.156627	197	237	169	1	40	0.0250000
NODE_246606_length_265_cov_2.156627	197	237	173	1	40	0.0250000
NODE_246606_length_265_cov_2.156627	197	237	177	1	40	0.0250000
NODE_246606_length_265_cov_2.156627	197	237	181	1	40	0.0250000
NODE_246606_length_265_cov_2.156627	197	237	183	3	40	0.0750000
NODE_246606_length_265_cov_2.156627	197	237	185	1	40	0.0250000
NODE_246606_length_265_cov_2.156627	197	237	191	2	40	0.0500000
NODE_246606_length_265_cov_2.156627	197	237	200	3	40	0.0750000
NODE_246606_length_265_cov_2.156627	197	237	212	1	40	0.0250000
NODE_246606_length_265_cov_2.156627	197	237	220	1	40	0.0250000
NODE_246606_length_265_cov_2.156627	197	237	222	1	40	0.0250000
NODE_246606_length_265_cov_2.156627	197	237	224	2	40	0.0500000
NODE_246624_length_265_cov_2.150602	169	218	0	49	49	1.0000000
NODE_246692_length_265_cov_1.975904	15	44	0	29	29	1.0000000
NODE_246811_length_265_cov_1.843373	195	265	0	15	70	0.2142857
NODE_246811_length_265_cov_1.843373	195	265	2	5	70	0.0714286
NODE_246811_length_265_cov_1.843373	195	265	4	50	70	0.7142857
NODE_247028_length_265_cov_1.620482	115	186	0	37	71	0.5211267
NODE_247028_length_265_cov_1.620482	115	186	2	34	71	0.4788733
NODE_247028_length_265_cov_1.620482	117	171	0	35	54	0.6481481
NODE_247028_length_265_cov_1.620482	117	171	2	19	54	0.3518519
NODE_247031_length_265_cov_1.614458	53	113	4	3	60	0.0500000
NODE_247031_length_265_cov_1.614458	53	113	6	1	60	0.0166667
NODE_247031_length_265_cov_1.614458	53	113	12	1	60	0.0166667
NODE_247031_length_265_cov_1.614458	53	113	14	2	60	0.0333333
NODE_247031_length_265_cov_1.614458	53	113	16	6	60	0.1000000
NODE_247031_length_265_cov_1.614458	53	113	18	3	60	0.0500000
NODE_247031_length_265_cov_1.614458	53	113	20	1	60	0.0166667
NODE_247031_length_265_cov_1.614458	53	113	22	1	60	0.0166667
NODE_247031_length_265_cov_1.614458	53	113	24	3	60	0.0500000
NODE_247031_length_265_cov_1.614458	53	113	26	1	60	0.0166667
NODE_247031_length_265_cov_1.614458	53	113	30	3	60	0.0500000
NODE_247031_length_265_cov_1.614458	53	113	31	5	60	0.0833333
NODE_247031_length_265_cov_1.614458	53	113	35	6	60	0.1000000
NODE_247031_length_265_cov_1.614458	53	113	39	1	60	0.0166667
NODE_247031_length_265_cov_1.614458	53	113	42	5	60	0.0833333
NODE_247031_length_265_cov_1.614458	53	113	43	1	60	0.0166667
NODE_247031_length_265_cov_1.614458	53	113	46	1	60	0.0166667
NODE_247031_length_265_cov_1.614458	53	113	48	2	60	0.0333333
NODE_247031_length_265_cov_1.614458	53	113	50	4	60	0.0666667
NODE_247031_length_265_cov_1.614458	53	113	52	4	60	0.0666667
NODE_247031_length_265_cov_1.614458	53	113	54	1	60	0.0166667
NODE_247031_length_265_cov_1.614458	53	113	56	1	60	0.0166667
NODE_247031_length_265_cov_1.614458	53	113	60	2	60	0.0333333
NODE_247031_length_265_cov_1.614458	53	113	68	1	60	0.0166667
NODE_247031_length_265_cov_1.614458	53	113	70	1	60	0.0166667
NODE_247031_length_265_cov_1.614458	86	166	35	3	80	0.0375000
NODE_247031_length_265_cov_1.614458	86	166	39	1	80	0.0125000
NODE_247031_length_265_cov_1.614458	86	166	42	5	80	0.0625000
NODE_247031_length_265_cov_1.614458	86	166	43	1	80	0.0125000
NODE_247031_length_265_cov_1.614458	86	166	46	1	80	0.0125000
NODE_247031_length_265_cov_1.614458	86	166	48	2	80	0.0250000
NODE_247031_length_265_cov_1.614458	86	166	50	4	80	0.0500000
NODE_247031_length_265_cov_1.614458	86	166	52	4	80	0.0500000
NODE_247031_length_265_cov_1.614458	86	166	54	1	80	0.0125000
NODE_247031_length_265_cov_1.614458	86	166	56	1	80	0.0125000
NODE_247031_length_265_cov_1.614458	86	166	60	2	80	0.0250000
NODE_247031_length_265_cov_1.614458	86	166	68	1	80	0.0125000
NODE_247031_length_265_cov_1.614458	86	166	70	1	80	0.0125000
NODE_247031_length_265_cov_1.614458	86	166	72	4	80	0.0500000
NODE_247031_length_265_cov_1.614458	86	166	86	4	80	0.0500000
NODE_247031_length_265_cov_1.614458	86	166	88	5	80	0.0625000
NODE_247031_length_265_cov_1.614458	86	166	92	1	80	0.0125000
NODE_247031_length_265_cov_1.614458	86	166	96	1	80	0.0125000
NODE_247031_length_265_cov_1.614458	86	166	98	2	80	0.0250000
NODE_247031_length_265_cov_1.614458	86	166	100	14	80	0.1750000
NODE_247031_length_265_cov_1.614458	86	166	102	18	80	0.2250000
NODE_247031_length_265_cov_1.614458	86	166	104	4	80	0.0500000
NODE_247314_length_265_cov_1.337349	107	168	12	3	61	0.0491803
NODE_247314_length_265_cov_1.337349	107	168	16	5	61	0.0819672
NODE_247314_length_265_cov_1.337349	107	168	20	53	61	0.8688524
NODE_247952_length_265_cov_1.000000	187	251	4	2	64	0.0312500
NODE_247952_length_265_cov_1.000000	187	251	6	10	64	0.1562500
NODE_247952_length_265_cov_1.000000	187	251	8	52	64	0.8125000
NODE_247972_length_265_cov_0.987952	44	63	0	19	19	1.0000000
NODE_249395_length_264_cov_4.018182	141	178	0	37	37	1.0000000
NODE_249404_length_264_cov_3.957576	59	132	0	73	73	1.0000000
NODE_249404_length_264_cov_3.957576	112	192	0	80	80	1.0000000
NODE_249415_length_264_cov_3.824242	178	220	0	42	42	1.0000000
NODE_249452_length_264_cov_3.400000	73	125	0	52	52	1.0000000
NODE_249452_length_264_cov_3.400000	124	165	0	41	41	1.0000000
NODE_249485_length_264_cov_3.133333	119	186	0	67	67	1.0000000
NODE_249530_length_264_cov_3.012121	122	198	0	47	76	0.6184211
NODE_249530_length_264_cov_3.012121	122	198	2	29	76	0.3815790
NODE_249904_length_264_cov_2.048485	32	98	4	9	66	0.1363636
NODE_249904_length_264_cov_2.048485	32	98	6	9	66	0.1363636
NODE_249904_length_264_cov_2.048485	32	98	8	39	66	0.5909091
NODE_249904_length_264_cov_2.048485	32	98	10	6	66	0.0909091
NODE_249904_length_264_cov_2.048485	32	98	13	3	66	0.0454545
NODE_249905_length_264_cov_2.048485	133	176	0	43	43	1.0000000
NODE_249912_length_264_cov_2.012121	20	84	0	64	64	1.0000000
NODE_249931_length_264_cov_1.951515	178	211	1	4	33	0.1212121
NODE_249931_length_264_cov_1.951515	178	211	6	24	33	0.7272727
NODE_249931_length_264_cov_1.951515	178	211	7	5	33	0.1515152
NODE_249982_length_264_cov_1.854545	130	161	2	31	31	1.0000000
NODE_250202_length_264_cov_1.745455	26	81	0	55	55	1.0000000
NODE_250202_length_264_cov_1.745455	86	153	0	67	67	1.0000000
NODE_250203_length_264_cov_1.745455	90	169	6	4	79	0.0506329
NODE_250203_length_264_cov_1.745455	90	169	22	2	79	0.0253165
NODE_250203_length_264_cov_1.745455	90	169	24	9	79	0.1139240
NODE_250203_length_264_cov_1.745455	90	169	26	40	79	0.5063291
NODE_250203_length_264_cov_1.745455	90	169	28	6	79	0.0759494
NODE_250203_length_264_cov_1.745455	90	169	30	5	79	0.0632911
NODE_250203_length_264_cov_1.745455	90	169	34	10	79	0.1265823
NODE_250203_length_264_cov_1.745455	90	169	36	3	79	0.0379747
NODE_250203_length_264_cov_1.745455	143	207	26	2	64	0.0312500
NODE_250203_length_264_cov_1.745455	143	207	28	6	64	0.0937500
NODE_250203_length_264_cov_1.745455	143	207	30	19	64	0.2968750
NODE_250203_length_264_cov_1.745455	143	207	32	4	64	0.0625000
NODE_250203_length_264_cov_1.745455	143	207	34	30	64	0.4687500
NODE_250203_length_264_cov_1.745455	143	207	36	3	64	0.0468750
NODE_250297_length_264_cov_1.569697	173	236	0	17	63	0.2698413
NODE_250297_length_264_cov_1.569697	173	236	2	35	63	0.5555556
NODE_250297_length_264_cov_1.569697	173	236	3	11	63	0.1746032
NODE_250314_length_264_cov_1.545455	206	255	0	1	49	0.0204082
NODE_250314_length_264_cov_1.545455	206	255	2	48	49	0.9795918
NODE_250381_length_264_cov_1.545455	35	66	2	31	31	1.0000000
NODE_250446_length_264_cov_1.503030	0	63	0	4	63	0.0634921
NODE_250446_length_264_cov_1.503030	0	63	2	59	63	0.9365079
NODE_250513_length_264_cov_1.406061	149	230	0	81	81	1.0000000
NODE_250513_length_264_cov_1.406061	225	260	0	35	35	1.0000000
NODE_250635_length_264_cov_1.236364	2	63	4	61	61	1.0000000
NODE_251015_length_264_cov_1.151515	11	68	0	57	57	1.0000000
NODE_251529_length_264_cov_0.921212	49	85	0	17	36	0.4722222
NODE_251529_length_264_cov_0.921212	49	85	2	19	36	0.5277778
NODE_251703_length_264_cov_0.721212	233	252	0	19	19	1.0000000
NODE_252559_length_263_cov_5.115854	132	219	26	2	87	0.0229885
NODE_252559_length_263_cov_5.115854	132	219	35	1	87	0.0114943
NODE_252559_length_263_cov_5.115854	132	219	36	2	87	0.0229885
NODE_252559_length_263_cov_5.115854	132	219	46	6	87	0.0689655
NODE_252559_length_263_cov_5.115854	132	219	48	1	87	0.0114943
NODE_252559_length_263_cov_5.115854	132	219	56	3	87	0.0344828
NODE_252559_length_263_cov_5.115854	132	219	58	7	87	0.0804598
NODE_252559_length_263_cov_5.115854	132	219	64	1	87	0.0114943
NODE_252559_length_263_cov_5.115854	132	219	68	8	87	0.0919540
NODE_252559_length_263_cov_5.115854	132	219	70	10	87	0.1149425
NODE_252559_length_263_cov_5.115854	132	219	72	14	87	0.1609195
NODE_252559_length_263_cov_5.115854	132	219	74	32	87	0.3678161
NODE_252563_length_263_cov_4.914634	45	117	19	2	72	0.0277778
NODE_252563_length_263_cov_4.914634	45	117	21	8	72	0.1111111
NODE_252563_length_263_cov_4.914634	45	117	23	4	72	0.0555556
NODE_252563_length_263_cov_4.914634	45	117	24	4	72	0.0555556
NODE_252563_length_263_cov_4.914634	45	117	26	10	72	0.1388889
NODE_252563_length_263_cov_4.914634	45	117	30	19	72	0.2638889
NODE_252563_length_263_cov_4.914634	45	117	32	25	72	0.3472222
NODE_252595_length_263_cov_4.225610	67	124	8	8	57	0.1403509
NODE_252595_length_263_cov_4.225610	67	124	10	28	57	0.4912281
NODE_252595_length_263_cov_4.225610	67	124	12	21	57	0.3684210
NODE_252663_length_263_cov_3.518293	104	176	2	72	72	1.0000000
NODE_252766_length_263_cov_2.908537	7	93	0	7	86	0.0813954
NODE_252766_length_263_cov_2.908537	7	93	2	34	86	0.3953488
NODE_252766_length_263_cov_2.908537	7	93	4	3	86	0.0348837
NODE_252766_length_263_cov_2.908537	7	93	6	37	86	0.4302326
NODE_252766_length_263_cov_2.908537	7	93	10	5	86	0.0581395
NODE_252778_length_263_cov_2.798780	67	146	8	11	79	0.1392405
NODE_252778_length_263_cov_2.798780	67	146	10	68	79	0.8607595
NODE_252932_length_263_cov_2.396341	207	238	4	31	31	1.0000000
NODE_253261_length_263_cov_1.865854	51	81	16	3	30	0.1000000
NODE_253261_length_263_cov_1.865854	51	81	18	10	30	0.3333333
NODE_253261_length_263_cov_1.865854	51	81	20	4	30	0.1333333
NODE_253261_length_263_cov_1.865854	51	81	22	2	30	0.0666667
NODE_253261_length_263_cov_1.865854	51	81	24	2	30	0.0666667
NODE_253261_length_263_cov_1.865854	51	81	26	9	30	0.3000000
NODE_253310_length_263_cov_1.847561	113	189	0	24	76	0.3157895
NODE_253310_length_263_cov_1.847561	113	189	2	52	76	0.6842105
NODE_253379_length_263_cov_1.750000	151	231	0	10	80	0.1250000
NODE_253379_length_263_cov_1.750000	151	231	2	40	80	0.5000000
NODE_253379_length_263_cov_1.750000	151	231	4	30	80	0.3750000
NODE_253468_length_263_cov_1.579268	32	95	24	4	63	0.0634921
NODE_253468_length_263_cov_1.579268	32	95	28	1	63	0.0158730
NODE_253468_length_263_cov_1.579268	32	95	30	1	63	0.0158730
NODE_253468_length_263_cov_1.579268	32	95	34	2	63	0.0317460
NODE_253468_length_263_cov_1.579268	32	95	36	8	63	0.1269841
NODE_253468_length_263_cov_1.579268	32	95	42	1	63	0.0158730
NODE_253468_length_263_cov_1.579268	32	95	44	2	63	0.0317460
NODE_253468_length_263_cov_1.579268	32	95	46	1	63	0.0158730
NODE_253468_length_263_cov_1.579268	32	95	48	2	63	0.0317460
NODE_253468_length_263_cov_1.579268	32	95	50	1	63	0.0158730
NODE_253468_length_263_cov_1.579268	32	95	52	1	63	0.0158730
NODE_253468_length_263_cov_1.579268	32	95	56	7	63	0.1111111
NODE_253468_length_263_cov_1.579268	32	95	62	1	63	0.0158730
NODE_253468_length_263_cov_1.579268	32	95	64	5	63	0.0793651
NODE_253468_length_263_cov_1.579268	32	95	68	10	63	0.1587302
NODE_253468_length_263_cov_1.579268	32	95	70	3	63	0.0476190
NODE_253468_length_263_cov_1.579268	32	95	72	5	63	0.0793651
NODE_253468_length_263_cov_1.579268	32	95	74	8	63	0.1269841
NODE_253477_length_263_cov_1.567073	98	155	0	22	57	0.3859649
NODE_253477_length_263_cov_1.567073	98	155	3	3	57	0.0526316
NODE_253477_length_263_cov_1.567073	98	155	5	1	57	0.0175439
NODE_253477_length_263_cov_1.567073	98	155	6	31	57	0.5438597
NODE_253619_length_263_cov_1.506098	157	217	0	24	60	0.4000000
NODE_253619_length_263_cov_1.506098	157	217	2	36	60	0.6000000
NODE_253620_length_263_cov_1.506098	84	113	10	2	29	0.0689655
NODE_253620_length_263_cov_1.506098	84	113	12	27	29	0.9310345
NODE_253753_length_263_cov_1.286585	143	223	0	3	80	0.0375000
NODE_253753_length_263_cov_1.286585	143	223	1	2	80	0.0250000
NODE_253753_length_263_cov_1.286585	143	223	5	23	80	0.2875000
NODE_253753_length_263_cov_1.286585	143	223	6	7	80	0.0875000
NODE_253753_length_263_cov_1.286585	143	223	8	1	80	0.0125000
NODE_253753_length_263_cov_1.286585	143	223	12	2	80	0.0250000
NODE_253753_length_263_cov_1.286585	143	223	14	1	80	0.0125000
NODE_253753_length_263_cov_1.286585	143	223	16	1	80	0.0125000
NODE_253753_length_263_cov_1.286585	143	223	18	1	80	0.0125000
NODE_253753_length_263_cov_1.286585	143	223	20	3	80	0.0375000
NODE_253753_length_263_cov_1.286585	143	223	22	12	80	0.1500000
NODE_253753_length_263_cov_1.286585	143	223	24	5	80	0.0625000
NODE_253753_length_263_cov_1.286585	143	223	26	1	80	0.0125000
NODE_253753_length_263_cov_1.286585	143	223	28	18	80	0.2250000
NODE_253788_length_263_cov_1.243902	206	263	0	57	57	1.0000000
NODE_254174_length_263_cov_1.170732	12	66	0	54	54	1.0000000
NODE_254174_length_263_cov_1.170732	39	119	0	80	80	1.0000000
NODE_254301_length_263_cov_1.067073	137	202	0	65	65	1.0000000
NODE_254301_length_263_cov_1.067073	175	255	0	80	80	1.0000000
NODE_254783_length_263_cov_0.810976	163	245	79	1	82	0.0121951
NODE_254783_length_263_cov_0.810976	163	245	85	1	82	0.0121951
NODE_254783_length_263_cov_0.810976	163	245	93	2	82	0.0243902
NODE_254783_length_263_cov_0.810976	163	245	99	1	82	0.0121951
NODE_254783_length_263_cov_0.810976	163	245	101	1	82	0.0121951
NODE_254783_length_263_cov_0.810976	163	245	103	1	82	0.0121951
NODE_254783_length_263_cov_0.810976	163	245	105	1	82	0.0121951
NODE_254783_length_263_cov_0.810976	163	245	113	1	82	0.0121951
NODE_254783_length_263_cov_0.810976	163	245	122	1	82	0.0121951
NODE_254783_length_263_cov_0.810976	163	245	123	1	82	0.0121951
NODE_254783_length_263_cov_0.810976	163	245	125	2	82	0.0243902
NODE_254783_length_263_cov_0.810976	163	245	137	1	82	0.0121951
NODE_254783_length_263_cov_0.810976	163	245	149	1	82	0.0121951
NODE_254783_length_263_cov_0.810976	163	245	159	1	82	0.0121951
NODE_254783_length_263_cov_0.810976	163	245	163	1	82	0.0121951
NODE_254783_length_263_cov_0.810976	163	245	169	1	82	0.0121951
NODE_254783_length_263_cov_0.810976	163	245	175	1	82	0.0121951
NODE_254783_length_263_cov_0.810976	163	245	191	1	82	0.0121951
NODE_254783_length_263_cov_0.810976	163	245	204	1	82	0.0121951
NODE_254783_length_263_cov_0.810976	163	245	206	1	82	0.0121951
NODE_254783_length_263_cov_0.810976	163	245	208	1	82	0.0121951
NODE_254783_length_263_cov_0.810976	163	245	211	2	82	0.0243902
NODE_254783_length_263_cov_0.810976	163	245	215	1	82	0.0121951
NODE_254783_length_263_cov_0.810976	163	245	219	1	82	0.0121951
NODE_254783_length_263_cov_0.810976	163	245	224	2	82	0.0243902
NODE_254783_length_263_cov_0.810976	163	245	225	2	82	0.0243902
NODE_254783_length_263_cov_0.810976	163	245	233	1	82	0.0121951
NODE_254783_length_263_cov_0.810976	163	245	234	1	82	0.0121951
NODE_254783_length_263_cov_0.810976	163	245	238	1	82	0.0121951
NODE_254783_length_263_cov_0.810976	163	245	249	1	82	0.0121951
NODE_254783_length_263_cov_0.810976	163	245	255	1	82	0.0121951
NODE_254783_length_263_cov_0.810976	163	245	267	1	82	0.0121951
NODE_254783_length_263_cov_0.810976	163	245	277	1	82	0.0121951
NODE_254783_length_263_cov_0.810976	163	245	285	1	82	0.0121951
NODE_254783_length_263_cov_0.810976	163	245	310	1	82	0.0121951
NODE_254783_length_263_cov_0.810976	163	245	323	1	82	0.0121951
NODE_254783_length_263_cov_0.810976	163	245	351	1	82	0.0121951
NODE_254783_length_263_cov_0.810976	163	245	356	1	82	0.0121951
NODE_254783_length_263_cov_0.810976	163	245	362	1	82	0.0121951
NODE_254783_length_263_cov_0.810976	163	245	364	1	82	0.0121951
NODE_254783_length_263_cov_0.810976	163	245	380	1	82	0.0121951
NODE_254783_length_263_cov_0.810976	163	245	392	1	82	0.0121951
NODE_254783_length_263_cov_0.810976	163	245	396	1	82	0.0121951
NODE_254783_length_263_cov_0.810976	163	245	400	1	82	0.0121951
NODE_254783_length_263_cov_0.810976	163	245	409	1	82	0.0121951
NODE_254783_length_263_cov_0.810976	163	245	418	2	82	0.0243902
NODE_254783_length_263_cov_0.810976	163	245	426	1	82	0.0121951
NODE_254783_length_263_cov_0.810976	163	245	430	2	82	0.0243902
NODE_254783_length_263_cov_0.810976	163	245	442	1	82	0.0121951
NODE_254783_length_263_cov_0.810976	163	245	445	1	82	0.0121951
NODE_254783_length_263_cov_0.810976	163	245	452	1	82	0.0121951
NODE_254783_length_263_cov_0.810976	163	245	455	1	82	0.0121951
NODE_254783_length_263_cov_0.810976	163	245	457	1	82	0.0121951
NODE_254783_length_263_cov_0.810976	163	245	459	1	82	0.0121951
NODE_254783_length_263_cov_0.810976	163	245	460	1	82	0.0121951
NODE_254783_length_263_cov_0.810976	163	245	468	1	82	0.0121951
NODE_254783_length_263_cov_0.810976	163	245	476	1	82	0.0121951
NODE_254783_length_263_cov_0.810976	163	245	482	1	82	0.0121951
NODE_254783_length_263_cov_0.810976	163	245	490	1	82	0.0121951
NODE_254783_length_263_cov_0.810976	163	245	497	1	82	0.0121951
NODE_254783_length_263_cov_0.810976	163	245	506	1	82	0.0121951
NODE_254783_length_263_cov_0.810976	163	245	512	1	82	0.0121951
NODE_254783_length_263_cov_0.810976	163	245	529	1	82	0.0121951
NODE_254783_length_263_cov_0.810976	163	245	530	3	82	0.0365854
NODE_254783_length_263_cov_0.810976	163	245	533	2	82	0.0243902
NODE_254783_length_263_cov_0.810976	163	245	537	2	82	0.0243902
NODE_254783_length_263_cov_0.810976	163	245	539	4	82	0.0487805
NODE_254783_length_263_cov_0.810976	163	245	541	1	82	0.0121951
NODE_255446_length_263_cov_0.621951	212	258	2	33	46	0.7173913
NODE_255446_length_263_cov_0.621951	212	258	4	13	46	0.2826087
NODE_255524_length_263_cov_0.621951	131	151	0	20	20	1.0000000
NODE_255559_length_263_cov_0.621951	67	86	0	19	19	1.0000000
NODE_255727_length_262_cov_5.312883	20	82	2	62	62	1.0000000
NODE_255769_length_262_cov_4.447853	102	155	0	27	53	0.5094340
NODE_255769_length_262_cov_4.447853	102	155	2	8	53	0.1509434
NODE_255769_length_262_cov_4.447853	102	155	6	18	53	0.3396226
NODE_255821_length_262_cov_3.766871	48	89	0	41	41	1.0000000
NODE_255860_length_262_cov_3.435583	158	235	2	77	77	1.0000000
NODE_255945_length_262_cov_2.938650	142	222	0	80	80	1.0000000
NODE_256009_length_262_cov_2.723926	103	183	0	80	80	1.0000000
NODE_256049_length_262_cov_2.509202	88	148	2	23	60	0.3833333
NODE_256049_length_262_cov_2.509202	88	148	6	8	60	0.1333333
NODE_256049_length_262_cov_2.509202	88	148	8	29	60	0.4833333
NODE_256050_length_262_cov_2.509202	0	61	0	61	61	1.0000000
NODE_256050_length_262_cov_2.509202	107	171	0	64	64	1.0000000
NODE_256050_length_262_cov_2.509202	144	224	0	80	80	1.0000000
NODE_256129_length_262_cov_2.429448	14	87	0	73	73	1.0000000
NODE_256129_length_262_cov_2.429448	62	149	0	87	87	1.0000000
NODE_256176_length_262_cov_2.226994	2	79	2	1	77	0.0129870
NODE_256176_length_262_cov_2.226994	2	79	4	11	77	0.1428571
NODE_256176_length_262_cov_2.226994	2	79	6	65	77	0.8441558
NODE_256187_length_262_cov_2.202454	61	81	0	20	20	1.0000000
NODE_256199_length_262_cov_2.190184	172	235	0	4	63	0.0634921
NODE_256199_length_262_cov_2.190184	172	235	2	59	63	0.9365079
NODE_256239_length_262_cov_2.177914	133	189	0	19	56	0.3392857
NODE_256239_length_262_cov_2.177914	133	189	4	37	56	0.6607143
NODE_256265_length_262_cov_2.122699	96	157	13	7	61	0.1147541
NODE_256265_length_262_cov_2.122699	96	157	15	8	61	0.1311475
NODE_256265_length_262_cov_2.122699	96	157	17	4	61	0.0655738
NODE_256265_length_262_cov_2.122699	96	157	19	11	61	0.1803279
NODE_256265_length_262_cov_2.122699	96	157	21	3	61	0.0491803
NODE_256265_length_262_cov_2.122699	96	157	25	4	61	0.0655738
NODE_256265_length_262_cov_2.122699	96	157	29	11	61	0.1803279
NODE_256265_length_262_cov_2.122699	96	157	31	13	61	0.2131148
NODE_256386_length_262_cov_1.877301	0	77	0	29	77	0.3766234
NODE_256386_length_262_cov_1.877301	0	77	2	48	77	0.6233766
NODE_256390_length_262_cov_1.877301	77	124	16	31	47	0.6595744
NODE_256390_length_262_cov_1.877301	77	124	18	16	47	0.3404255
NODE_256481_length_262_cov_1.871166	192	252	0	60	60	1.0000000
NODE_256596_length_262_cov_1.736196	149	208	0	37	59	0.6271186
NODE_256596_length_262_cov_1.736196	149	208	2	22	59	0.3728814
NODE_256630_length_262_cov_1.680982	2	82	0	80	80	1.0000000
NODE_256650_length_262_cov_1.656442	135	166	0	3	31	0.0967742
NODE_256650_length_262_cov_1.656442	135	166	2	28	31	0.9032258
NODE_256659_length_262_cov_1.638037	111	142	14	2	31	0.0645161
NODE_256659_length_262_cov_1.638037	111	142	16	5	31	0.1612903
NODE_256659_length_262_cov_1.638037	111	142	17	5	31	0.1612903
NODE_256659_length_262_cov_1.638037	111	142	18	3	31	0.0967742
NODE_256659_length_262_cov_1.638037	111	142	20	5	31	0.1612903
NODE_256659_length_262_cov_1.638037	111	142	22	1	31	0.0322581
NODE_256659_length_262_cov_1.638037	111	142	24	8	31	0.2580645
NODE_256659_length_262_cov_1.638037	111	142	26	1	31	0.0322581
NODE_256659_length_262_cov_1.638037	111	142	28	1	31	0.0322581
NODE_256704_length_262_cov_1.576687	102	182	2	10	80	0.1250000
NODE_256704_length_262_cov_1.576687	102	182	4	15	80	0.1875000
NODE_256704_length_262_cov_1.576687	102	182	5	55	80	0.6875000
NODE_256704_length_262_cov_1.576687	155	221	3	38	66	0.5757576
NODE_256704_length_262_cov_1.576687	155	221	5	28	66	0.4242424
NODE_256742_length_262_cov_1.564417	69	124	0	51	55	0.9272727
NODE_256742_length_262_cov_1.564417	69	124	2	4	55	0.0727273
NODE_256742_length_262_cov_1.564417	106	177	0	14	71	0.1971831
NODE_256742_length_262_cov_1.564417	106	177	2	29	71	0.4084507
NODE_256742_length_262_cov_1.564417	106	177	4	28	71	0.3943662
NODE_256933_length_262_cov_1.349693	52	102	0	50	50	1.0000000
NODE_256933_length_262_cov_1.349693	83	149	0	66	66	1.0000000
NODE_257199_length_262_cov_1.251534	44	124	0	47	80	0.5875000
NODE_257199_length_262_cov_1.251534	44	124	2	33	80	0.4125000
NODE_257199_length_262_cov_1.251534	97	171	2	74	74	1.0000000
NODE_258876_length_261_cov_31.913580	32	112	0	80	80	1.0000000
NODE_258876_length_261_cov_31.913580	85	171	0	86	86	1.0000000
NODE_258901_length_261_cov_6.376543	126	201	2	75	75	1.0000000
NODE_258901_length_261_cov_6.376543	179	254	0	2	75	0.0266667
NODE_258901_length_261_cov_6.376543	179	254	2	73	75	0.9733334
NODE_258929_length_261_cov_5.469136	56	132	0	76	76	1.0000000
NODE_259329_length_261_cov_2.425926	53	134	0	81	81	1.0000000
NODE_259361_length_261_cov_2.333333	41	136	0	95	95	1.0000000
NODE_259435_length_261_cov_2.191358	86	122	2	36	36	1.0000000
NODE_259495_length_261_cov_1.993827	134	214	8	43	80	0.5375000
NODE_259495_length_261_cov_1.993827	134	214	9	21	80	0.2625000
NODE_259495_length_261_cov_1.993827	134	214	10	3	80	0.0375000
NODE_259495_length_261_cov_1.993827	134	214	11	13	80	0.1625000
NODE_259672_length_261_cov_1.882716	51	105	18	4	54	0.0740741
NODE_259672_length_261_cov_1.882716	51	105	20	2	54	0.0370370
NODE_259672_length_261_cov_1.882716	51	105	24	4	54	0.0740741
NODE_259672_length_261_cov_1.882716	51	105	28	2	54	0.0370370
NODE_259672_length_261_cov_1.882716	51	105	30	4	54	0.0740741
NODE_259672_length_261_cov_1.882716	51	105	36	2	54	0.0370370
NODE_259672_length_261_cov_1.882716	51	105	38	1	54	0.0185185
NODE_259672_length_261_cov_1.882716	51	105	40	4	54	0.0740741
NODE_259672_length_261_cov_1.882716	51	105	42	4	54	0.0740741
NODE_259672_length_261_cov_1.882716	51	105	48	1	54	0.0185185
NODE_259672_length_261_cov_1.882716	51	105	50	26	54	0.4814815
NODE_259740_length_261_cov_1.839506	118	197	0	32	79	0.4050633
NODE_259740_length_261_cov_1.839506	118	197	2	1	79	0.0126582
NODE_259740_length_261_cov_1.839506	118	197	4	25	79	0.3164557
NODE_259740_length_261_cov_1.839506	118	197	6	9	79	0.1139240
NODE_259740_length_261_cov_1.839506	118	197	8	3	79	0.0379747
NODE_259740_length_261_cov_1.839506	118	197	10	3	79	0.0379747
NODE_259740_length_261_cov_1.839506	118	197	12	6	79	0.0759494
NODE_259769_length_261_cov_1.783951	69	141	6	18	72	0.2500000
NODE_259769_length_261_cov_1.783951	69	141	8	41	72	0.5694444
NODE_259769_length_261_cov_1.783951	69	141	10	13	72	0.1805556
NODE_260089_length_261_cov_1.388889	202	247	0	44	45	0.9777778
NODE_260089_length_261_cov_1.388889	202	247	4	1	45	0.0222222
NODE_260090_length_261_cov_1.382716	14	61	0	47	47	1.0000000
NODE_260428_length_261_cov_1.253086	100	138	16	38	38	1.0000000
NODE_260738_length_261_cov_1.030864	122	205	2	6	83	0.0722892
NODE_260738_length_261_cov_1.030864	122	205	4	4	83	0.0481928
NODE_260738_length_261_cov_1.030864	122	205	6	73	83	0.8795181
NODE_260738_length_261_cov_1.030864	129	210	4	3	81	0.0370370
NODE_260738_length_261_cov_1.030864	129	210	6	78	81	0.9629630
NODE_260738_length_261_cov_1.030864	129	184	4	3	55	0.0545455
NODE_260738_length_261_cov_1.030864	129	184	6	52	55	0.9454545
NODE_260738_length_261_cov_1.030864	187	248	4	20	61	0.3278688
NODE_260738_length_261_cov_1.030864	187	248	6	41	61	0.6721311
NODE_260767_length_261_cov_1.006173	3	45	0	9	42	0.2142857
NODE_260767_length_261_cov_1.006173	3	45	2	16	42	0.3809524
NODE_260767_length_261_cov_1.006173	3	45	4	17	42	0.4047619
NODE_260767_length_261_cov_1.006173	46	98	2	7	52	0.1346154
NODE_260767_length_261_cov_1.006173	46	98	4	45	52	0.8653846
NODE_262062_length_261_cov_0.580247	11	31	0	20	20	1.0000000
NODE_262121_length_260_cov_8.844720	74	138	0	64	64	1.0000000
NODE_262123_length_260_cov_8.447205	30	110	0	80	80	1.0000000
NODE_262123_length_260_cov_8.447205	83	167	0	84	84	1.0000000
NODE_262123_length_260_cov_8.447205	163	243	0	80	80	1.0000000
NODE_262149_length_260_cov_5.807453	38	118	0	80	80	1.0000000
NODE_262149_length_260_cov_5.807453	91	171	0	80	80	1.0000000
NODE_262264_length_260_cov_3.645963	5	57	0	20	52	0.3846154
NODE_262264_length_260_cov_3.645963	5	57	4	32	52	0.6153846
NODE_262329_length_260_cov_3.167702	91	163	0	72	72	1.0000000
NODE_262378_length_260_cov_2.981366	58	127	0	69	69	1.0000000
NODE_262384_length_260_cov_2.913043	10	90	0	80	80	1.0000000
NODE_262708_length_260_cov_2.161491	174	251	0	77	77	1.0000000
NODE_262733_length_260_cov_2.080745	188	258	0	70	70	1.0000000
NODE_262788_length_260_cov_1.950311	27	85	10	20	58	0.3448276
NODE_262788_length_260_cov_1.950311	27	85	12	38	58	0.6551724
NODE_262930_length_260_cov_1.900621	14	50	0	36	36	1.0000000
NODE_263117_length_260_cov_1.683230	50	130	0	21	80	0.2625000
NODE_263117_length_260_cov_1.683230	50	130	2	20	80	0.2500000
NODE_263117_length_260_cov_1.683230	50	130	4	39	80	0.4875000
NODE_263428_length_260_cov_1.347826	38	118	2	80	80	1.0000000
NODE_263533_length_260_cov_1.267081	114	199	0	85	85	1.0000000
NODE_263556_length_260_cov_1.267081	198	244	0	46	46	1.0000000
NODE_263568_length_260_cov_1.267081	145	189	10	41	44	0.9318182
NODE_263568_length_260_cov_1.267081	145	189	12	3	44	0.0681818
NODE_265483_length_259_cov_4.800000	35	95	2	12	60	0.2000000
NODE_265483_length_259_cov_4.800000	35	95	4	48	60	0.8000000
NODE_265584_length_259_cov_3.675000	119	161	2	42	42	1.0000000
NODE_265584_length_259_cov_3.675000	134	214	2	80	80	1.0000000
NODE_265592_length_259_cov_3.593750	100	143	0	43	43	1.0000000
NODE_265611_length_259_cov_3.475000	198	259	5	21	61	0.3442623
NODE_265611_length_259_cov_3.475000	198	259	7	27	61	0.4426230
NODE_265611_length_259_cov_3.475000	198	259	9	8	61	0.1311475
NODE_265611_length_259_cov_3.475000	198	259	14	2	61	0.0327869
NODE_265611_length_259_cov_3.475000	198	259	15	3	61	0.0491803
NODE_265625_length_259_cov_3.331250	72	118	0	46	46	1.0000000
NODE_265636_length_259_cov_3.237500	103	160	0	57	57	1.0000000
NODE_265704_length_259_cov_2.937500	209	233	5	15	24	0.6250000
NODE_265704_length_259_cov_2.937500	209	233	7	8	24	0.3333333
NODE_265704_length_259_cov_2.937500	209	233	9	1	24	0.0416667
NODE_265735_length_259_cov_2.850000	0	41	2	41	41	1.0000000
NODE_265735_length_259_cov_2.850000	14	94	2	80	80	1.0000000
NODE_265818_length_259_cov_2.550000	9	82	0	73	73	1.0000000
NODE_265942_length_259_cov_2.287500	147	225	0	78	78	1.0000000
NODE_265942_length_259_cov_2.287500	198	241	0	43	43	1.0000000
NODE_266032_length_259_cov_2.156250	0	72	0	72	72	1.0000000
NODE_266080_length_259_cov_2.012500	8	73	4	51	65	0.7846154
NODE_266080_length_259_cov_2.012500	8	73	6	14	65	0.2153846
NODE_266080_length_259_cov_2.012500	53	126	4	6	73	0.0821918
NODE_266080_length_259_cov_2.012500	53	126	6	45	73	0.6164383
NODE_266080_length_259_cov_2.012500	53	126	8	22	73	0.3013699
NODE_266101_length_259_cov_1.962500	108	189	16	2	81	0.0246914
NODE_266101_length_259_cov_1.962500	108	189	18	18	81	0.2222222
NODE_266101_length_259_cov_1.962500	108	189	20	1	81	0.0123457
NODE_266101_length_259_cov_1.962500	108	189	22	38	81	0.4691358
NODE_266101_length_259_cov_1.962500	108	189	24	6	81	0.0740741
NODE_266101_length_259_cov_1.962500	108	189	25	2	81	0.0246914
NODE_266101_length_259_cov_1.962500	108	189	26	14	81	0.1728395
NODE_266117_length_259_cov_1.918750	49	120	0	71	71	1.0000000
NODE_266183_length_259_cov_1.912500	114	177	0	60	63	0.9523810
NODE_266183_length_259_cov_1.912500	114	177	2	3	63	0.0476190
NODE_266365_length_259_cov_1.837500	180	252	2	4	72	0.0555556
NODE_266365_length_259_cov_1.837500	180	252	4	23	72	0.3194444
NODE_266365_length_259_cov_1.837500	180	252	6	26	72	0.3611111
NODE_266365_length_259_cov_1.837500	180	252	8	19	72	0.2638889
NODE_266609_length_259_cov_1.593750	27	67	0	40	40	1.0000000
NODE_266746_length_259_cov_1.400000	117	164	2	20	47	0.4255319
NODE_266746_length_259_cov_1.400000	117	164	4	27	47	0.5744681
NODE_266746_length_259_cov_1.400000	137	217	0	44	80	0.5500000
NODE_266746_length_259_cov_1.400000	137	217	1	1	80	0.0125000
NODE_266746_length_259_cov_1.400000	137	217	2	28	80	0.3500000
NODE_266746_length_259_cov_1.400000	137	217	4	7	80	0.0875000
NODE_268816_length_258_cov_6.415094	129	209	0	80	80	1.0000000
NODE_268816_length_258_cov_6.415094	182	258	0	76	76	1.0000000
NODE_268823_length_258_cov_6.157233	1	81	0	80	80	1.0000000
NODE_268823_length_258_cov_6.157233	9	64	0	55	55	1.0000000
NODE_268852_length_258_cov_4.798742	83	163	4	48	80	0.6000000
NODE_268852_length_258_cov_4.798742	83	163	6	28	80	0.3500000
NODE_268852_length_258_cov_4.798742	83	163	8	4	80	0.0500000
NODE_268870_length_258_cov_4.396226	0	44	0	44	44	1.0000000
NODE_268870_length_258_cov_4.396226	24	97	0	73	73	1.0000000
NODE_268880_length_258_cov_4.301887	0	54	0	54	54	1.0000000
NODE_268942_length_258_cov_3.616352	29	58	0	29	29	1.0000000
NODE_268982_length_258_cov_3.352201	47	127	16	1	80	0.0125000
NODE_268982_length_258_cov_3.352201	47	127	20	1	80	0.0125000
NODE_268982_length_258_cov_3.352201	47	127	24	1	80	0.0125000
NODE_268982_length_258_cov_3.352201	47	127	26	1	80	0.0125000
NODE_268982_length_258_cov_3.352201	47	127	32	1	80	0.0125000
NODE_268982_length_258_cov_3.352201	47	127	34	2	80	0.0250000
NODE_268982_length_258_cov_3.352201	47	127	36	1	80	0.0125000
NODE_268982_length_258_cov_3.352201	47	127	40	5	80	0.0625000
NODE_268982_length_258_cov_3.352201	47	127	42	2	80	0.0250000
NODE_268982_length_258_cov_3.352201	47	127	44	2	80	0.0250000
NODE_268982_length_258_cov_3.352201	47	127	46	1	80	0.0125000
NODE_268982_length_258_cov_3.352201	47	127	48	10	80	0.1250000
NODE_268982_length_258_cov_3.352201	47	127	50	8	80	0.1000000
NODE_268982_length_258_cov_3.352201	47	127	52	44	80	0.5500000
NODE_269086_length_258_cov_2.886792	102	121	0	19	19	1.0000000
NODE_269091_length_258_cov_2.880503	92	172	0	80	80	1.0000000
NODE_269102_length_258_cov_2.855346	96	138	31	1	42	0.0238095
NODE_269102_length_258_cov_2.855346	96	138	33	11	42	0.2619048
NODE_269102_length_258_cov_2.855346	96	138	35	8	42	0.1904762
NODE_269102_length_258_cov_2.855346	96	138	37	3	42	0.0714286
NODE_269102_length_258_cov_2.855346	96	138	39	1	42	0.0238095
NODE_269102_length_258_cov_2.855346	96	138	41	6	42	0.1428571
NODE_269102_length_258_cov_2.855346	96	138	43	12	42	0.2857143
NODE_269102_length_258_cov_2.855346	148	191	4	6	43	0.1395349
NODE_269102_length_258_cov_2.855346	148	191	6	1	43	0.0232558
NODE_269102_length_258_cov_2.855346	148	191	9	7	43	0.1627907
NODE_269102_length_258_cov_2.855346	148	191	10	5	43	0.1162791
NODE_269102_length_258_cov_2.855346	148	191	12	5	43	0.1162791
NODE_269102_length_258_cov_2.855346	148	191	13	7	43	0.1627907
NODE_269102_length_258_cov_2.855346	148	191	15	5	43	0.1162791
NODE_269102_length_258_cov_2.855346	148	191	19	7	43	0.1627907
NODE_269113_length_258_cov_2.817610	10	58	0	30	48	0.6250000
NODE_269113_length_258_cov_2.817610	10	58	2	18	48	0.3750000
NODE_269264_length_258_cov_2.383648	48	128	2	4	80	0.0500000
NODE_269264_length_258_cov_2.383648	48	128	4	5	80	0.0625000
NODE_269264_length_258_cov_2.383648	48	128	6	4	80	0.0500000
NODE_269264_length_258_cov_2.383648	48	128	8	5	80	0.0625000
NODE_269264_length_258_cov_2.383648	48	128	10	62	80	0.7750000
NODE_269264_length_258_cov_2.383648	101	182	5	19	81	0.2345679
NODE_269264_length_258_cov_2.383648	101	182	7	11	81	0.1358025
NODE_269264_length_258_cov_2.383648	101	182	9	10	81	0.1234568
NODE_269264_length_258_cov_2.383648	101	182	10	41	81	0.5061728
NODE_269338_length_258_cov_2.238994	61	141	0	80	80	1.0000000
NODE_269615_length_258_cov_1.918239	0	51	0	51	51	1.0000000
NODE_269682_length_258_cov_1.855346	26	47	0	21	21	1.0000000
NODE_269682_length_258_cov_1.855346	71	104	9	12	33	0.3636364
NODE_269682_length_258_cov_1.855346	71	104	11	6	33	0.1818182
NODE_269682_length_258_cov_1.855346	71	104	18	6	33	0.1818182
NODE_269682_length_258_cov_1.855346	71	104	20	9	33	0.2727273
NODE_269682_length_258_cov_1.855346	81	156	9	2	75	0.0266667
NODE_269682_length_258_cov_1.855346	81	156	11	6	75	0.0800000
NODE_269682_length_258_cov_1.855346	81	156	18	6	75	0.0800000
NODE_269682_length_258_cov_1.855346	81	156	20	34	75	0.4533333
NODE_269682_length_258_cov_1.855346	81	156	24	27	75	0.3600000
NODE_269749_length_258_cov_1.735849	105	176	5	3	71	0.0422535
NODE_269749_length_258_cov_1.735849	105	176	6	1	71	0.0140845
NODE_269749_length_258_cov_1.735849	105	176	8	17	71	0.2394366
NODE_269749_length_258_cov_1.735849	105	176	10	5	71	0.0704225
NODE_269749_length_258_cov_1.735849	105	176	12	1	71	0.0140845
NODE_269749_length_258_cov_1.735849	105	176	14	1	71	0.0140845
NODE_269749_length_258_cov_1.735849	105	176	16	6	71	0.0845070
NODE_269749_length_258_cov_1.735849	105	176	18	23	71	0.3239437
NODE_269749_length_258_cov_1.735849	105	176	20	9	71	0.1267606
NODE_269749_length_258_cov_1.735849	105	176	24	2	71	0.0281690
NODE_269749_length_258_cov_1.735849	105	176	26	2	71	0.0281690
NODE_269749_length_258_cov_1.735849	105	176	28	1	71	0.0140845
NODE_269767_length_258_cov_1.710692	8	49	0	41	41	1.0000000
NODE_270191_length_258_cov_1.283019	127	191	2	15	64	0.2343750
NODE_270191_length_258_cov_1.283019	127	191	4	49	64	0.7656250
NODE_270191_length_258_cov_1.283019	164	227	2	22	63	0.3492064
NODE_270191_length_258_cov_1.283019	164	227	4	41	63	0.6507937
NODE_270465_length_258_cov_1.270440	4	55	0	51	51	1.0000000
NODE_270504_length_258_cov_1.232704	90	166	10	4	76	0.0526316
NODE_270504_length_258_cov_1.232704	90	166	12	2	76	0.0263158
NODE_270504_length_258_cov_1.232704	90	166	14	1	76	0.0131579
NODE_270504_length_258_cov_1.232704	90	166	16	1	76	0.0131579
NODE_270504_length_258_cov_1.232704	90	166	24	3	76	0.0394737
NODE_270504_length_258_cov_1.232704	90	166	26	1	76	0.0131579
NODE_270504_length_258_cov_1.232704	90	166	28	5	76	0.0657895
NODE_270504_length_258_cov_1.232704	90	166	32	19	76	0.2500000
NODE_270504_length_258_cov_1.232704	90	166	34	32	76	0.4210526
NODE_270504_length_258_cov_1.232704	90	166	35	1	76	0.0131579
NODE_270504_length_258_cov_1.232704	90	166	36	7	76	0.0921053
NODE_270547_length_258_cov_1.201258	49	98	2	16	49	0.3265306
NODE_270547_length_258_cov_1.201258	49	98	4	33	49	0.6734694
NODE_270876_length_258_cov_0.962264	186	258	0	72	72	1.0000000
NODE_270970_length_258_cov_0.962264	69	124	0	31	55	0.5636364
NODE_270970_length_258_cov_0.962264	69	124	2	24	55	0.4363636
NODE_272169_length_257_cov_71.158228	81	165	107	9	84	0.1071429
NODE_272169_length_257_cov_71.158228	81	165	108	3	84	0.0357143
NODE_272169_length_257_cov_71.158228	81	165	109	1	84	0.0119048
NODE_272169_length_257_cov_71.158228	81	165	111	1	84	0.0119048
NODE_272169_length_257_cov_71.158228	81	165	112	1	84	0.0119048
NODE_272169_length_257_cov_71.158228	81	165	113	1	84	0.0119048
NODE_272169_length_257_cov_71.158228	81	165	114	1	84	0.0119048
NODE_272169_length_257_cov_71.158228	81	165	115	1	84	0.0119048
NODE_272169_length_257_cov_71.158228	81	165	116	8	84	0.0952381
NODE_272169_length_257_cov_71.158228	81	165	117	4	84	0.0476190
NODE_272169_length_257_cov_71.158228	81	165	118	3	84	0.0357143
NODE_272169_length_257_cov_71.158228	81	165	119	2	84	0.0238095
NODE_272169_length_257_cov_71.158228	81	165	120	2	84	0.0238095
NODE_272169_length_257_cov_71.158228	81	165	121	7	84	0.0833333
NODE_272169_length_257_cov_71.158228	81	165	123	8	84	0.0952381
NODE_272169_length_257_cov_71.158228	81	165	125	1	84	0.0119048
NODE_272169_length_257_cov_71.158228	81	165	128	1	84	0.0119048
NODE_272169_length_257_cov_71.158228	81	165	129	3	84	0.0357143
NODE_272169_length_257_cov_71.158228	81	165	130	2	84	0.0238095
NODE_272169_length_257_cov_71.158228	81	165	131	2	84	0.0238095
NODE_272169_length_257_cov_71.158228	81	165	132	3	84	0.0357143
NODE_272169_length_257_cov_71.158228	81	165	133	8	84	0.0952381
NODE_272169_length_257_cov_71.158228	81	165	134	3	84	0.0357143
NODE_272169_length_257_cov_71.158228	81	165	135	6	84	0.0714286
NODE_272169_length_257_cov_71.158228	81	165	137	3	84	0.0357143
NODE_272169_length_257_cov_71.158228	145	218	46	6	73	0.0821918
NODE_272169_length_257_cov_71.158228	145	218	50	7	73	0.0958904
NODE_272169_length_257_cov_71.158228	145	218	51	3	73	0.0410959
NODE_272169_length_257_cov_71.158228	145	218	53	2	73	0.0273973
NODE_272169_length_257_cov_71.158228	145	218	55	3	73	0.0410959
NODE_272169_length_257_cov_71.158228	145	218	59	8	73	0.1095890
NODE_272169_length_257_cov_71.158228	145	218	61	4	73	0.0547945
NODE_272169_length_257_cov_71.158228	145	218	65	1	73	0.0136986
NODE_272169_length_257_cov_71.158228	145	218	66	1	73	0.0136986
NODE_272169_length_257_cov_71.158228	145	218	73	1	73	0.0136986
NODE_272169_length_257_cov_71.158228	145	218	74	1	73	0.0136986
NODE_272169_length_257_cov_71.158228	145	218	76	2	73	0.0273973
NODE_272169_length_257_cov_71.158228	145	218	78	2	73	0.0273973
NODE_272169_length_257_cov_71.158228	145	218	80	1	73	0.0136986
NODE_272169_length_257_cov_71.158228	145	218	83	3	73	0.0410959
NODE_272169_length_257_cov_71.158228	145	218	95	3	73	0.0410959
NODE_272169_length_257_cov_71.158228	145	218	99	1	73	0.0136986
NODE_272169_length_257_cov_71.158228	145	218	101	1	73	0.0136986
NODE_272169_length_257_cov_71.158228	145	218	103	1	73	0.0136986
NODE_272169_length_257_cov_71.158228	145	218	105	2	73	0.0273973
NODE_272169_length_257_cov_71.158228	145	218	107	9	73	0.1232877
NODE_272169_length_257_cov_71.158228	145	218	108	3	73	0.0410959
NODE_272169_length_257_cov_71.158228	145	218	109	1	73	0.0136986
NODE_272169_length_257_cov_71.158228	145	218	111	1	73	0.0136986
NODE_272169_length_257_cov_71.158228	145	218	112	1	73	0.0136986
NODE_272169_length_257_cov_71.158228	145	218	114	1	73	0.0136986
NODE_272169_length_257_cov_71.158228	145	218	116	1	73	0.0136986
NODE_272169_length_257_cov_71.158228	145	218	117	1	73	0.0136986
NODE_272169_length_257_cov_71.158228	145	218	118	2	73	0.0273973
NODE_272194_length_257_cov_6.329114	15	93	0	14	78	0.1794872
NODE_272194_length_257_cov_6.329114	15	93	2	2	78	0.0256410
NODE_272194_length_257_cov_6.329114	15	93	4	62	78	0.7948718
NODE_272275_length_257_cov_4.177215	25	86	0	58	61	0.9508197
NODE_272275_length_257_cov_4.177215	25	86	3	1	61	0.0163934
NODE_272275_length_257_cov_4.177215	25	86	4	2	61	0.0327869
NODE_272291_length_257_cov_3.987342	55	107	4	24	52	0.4615385
NODE_272291_length_257_cov_3.987342	55	107	6	28	52	0.5384616
NODE_272304_length_257_cov_3.873418	145	225	0	80	80	1.0000000
NODE_272304_length_257_cov_3.873418	198	254	0	56	56	1.0000000
NODE_272322_length_257_cov_3.740506	133	199	9	1	66	0.0151515
NODE_272322_length_257_cov_3.740506	133	199	10	3	66	0.0454545
NODE_272322_length_257_cov_3.740506	133	199	11	1	66	0.0151515
NODE_272322_length_257_cov_3.740506	133	199	15	1	66	0.0151515
NODE_272322_length_257_cov_3.740506	133	199	16	8	66	0.1212121
NODE_272322_length_257_cov_3.740506	133	199	17	7	66	0.1060606
NODE_272322_length_257_cov_3.740506	133	199	18	1	66	0.0151515
NODE_272322_length_257_cov_3.740506	133	199	22	3	66	0.0454545
NODE_272322_length_257_cov_3.740506	133	199	26	1	66	0.0151515
NODE_272322_length_257_cov_3.740506	133	199	28	4	66	0.0606061
NODE_272322_length_257_cov_3.740506	133	199	36	2	66	0.0303030
NODE_272322_length_257_cov_3.740506	133	199	42	1	66	0.0151515
NODE_272322_length_257_cov_3.740506	133	199	50	4	66	0.0606061
NODE_272322_length_257_cov_3.740506	133	199	52	3	66	0.0454545
NODE_272322_length_257_cov_3.740506	133	199	56	1	66	0.0151515
NODE_272322_length_257_cov_3.740506	133	199	58	2	66	0.0303030
NODE_272322_length_257_cov_3.740506	133	199	60	1	66	0.0151515
NODE_272322_length_257_cov_3.740506	133	199	62	1	66	0.0151515
NODE_272322_length_257_cov_3.740506	133	199	64	3	66	0.0454545
NODE_272322_length_257_cov_3.740506	133	199	66	1	66	0.0151515
NODE_272322_length_257_cov_3.740506	133	199	69	4	66	0.0606061
NODE_272322_length_257_cov_3.740506	133	199	71	1	66	0.0151515
NODE_272322_length_257_cov_3.740506	133	199	75	1	66	0.0151515
NODE_272322_length_257_cov_3.740506	133	199	77	1	66	0.0151515
NODE_272322_length_257_cov_3.740506	133	199	81	2	66	0.0303030
NODE_272322_length_257_cov_3.740506	133	199	83	3	66	0.0454545
NODE_272322_length_257_cov_3.740506	133	199	85	1	66	0.0151515
NODE_272322_length_257_cov_3.740506	133	199	87	3	66	0.0454545
NODE_272322_length_257_cov_3.740506	133	199	93	1	66	0.0151515
NODE_272322_length_257_cov_3.740506	177	256	1	26	79	0.3291139
NODE_272322_length_257_cov_3.740506	177	256	2	21	79	0.2658228
NODE_272322_length_257_cov_3.740506	177	256	3	3	79	0.0379747
NODE_272322_length_257_cov_3.740506	177	256	5	3	79	0.0379747
NODE_272322_length_257_cov_3.740506	177	256	7	1	79	0.0126582
NODE_272322_length_257_cov_3.740506	177	256	9	4	79	0.0506329
NODE_272322_length_257_cov_3.740506	177	256	10	3	79	0.0379747
NODE_272322_length_257_cov_3.740506	177	256	11	1	79	0.0126582
NODE_272322_length_257_cov_3.740506	177	256	15	1	79	0.0126582
NODE_272322_length_257_cov_3.740506	177	256	16	8	79	0.1012658
NODE_272322_length_257_cov_3.740506	177	256	17	7	79	0.0886076
NODE_272322_length_257_cov_3.740506	177	256	18	1	79	0.0126582
NODE_272486_length_257_cov_2.734177	1	65	0	63	64	0.9843750
NODE_272486_length_257_cov_2.734177	1	65	2	1	64	0.0156250
NODE_272491_length_257_cov_2.677215	170	250	0	30	80	0.3750000
NODE_272491_length_257_cov_2.677215	170	250	2	7	80	0.0875000
NODE_272491_length_257_cov_2.677215	170	250	4	2	80	0.0250000
NODE_272491_length_257_cov_2.677215	170	250	6	2	80	0.0250000
NODE_272491_length_257_cov_2.677215	170	250	10	1	80	0.0125000
NODE_272491_length_257_cov_2.677215	170	250	12	6	80	0.0750000
NODE_272491_length_257_cov_2.677215	170	250	14	2	80	0.0250000
NODE_272491_length_257_cov_2.677215	170	250	16	5	80	0.0625000
NODE_272491_length_257_cov_2.677215	170	250	18	1	80	0.0125000
NODE_272491_length_257_cov_2.677215	170	250	20	6	80	0.0750000
NODE_272491_length_257_cov_2.677215	170	250	22	6	80	0.0750000
NODE_272491_length_257_cov_2.677215	170	250	26	6	80	0.0750000
NODE_272491_length_257_cov_2.677215	170	250	30	2	80	0.0250000
NODE_272491_length_257_cov_2.677215	170	250	34	4	80	0.0500000
NODE_272580_length_257_cov_2.537975	60	137	4	77	77	1.0000000
NODE_272596_length_257_cov_2.487342	95	172	0	47	77	0.6103896
NODE_272596_length_257_cov_2.487342	95	172	1	4	77	0.0519481
NODE_272596_length_257_cov_2.487342	95	172	2	1	77	0.0129870
NODE_272596_length_257_cov_2.487342	95	172	3	25	77	0.3246753
NODE_272625_length_257_cov_2.379747	106	186	8	2	80	0.0250000
NODE_272625_length_257_cov_2.379747	106	186	14	7	80	0.0875000
NODE_272625_length_257_cov_2.379747	106	186	16	2	80	0.0250000
NODE_272625_length_257_cov_2.379747	106	186	18	18	80	0.2250000
NODE_272625_length_257_cov_2.379747	106	186	20	16	80	0.2000000
NODE_272625_length_257_cov_2.379747	106	186	22	2	80	0.0250000
NODE_272625_length_257_cov_2.379747	106	186	24	19	80	0.2375000
NODE_272625_length_257_cov_2.379747	106	186	26	14	80	0.1750000
NODE_272625_length_257_cov_2.379747	159	207	10	4	48	0.0833333
NODE_272625_length_257_cov_2.379747	159	207	16	8	48	0.1666667
NODE_272625_length_257_cov_2.379747	159	207	18	3	48	0.0625000
NODE_272625_length_257_cov_2.379747	159	207	20	4	48	0.0833333
NODE_272625_length_257_cov_2.379747	159	207	22	2	48	0.0416667
NODE_272625_length_257_cov_2.379747	159	207	24	19	48	0.3958333
NODE_272625_length_257_cov_2.379747	159	207	26	8	48	0.1666667
NODE_272724_length_257_cov_2.221519	163	240	0	8	77	0.1038961
NODE_272724_length_257_cov_2.221519	163	240	2	53	77	0.6883117
NODE_272724_length_257_cov_2.221519	163	240	4	16	77	0.2077922
NODE_272729_length_257_cov_2.202532	16	97	2	1	81	0.0123457
NODE_272729_length_257_cov_2.202532	16	97	3	9	81	0.1111111
NODE_272729_length_257_cov_2.202532	16	97	4	27	81	0.3333333
NODE_272729_length_257_cov_2.202532	16	97	6	34	81	0.4197531
NODE_272729_length_257_cov_2.202532	16	97	8	10	81	0.1234568
NODE_273151_length_257_cov_1.664557	220	239	0	19	19	1.0000000
NODE_273357_length_257_cov_1.500000	85	166	2	7	81	0.0864198
NODE_273357_length_257_cov_1.500000	85	166	4	74	81	0.9135802
NODE_273462_length_257_cov_1.329114	120	186	2	66	66	1.0000000
NODE_273533_length_257_cov_1.291139	13	53	0	40	40	1.0000000
NODE_273697_length_257_cov_1.291139	205	257	0	10	52	0.1923077
NODE_273697_length_257_cov_1.291139	205	257	2	42	52	0.8076923
NODE_273894_length_257_cov_1.221519	10	74	0	64	64	1.0000000
NODE_273917_length_257_cov_1.196203	70	150	0	17	80	0.2125000
NODE_273917_length_257_cov_1.196203	70	150	2	63	80	0.7875000
NODE_273917_length_257_cov_1.196203	123	204	0	30	81	0.3703704
NODE_273917_length_257_cov_1.196203	123	204	2	51	81	0.6296296
NODE_275399_length_257_cov_0.645570	138	158	0	20	20	1.0000000
NODE_275419_length_257_cov_0.645570	181	241	0	58	60	0.9666666
NODE_275419_length_257_cov_0.645570	181	241	6	2	60	0.0333333
NODE_275598_length_256_cov_5.235669	30	77	0	47	47	1.0000000
NODE_275624_length_256_cov_4.598726	100	180	0	80	80	1.0000000
NODE_275624_length_256_cov_4.598726	160	211	0	51	51	1.0000000
NODE_275682_length_256_cov_3.866242	112	166	0	26	54	0.4814815
NODE_275682_length_256_cov_3.866242	112	166	2	2	54	0.0370370
NODE_275682_length_256_cov_3.866242	112	166	4	26	54	0.4814815
NODE_275840_length_256_cov_2.878981	79	159	0	80	80	1.0000000
NODE_275840_length_256_cov_2.878981	132	212	0	80	80	1.0000000
NODE_275909_length_256_cov_2.598726	157	222	2	65	65	1.0000000
NODE_275909_length_256_cov_2.598726	195	249	0	18	54	0.3333333
NODE_275909_length_256_cov_2.598726	195	249	2	36	54	0.6666667
NODE_275981_length_256_cov_2.445860	104	183	0	79	79	1.0000000
NODE_276082_length_256_cov_2.229299	0	58	0	46	58	0.7931035
NODE_276082_length_256_cov_2.229299	0	58	2	12	58	0.2068966
NODE_276082_length_256_cov_2.229299	17	68	0	29	51	0.5686275
NODE_276082_length_256_cov_2.229299	17	68	2	22	51	0.4313726
NODE_276082_length_256_cov_2.229299	41	88	0	5	47	0.1063830
NODE_276082_length_256_cov_2.229299	41	88	2	42	47	0.8936170
NODE_276082_length_256_cov_2.229299	42	122	0	4	80	0.0500000
NODE_276082_length_256_cov_2.229299	42	122	2	76	80	0.9500000
NODE_276098_length_256_cov_2.184713	192	246	0	6	54	0.1111111
NODE_276098_length_256_cov_2.184713	192	246	2	48	54	0.8888889
NODE_276119_length_256_cov_2.121019	150	236	2	27	86	0.3139535
NODE_276119_length_256_cov_2.121019	150	236	4	27	86	0.3139535
NODE_276119_length_256_cov_2.121019	150	236	6	32	86	0.3720930
NODE_276174_length_256_cov_1.974522	130	174	0	44	44	1.0000000
NODE_276471_length_256_cov_1.707006	39	92	0	3	53	0.0566038
NODE_276471_length_256_cov_1.707006	39	92	2	3	53	0.0566038
NODE_276471_length_256_cov_1.707006	39	92	4	8	53	0.1509434
NODE_276471_length_256_cov_1.707006	39	92	5	2	53	0.0377358
NODE_276471_length_256_cov_1.707006	39	92	6	5	53	0.0943396
NODE_276471_length_256_cov_1.707006	39	92	8	7	53	0.1320755
NODE_276471_length_256_cov_1.707006	39	92	10	12	53	0.2264151
NODE_276471_length_256_cov_1.707006	39	92	12	4	53	0.0754717
NODE_276471_length_256_cov_1.707006	39	92	14	1	53	0.0188679
NODE_276471_length_256_cov_1.707006	39	92	15	2	53	0.0377358
NODE_276471_length_256_cov_1.707006	39	92	17	1	53	0.0188679
NODE_276471_length_256_cov_1.707006	39	92	19	2	53	0.0377358
NODE_276471_length_256_cov_1.707006	39	92	21	3	53	0.0566038
NODE_276471_length_256_cov_1.707006	93	135	21	6	42	0.1428571
NODE_276471_length_256_cov_1.707006	93	135	22	1	42	0.0238095
NODE_276471_length_256_cov_1.707006	93	135	23	3	42	0.0714286
NODE_276471_length_256_cov_1.707006	93	135	27	3	42	0.0714286
NODE_276471_length_256_cov_1.707006	93	135	30	5	42	0.1190476
NODE_276471_length_256_cov_1.707006	93	135	32	1	42	0.0238095
NODE_276471_length_256_cov_1.707006	93	135	34	1	42	0.0238095
NODE_276471_length_256_cov_1.707006	93	135	38	10	42	0.2380952
NODE_276471_length_256_cov_1.707006	93	135	42	5	42	0.1190476
NODE_276471_length_256_cov_1.707006	93	135	44	1	42	0.0238095
NODE_276471_length_256_cov_1.707006	93	135	46	4	42	0.0952381
NODE_276471_length_256_cov_1.707006	93	135	48	2	42	0.0476190
NODE_276484_length_256_cov_1.700637	107	129	0	22	22	1.0000000
NODE_276495_length_256_cov_1.675159	52	98	0	46	46	1.0000000
NODE_276654_length_256_cov_1.598726	125	202	0	8	77	0.1038961
NODE_276654_length_256_cov_1.598726	125	202	4	11	77	0.1428571
NODE_276654_length_256_cov_1.598726	125	202	6	14	77	0.1818182
NODE_276654_length_256_cov_1.598726	125	202	8	44	77	0.5714286
NODE_276654_length_256_cov_1.598726	178	256	2	17	78	0.2179487
NODE_276654_length_256_cov_1.598726	178	256	4	3	78	0.0384615
NODE_276654_length_256_cov_1.598726	178	256	6	13	78	0.1666667
NODE_276654_length_256_cov_1.598726	178	256	8	45	78	0.5769231
NODE_276672_length_256_cov_1.579618	110	172	11	16	62	0.2580645
NODE_276672_length_256_cov_1.579618	110	172	15	15	62	0.2419355
NODE_276672_length_256_cov_1.579618	110	172	17	1	62	0.0161290
NODE_276672_length_256_cov_1.579618	110	172	19	26	62	0.4193548
NODE_276672_length_256_cov_1.579618	110	172	21	4	62	0.0645161
NODE_276672_length_256_cov_1.579618	194	239	0	29	45	0.6444445
NODE_276672_length_256_cov_1.579618	194	239	1	12	45	0.2666667
NODE_276672_length_256_cov_1.579618	194	239	3	4	45	0.0888889
NODE_276742_length_256_cov_1.464968	112	135	2	23	23	1.0000000
NODE_276826_length_256_cov_1.331210	138	209	2	4	71	0.0563380
NODE_276826_length_256_cov_1.331210	138	209	4	2	71	0.0281690
NODE_276826_length_256_cov_1.331210	138	209	6	65	71	0.9154930
NODE_276826_length_256_cov_1.331210	182	240	0	8	58	0.1379310
NODE_276826_length_256_cov_1.331210	182	240	2	3	58	0.0517241
NODE_276826_length_256_cov_1.331210	182	240	4	1	58	0.0172414
NODE_276826_length_256_cov_1.331210	182	240	6	46	58	0.7931035
NODE_277113_length_256_cov_1.299363	88	160	8	27	72	0.3750000
NODE_277113_length_256_cov_1.299363	88	160	10	6	72	0.0833333
NODE_277113_length_256_cov_1.299363	88	160	11	2	72	0.0277778
NODE_277113_length_256_cov_1.299363	88	160	12	8	72	0.1111111
NODE_277113_length_256_cov_1.299363	88	160	13	29	72	0.4027778
NODE_277305_length_256_cov_1.203822	3	43	10	6	40	0.1500000
NODE_277305_length_256_cov_1.203822	3	43	11	5	40	0.1250000
NODE_277305_length_256_cov_1.203822	3	43	13	3	40	0.0750000
NODE_277305_length_256_cov_1.203822	3	43	14	1	40	0.0250000
NODE_277305_length_256_cov_1.203822	3	43	16	5	40	0.1250000
NODE_277305_length_256_cov_1.203822	3	43	20	1	40	0.0250000
NODE_277305_length_256_cov_1.203822	3	43	22	1	40	0.0250000
NODE_277305_length_256_cov_1.203822	3	43	26	3	40	0.0750000
NODE_277305_length_256_cov_1.203822	3	43	30	15	40	0.3750000
NODE_277305_length_256_cov_1.203822	16	96	13	1	80	0.0125000
NODE_277305_length_256_cov_1.203822	16	96	14	1	80	0.0125000
NODE_277305_length_256_cov_1.203822	16	96	16	5	80	0.0625000
NODE_277305_length_256_cov_1.203822	16	96	18	2	80	0.0250000
NODE_277305_length_256_cov_1.203822	16	96	20	1	80	0.0125000
NODE_277305_length_256_cov_1.203822	16	96	22	2	80	0.0250000
NODE_277305_length_256_cov_1.203822	16	96	24	2	80	0.0250000
NODE_277305_length_256_cov_1.203822	16	96	26	6	80	0.0750000
NODE_277305_length_256_cov_1.203822	16	96	30	25	80	0.3125000
NODE_277305_length_256_cov_1.203822	16	96	32	19	80	0.2375000
NODE_277305_length_256_cov_1.203822	16	96	34	16	80	0.2000000
NODE_278934_length_255_cov_73.756410	52	99	6	34	47	0.7234042
NODE_278934_length_255_cov_73.756410	52	99	14	13	47	0.2765957
NODE_278934_length_255_cov_73.756410	133	184	8	9	51	0.1764706
NODE_278934_length_255_cov_73.756410	133	184	12	3	51	0.0588235
NODE_278934_length_255_cov_73.756410	133	184	14	39	51	0.7647059
NODE_278934_length_255_cov_73.756410	157	237	4	38	80	0.4750000
NODE_278934_length_255_cov_73.756410	157	237	6	6	80	0.0750000
NODE_278934_length_255_cov_73.756410	157	237	13	1	80	0.0125000
NODE_278934_length_255_cov_73.756410	157	237	14	35	80	0.4375000
NODE_278937_length_255_cov_15.538462	219	255	0	36	36	1.0000000
NODE_279003_length_255_cov_4.884615	157	230	0	71	73	0.9726027
NODE_279003_length_255_cov_4.884615	157	230	12	2	73	0.0273973
NODE_279003_length_255_cov_4.884615	203	248	0	45	45	1.0000000
NODE_279058_length_255_cov_4.012821	68	148	0	2	80	0.0250000
NODE_279058_length_255_cov_4.012821	68	148	2	3	80	0.0375000
NODE_279058_length_255_cov_4.012821	68	148	4	75	80	0.9375000
NODE_279075_length_255_cov_3.826923	16	80	4	33	64	0.5156250
NODE_279075_length_255_cov_3.826923	16	80	6	31	64	0.4843750
NODE_279102_length_255_cov_3.596154	30	60	4	3	30	0.1000000
NODE_279102_length_255_cov_3.596154	30	60	6	27	30	0.9000000
NODE_279134_length_255_cov_3.423077	64	109	2	8	45	0.1777778
NODE_279134_length_255_cov_3.423077	64	109	5	37	45	0.8222222
NODE_279166_length_255_cov_3.262821	0	48	2	1	48	0.0208333
NODE_279166_length_255_cov_3.262821	0	48	4	6	48	0.1250000
NODE_279166_length_255_cov_3.262821	0	48	6	5	48	0.1041667
NODE_279166_length_255_cov_3.262821	0	48	10	10	48	0.2083333
NODE_279166_length_255_cov_3.262821	0	48	12	16	48	0.3333333
NODE_279166_length_255_cov_3.262821	0	48	14	10	48	0.2083333
NODE_279166_length_255_cov_3.262821	66	113	6	6	47	0.1276596
NODE_279166_length_255_cov_3.262821	66	113	10	13	47	0.2765957
NODE_279166_length_255_cov_3.262821	66	113	12	7	47	0.1489362
NODE_279166_length_255_cov_3.262821	66	113	14	21	47	0.4468085
NODE_279241_length_255_cov_2.942308	157	176	2	19	19	1.0000000
NODE_279320_length_255_cov_2.621795	227	254	0	27	27	1.0000000
NODE_279379_length_255_cov_2.602564	131	185	4	3	54	0.0555556
NODE_279379_length_255_cov_2.602564	131	185	6	51	54	0.9444444
NODE_279427_length_255_cov_2.487179	43	119	2	4	76	0.0526316
NODE_279427_length_255_cov_2.487179	43	119	4	2	76	0.0263158
NODE_279427_length_255_cov_2.487179	43	119	8	5	76	0.0657895
NODE_279427_length_255_cov_2.487179	43	119	10	30	76	0.3947369
NODE_279427_length_255_cov_2.487179	43	119	11	6	76	0.0789474
NODE_279427_length_255_cov_2.487179	43	119	12	29	76	0.3815790
NODE_279447_length_255_cov_2.435897	0	58	0	58	58	1.0000000
NODE_279462_length_255_cov_2.391026	189	255	0	66	66	1.0000000
NODE_279507_length_255_cov_2.288462	0	60	0	60	60	1.0000000
NODE_279510_length_255_cov_2.288462	0	74	0	74	74	1.0000000
NODE_279620_length_255_cov_2.089744	105	145	4	40	40	1.0000000
NODE_279649_length_255_cov_1.987179	0	72	0	72	72	1.0000000
NODE_279842_length_255_cov_1.910256	198	255	0	52	57	0.9122807
NODE_279842_length_255_cov_1.910256	198	255	2	2	57	0.0350877
NODE_279842_length_255_cov_1.910256	198	255	4	3	57	0.0526316
NODE_279871_length_255_cov_1.871795	16	68	0	52	52	1.0000000
NODE_279892_length_255_cov_1.826923	146	218	2	72	72	1.0000000
NODE_279956_length_255_cov_1.705128	0	45	0	37	45	0.8222222
NODE_279956_length_255_cov_1.705128	0	45	5	1	45	0.0222222
NODE_279956_length_255_cov_1.705128	0	45	6	7	45	0.1555556
NODE_279956_length_255_cov_1.705128	41	121	6	60	80	0.7500000
NODE_279956_length_255_cov_1.705128	41	121	10	19	80	0.2375000
NODE_279956_length_255_cov_1.705128	41	121	12	1	80	0.0125000
NODE_279956_length_255_cov_1.705128	94	174	6	35	80	0.4375000
NODE_279956_length_255_cov_1.705128	94	174	10	43	80	0.5375000
NODE_279956_length_255_cov_1.705128	94	174	12	2	80	0.0250000
NODE_280153_length_255_cov_1.576923	43	117	0	16	74	0.2162162
NODE_280153_length_255_cov_1.576923	43	117	2	4	74	0.0540541
NODE_280153_length_255_cov_1.576923	43	117	4	32	74	0.4324324
NODE_280153_length_255_cov_1.576923	43	117	8	19	74	0.2567568
NODE_280153_length_255_cov_1.576923	43	117	10	3	74	0.0405405
NODE_280153_length_255_cov_1.576923	90	175	0	3	85	0.0352941
NODE_280153_length_255_cov_1.576923	90	175	4	2	85	0.0235294
NODE_280153_length_255_cov_1.576923	90	175	8	19	85	0.2235294
NODE_280153_length_255_cov_1.576923	90	175	10	18	85	0.2117647
NODE_280153_length_255_cov_1.576923	90	175	12	43	85	0.5058824
NODE_280168_length_255_cov_1.557692	62	125	0	55	63	0.8730159
NODE_280168_length_255_cov_1.557692	62	125	2	8	63	0.1269841
NODE_280297_length_255_cov_1.358974	178	246	0	68	68	1.0000000
NODE_280904_length_255_cov_1.128205	183	219	0	36	36	1.0000000
NODE_281094_length_255_cov_0.987179	220	241	0	21	21	1.0000000
NODE_281380_length_255_cov_0.955128	119	171	6	52	52	1.0000000
NODE_281384_length_255_cov_0.955128	12	92	2	80	80	1.0000000
NODE_282137_length_255_cov_0.653846	87	106	0	19	19	1.0000000
NODE_282534_length_254_cov_4.935484	144	189	4	45	45	1.0000000
NODE_282534_length_254_cov_4.935484	164	242	2	4	78	0.0512821
NODE_282534_length_254_cov_4.935484	164	242	4	74	78	0.9487180
NODE_282548_length_254_cov_4.722581	44	85	12	41	41	1.0000000
NODE_282576_length_254_cov_4.296774	149	174	2	25	25	1.0000000
NODE_282576_length_254_cov_4.296774	149	223	0	26	74	0.3513514
NODE_282576_length_254_cov_4.296774	149	223	2	48	74	0.6486486
NODE_282590_length_254_cov_4.206452	57	86	19	9	29	0.3103448
NODE_282590_length_254_cov_4.206452	57	86	20	20	29	0.6896552
NODE_282626_length_254_cov_3.677419	7	64	12	5	57	0.0877193
NODE_282626_length_254_cov_3.677419	7	64	16	4	57	0.0701754
NODE_282626_length_254_cov_3.677419	7	64	23	1	57	0.0175439
NODE_282626_length_254_cov_3.677419	7	64	24	4	57	0.0701754
NODE_282626_length_254_cov_3.677419	7	64	28	3	57	0.0526316
NODE_282626_length_254_cov_3.677419	7	64	30	5	57	0.0877193
NODE_282626_length_254_cov_3.677419	7	64	32	2	57	0.0350877
NODE_282626_length_254_cov_3.677419	7	64	34	3	57	0.0526316
NODE_282626_length_254_cov_3.677419	7	64	35	30	57	0.5263158
NODE_282626_length_254_cov_3.677419	60	117	7	13	57	0.2280702
NODE_282626_length_254_cov_3.677419	60	117	11	5	57	0.0877193
NODE_282626_length_254_cov_3.677419	60	117	15	1	57	0.0175439
NODE_282626_length_254_cov_3.677419	60	117	19	2	57	0.0350877
NODE_282626_length_254_cov_3.677419	60	117	23	3	57	0.0526316
NODE_282626_length_254_cov_3.677419	60	117	26	2	57	0.0350877
NODE_282626_length_254_cov_3.677419	60	117	27	3	57	0.0526316
NODE_282626_length_254_cov_3.677419	60	117	29	1	57	0.0175439
NODE_282626_length_254_cov_3.677419	60	117	33	5	57	0.0877193
NODE_282626_length_254_cov_3.677419	60	117	35	22	57	0.3859649
NODE_282642_length_254_cov_3.593548	154	197	0	43	43	1.0000000
NODE_282659_length_254_cov_3.438710	82	129	0	47	47	1.0000000
NODE_282659_length_254_cov_3.438710	102	182	0	80	80	1.0000000
NODE_282736_length_254_cov_2.961290	5	79	6	9	74	0.1216216
NODE_282736_length_254_cov_2.961290	5	79	8	65	74	0.8783784
NODE_282736_length_254_cov_2.961290	52	118	2	4	66	0.0606061
NODE_282736_length_254_cov_2.961290	52	118	4	10	66	0.1515152
NODE_282736_length_254_cov_2.961290	52	118	8	52	66	0.7878788
NODE_282771_length_254_cov_2.780645	169	252	0	3	83	0.0361446
NODE_282771_length_254_cov_2.780645	169	252	4	1	83	0.0120482
NODE_282771_length_254_cov_2.780645	169	252	6	12	83	0.1445783
NODE_282771_length_254_cov_2.780645	169	252	8	3	83	0.0361446
NODE_282771_length_254_cov_2.780645	169	252	10	7	83	0.0843373
NODE_282771_length_254_cov_2.780645	169	252	12	8	83	0.0963855
NODE_282771_length_254_cov_2.780645	169	252	14	2	83	0.0240964
NODE_282771_length_254_cov_2.780645	169	252	16	14	83	0.1686747
NODE_282771_length_254_cov_2.780645	169	252	18	1	83	0.0120482
NODE_282771_length_254_cov_2.780645	169	252	20	5	83	0.0602410
NODE_282771_length_254_cov_2.780645	169	252	28	2	83	0.0240964
NODE_282771_length_254_cov_2.780645	169	252	32	3	83	0.0361446
NODE_282771_length_254_cov_2.780645	169	252	34	4	83	0.0481928
NODE_282771_length_254_cov_2.780645	169	252	36	3	83	0.0361446
NODE_282771_length_254_cov_2.780645	169	252	38	2	83	0.0240964
NODE_282771_length_254_cov_2.780645	169	252	40	2	83	0.0240964
NODE_282771_length_254_cov_2.780645	169	252	42	6	83	0.0722892
NODE_282771_length_254_cov_2.780645	169	252	46	1	83	0.0120482
NODE_282771_length_254_cov_2.780645	169	252	48	4	83	0.0481928
NODE_282947_length_254_cov_2.341935	167	201	0	34	34	1.0000000
NODE_283082_length_254_cov_2.161290	14	74	0	60	60	1.0000000
NODE_283244_length_254_cov_1.974194	156	204	0	48	48	1.0000000
NODE_283440_length_254_cov_1.780645	79	126	2	4	47	0.0851064
NODE_283440_length_254_cov_1.780645	79	126	6	1	47	0.0212766
NODE_283440_length_254_cov_1.780645	79	126	8	1	47	0.0212766
NODE_283440_length_254_cov_1.780645	79	126	10	1	47	0.0212766
NODE_283440_length_254_cov_1.780645	79	126	14	2	47	0.0425532
NODE_283440_length_254_cov_1.780645	79	126	16	2	47	0.0425532
NODE_283440_length_254_cov_1.780645	79	126	18	4	47	0.0851064
NODE_283440_length_254_cov_1.780645	79	126	19	3	47	0.0638298
NODE_283440_length_254_cov_1.780645	79	126	23	3	47	0.0638298
NODE_283440_length_254_cov_1.780645	79	126	27	1	47	0.0212766
NODE_283440_length_254_cov_1.780645	79	126	28	1	47	0.0212766
NODE_283440_length_254_cov_1.780645	79	126	31	7	47	0.1489362
NODE_283440_length_254_cov_1.780645	79	126	33	1	47	0.0212766
NODE_283440_length_254_cov_1.780645	79	126	34	3	47	0.0638298
NODE_283440_length_254_cov_1.780645	79	126	36	13	47	0.2765957
NODE_283952_length_254_cov_1.316129	23	87	0	64	64	1.0000000
NODE_284013_length_254_cov_1.316129	193	215	0	22	22	1.0000000
NODE_284256_length_254_cov_1.258065	181	249	0	68	68	1.0000000
NODE_284275_length_254_cov_1.238710	9	82	0	73	73	1.0000000
NODE_284275_length_254_cov_1.238710	62	82	0	20	20	1.0000000
NODE_284277_length_254_cov_1.238710	54	73	2	19	19	1.0000000
NODE_284301_length_254_cov_1.219355	98	157	0	56	59	0.9491525
NODE_284301_length_254_cov_1.219355	98	157	2	3	59	0.0508475
NODE_284638_length_254_cov_0.987097	139	193	0	54	54	1.0000000
NODE_284638_length_254_cov_0.987097	205	254	0	49	49	1.0000000
NODE_284796_length_254_cov_0.987097	121	152	0	31	31	1.0000000
NODE_285963_length_253_cov_60.311688	137	202	12	1	65	0.0153846
NODE_285963_length_253_cov_60.311688	137	202	29	3	65	0.0461538
NODE_285963_length_253_cov_60.311688	137	202	33	2	65	0.0307692
NODE_285963_length_253_cov_60.311688	137	202	37	3	65	0.0461538
NODE_285963_length_253_cov_60.311688	137	202	41	1	65	0.0153846
NODE_285963_length_253_cov_60.311688	137	202	47	2	65	0.0307692
NODE_285963_length_253_cov_60.311688	137	202	51	1	65	0.0153846
NODE_285963_length_253_cov_60.311688	137	202	52	1	65	0.0153846
NODE_285963_length_253_cov_60.311688	137	202	54	51	65	0.7846154
NODE_285963_length_253_cov_60.311688	175	253	2	1	78	0.0128205
NODE_285963_length_253_cov_60.311688	175	253	4	1	78	0.0128205
NODE_285963_length_253_cov_60.311688	175	253	6	2	78	0.0256410
NODE_285963_length_253_cov_60.311688	175	253	12	1	78	0.0128205
NODE_285963_length_253_cov_60.311688	175	253	16	1	78	0.0128205
NODE_285963_length_253_cov_60.311688	175	253	18	1	78	0.0128205
NODE_285963_length_253_cov_60.311688	175	253	33	1	78	0.0128205
NODE_285963_length_253_cov_60.311688	175	253	34	1	78	0.0128205
NODE_285963_length_253_cov_60.311688	175	253	38	3	78	0.0384615
NODE_285963_length_253_cov_60.311688	175	253	40	1	78	0.0128205
NODE_285963_length_253_cov_60.311688	175	253	44	1	78	0.0128205
NODE_285963_length_253_cov_60.311688	175	253	46	1	78	0.0128205
NODE_285963_length_253_cov_60.311688	175	253	50	1	78	0.0128205
NODE_285963_length_253_cov_60.311688	175	253	52	4	78	0.0512821
NODE_285963_length_253_cov_60.311688	175	253	54	58	78	0.7435898
NODE_285965_length_253_cov_41.519481	0	68	0	8	68	0.1176471
NODE_285965_length_253_cov_41.519481	0	68	1	1	68	0.0147059
NODE_285965_length_253_cov_41.519481	0	68	2	4	68	0.0588235
NODE_285965_length_253_cov_41.519481	0	68	3	16	68	0.2352941
NODE_285965_length_253_cov_41.519481	0	68	7	7	68	0.1029412
NODE_285965_length_253_cov_41.519481	0	68	30	1	68	0.0147059
NODE_285965_length_253_cov_41.519481	0	68	31	1	68	0.0147059
NODE_285965_length_253_cov_41.519481	0	68	33	3	68	0.0441176
NODE_285965_length_253_cov_41.519481	0	68	37	18	68	0.2647059
NODE_285965_length_253_cov_41.519481	0	68	38	3	68	0.0441176
NODE_285965_length_253_cov_41.519481	0	68	40	6	68	0.0882353
NODE_285965_length_253_cov_41.519481	0	70	0	8	70	0.1142857
NODE_285965_length_253_cov_41.519481	0	70	1	1	70	0.0142857
NODE_285965_length_253_cov_41.519481	0	70	2	4	70	0.0571429
NODE_285965_length_253_cov_41.519481	0	70	3	16	70	0.2285714
NODE_285965_length_253_cov_41.519481	0	70	7	7	70	0.1000000
NODE_285965_length_253_cov_41.519481	0	70	30	1	70	0.0142857
NODE_285965_length_253_cov_41.519481	0	70	31	1	70	0.0142857
NODE_285965_length_253_cov_41.519481	0	70	33	3	70	0.0428571
NODE_285965_length_253_cov_41.519481	0	70	37	18	70	0.2571429
NODE_285965_length_253_cov_41.519481	0	70	38	3	70	0.0428571
NODE_285965_length_253_cov_41.519481	0	70	40	8	70	0.1142857
NODE_285965_length_253_cov_41.519481	2	73	0	6	71	0.0845070
NODE_285965_length_253_cov_41.519481	2	73	1	1	71	0.0140845
NODE_285965_length_253_cov_41.519481	2	73	2	4	71	0.0563380
NODE_285965_length_253_cov_41.519481	2	73	3	16	71	0.2253521
NODE_285965_length_253_cov_41.519481	2	73	7	7	71	0.0985916
NODE_285965_length_253_cov_41.519481	2	73	30	1	71	0.0140845
NODE_285965_length_253_cov_41.519481	2	73	31	1	71	0.0140845
NODE_285965_length_253_cov_41.519481	2	73	33	3	71	0.0422535
NODE_285965_length_253_cov_41.519481	2	73	37	18	71	0.2535211
NODE_285965_length_253_cov_41.519481	2	73	38	3	71	0.0422535
NODE_285965_length_253_cov_41.519481	2	73	40	11	71	0.1549296
NODE_285965_length_253_cov_41.519481	7	73	0	1	66	0.0151515
NODE_285965_length_253_cov_41.519481	7	73	1	1	66	0.0151515
NODE_285965_length_253_cov_41.519481	7	73	2	4	66	0.0606061
NODE_285965_length_253_cov_41.519481	7	73	3	16	66	0.2424242
NODE_285965_length_253_cov_41.519481	7	73	7	7	66	0.1060606
NODE_285965_length_253_cov_41.519481	7	73	30	1	66	0.0151515
NODE_285965_length_253_cov_41.519481	7	73	31	1	66	0.0151515
NODE_285965_length_253_cov_41.519481	7	73	33	3	66	0.0454545
NODE_285965_length_253_cov_41.519481	7	73	37	18	66	0.2727273
NODE_285965_length_253_cov_41.519481	7	73	38	3	66	0.0454545
NODE_285965_length_253_cov_41.519481	7	73	40	11	66	0.1666667
NODE_285965_length_253_cov_41.519481	46	123	37	13	77	0.1688312
NODE_285965_length_253_cov_41.519481	46	123	38	3	77	0.0389610
NODE_285965_length_253_cov_41.519481	46	123	39	2	77	0.0259740
NODE_285965_length_253_cov_41.519481	46	123	40	13	77	0.1688312
NODE_285965_length_253_cov_41.519481	46	123	59	8	77	0.1038961
NODE_285965_length_253_cov_41.519481	46	123	61	5	77	0.0649351
NODE_285965_length_253_cov_41.519481	46	123	65	33	77	0.4285714
NODE_285965_length_253_cov_41.519481	46	123	37	13	77	0.1688312
NODE_285965_length_253_cov_41.519481	46	123	38	3	77	0.0389610
NODE_285965_length_253_cov_41.519481	46	123	39	2	77	0.0259740
NODE_285965_length_253_cov_41.519481	46	123	40	13	77	0.1688312
NODE_285965_length_253_cov_41.519481	46	123	59	8	77	0.1038961
NODE_285965_length_253_cov_41.519481	46	123	61	5	77	0.0649351
NODE_285965_length_253_cov_41.519481	46	123	65	33	77	0.4285714
NODE_285965_length_253_cov_41.519481	46	123	37	13	77	0.1688312
NODE_285965_length_253_cov_41.519481	46	123	38	3	77	0.0389610
NODE_285965_length_253_cov_41.519481	46	123	39	2	77	0.0259740
NODE_285965_length_253_cov_41.519481	46	123	40	13	77	0.1688312
NODE_285965_length_253_cov_41.519481	46	123	59	8	77	0.1038961
NODE_285965_length_253_cov_41.519481	46	123	61	5	77	0.0649351
NODE_285965_length_253_cov_41.519481	46	123	65	33	77	0.4285714
NODE_285967_length_253_cov_13.967532	25	105	0	80	80	1.0000000
NODE_285967_length_253_cov_13.967532	78	158	0	80	80	1.0000000
NODE_285969_length_253_cov_12.259740	0	54	0	54	54	1.0000000
NODE_285969_length_253_cov_12.259740	27	62	0	35	35	1.0000000
NODE_285969_length_253_cov_12.259740	51	131	0	80	80	1.0000000
NODE_285969_length_253_cov_12.259740	104	139	0	35	35	1.0000000
NODE_285969_length_253_cov_12.259740	128	208	0	80	80	1.0000000
NODE_285969_length_253_cov_12.259740	181	216	0	35	35	1.0000000
NODE_285987_length_253_cov_7.279221	184	250	0	3	66	0.0454545
NODE_285987_length_253_cov_7.279221	184	250	2	9	66	0.1363636
NODE_285987_length_253_cov_7.279221	184	250	6	39	66	0.5909091
NODE_285987_length_253_cov_7.279221	184	250	8	15	66	0.2272727
NODE_286022_length_253_cov_5.376623	66	147	8	5	81	0.0617284
NODE_286022_length_253_cov_5.376623	66	147	9	43	81	0.5308642
NODE_286022_length_253_cov_5.376623	66	147	10	5	81	0.0617284
NODE_286022_length_253_cov_5.376623	66	147	12	1	81	0.0123457
NODE_286022_length_253_cov_5.376623	66	147	14	13	81	0.1604938
NODE_286022_length_253_cov_5.376623	66	147	16	14	81	0.1728395
NODE_286022_length_253_cov_5.376623	120	185	10	31	65	0.4769231
NODE_286022_length_253_cov_5.376623	120	185	12	8	65	0.1230769
NODE_286022_length_253_cov_5.376623	120	185	14	12	65	0.1846154
NODE_286022_length_253_cov_5.376623	120	185	16	14	65	0.2153846
NODE_286042_length_253_cov_4.896104	102	182	15	2	80	0.0250000
NODE_286042_length_253_cov_4.896104	102	182	21	2	80	0.0250000
NODE_286042_length_253_cov_4.896104	102	182	22	1	80	0.0125000
NODE_286042_length_253_cov_4.896104	102	182	26	1	80	0.0125000
NODE_286042_length_253_cov_4.896104	102	182	28	1	80	0.0125000
NODE_286042_length_253_cov_4.896104	102	182	30	3	80	0.0375000
NODE_286042_length_253_cov_4.896104	102	182	34	1	80	0.0125000
NODE_286042_length_253_cov_4.896104	102	182	39	8	80	0.1000000
NODE_286042_length_253_cov_4.896104	102	182	40	1	80	0.0125000
NODE_286042_length_253_cov_4.896104	102	182	46	2	80	0.0250000
NODE_286042_length_253_cov_4.896104	102	182	50	2	80	0.0250000
NODE_286042_length_253_cov_4.896104	102	182	54	4	80	0.0500000
NODE_286042_length_253_cov_4.896104	102	182	56	2	80	0.0250000
NODE_286042_length_253_cov_4.896104	102	182	59	2	80	0.0250000
NODE_286042_length_253_cov_4.896104	102	182	71	1	80	0.0125000
NODE_286042_length_253_cov_4.896104	102	182	79	6	80	0.0750000
NODE_286042_length_253_cov_4.896104	102	182	89	5	80	0.0625000
NODE_286042_length_253_cov_4.896104	102	182	90	1	80	0.0125000
NODE_286042_length_253_cov_4.896104	102	182	92	1	80	0.0125000
NODE_286042_length_253_cov_4.896104	102	182	93	2	80	0.0250000
NODE_286042_length_253_cov_4.896104	102	182	94	1	80	0.0125000
NODE_286042_length_253_cov_4.896104	102	182	97	3	80	0.0375000
NODE_286042_length_253_cov_4.896104	102	182	98	3	80	0.0375000
NODE_286042_length_253_cov_4.896104	102	182	100	7	80	0.0875000
NODE_286042_length_253_cov_4.896104	102	182	102	3	80	0.0375000
NODE_286042_length_253_cov_4.896104	102	182	103	5	80	0.0625000
NODE_286042_length_253_cov_4.896104	102	182	104	5	80	0.0625000
NODE_286042_length_253_cov_4.896104	102	182	107	2	80	0.0250000
NODE_286042_length_253_cov_4.896104	102	182	108	1	80	0.0125000
NODE_286042_length_253_cov_4.896104	102	182	109	2	80	0.0250000
NODE_286046_length_253_cov_4.798701	199	253	0	54	54	1.0000000
NODE_286069_length_253_cov_4.487013	85	126	0	3	41	0.0731707
NODE_286069_length_253_cov_4.487013	85	126	2	2	41	0.0487805
NODE_286069_length_253_cov_4.487013	85	126	4	7	41	0.1707317
NODE_286069_length_253_cov_4.487013	85	126	6	2	41	0.0487805
NODE_286069_length_253_cov_4.487013	85	126	8	27	41	0.6585366
NODE_286151_length_253_cov_3.500000	44	105	0	61	61	1.0000000
NODE_286151_length_253_cov_3.500000	90	158	0	68	68	1.0000000
NODE_286259_length_253_cov_2.987013	85	165	0	79	80	0.9875000
NODE_286259_length_253_cov_2.987013	85	165	2	1	80	0.0125000
NODE_286259_length_253_cov_2.987013	138	169	0	31	31	1.0000000
NODE_286275_length_253_cov_2.954545	100	148	0	48	48	1.0000000
NODE_286281_length_253_cov_2.909091	34	99	14	14	65	0.2153846
NODE_286281_length_253_cov_2.909091	34	99	16	8	65	0.1230769
NODE_286281_length_253_cov_2.909091	34	99	18	2	65	0.0307692
NODE_286281_length_253_cov_2.909091	34	99	19	3	65	0.0461538
NODE_286281_length_253_cov_2.909091	34	99	20	16	65	0.2461538
NODE_286281_length_253_cov_2.909091	34	99	22	22	65	0.3384615
NODE_286288_length_253_cov_2.889610	129	200	14	2	71	0.0281690
NODE_286288_length_253_cov_2.889610	129	200	15	6	71	0.0845070
NODE_286288_length_253_cov_2.889610	129	200	16	4	71	0.0563380
NODE_286288_length_253_cov_2.889610	129	200	17	8	71	0.1126761
NODE_286288_length_253_cov_2.889610	129	200	19	9	71	0.1267606
NODE_286288_length_253_cov_2.889610	129	200	20	4	71	0.0563380
NODE_286288_length_253_cov_2.889610	129	200	21	24	71	0.3380282
NODE_286288_length_253_cov_2.889610	129	200	23	13	71	0.1830986
NODE_286288_length_253_cov_2.889610	129	200	25	1	71	0.0140845
NODE_286288_length_253_cov_2.889610	173	253	4	1	80	0.0125000
NODE_286288_length_253_cov_2.889610	173	253	9	1	80	0.0125000
NODE_286288_length_253_cov_2.889610	173	253	11	1	80	0.0125000
NODE_286288_length_253_cov_2.889610	173	253	13	4	80	0.0500000
NODE_286288_length_253_cov_2.889610	173	253	15	7	80	0.0875000
NODE_286288_length_253_cov_2.889610	173	253	16	5	80	0.0625000
NODE_286288_length_253_cov_2.889610	173	253	17	6	80	0.0750000
NODE_286288_length_253_cov_2.889610	173	253	19	4	80	0.0500000
NODE_286288_length_253_cov_2.889610	173	253	20	32	80	0.4000000
NODE_286288_length_253_cov_2.889610	173	253	21	19	80	0.2375000
NODE_286289_length_253_cov_2.889610	21	76	0	55	55	1.0000000
NODE_286289_length_253_cov_2.889610	149	229	0	1	80	0.0125000
NODE_286289_length_253_cov_2.889610	149	229	3	4	80	0.0500000
NODE_286289_length_253_cov_2.889610	149	229	4	75	80	0.9375000
NODE_286379_length_253_cov_2.610390	113	193	0	80	80	1.0000000
NODE_286386_length_253_cov_2.584416	97	154	2	28	57	0.4912281
NODE_286386_length_253_cov_2.584416	97	154	4	29	57	0.5087720
NODE_286545_length_253_cov_2.240260	185	250	0	65	65	1.0000000
NODE_286667_length_253_cov_1.987013	157	237	0	80	80	1.0000000
NODE_286667_length_253_cov_1.987013	210	253	0	43	43	1.0000000
NODE_286685_length_253_cov_1.987013	18	60	0	42	42	1.0000000
NODE_286829_length_253_cov_1.961039	186	232	0	46	46	1.0000000
NODE_286837_length_253_cov_1.948052	68	120	0	52	52	1.0000000
NODE_286838_length_253_cov_1.948052	63	114	0	20	51	0.3921569
NODE_286838_length_253_cov_1.948052	63	114	2	15	51	0.2941177
NODE_286838_length_253_cov_1.948052	63	114	4	16	51	0.3137255
NODE_286947_length_253_cov_1.746753	164	193	0	29	29	1.0000000
NODE_287031_length_253_cov_1.655844	40	120	0	35	80	0.4375000
NODE_287031_length_253_cov_1.655844	40	120	2	45	80	0.5625000
NODE_287031_length_253_cov_1.655844	93	152	0	2	59	0.0338983
NODE_287031_length_253_cov_1.655844	93	152	2	57	59	0.9661017
NODE_287133_length_253_cov_1.590909	102	148	6	46	46	1.0000000
NODE_287156_length_253_cov_1.558442	67	149	0	6	82	0.0731707
NODE_287156_length_253_cov_1.558442	67	149	2	30	82	0.3658537
NODE_287156_length_253_cov_1.558442	67	149	4	46	82	0.5609756
NODE_287230_length_253_cov_1.441558	49	113	0	64	64	1.0000000
NODE_287230_length_253_cov_1.441558	102	166	0	64	64	1.0000000
NODE_287232_length_253_cov_1.441558	121	185	2	1	64	0.0156250
NODE_287232_length_253_cov_1.441558	121	185	6	5	64	0.0781250
NODE_287232_length_253_cov_1.441558	121	185	8	24	64	0.3750000
NODE_287232_length_253_cov_1.441558	121	185	10	34	64	0.5312500
NODE_287234_length_253_cov_1.435065	50	81	0	31	31	1.0000000
NODE_287584_length_253_cov_1.324675	193	239	4	1	46	0.0217391
NODE_287584_length_253_cov_1.324675	193	239	6	45	46	0.9782609
NODE_287599_length_253_cov_1.324675	90	132	37	17	42	0.4047619
NODE_287599_length_253_cov_1.324675	90	132	38	13	42	0.3095238
NODE_287599_length_253_cov_1.324675	90	132	39	12	42	0.2857143
NODE_287599_length_253_cov_1.324675	133	185	8	2	52	0.0384615
NODE_287599_length_253_cov_1.324675	133	185	14	6	52	0.1153846
NODE_287599_length_253_cov_1.324675	133	185	18	6	52	0.1153846
NODE_287599_length_253_cov_1.324675	133	185	20	5	52	0.0961538
NODE_287599_length_253_cov_1.324675	133	185	22	1	52	0.0192308
NODE_287599_length_253_cov_1.324675	133	185	24	1	52	0.0192308
NODE_287599_length_253_cov_1.324675	133	185	26	1	52	0.0192308
NODE_287599_length_253_cov_1.324675	133	185	28	5	52	0.0961538
NODE_287599_length_253_cov_1.324675	133	185	30	2	52	0.0384615
NODE_287599_length_253_cov_1.324675	133	185	32	2	52	0.0384615
NODE_287599_length_253_cov_1.324675	133	185	35	10	52	0.1923077
NODE_287599_length_253_cov_1.324675	133	185	37	11	52	0.2115385
NODE_287721_length_253_cov_1.285714	87	125	2	24	38	0.6315789
NODE_287721_length_253_cov_1.285714	87	125	4	7	38	0.1842105
NODE_287721_length_253_cov_1.285714	87	125	6	7	38	0.1842105
NODE_287794_length_253_cov_1.214286	99	148	0	49	49	1.0000000
NODE_287845_length_253_cov_1.181818	185	247	0	62	62	1.0000000
NODE_287845_length_253_cov_1.181818	185	247	0	62	62	1.0000000
NODE_287989_length_253_cov_1.064935	83	159	7	1	76	0.0131579
NODE_287989_length_253_cov_1.064935	83	159	8	2	76	0.0263158
NODE_287989_length_253_cov_1.064935	83	159	12	2	76	0.0263158
NODE_287989_length_253_cov_1.064935	83	159	16	1	76	0.0131579
NODE_287989_length_253_cov_1.064935	83	159	18	1	76	0.0131579
NODE_287989_length_253_cov_1.064935	83	159	24	2	76	0.0263158
NODE_287989_length_253_cov_1.064935	83	159	26	2	76	0.0263158
NODE_287989_length_253_cov_1.064935	83	159	28	1	76	0.0131579
NODE_287989_length_253_cov_1.064935	83	159	30	1	76	0.0131579
NODE_287989_length_253_cov_1.064935	83	159	32	13	76	0.1710526
NODE_287989_length_253_cov_1.064935	83	159	34	1	76	0.0131579
NODE_287989_length_253_cov_1.064935	83	159	38	6	76	0.0789474
NODE_287989_length_253_cov_1.064935	83	159	40	1	76	0.0131579
NODE_287989_length_253_cov_1.064935	83	159	42	18	76	0.2368421
NODE_287989_length_253_cov_1.064935	83	159	44	24	76	0.3157895
NODE_288099_length_253_cov_0.993506	0	44	0	44	44	1.0000000
NODE_288465_length_253_cov_0.870130	17	46	0	29	29	1.0000000
NODE_288478_length_253_cov_0.850649	0	89	0	89	89	1.0000000
NODE_289563_length_252_cov_4.771242	94	148	0	11	54	0.2037037
NODE_289563_length_252_cov_4.771242	94	148	2	43	54	0.7962963
NODE_289574_length_252_cov_4.614379	16	37	0	4	21	0.1904762
NODE_289574_length_252_cov_4.614379	16	37	2	17	21	0.8095238
NODE_289624_length_252_cov_3.960784	7	85	4	78	78	1.0000000
NODE_289624_length_252_cov_3.960784	63	136	0	28	73	0.3835616
NODE_289624_length_252_cov_3.960784	63	136	4	45	73	0.6164383
NODE_289663_length_252_cov_3.549020	89	157	0	68	68	1.0000000
NODE_289672_length_252_cov_3.405229	26	107	12	3	81	0.0370370
NODE_289672_length_252_cov_3.405229	26	107	14	13	81	0.1604938
NODE_289672_length_252_cov_3.405229	26	107	18	8	81	0.0987654
NODE_289672_length_252_cov_3.405229	26	107	20	11	81	0.1358025
NODE_289672_length_252_cov_3.405229	26	107	22	42	81	0.5185185
NODE_289672_length_252_cov_3.405229	26	107	24	4	81	0.0493827
NODE_289705_length_252_cov_3.307190	91	141	0	50	50	1.0000000
NODE_289742_length_252_cov_3.032680	135	212	6	35	77	0.4545455
NODE_289742_length_252_cov_3.032680	135	212	8	42	77	0.5454546
NODE_289775_length_252_cov_2.928105	0	57	0	57	57	1.0000000
NODE_289799_length_252_cov_2.803922	41	121	0	80	80	1.0000000
NODE_290032_length_252_cov_2.320261	0	64	0	59	64	0.9218750
NODE_290032_length_252_cov_2.320261	0	64	46	2	64	0.0312500
NODE_290032_length_252_cov_2.320261	0	64	48	1	64	0.0156250
NODE_290032_length_252_cov_2.320261	0	64	50	1	64	0.0156250
NODE_290032_length_252_cov_2.320261	0	64	52	1	64	0.0156250
NODE_290046_length_252_cov_2.281046	120	170	2	50	50	1.0000000
NODE_290066_length_252_cov_2.215686	137	175	64	1	38	0.0263158
NODE_290066_length_252_cov_2.215686	137	175	66	2	38	0.0526316
NODE_290066_length_252_cov_2.215686	137	175	68	2	38	0.0526316
NODE_290066_length_252_cov_2.215686	137	175	70	8	38	0.2105263
NODE_290066_length_252_cov_2.215686	137	175	72	14	38	0.3684210
NODE_290066_length_252_cov_2.215686	137	175	73	3	38	0.0789474
NODE_290066_length_252_cov_2.215686	137	175	74	7	38	0.1842105
NODE_290066_length_252_cov_2.215686	137	175	76	1	38	0.0263158
NODE_290103_length_252_cov_2.052288	18	39	0	21	21	1.0000000
NODE_290238_length_252_cov_1.993464	80	139	6	59	59	1.0000000
NODE_290385_length_252_cov_1.810458	3	49	0	46	46	1.0000000
NODE_290623_length_252_cov_1.594771	103	156	0	53	53	1.0000000
NODE_290623_length_252_cov_1.594771	152	192	0	40	40	1.0000000
NODE_290638_length_252_cov_1.568627	1	68	0	4	67	0.0597015
NODE_290638_length_252_cov_1.568627	1	68	2	40	67	0.5970149
NODE_290638_length_252_cov_1.568627	1	68	4	7	67	0.1044776
NODE_290638_length_252_cov_1.568627	1	68	6	16	67	0.2388060
NODE_290767_length_252_cov_1.359477	26	93	0	67	67	1.0000000
NODE_290790_length_252_cov_1.333333	179	232	0	3	53	0.0566038
NODE_290790_length_252_cov_1.333333	179	232	2	50	53	0.9433962
NODE_290850_length_252_cov_1.333333	187	222	2	35	35	1.0000000
NODE_291072_length_252_cov_1.333333	31	111	0	80	80	1.0000000
NODE_291076_length_252_cov_1.333333	90	140	6	7	50	0.1400000
NODE_291076_length_252_cov_1.333333	90	140	8	43	50	0.8600000
NODE_291118_length_252_cov_1.326797	112	143	0	9	31	0.2903226
NODE_291118_length_252_cov_1.326797	112	143	1	22	31	0.7096774
NODE_291351_length_252_cov_1.156863	1	32	0	31	31	1.0000000
NODE_291650_length_252_cov_1.000000	49	79	0	30	30	1.0000000
NODE_291911_length_252_cov_0.836601	125	172	0	2	47	0.0425532
NODE_291911_length_252_cov_0.836601	125	172	3	1	47	0.0212766
NODE_291911_length_252_cov_0.836601	125	172	5	19	47	0.4042553
NODE_291911_length_252_cov_0.836601	125	172	7	7	47	0.1489362
NODE_291911_length_252_cov_0.836601	125	172	8	13	47	0.2765957
NODE_291911_length_252_cov_0.836601	125	172	10	3	47	0.0638298
NODE_291911_length_252_cov_0.836601	125	172	12	2	47	0.0425532
NODE_293004_length_251_cov_5.032895	0	62	2	5	62	0.0806452
NODE_293004_length_251_cov_5.032895	0	62	4	57	62	0.9193549
NODE_293005_length_251_cov_5.026316	84	164	0	80	80	1.0000000
NODE_293165_length_251_cov_3.302632	187	249	0	36	62	0.5806451
NODE_293165_length_251_cov_3.302632	187	249	2	26	62	0.4193548
NODE_293195_length_251_cov_3.131579	96	148	0	52	52	1.0000000
NODE_293238_length_251_cov_2.980263	11	38	10	1	27	0.0370370
NODE_293238_length_251_cov_2.980263	11	38	12	1	27	0.0370370
NODE_293238_length_251_cov_2.980263	11	38	14	4	27	0.1481481
NODE_293238_length_251_cov_2.980263	11	38	16	4	27	0.1481481
NODE_293238_length_251_cov_2.980263	11	38	18	17	27	0.6296296
NODE_293238_length_251_cov_2.980263	11	91	10	1	80	0.0125000
NODE_293238_length_251_cov_2.980263	11	91	12	1	80	0.0125000
NODE_293238_length_251_cov_2.980263	11	91	14	4	80	0.0500000
NODE_293238_length_251_cov_2.980263	11	91	16	4	80	0.0500000
NODE_293238_length_251_cov_2.980263	11	91	18	18	80	0.2250000
NODE_293238_length_251_cov_2.980263	11	91	22	12	80	0.1500000
NODE_293238_length_251_cov_2.980263	11	91	24	25	80	0.3125000
NODE_293238_length_251_cov_2.980263	11	91	26	1	80	0.0125000
NODE_293238_length_251_cov_2.980263	11	91	28	14	80	0.1750000
NODE_293259_length_251_cov_2.842105	170	198	0	28	28	1.0000000
NODE_293279_length_251_cov_2.743421	181	232	0	51	51	1.0000000
NODE_293335_length_251_cov_2.677632	35	54	0	19	19	1.0000000
NODE_293454_length_251_cov_2.348684	196	251	0	55	55	1.0000000
NODE_293502_length_251_cov_2.328947	86	149	0	56	63	0.8888889
NODE_293502_length_251_cov_2.328947	86	149	2	1	63	0.0158730
NODE_293502_length_251_cov_2.328947	86	149	4	1	63	0.0158730
NODE_293502_length_251_cov_2.328947	86	149	10	5	63	0.0793651
NODE_293516_length_251_cov_2.296053	91	171	1	16	80	0.2000000
NODE_293516_length_251_cov_2.296053	91	171	3	8	80	0.1000000
NODE_293516_length_251_cov_2.296053	91	171	7	3	80	0.0375000
NODE_293516_length_251_cov_2.296053	91	171	8	53	80	0.6625000
NODE_293516_length_251_cov_2.296053	144	224	0	35	80	0.4375000
NODE_293516_length_251_cov_2.296053	144	224	1	34	80	0.4250000
NODE_293516_length_251_cov_2.296053	144	224	3	8	80	0.1000000
NODE_293516_length_251_cov_2.296053	144	224	7	3	80	0.0375000
NODE_293591_length_251_cov_2.065789	7	52	0	45	45	1.0000000
NODE_293698_length_251_cov_2.013158	96	179	0	83	83	1.0000000
NODE_293698_length_251_cov_2.013158	96	179	0	83	83	1.0000000
NODE_293698_length_251_cov_2.013158	152	203	0	51	51	1.0000000
NODE_293698_length_251_cov_2.013158	152	201	0	49	49	1.0000000
NODE_293919_length_251_cov_1.710526	135	194	0	38	59	0.6440678
NODE_293919_length_251_cov_1.710526	135	194	2	21	59	0.3559322
NODE_294028_length_251_cov_1.671053	94	127	0	33	33	1.0000000
NODE_294063_length_251_cov_1.644737	135	164	2	29	29	1.0000000
NODE_294147_length_251_cov_1.473684	137	202	2	65	65	1.0000000
NODE_294153_length_251_cov_1.460526	17	78	0	61	61	1.0000000
NODE_294190_length_251_cov_1.407895	182	246	4	64	64	1.0000000
NODE_294393_length_251_cov_1.342105	9	89	0	80	80	1.0000000
NODE_294393_length_251_cov_1.342105	62	91	0	29	29	1.0000000
NODE_294624_length_251_cov_1.296053	7	47	0	40	40	1.0000000
NODE_294624_length_251_cov_1.296053	24	47	0	23	23	1.0000000
NODE_295165_length_251_cov_1.006579	4	50	0	46	46	1.0000000
NODE_296033_length_251_cov_0.671053	184	204	0	20	20	1.0000000
NODE_296386_length_251_cov_0.572368	54	74	0	17	20	0.8500000
NODE_296386_length_251_cov_0.572368	54	74	2	3	20	0.1500000
NODE_296437_length_250_cov_35.662252	33	99	0	66	66	1.0000000
NODE_296437_length_250_cov_35.662252	143	223	2	80	80	1.0000000
NODE_296456_length_250_cov_6.503311	186	250	0	64	64	1.0000000
NODE_296467_length_250_cov_5.867550	99	120	2	21	21	1.0000000
NODE_296520_length_250_cov_4.662252	143	187	0	44	44	1.0000000
NODE_296520_length_250_cov_4.662252	160	227	0	67	67	1.0000000
NODE_296598_length_250_cov_3.715232	37	90	4	53	53	1.0000000
NODE_296633_length_250_cov_3.417219	113	193	4	11	80	0.1375000
NODE_296633_length_250_cov_3.417219	113	193	6	1	80	0.0125000
NODE_296633_length_250_cov_3.417219	113	193	7	2	80	0.0250000
NODE_296633_length_250_cov_3.417219	113	193	9	2	80	0.0250000
NODE_296633_length_250_cov_3.417219	113	193	11	9	80	0.1125000
NODE_296633_length_250_cov_3.417219	113	193	12	5	80	0.0625000
NODE_296633_length_250_cov_3.417219	113	193	13	1	80	0.0125000
NODE_296633_length_250_cov_3.417219	113	193	14	13	80	0.1625000
NODE_296633_length_250_cov_3.417219	113	193	16	36	80	0.4500000
NODE_296633_length_250_cov_3.417219	166	246	0	10	80	0.1250000
NODE_296633_length_250_cov_3.417219	166	246	2	2	80	0.0250000
NODE_296633_length_250_cov_3.417219	166	246	4	52	80	0.6500000
NODE_296633_length_250_cov_3.417219	166	246	6	1	80	0.0125000
NODE_296633_length_250_cov_3.417219	166	246	7	2	80	0.0250000
NODE_296633_length_250_cov_3.417219	166	246	9	2	80	0.0250000
NODE_296633_length_250_cov_3.417219	166	246	11	9	80	0.1125000
NODE_296633_length_250_cov_3.417219	166	246	13	1	80	0.0125000
NODE_296633_length_250_cov_3.417219	166	246	16	1	80	0.0125000
NODE_296653_length_250_cov_3.364238	0	61	0	1	61	0.0163934
NODE_296653_length_250_cov_3.364238	0	61	6	3	61	0.0491803
NODE_296653_length_250_cov_3.364238	0	61	10	8	61	0.1311475
NODE_296653_length_250_cov_3.364238	0	61	12	8	61	0.1311475
NODE_296653_length_250_cov_3.364238	0	61	16	41	61	0.6721311
NODE_296653_length_250_cov_3.364238	34	94	16	44	60	0.7333333
NODE_296653_length_250_cov_3.364238	34	94	18	16	60	0.2666667
NODE_296680_length_250_cov_3.225166	157	209	6	49	52	0.9423077
NODE_296680_length_250_cov_3.225166	157	209	8	3	52	0.0576923
NODE_296680_length_250_cov_3.225166	182	250	0	11	68	0.1617647
NODE_296680_length_250_cov_3.225166	182	250	4	1	68	0.0147059
NODE_296680_length_250_cov_3.225166	182	250	6	56	68	0.8235294
NODE_296699_length_250_cov_3.086093	33	67	0	34	34	1.0000000
NODE_296703_length_250_cov_3.052980	29	94	4	5	65	0.0769231
NODE_296703_length_250_cov_3.052980	29	94	6	10	65	0.1538462
NODE_296703_length_250_cov_3.052980	29	94	8	12	65	0.1846154
NODE_296703_length_250_cov_3.052980	29	94	10	1	65	0.0153846
NODE_296703_length_250_cov_3.052980	29	94	12	10	65	0.1538462
NODE_296703_length_250_cov_3.052980	29	94	14	27	65	0.4153846
NODE_296707_length_250_cov_3.039735	51	106	0	55	55	1.0000000
NODE_296737_length_250_cov_2.986755	124	185	14	34	61	0.5573770
NODE_296737_length_250_cov_2.986755	124	185	16	12	61	0.1967213
NODE_296737_length_250_cov_2.986755	124	185	18	15	61	0.2459016
NODE_296737_length_250_cov_2.986755	172	243	4	18	71	0.2535211
NODE_296737_length_250_cov_2.986755	172	243	6	4	71	0.0563380
NODE_296737_length_250_cov_2.986755	172	243	14	38	71	0.5352113
NODE_296737_length_250_cov_2.986755	172	243	16	11	71	0.1549296
NODE_296885_length_250_cov_2.516556	0	49	0	49	49	1.0000000
NODE_296893_length_250_cov_2.476821	94	174	0	80	80	1.0000000
NODE_296893_length_250_cov_2.476821	147	227	0	80	80	1.0000000
NODE_296897_length_250_cov_2.470199	166	212	0	46	46	1.0000000
NODE_297070_length_250_cov_2.059603	150	207	0	57	57	1.0000000
NODE_297211_length_250_cov_2.019868	74	141	24	8	67	0.1194030
NODE_297211_length_250_cov_2.019868	74	141	26	24	67	0.3582090
NODE_297211_length_250_cov_2.019868	74	141	27	12	67	0.1791045
NODE_297211_length_250_cov_2.019868	74	141	28	19	67	0.2835821
NODE_297211_length_250_cov_2.019868	74	141	30	4	67	0.0597015
NODE_297211_length_250_cov_2.019868	158	204	7	5	46	0.1086956
NODE_297211_length_250_cov_2.019868	158	204	11	3	46	0.0652174
NODE_297211_length_250_cov_2.019868	158	204	13	1	46	0.0217391
NODE_297211_length_250_cov_2.019868	158	204	15	4	46	0.0869565
NODE_297211_length_250_cov_2.019868	158	204	18	1	46	0.0217391
NODE_297211_length_250_cov_2.019868	158	204	20	2	46	0.0434783
NODE_297211_length_250_cov_2.019868	158	204	21	1	46	0.0217391
NODE_297211_length_250_cov_2.019868	158	204	26	9	46	0.1956522
NODE_297211_length_250_cov_2.019868	158	204	28	7	46	0.1521739
NODE_297211_length_250_cov_2.019868	158	204	30	13	46	0.2826087
NODE_297550_length_250_cov_1.688742	6	42	0	36	36	1.0000000
NODE_297624_length_250_cov_1.635762	150	191	0	2	41	0.0487805
NODE_297624_length_250_cov_1.635762	150	191	2	1	41	0.0243902
NODE_297624_length_250_cov_1.635762	150	191	4	4	41	0.0975610
NODE_297624_length_250_cov_1.635762	150	191	8	34	41	0.8292683
NODE_297679_length_250_cov_1.529801	59	108	0	49	49	1.0000000
NODE_297679_length_250_cov_1.529801	81	161	0	80	80	1.0000000
NODE_297693_length_250_cov_1.516556	124	184	0	31	60	0.5166667
NODE_297693_length_250_cov_1.516556	124	184	2	29	60	0.4833333
NODE_297693_length_250_cov_1.516556	166	237	0	71	71	1.0000000
NODE_297762_length_250_cov_1.377483	0	80	0	80	80	1.0000000
NODE_297963_length_250_cov_1.350993	40	98	0	58	58	1.0000000
NODE_298213_length_250_cov_1.291391	116	196	2	7	80	0.0875000
NODE_298213_length_250_cov_1.291391	116	196	10	16	80	0.2000000
NODE_298213_length_250_cov_1.291391	116	196	14	57	80	0.7125000
NODE_298719_length_250_cov_1.013245	126	163	0	37	37	1.0000000
NODE_298794_length_250_cov_1.006623	129	148	0	19	19	1.0000000
NODE_298900_length_250_cov_0.920530	126	178	24	8	52	0.1538462
NODE_298900_length_250_cov_0.920530	126	178	26	1	52	0.0192308
NODE_298900_length_250_cov_0.920530	126	178	36	7	52	0.1346154
NODE_298900_length_250_cov_0.920530	126	178	38	10	52	0.1923077
NODE_298900_length_250_cov_0.920530	126	178	42	7	52	0.1346154
NODE_298900_length_250_cov_0.920530	126	178	44	3	52	0.0576923
NODE_298900_length_250_cov_0.920530	126	178	50	10	52	0.1923077
NODE_298900_length_250_cov_0.920530	126	178	52	6	52	0.1153846
NODE_299979_length_249_cov_55.413333	97	172	0	75	75	1.0000000
NODE_299979_length_249_cov_55.413333	150	225	0	75	75	1.0000000
NODE_300012_length_247_cov_51.243243	172	247	0	75	75	1.0000000
NODE_300014_length_247_cov_37.614865	156	239	0	83	83	1.0000000
NODE_300056_length_245_cov_40.876712	138	202	40	4	64	0.0625000
NODE_300056_length_245_cov_40.876712	138	202	42	2	64	0.0312500
NODE_300056_length_245_cov_40.876712	138	202	50	2	64	0.0312500
NODE_300056_length_245_cov_40.876712	138	202	52	1	64	0.0156250
NODE_300056_length_245_cov_40.876712	138	202	56	1	64	0.0156250
NODE_300056_length_245_cov_40.876712	138	202	58	3	64	0.0468750
NODE_300056_length_245_cov_40.876712	138	202	59	2	64	0.0312500
NODE_300056_length_245_cov_40.876712	138	202	67	2	64	0.0312500
NODE_300056_length_245_cov_40.876712	138	202	71	1	64	0.0156250
NODE_300056_length_245_cov_40.876712	138	202	75	1	64	0.0156250
NODE_300056_length_245_cov_40.876712	138	202	83	2	64	0.0312500
NODE_300056_length_245_cov_40.876712	138	202	85	2	64	0.0312500
NODE_300056_length_245_cov_40.876712	138	202	87	4	64	0.0625000
NODE_300056_length_245_cov_40.876712	138	202	89	1	64	0.0156250
NODE_300056_length_245_cov_40.876712	138	202	91	6	64	0.0937500
NODE_300056_length_245_cov_40.876712	138	202	94	1	64	0.0156250
NODE_300056_length_245_cov_40.876712	138	202	95	1	64	0.0156250
NODE_300056_length_245_cov_40.876712	138	202	101	1	64	0.0156250
NODE_300056_length_245_cov_40.876712	138	202	102	10	64	0.1562500
NODE_300056_length_245_cov_40.876712	138	202	104	1	64	0.0156250
NODE_300056_length_245_cov_40.876712	138	202	107	1	64	0.0156250
NODE_300056_length_245_cov_40.876712	138	202	108	2	64	0.0312500
NODE_300056_length_245_cov_40.876712	138	202	113	1	64	0.0156250
NODE_300056_length_245_cov_40.876712	138	202	114	3	64	0.0468750
NODE_300056_length_245_cov_40.876712	138	202	116	1	64	0.0156250
NODE_300056_length_245_cov_40.876712	138	202	118	5	64	0.0781250
NODE_300056_length_245_cov_40.876712	138	202	121	1	64	0.0156250
NODE_300056_length_245_cov_40.876712	138	202	122	1	64	0.0156250
NODE_300056_length_245_cov_40.876712	138	202	124	1	64	0.0156250
NODE_300056_length_245_cov_40.876712	138	202	40	4	64	0.0625000
NODE_300056_length_245_cov_40.876712	138	202	42	2	64	0.0312500
NODE_300056_length_245_cov_40.876712	138	202	50	2	64	0.0312500
NODE_300056_length_245_cov_40.876712	138	202	52	1	64	0.0156250
NODE_300056_length_245_cov_40.876712	138	202	56	1	64	0.0156250
NODE_300056_length_245_cov_40.876712	138	202	58	3	64	0.0468750
NODE_300056_length_245_cov_40.876712	138	202	59	2	64	0.0312500
NODE_300056_length_245_cov_40.876712	138	202	67	2	64	0.0312500
NODE_300056_length_245_cov_40.876712	138	202	71	1	64	0.0156250
NODE_300056_length_245_cov_40.876712	138	202	75	1	64	0.0156250
NODE_300056_length_245_cov_40.876712	138	202	83	2	64	0.0312500
NODE_300056_length_245_cov_40.876712	138	202	85	2	64	0.0312500
NODE_300056_length_245_cov_40.876712	138	202	87	4	64	0.0625000
NODE_300056_length_245_cov_40.876712	138	202	89	1	64	0.0156250
NODE_300056_length_245_cov_40.876712	138	202	91	6	64	0.0937500
NODE_300056_length_245_cov_40.876712	138	202	94	1	64	0.0156250
NODE_300056_length_245_cov_40.876712	138	202	95	1	64	0.0156250
NODE_300056_length_245_cov_40.876712	138	202	101	1	64	0.0156250
NODE_300056_length_245_cov_40.876712	138	202	102	10	64	0.1562500
NODE_300056_length_245_cov_40.876712	138	202	104	1	64	0.0156250
NODE_300056_length_245_cov_40.876712	138	202	107	1	64	0.0156250
NODE_300056_length_245_cov_40.876712	138	202	108	2	64	0.0312500
NODE_300056_length_245_cov_40.876712	138	202	113	1	64	0.0156250
NODE_300056_length_245_cov_40.876712	138	202	114	3	64	0.0468750
NODE_300056_length_245_cov_40.876712	138	202	116	1	64	0.0156250
NODE_300056_length_245_cov_40.876712	138	202	118	5	64	0.0781250
NODE_300056_length_245_cov_40.876712	138	202	121	1	64	0.0156250
NODE_300056_length_245_cov_40.876712	138	202	122	1	64	0.0156250
NODE_300056_length_245_cov_40.876712	138	202	124	1	64	0.0156250
NODE_300056_length_245_cov_40.876712	138	202	40	4	64	0.0625000
NODE_300056_length_245_cov_40.876712	138	202	42	2	64	0.0312500
NODE_300056_length_245_cov_40.876712	138	202	50	2	64	0.0312500
NODE_300056_length_245_cov_40.876712	138	202	52	1	64	0.0156250
NODE_300056_length_245_cov_40.876712	138	202	56	1	64	0.0156250
NODE_300056_length_245_cov_40.876712	138	202	58	3	64	0.0468750
NODE_300056_length_245_cov_40.876712	138	202	59	2	64	0.0312500
NODE_300056_length_245_cov_40.876712	138	202	67	2	64	0.0312500
NODE_300056_length_245_cov_40.876712	138	202	71	1	64	0.0156250
NODE_300056_length_245_cov_40.876712	138	202	75	1	64	0.0156250
NODE_300056_length_245_cov_40.876712	138	202	83	2	64	0.0312500
NODE_300056_length_245_cov_40.876712	138	202	85	2	64	0.0312500
NODE_300056_length_245_cov_40.876712	138	202	87	4	64	0.0625000
NODE_300056_length_245_cov_40.876712	138	202	89	1	64	0.0156250
NODE_300056_length_245_cov_40.876712	138	202	91	6	64	0.0937500
NODE_300056_length_245_cov_40.876712	138	202	94	1	64	0.0156250
NODE_300056_length_245_cov_40.876712	138	202	95	1	64	0.0156250
NODE_300056_length_245_cov_40.876712	138	202	101	1	64	0.0156250
NODE_300056_length_245_cov_40.876712	138	202	102	10	64	0.1562500
NODE_300056_length_245_cov_40.876712	138	202	104	1	64	0.0156250
NODE_300056_length_245_cov_40.876712	138	202	107	1	64	0.0156250
NODE_300056_length_245_cov_40.876712	138	202	108	2	64	0.0312500
NODE_300056_length_245_cov_40.876712	138	202	113	1	64	0.0156250
NODE_300056_length_245_cov_40.876712	138	202	114	3	64	0.0468750
NODE_300056_length_245_cov_40.876712	138	202	116	1	64	0.0156250
NODE_300056_length_245_cov_40.876712	138	202	118	5	64	0.0781250
NODE_300056_length_245_cov_40.876712	138	202	121	1	64	0.0156250
NODE_300056_length_245_cov_40.876712	138	202	122	1	64	0.0156250
NODE_300056_length_245_cov_40.876712	138	202	124	1	64	0.0156250
NODE_300056_length_245_cov_40.876712	175	241	1	4	66	0.0606061
NODE_300056_length_245_cov_40.876712	175	241	5	8	66	0.1212121
NODE_300056_length_245_cov_40.876712	175	241	7	6	66	0.0909091
NODE_300056_length_245_cov_40.876712	175	241	12	3	66	0.0454545
NODE_300056_length_245_cov_40.876712	175	241	14	1	66	0.0151515
NODE_300056_length_245_cov_40.876712	175	241	20	5	66	0.0757576
NODE_300056_length_245_cov_40.876712	175	241	21	1	66	0.0151515
NODE_300056_length_245_cov_40.876712	175	241	23	1	66	0.0151515
NODE_300056_length_245_cov_40.876712	175	241	25	1	66	0.0151515
NODE_300056_length_245_cov_40.876712	175	241	27	4	66	0.0606061
NODE_300056_length_245_cov_40.876712	175	241	31	1	66	0.0151515
NODE_300056_length_245_cov_40.876712	175	241	32	2	66	0.0303030
NODE_300056_length_245_cov_40.876712	175	241	34	1	66	0.0151515
NODE_300056_length_245_cov_40.876712	175	241	40	5	66	0.0757576
NODE_300056_length_245_cov_40.876712	175	241	42	2	66	0.0303030
NODE_300056_length_245_cov_40.876712	175	241	50	2	66	0.0303030
NODE_300056_length_245_cov_40.876712	175	241	52	1	66	0.0151515
NODE_300056_length_245_cov_40.876712	175	241	56	1	66	0.0151515
NODE_300056_length_245_cov_40.876712	175	241	58	3	66	0.0454545
NODE_300056_length_245_cov_40.876712	175	241	59	2	66	0.0303030
NODE_300056_length_245_cov_40.876712	175	241	67	2	66	0.0303030
NODE_300056_length_245_cov_40.876712	175	241	71	1	66	0.0151515
NODE_300056_length_245_cov_40.876712	175	241	75	1	66	0.0151515
NODE_300056_length_245_cov_40.876712	175	241	83	2	66	0.0303030
NODE_300056_length_245_cov_40.876712	175	241	85	2	66	0.0303030
NODE_300056_length_245_cov_40.876712	175	241	87	4	66	0.0606061
NODE_300147_length_240_cov_80.744681	167	238	0	13	71	0.1830986
NODE_300147_length_240_cov_80.744681	167	238	8	41	71	0.5774648
NODE_300147_length_240_cov_80.744681	167	238	10	17	71	0.2394366
NODE_300148_length_240_cov_38.035461	31	82	0	51	51	1.0000000
NODE_300165_length_239_cov_72.878571	0	48	0	13	48	0.2708333
NODE_300165_length_239_cov_72.878571	0	48	10	35	48	0.7291667
NODE_300165_length_239_cov_72.878571	21	101	10	35	80	0.4375000
NODE_300165_length_239_cov_72.878571	21	101	14	45	80	0.5625000
NODE_300165_length_239_cov_72.878571	150	230	0	22	80	0.2750000
NODE_300165_length_239_cov_72.878571	150	230	4	16	80	0.2000000
NODE_300165_length_239_cov_72.878571	150	230	12	39	80	0.4875000
NODE_300165_length_239_cov_72.878571	150	230	18	3	80	0.0375000
NODE_300165_length_239_cov_72.878571	150	230	0	22	80	0.2750000
NODE_300165_length_239_cov_72.878571	150	230	4	16	80	0.2000000
NODE_300165_length_239_cov_72.878571	150	230	12	39	80	0.4875000
NODE_300165_length_239_cov_72.878571	150	230	18	3	80	0.0375000
NODE_300165_length_239_cov_72.878571	150	212	0	4	62	0.0645161
NODE_300165_length_239_cov_72.878571	150	212	4	16	62	0.2580645
NODE_300165_length_239_cov_72.878571	150	212	12	39	62	0.6290323
NODE_300165_length_239_cov_72.878571	150	212	18	3	62	0.0483871
NODE_300165_length_239_cov_72.878571	150	221	0	13	71	0.1830986
NODE_300165_length_239_cov_72.878571	150	221	4	16	71	0.2253521
NODE_300165_length_239_cov_72.878571	150	221	12	39	71	0.5492958
NODE_300165_length_239_cov_72.878571	150	221	18	3	71	0.0422535
NODE_300208_length_238_cov_385.683453	35	104	273	1	69	0.0144928
NODE_300208_length_238_cov_385.683453	35	104	275	1	69	0.0144928
NODE_300208_length_238_cov_385.683453	35	104	309	1	69	0.0144928
NODE_300208_length_238_cov_385.683453	35	104	312	1	69	0.0144928
NODE_300208_length_238_cov_385.683453	35	104	319	1	69	0.0144928
NODE_300208_length_238_cov_385.683453	35	104	332	1	69	0.0144928
NODE_300208_length_238_cov_385.683453	35	104	343	1	69	0.0144928
NODE_300208_length_238_cov_385.683453	35	104	347	1	69	0.0144928
NODE_300208_length_238_cov_385.683453	35	104	354	1	69	0.0144928
NODE_300208_length_238_cov_385.683453	35	104	359	1	69	0.0144928
NODE_300208_length_238_cov_385.683453	35	104	376	1	69	0.0144928
NODE_300208_length_238_cov_385.683453	35	104	377	1	69	0.0144928
NODE_300208_length_238_cov_385.683453	35	104	383	1	69	0.0144928
NODE_300208_length_238_cov_385.683453	35	104	384	1	69	0.0144928
NODE_300208_length_238_cov_385.683453	35	104	408	1	69	0.0144928
NODE_300208_length_238_cov_385.683453	35	104	415	1	69	0.0144928
NODE_300208_length_238_cov_385.683453	35	104	435	1	69	0.0144928
NODE_300208_length_238_cov_385.683453	35	104	440	1	69	0.0144928
NODE_300208_length_238_cov_385.683453	35	104	457	1	69	0.0144928
NODE_300208_length_238_cov_385.683453	35	104	470	1	69	0.0144928
NODE_300208_length_238_cov_385.683453	35	104	480	1	69	0.0144928
NODE_300208_length_238_cov_385.683453	35	104	486	1	69	0.0144928
NODE_300208_length_238_cov_385.683453	35	104	511	1	69	0.0144928
NODE_300208_length_238_cov_385.683453	35	104	512	2	69	0.0289855
NODE_300208_length_238_cov_385.683453	35	104	525	1	69	0.0144928
NODE_300208_length_238_cov_385.683453	35	104	529	1	69	0.0144928
NODE_300208_length_238_cov_385.683453	35	104	532	1	69	0.0144928
NODE_300208_length_238_cov_385.683453	35	104	533	1	69	0.0144928
NODE_300208_length_238_cov_385.683453	35	104	535	2	69	0.0289855
NODE_300208_length_238_cov_385.683453	35	104	542	1	69	0.0144928
NODE_300208_length_238_cov_385.683453	35	104	636	1	69	0.0144928
NODE_300208_length_238_cov_385.683453	35	104	646	1	69	0.0144928
NODE_300208_length_238_cov_385.683453	35	104	656	1	69	0.0144928
NODE_300208_length_238_cov_385.683453	35	104	664	1	69	0.0144928
NODE_300208_length_238_cov_385.683453	35	104	683	1	69	0.0144928
NODE_300208_length_238_cov_385.683453	35	104	693	1	69	0.0144928
NODE_300208_length_238_cov_385.683453	35	104	704	1	69	0.0144928
NODE_300208_length_238_cov_385.683453	35	104	709	1	69	0.0144928
NODE_300208_length_238_cov_385.683453	35	104	722	1	69	0.0144928
NODE_300208_length_238_cov_385.683453	35	104	726	1	69	0.0144928
NODE_300208_length_238_cov_385.683453	35	104	732	1	69	0.0144928
NODE_300208_length_238_cov_385.683453	35	104	736	1	69	0.0144928
NODE_300208_length_238_cov_385.683453	35	104	746	1	69	0.0144928
NODE_300208_length_238_cov_385.683453	35	104	749	1	69	0.0144928
NODE_300208_length_238_cov_385.683453	35	104	760	1	69	0.0144928
NODE_300208_length_238_cov_385.683453	35	104	768	1	69	0.0144928
NODE_300208_length_238_cov_385.683453	35	104	776	1	69	0.0144928
NODE_300208_length_238_cov_385.683453	35	104	782	1	69	0.0144928
NODE_300208_length_238_cov_385.683453	35	104	790	1	69	0.0144928
NODE_300208_length_238_cov_385.683453	35	104	797	1	69	0.0144928
NODE_300208_length_238_cov_385.683453	35	104	804	1	69	0.0144928
NODE_300208_length_238_cov_385.683453	35	104	812	1	69	0.0144928
NODE_300208_length_238_cov_385.683453	35	104	825	1	69	0.0144928
NODE_300208_length_238_cov_385.683453	35	104	829	1	69	0.0144928
NODE_300208_length_238_cov_385.683453	35	104	838	1	69	0.0144928
NODE_300208_length_238_cov_385.683453	35	104	839	1	69	0.0144928
NODE_300208_length_238_cov_385.683453	35	104	849	1	69	0.0144928
NODE_300208_length_238_cov_385.683453	35	104	866	1	69	0.0144928
NODE_300208_length_238_cov_385.683453	35	104	868	2	69	0.0289855
NODE_300208_length_238_cov_385.683453	35	104	878	1	69	0.0144928
NODE_300208_length_238_cov_385.683453	35	104	882	1	69	0.0144928
NODE_300208_length_238_cov_385.683453	35	104	898	1	69	0.0144928
NODE_300208_length_238_cov_385.683453	35	104	905	1	69	0.0144928
NODE_300208_length_238_cov_385.683453	35	104	914	1	69	0.0144928
NODE_300208_length_238_cov_385.683453	35	104	921	1	69	0.0144928
NODE_300208_length_238_cov_385.683453	35	104	931	1	69	0.0144928
NODE_300225_length_237_cov_101.543478	83	163	2	8	80	0.1000000
NODE_300225_length_237_cov_101.543478	83	163	3	17	80	0.2125000
NODE_300225_length_237_cov_101.543478	83	163	4	55	80	0.6875000
NODE_300225_length_237_cov_101.543478	83	163	2	8	80	0.1000000
NODE_300225_length_237_cov_101.543478	83	163	3	17	80	0.2125000
NODE_300225_length_237_cov_101.543478	83	163	4	55	80	0.6875000
NODE_300225_length_237_cov_101.543478	83	163	2	8	80	0.1000000
NODE_300225_length_237_cov_101.543478	83	163	3	17	80	0.2125000
NODE_300225_length_237_cov_101.543478	83	163	4	55	80	0.6875000
NODE_300225_length_237_cov_101.543478	83	163	2	8	80	0.1000000
NODE_300225_length_237_cov_101.543478	83	163	3	17	80	0.2125000
NODE_300225_length_237_cov_101.543478	83	163	4	55	80	0.6875000
NODE_300225_length_237_cov_101.543478	136	216	2	46	80	0.5750000
NODE_300225_length_237_cov_101.543478	136	216	4	34	80	0.4250000
NODE_300225_length_237_cov_101.543478	136	216	2	46	80	0.5750000
NODE_300225_length_237_cov_101.543478	136	216	4	34	80	0.4250000
NODE_300225_length_237_cov_101.543478	136	216	2	46	80	0.5750000
NODE_300225_length_237_cov_101.543478	136	216	4	34	80	0.4250000
NODE_300225_length_237_cov_101.543478	138	216	2	46	78	0.5897436
NODE_300225_length_237_cov_101.543478	138	216	4	32	78	0.4102564
NODE_300225_length_237_cov_101.543478	138	216	2	46	78	0.5897436
NODE_300225_length_237_cov_101.543478	138	216	4	32	78	0.4102564
NODE_300227_length_237_cov_49.623188	13	88	0	75	75	1.0000000
NODE_300227_length_237_cov_49.623188	73	153	0	80	80	1.0000000
NODE_300227_length_237_cov_49.623188	126	206	0	80	80	1.0000000
NODE_300289_length_235_cov_67.904412	0	62	0	62	62	1.0000000
NODE_300289_length_235_cov_67.904412	25	111	0	86	86	1.0000000
NODE_300289_length_235_cov_67.904412	69	150	0	81	81	1.0000000
NODE_300289_length_235_cov_67.904412	113	194	0	81	81	1.0000000
NODE_300289_length_235_cov_67.904412	157	235	0	78	78	1.0000000
NODE_300322_length_234_cov_76.496296	0	76	0	44	76	0.5789474
NODE_300322_length_234_cov_76.496296	0	76	13	5	76	0.0657895
NODE_300322_length_234_cov_76.496296	0	76	15	27	76	0.3552631
NODE_300322_length_234_cov_76.496296	0	76	0	44	76	0.5789474
NODE_300322_length_234_cov_76.496296	0	76	13	5	76	0.0657895
NODE_300322_length_234_cov_76.496296	0	76	15	27	76	0.3552631
NODE_300322_length_234_cov_76.496296	0	76	0	44	76	0.5789474
NODE_300322_length_234_cov_76.496296	0	76	13	5	76	0.0657895
NODE_300322_length_234_cov_76.496296	0	76	15	27	76	0.3552631
NODE_300322_length_234_cov_76.496296	0	76	0	44	76	0.5789474
NODE_300322_length_234_cov_76.496296	0	76	13	5	76	0.0657895
NODE_300322_length_234_cov_76.496296	0	76	15	27	76	0.3552631
NODE_300322_length_234_cov_76.496296	49	128	15	27	79	0.3417721
NODE_300322_length_234_cov_76.496296	49	128	16	26	79	0.3291139
NODE_300322_length_234_cov_76.496296	49	128	20	17	79	0.2151899
NODE_300322_length_234_cov_76.496296	49	128	26	1	79	0.0126582
NODE_300322_length_234_cov_76.496296	49	128	27	1	79	0.0126582
NODE_300322_length_234_cov_76.496296	49	128	28	7	79	0.0886076
NODE_300322_length_234_cov_76.496296	49	128	15	27	79	0.3417721
NODE_300322_length_234_cov_76.496296	49	128	16	26	79	0.3291139
NODE_300322_length_234_cov_76.496296	49	128	20	17	79	0.2151899
NODE_300322_length_234_cov_76.496296	49	128	26	1	79	0.0126582
NODE_300322_length_234_cov_76.496296	49	128	27	1	79	0.0126582
NODE_300322_length_234_cov_76.496296	49	128	28	7	79	0.0886076
NODE_300322_length_234_cov_76.496296	124	204	12	13	80	0.1625000
NODE_300322_length_234_cov_76.496296	124	204	19	4	80	0.0500000
NODE_300322_length_234_cov_76.496296	124	204	28	4	80	0.0500000
NODE_300322_length_234_cov_76.496296	124	204	30	59	80	0.7375000
NODE_300322_length_234_cov_76.496296	124	204	12	13	80	0.1625000
NODE_300322_length_234_cov_76.496296	124	204	19	4	80	0.0500000
NODE_300322_length_234_cov_76.496296	124	204	28	4	80	0.0500000
NODE_300322_length_234_cov_76.496296	124	204	30	59	80	0.7375000
NODE_300322_length_234_cov_76.496296	124	204	12	13	80	0.1625000
NODE_300322_length_234_cov_76.496296	124	204	19	4	80	0.0500000
NODE_300322_length_234_cov_76.496296	124	204	28	4	80	0.0500000
NODE_300322_length_234_cov_76.496296	124	204	30	59	80	0.7375000
NODE_300322_length_234_cov_76.496296	177	226	0	1	49	0.0204082
NODE_300322_length_234_cov_76.496296	177	226	2	10	49	0.2040816
NODE_300322_length_234_cov_76.496296	177	226	12	24	49	0.4897959
NODE_300322_length_234_cov_76.496296	177	226	19	4	49	0.0816327
NODE_300322_length_234_cov_76.496296	177	226	30	10	49	0.2040816
NODE_300322_length_234_cov_76.496296	177	234	0	9	57	0.1578947
NODE_300322_length_234_cov_76.496296	177	234	2	10	57	0.1754386
NODE_300322_length_234_cov_76.496296	177	234	12	24	57	0.4210526
NODE_300322_length_234_cov_76.496296	177	234	19	4	57	0.0701754
NODE_300322_length_234_cov_76.496296	177	234	30	10	57	0.1754386
NODE_300322_length_234_cov_76.496296	182	234	0	9	52	0.1730769
NODE_300322_length_234_cov_76.496296	182	234	2	10	52	0.1923077
NODE_300322_length_234_cov_76.496296	182	234	12	24	52	0.4615385
NODE_300322_length_234_cov_76.496296	182	234	19	4	52	0.0769231
NODE_300322_length_234_cov_76.496296	182	234	30	5	52	0.0961538
NODE_300323_length_234_cov_71.548148	90	162	8	72	72	1.0000000
NODE_300323_length_234_cov_71.548148	90	162	8	72	72	1.0000000
NODE_300323_length_234_cov_71.548148	135	215	0	40	80	0.5000000
NODE_300323_length_234_cov_71.548148	135	215	2	11	80	0.1375000
NODE_300323_length_234_cov_71.548148	135	215	8	29	80	0.3625000
NODE_300323_length_234_cov_71.548148	135	215	0	40	80	0.5000000
NODE_300323_length_234_cov_71.548148	135	215	2	11	80	0.1375000
NODE_300323_length_234_cov_71.548148	135	215	8	29	80	0.3625000
NODE_300357_length_233_cov_180.701493	0	65	0	65	65	1.0000000
NODE_300357_length_233_cov_180.701493	38	118	0	80	80	1.0000000
NODE_300392_length_232_cov_132.045113	53	133	24	17	80	0.2125000
NODE_300392_length_232_cov_132.045113	53	133	26	63	80	0.7875000
NODE_300392_length_232_cov_132.045113	106	186	19	13	80	0.1625000
NODE_300392_length_232_cov_132.045113	106	186	21	24	80	0.3000000
NODE_300392_length_232_cov_132.045113	106	186	22	3	80	0.0375000
NODE_300392_length_232_cov_132.045113	106	186	24	30	80	0.3750000
NODE_300392_length_232_cov_132.045113	106	186	26	10	80	0.1250000
NODE_300471_length_230_cov_34.427481	0	59	0	59	59	1.0000000
NODE_300471_length_230_cov_34.427481	0	59	0	59	59	1.0000000
NODE_300471_length_230_cov_34.427481	10	59	0	49	49	1.0000000
NODE_300487_length_229_cov_76.907692	94	176	36	6	82	0.0731707
NODE_300487_length_229_cov_76.907692	94	176	40	3	82	0.0365854
NODE_300487_length_229_cov_76.907692	94	176	42	2	82	0.0243902
NODE_300487_length_229_cov_76.907692	94	176	45	8	82	0.0975610
NODE_300487_length_229_cov_76.907692	94	176	49	1	82	0.0121951
NODE_300487_length_229_cov_76.907692	94	176	50	5	82	0.0609756
NODE_300487_length_229_cov_76.907692	94	176	52	1	82	0.0121951
NODE_300487_length_229_cov_76.907692	94	176	54	3	82	0.0365854
NODE_300487_length_229_cov_76.907692	94	176	56	5	82	0.0609756
NODE_300487_length_229_cov_76.907692	94	176	60	3	82	0.0365854
NODE_300487_length_229_cov_76.907692	94	176	64	17	82	0.2073171
NODE_300487_length_229_cov_76.907692	94	176	66	3	82	0.0365854
NODE_300487_length_229_cov_76.907692	94	176	68	3	82	0.0365854
NODE_300487_length_229_cov_76.907692	94	176	70	2	82	0.0243902
NODE_300487_length_229_cov_76.907692	94	176	72	14	82	0.1707317
NODE_300487_length_229_cov_76.907692	94	176	74	6	82	0.0731707
NODE_300523_length_228_cov_127.131783	0	76	0	10	76	0.1315790
NODE_300523_length_228_cov_127.131783	0	76	2	4	76	0.0526316
NODE_300523_length_228_cov_127.131783	0	76	4	61	76	0.8026316
NODE_300523_length_228_cov_127.131783	0	76	8	1	76	0.0131579
NODE_300523_length_228_cov_127.131783	5	76	0	5	71	0.0704225
NODE_300523_length_228_cov_127.131783	5	76	2	4	71	0.0563380
NODE_300523_length_228_cov_127.131783	5	76	4	61	71	0.8591549
NODE_300523_length_228_cov_127.131783	5	76	8	1	71	0.0140845
NODE_300523_length_228_cov_127.131783	10	76	2	4	66	0.0606061
NODE_300523_length_228_cov_127.131783	10	76	4	61	66	0.9242424
NODE_300523_length_228_cov_127.131783	10	76	8	1	66	0.0151515
NODE_300523_length_228_cov_127.131783	49	129	4	26	80	0.3250000
NODE_300523_length_228_cov_127.131783	49	129	8	54	80	0.6750000
NODE_300523_length_228_cov_127.131783	49	129	4	26	80	0.3250000
NODE_300523_length_228_cov_127.131783	49	129	8	54	80	0.6750000
NODE_300523_length_228_cov_127.131783	49	129	4	26	80	0.3250000
NODE_300523_length_228_cov_127.131783	49	129	8	54	80	0.6750000
NODE_300523_length_228_cov_127.131783	125	205	0	9	80	0.1125000
NODE_300523_length_228_cov_127.131783	125	205	4	32	80	0.4000000
NODE_300523_length_228_cov_127.131783	125	205	6	4	80	0.0500000
NODE_300523_length_228_cov_127.131783	125	205	8	35	80	0.4375000
NODE_300523_length_228_cov_127.131783	125	205	0	9	80	0.1125000
NODE_300523_length_228_cov_127.131783	125	205	4	32	80	0.4000000
NODE_300523_length_228_cov_127.131783	125	205	6	4	80	0.0500000
NODE_300523_length_228_cov_127.131783	125	205	8	35	80	0.4375000
NODE_300523_length_228_cov_127.131783	125	205	0	9	80	0.1125000
NODE_300523_length_228_cov_127.131783	125	205	4	32	80	0.4000000
NODE_300523_length_228_cov_127.131783	125	205	6	4	80	0.0500000
NODE_300523_length_228_cov_127.131783	125	205	8	35	80	0.4375000
NODE_300523_length_228_cov_127.131783	178	228	0	32	50	0.6400000
NODE_300523_length_228_cov_127.131783	178	228	4	18	50	0.3600000
NODE_300523_length_228_cov_127.131783	178	228	0	32	50	0.6400000
NODE_300523_length_228_cov_127.131783	178	228	4	18	50	0.3600000
NODE_300523_length_228_cov_127.131783	178	228	0	32	50	0.6400000
NODE_300523_length_228_cov_127.131783	178	228	4	18	50	0.3600000
NODE_300524_length_228_cov_94.255814	34	99	2	22	65	0.3384615
NODE_300524_length_228_cov_94.255814	34	99	6	26	65	0.4000000
NODE_300524_length_228_cov_94.255814	34	99	8	13	65	0.2000000
NODE_300524_length_228_cov_94.255814	34	99	9	4	65	0.0615385
NODE_300524_length_228_cov_94.255814	34	114	2	22	80	0.2750000
NODE_300524_length_228_cov_94.255814	34	114	6	26	80	0.3250000
NODE_300524_length_228_cov_94.255814	34	114	8	13	80	0.1625000
NODE_300524_length_228_cov_94.255814	34	114	9	6	80	0.0750000
NODE_300524_length_228_cov_94.255814	34	114	10	5	80	0.0625000
NODE_300524_length_228_cov_94.255814	34	114	20	8	80	0.1000000
NODE_300524_length_228_cov_94.255814	41	111	2	15	70	0.2142857
NODE_300524_length_228_cov_94.255814	41	111	6	26	70	0.3714286
NODE_300524_length_228_cov_94.255814	41	111	8	13	70	0.1857143
NODE_300524_length_228_cov_94.255814	41	111	9	6	70	0.0857143
NODE_300524_length_228_cov_94.255814	41	111	10	5	70	0.0714286
NODE_300524_length_228_cov_94.255814	41	111	20	5	70	0.0714286
NODE_300524_length_228_cov_94.255814	43	114	2	13	71	0.1830986
NODE_300524_length_228_cov_94.255814	43	114	6	26	71	0.3661972
NODE_300524_length_228_cov_94.255814	43	114	8	13	71	0.1830986
NODE_300524_length_228_cov_94.255814	43	114	9	6	71	0.0845070
NODE_300524_length_228_cov_94.255814	43	114	10	5	71	0.0704225
NODE_300524_length_228_cov_94.255814	43	114	20	8	71	0.1126761
NODE_300524_length_228_cov_94.255814	87	167	8	8	80	0.1000000
NODE_300524_length_228_cov_94.255814	87	167	9	6	80	0.0750000
NODE_300524_length_228_cov_94.255814	87	167	10	5	80	0.0625000
NODE_300524_length_228_cov_94.255814	87	167	16	6	80	0.0750000
NODE_300524_length_228_cov_94.255814	87	167	17	3	80	0.0375000
NODE_300524_length_228_cov_94.255814	87	167	18	17	80	0.2125000
NODE_300524_length_228_cov_94.255814	87	167	20	35	80	0.4375000
NODE_300524_length_228_cov_94.255814	87	167	8	8	80	0.1000000
NODE_300524_length_228_cov_94.255814	87	167	9	6	80	0.0750000
NODE_300524_length_228_cov_94.255814	87	167	10	5	80	0.0625000
NODE_300524_length_228_cov_94.255814	87	167	16	6	80	0.0750000
NODE_300524_length_228_cov_94.255814	87	167	17	3	80	0.0375000
NODE_300524_length_228_cov_94.255814	87	167	18	17	80	0.2125000
NODE_300524_length_228_cov_94.255814	87	167	20	35	80	0.4375000
NODE_300524_length_228_cov_94.255814	87	167	8	8	80	0.1000000
NODE_300524_length_228_cov_94.255814	87	167	9	6	80	0.0750000
NODE_300524_length_228_cov_94.255814	87	167	10	5	80	0.0625000
NODE_300524_length_228_cov_94.255814	87	167	16	6	80	0.0750000
NODE_300524_length_228_cov_94.255814	87	167	17	3	80	0.0375000
NODE_300524_length_228_cov_94.255814	87	167	18	17	80	0.2125000
NODE_300524_length_228_cov_94.255814	87	167	20	35	80	0.4375000
NODE_300524_length_228_cov_94.255814	87	167	8	8	80	0.1000000
NODE_300524_length_228_cov_94.255814	87	167	9	6	80	0.0750000
NODE_300524_length_228_cov_94.255814	87	167	10	5	80	0.0625000
NODE_300524_length_228_cov_94.255814	87	167	16	6	80	0.0750000
NODE_300524_length_228_cov_94.255814	87	167	17	3	80	0.0375000
NODE_300524_length_228_cov_94.255814	87	167	18	17	80	0.2125000
NODE_300524_length_228_cov_94.255814	87	167	20	35	80	0.4375000
NODE_300547_length_228_cov_0.395349	27	107	0	80	80	1.0000000
NODE_300547_length_228_cov_0.395349	70	150	0	80	80	1.0000000
NODE_300556_length_227_cov_37.429688	40	111	2	34	71	0.4788733
NODE_300556_length_227_cov_37.429688	40	111	4	3	71	0.0422535
NODE_300556_length_227_cov_37.429688	40	111	6	7	71	0.0985916
NODE_300556_length_227_cov_37.429688	40	111	8	2	71	0.0281690
NODE_300556_length_227_cov_37.429688	40	111	12	21	71	0.2957746
NODE_300556_length_227_cov_37.429688	40	111	14	4	71	0.0563380
NODE_300556_length_227_cov_37.429688	49	112	2	25	63	0.3968254
NODE_300556_length_227_cov_37.429688	49	112	4	3	63	0.0476190
NODE_300556_length_227_cov_37.429688	49	112	6	7	63	0.1111111
NODE_300556_length_227_cov_37.429688	49	112	8	2	63	0.0317460
NODE_300556_length_227_cov_37.429688	49	112	12	21	63	0.3333333
NODE_300556_length_227_cov_37.429688	49	112	14	5	63	0.0793651
NODE_300556_length_227_cov_37.429688	93	172	2	15	79	0.1898734
NODE_300556_length_227_cov_37.429688	93	172	6	2	79	0.0253165
NODE_300556_length_227_cov_37.429688	93	172	8	1	79	0.0126582
NODE_300556_length_227_cov_37.429688	93	172	10	10	79	0.1265823
NODE_300556_length_227_cov_37.429688	93	172	12	24	79	0.3037975
NODE_300556_length_227_cov_37.429688	93	172	14	27	79	0.3417721
NODE_300556_length_227_cov_37.429688	168	227	0	54	59	0.9152542
NODE_300556_length_227_cov_37.429688	168	227	2	5	59	0.0847458
NODE_300556_length_227_cov_37.429688	168	227	0	54	59	0.9152542
NODE_300556_length_227_cov_37.429688	168	227	2	5	59	0.0847458
NODE_300595_length_226_cov_547.629921	82	162	964	1	80	0.0125000
NODE_300595_length_226_cov_547.629921	82	162	976	1	80	0.0125000
NODE_300595_length_226_cov_547.629921	82	162	983	1	80	0.0125000
NODE_300595_length_226_cov_547.629921	82	162	989	1	80	0.0125000
NODE_300595_length_226_cov_547.629921	82	162	998	1	80	0.0125000
NODE_300595_length_226_cov_547.629921	82	162	1002	1	80	0.0125000
NODE_300595_length_226_cov_547.629921	82	162	1010	1	80	0.0125000
NODE_300595_length_226_cov_547.629921	82	162	1015	1	80	0.0125000
NODE_300595_length_226_cov_547.629921	82	162	1025	2	80	0.0250000
NODE_300595_length_226_cov_547.629921	82	162	1032	1	80	0.0125000
NODE_300595_length_226_cov_547.629921	82	162	1033	1	80	0.0125000
NODE_300595_length_226_cov_547.629921	82	162	1044	1	80	0.0125000
NODE_300595_length_226_cov_547.629921	82	162	1052	1	80	0.0125000
NODE_300595_length_226_cov_547.629921	82	162	1054	1	80	0.0125000
NODE_300595_length_226_cov_547.629921	82	162	1059	1	80	0.0125000
NODE_300595_length_226_cov_547.629921	82	162	1061	1	80	0.0125000
NODE_300595_length_226_cov_547.629921	82	162	1068	1	80	0.0125000
NODE_300595_length_226_cov_547.629921	82	162	1072	1	80	0.0125000
NODE_300595_length_226_cov_547.629921	82	162	1076	2	80	0.0250000
NODE_300595_length_226_cov_547.629921	82	162	1094	2	80	0.0250000
NODE_300595_length_226_cov_547.629921	82	162	1098	1	80	0.0125000
NODE_300595_length_226_cov_547.629921	82	162	1100	1	80	0.0125000
NODE_300595_length_226_cov_547.629921	82	162	1109	1	80	0.0125000
NODE_300595_length_226_cov_547.629921	82	162	1113	1	80	0.0125000
NODE_300595_length_226_cov_547.629921	82	162	1115	1	80	0.0125000
NODE_300595_length_226_cov_547.629921	82	162	1116	1	80	0.0125000
NODE_300595_length_226_cov_547.629921	82	162	1127	1	80	0.0125000
NODE_300595_length_226_cov_547.629921	82	162	1134	1	80	0.0125000
NODE_300595_length_226_cov_547.629921	82	162	1154	1	80	0.0125000
NODE_300595_length_226_cov_547.629921	82	162	1160	1	80	0.0125000
NODE_300595_length_226_cov_547.629921	82	162	1167	1	80	0.0125000
NODE_300595_length_226_cov_547.629921	82	162	1168	1	80	0.0125000
NODE_300595_length_226_cov_547.629921	82	162	1176	1	80	0.0125000
NODE_300595_length_226_cov_547.629921	82	162	1186	1	80	0.0125000
NODE_300595_length_226_cov_547.629921	82	162	1194	2	80	0.0250000
NODE_300595_length_226_cov_547.629921	82	162	1198	1	80	0.0125000
NODE_300595_length_226_cov_547.629921	82	162	1201	1	80	0.0125000
NODE_300595_length_226_cov_547.629921	82	162	1202	1	80	0.0125000
NODE_300595_length_226_cov_547.629921	82	162	1205	1	80	0.0125000
NODE_300595_length_226_cov_547.629921	82	162	1207	1	80	0.0125000
NODE_300595_length_226_cov_547.629921	82	162	1211	1	80	0.0125000
NODE_300595_length_226_cov_547.629921	82	162	1219	1	80	0.0125000
NODE_300595_length_226_cov_547.629921	82	162	1220	1	80	0.0125000
NODE_300595_length_226_cov_547.629921	82	162	1224	1	80	0.0125000
NODE_300595_length_226_cov_547.629921	82	162	1225	1	80	0.0125000
NODE_300595_length_226_cov_547.629921	82	162	1227	1	80	0.0125000
NODE_300595_length_226_cov_547.629921	82	162	1233	1	80	0.0125000
NODE_300595_length_226_cov_547.629921	82	162	1241	1	80	0.0125000
NODE_300595_length_226_cov_547.629921	82	162	1244	1	80	0.0125000
NODE_300595_length_226_cov_547.629921	82	162	1250	1	80	0.0125000
NODE_300595_length_226_cov_547.629921	82	162	1252	2	80	0.0250000
NODE_300595_length_226_cov_547.629921	82	162	1254	1	80	0.0125000
NODE_300595_length_226_cov_547.629921	82	162	1260	1	80	0.0125000
NODE_300595_length_226_cov_547.629921	82	162	1263	1	80	0.0125000
NODE_300595_length_226_cov_547.629921	82	162	1269	1	80	0.0125000
NODE_300595_length_226_cov_547.629921	82	162	1275	1	80	0.0125000
NODE_300595_length_226_cov_547.629921	82	162	1279	2	80	0.0250000
NODE_300595_length_226_cov_547.629921	82	162	1281	1	80	0.0125000
NODE_300595_length_226_cov_547.629921	82	162	1286	2	80	0.0250000
NODE_300595_length_226_cov_547.629921	82	162	1287	1	80	0.0125000
NODE_300595_length_226_cov_547.629921	82	162	1288	2	80	0.0250000
NODE_300595_length_226_cov_547.629921	82	162	1292	1	80	0.0125000
NODE_300595_length_226_cov_547.629921	82	162	1293	1	80	0.0125000
NODE_300595_length_226_cov_547.629921	82	162	1299	1	80	0.0125000
NODE_300595_length_226_cov_547.629921	82	162	1305	1	80	0.0125000
NODE_300595_length_226_cov_547.629921	82	162	1307	1	80	0.0125000
NODE_300595_length_226_cov_547.629921	82	162	1308	1	80	0.0125000
NODE_300595_length_226_cov_547.629921	82	162	1309	2	80	0.0250000
NODE_300595_length_226_cov_547.629921	82	162	1316	1	80	0.0125000
NODE_300595_length_226_cov_547.629921	82	162	1317	2	80	0.0250000
NODE_300617_length_225_cov_41.269841	81	165	18	8	84	0.0952381
NODE_300617_length_225_cov_41.269841	81	165	20	2	84	0.0238095
NODE_300617_length_225_cov_41.269841	81	165	24	1	84	0.0119048
NODE_300617_length_225_cov_41.269841	81	165	26	1	84	0.0119048
NODE_300617_length_225_cov_41.269841	81	165	30	6	84	0.0714286
NODE_300617_length_225_cov_41.269841	81	165	36	3	84	0.0357143
NODE_300617_length_225_cov_41.269841	81	165	42	1	84	0.0119048
NODE_300617_length_225_cov_41.269841	81	165	44	10	84	0.1190476
NODE_300617_length_225_cov_41.269841	81	165	46	2	84	0.0238095
NODE_300617_length_225_cov_41.269841	81	165	48	10	84	0.1190476
NODE_300617_length_225_cov_41.269841	81	165	50	14	84	0.1666667
NODE_300617_length_225_cov_41.269841	81	165	52	6	84	0.0714286
NODE_300617_length_225_cov_41.269841	81	165	54	20	84	0.2380952
NODE_300617_length_225_cov_41.269841	134	218	0	8	84	0.0952381
NODE_300617_length_225_cov_41.269841	134	218	2	18	84	0.2142857
NODE_300617_length_225_cov_41.269841	134	218	4	1	84	0.0119048
NODE_300617_length_225_cov_41.269841	134	218	6	3	84	0.0357143
NODE_300617_length_225_cov_41.269841	134	218	12	5	84	0.0595238
NODE_300617_length_225_cov_41.269841	134	218	14	6	84	0.0714286
NODE_300617_length_225_cov_41.269841	134	218	16	4	84	0.0476190
NODE_300617_length_225_cov_41.269841	134	218	18	16	84	0.1904762
NODE_300617_length_225_cov_41.269841	134	218	20	2	84	0.0238095
NODE_300617_length_225_cov_41.269841	134	218	24	1	84	0.0119048
NODE_300617_length_225_cov_41.269841	134	218	26	1	84	0.0119048
NODE_300617_length_225_cov_41.269841	134	218	30	6	84	0.0714286
NODE_300617_length_225_cov_41.269841	134	218	36	3	84	0.0357143
NODE_300617_length_225_cov_41.269841	134	218	42	1	84	0.0119048
NODE_300617_length_225_cov_41.269841	134	218	44	9	84	0.1071429
NODE_300661_length_224_cov_209.528000	12	84	8	5	72	0.0694444
NODE_300661_length_224_cov_209.528000	12	84	10	2	72	0.0277778
NODE_300661_length_224_cov_209.528000	12	84	12	4	72	0.0555556
NODE_300661_length_224_cov_209.528000	12	84	14	1	72	0.0138889
NODE_300661_length_224_cov_209.528000	12	84	16	3	72	0.0416667
NODE_300661_length_224_cov_209.528000	12	84	18	2	72	0.0277778
NODE_300661_length_224_cov_209.528000	12	84	20	3	72	0.0416667
NODE_300661_length_224_cov_209.528000	12	84	22	15	72	0.2083333
NODE_300661_length_224_cov_209.528000	12	84	23	1	72	0.0138889
NODE_300661_length_224_cov_209.528000	12	84	24	2	72	0.0277778
NODE_300661_length_224_cov_209.528000	12	84	34	4	72	0.0555556
NODE_300661_length_224_cov_209.528000	12	84	36	1	72	0.0138889
NODE_300661_length_224_cov_209.528000	12	84	38	2	72	0.0277778
NODE_300661_length_224_cov_209.528000	12	84	40	3	72	0.0416667
NODE_300661_length_224_cov_209.528000	12	84	42	1	72	0.0138889
NODE_300661_length_224_cov_209.528000	12	84	44	7	72	0.0972222
NODE_300661_length_224_cov_209.528000	12	84	46	6	72	0.0833333
NODE_300661_length_224_cov_209.528000	12	84	48	3	72	0.0416667
NODE_300661_length_224_cov_209.528000	12	84	50	5	72	0.0694444
NODE_300661_length_224_cov_209.528000	12	84	54	2	72	0.0277778
NODE_300663_length_224_cov_146.568000	13	72	7	23	59	0.3898305
NODE_300663_length_224_cov_146.568000	13	72	9	5	59	0.0847458
NODE_300663_length_224_cov_146.568000	13	72	10	9	59	0.1525424
NODE_300663_length_224_cov_146.568000	13	72	11	6	59	0.1016949
NODE_300663_length_224_cov_146.568000	13	72	14	13	59	0.2203390
NODE_300663_length_224_cov_146.568000	13	72	16	1	59	0.0169492
NODE_300663_length_224_cov_146.568000	13	72	19	2	59	0.0338983
NODE_300663_length_224_cov_146.568000	46	72	10	4	26	0.1538462
NODE_300663_length_224_cov_146.568000	46	72	11	6	26	0.2307692
NODE_300663_length_224_cov_146.568000	46	72	14	13	26	0.5000000
NODE_300663_length_224_cov_146.568000	46	72	16	1	26	0.0384615
NODE_300663_length_224_cov_146.568000	46	72	19	2	26	0.0769231
NODE_300663_length_224_cov_146.568000	68	120	14	1	52	0.0192308
NODE_300663_length_224_cov_146.568000	68	120	16	1	52	0.0192308
NODE_300663_length_224_cov_146.568000	68	120	19	5	52	0.0961538
NODE_300663_length_224_cov_146.568000	68	120	22	5	52	0.0961538
NODE_300663_length_224_cov_146.568000	68	120	24	3	52	0.0576923
NODE_300663_length_224_cov_146.568000	68	120	30	3	52	0.0576923
NODE_300663_length_224_cov_146.568000	68	120	32	1	52	0.0192308
NODE_300663_length_224_cov_146.568000	68	120	36	1	52	0.0192308
NODE_300663_length_224_cov_146.568000	68	120	40	1	52	0.0192308
NODE_300663_length_224_cov_146.568000	68	120	48	12	52	0.2307692
NODE_300663_length_224_cov_146.568000	68	120	50	3	52	0.0576923
NODE_300663_length_224_cov_146.568000	68	120	52	5	52	0.0961538
NODE_300663_length_224_cov_146.568000	68	120	61	1	52	0.0192308
NODE_300663_length_224_cov_146.568000	68	120	63	6	52	0.1153846
NODE_300663_length_224_cov_146.568000	68	120	65	4	52	0.0769231
NODE_300665_length_224_cov_59.088000	98	178	14	8	80	0.1000000
NODE_300665_length_224_cov_59.088000	98	178	16	18	80	0.2250000
NODE_300665_length_224_cov_59.088000	98	178	18	15	80	0.1875000
NODE_300665_length_224_cov_59.088000	98	178	20	3	80	0.0375000
NODE_300665_length_224_cov_59.088000	98	178	22	12	80	0.1500000
NODE_300665_length_224_cov_59.088000	98	178	24	24	80	0.3000000
NODE_300665_length_224_cov_59.088000	98	178	14	8	80	0.1000000
NODE_300665_length_224_cov_59.088000	98	178	16	18	80	0.2250000
NODE_300665_length_224_cov_59.088000	98	178	18	15	80	0.1875000
NODE_300665_length_224_cov_59.088000	98	178	20	3	80	0.0375000
NODE_300665_length_224_cov_59.088000	98	178	22	12	80	0.1500000
NODE_300665_length_224_cov_59.088000	98	178	24	24	80	0.3000000
NODE_300665_length_224_cov_59.088000	98	178	14	8	80	0.1000000
NODE_300665_length_224_cov_59.088000	98	178	16	18	80	0.2250000
NODE_300665_length_224_cov_59.088000	98	178	18	15	80	0.1875000
NODE_300665_length_224_cov_59.088000	98	178	20	3	80	0.0375000
NODE_300665_length_224_cov_59.088000	98	178	22	12	80	0.1500000
NODE_300665_length_224_cov_59.088000	98	178	24	24	80	0.3000000
NODE_300665_length_224_cov_59.088000	151	217	3	1	66	0.0151515
NODE_300665_length_224_cov_59.088000	151	217	4	4	66	0.0606061
NODE_300665_length_224_cov_59.088000	151	217	14	19	66	0.2878788
NODE_300665_length_224_cov_59.088000	151	217	16	32	66	0.4848485
NODE_300665_length_224_cov_59.088000	151	217	20	3	66	0.0454545
NODE_300665_length_224_cov_59.088000	151	217	22	7	66	0.1060606
NODE_300665_length_224_cov_59.088000	151	224	0	3	73	0.0410959
NODE_300665_length_224_cov_59.088000	151	224	3	5	73	0.0684932
NODE_300665_length_224_cov_59.088000	151	224	4	4	73	0.0547945
NODE_300665_length_224_cov_59.088000	151	224	14	19	73	0.2602740
NODE_300665_length_224_cov_59.088000	151	224	16	32	73	0.4383562
NODE_300665_length_224_cov_59.088000	151	224	20	3	73	0.0410959
NODE_300665_length_224_cov_59.088000	151	224	22	7	73	0.0958904
NODE_300667_length_224_cov_43.640000	98	157	0	59	59	1.0000000
NODE_300667_length_224_cov_43.640000	98	157	0	59	59	1.0000000
NODE_300667_length_224_cov_43.640000	106	157	0	51	51	1.0000000
NODE_300669_length_224_cov_36.224000	100	171	30	14	71	0.1971831
NODE_300669_length_224_cov_36.224000	100	171	32	57	71	0.8028169
NODE_300669_length_224_cov_36.224000	151	224	0	5	73	0.0684932
NODE_300669_length_224_cov_36.224000	151	224	2	1	73	0.0136986
NODE_300669_length_224_cov_36.224000	151	224	4	2	73	0.0273973
NODE_300669_length_224_cov_36.224000	151	224	8	1	73	0.0136986
NODE_300669_length_224_cov_36.224000	151	224	10	2	73	0.0273973
NODE_300669_length_224_cov_36.224000	151	224	15	1	73	0.0136986
NODE_300669_length_224_cov_36.224000	151	224	17	1	73	0.0136986
NODE_300669_length_224_cov_36.224000	151	224	23	1	73	0.0136986
NODE_300669_length_224_cov_36.224000	151	224	24	4	73	0.0547945
NODE_300669_length_224_cov_36.224000	151	224	28	1	73	0.0136986
NODE_300669_length_224_cov_36.224000	151	224	29	1	73	0.0136986
NODE_300669_length_224_cov_36.224000	151	224	31	5	73	0.0684932
NODE_300669_length_224_cov_36.224000	151	224	32	48	73	0.6575342
NODE_300696_length_223_cov_35.814516	0	54	2	2	54	0.0370370
NODE_300696_length_223_cov_35.814516	0	54	4	11	54	0.2037037
NODE_300696_length_223_cov_35.814516	0	54	8	6	54	0.1111111
NODE_300696_length_223_cov_35.814516	0	54	10	1	54	0.0185185
NODE_300696_length_223_cov_35.814516	0	54	12	34	54	0.6296296
NODE_300696_length_223_cov_35.814516	30	107	12	65	77	0.8441558
NODE_300696_length_223_cov_35.814516	30	107	16	3	77	0.0389610
NODE_300696_length_223_cov_35.814516	30	107	18	7	77	0.0909091
NODE_300696_length_223_cov_35.814516	30	107	22	2	77	0.0259740
NODE_300768_length_221_cov_71.319672	14	94	4	1	80	0.0125000
NODE_300768_length_221_cov_71.319672	14	94	10	1	80	0.0125000
NODE_300768_length_221_cov_71.319672	14	94	12	1	80	0.0125000
NODE_300768_length_221_cov_71.319672	14	94	20	1	80	0.0125000
NODE_300768_length_221_cov_71.319672	14	94	22	2	80	0.0250000
NODE_300768_length_221_cov_71.319672	14	94	24	1	80	0.0125000
NODE_300768_length_221_cov_71.319672	14	94	26	1	80	0.0125000
NODE_300768_length_221_cov_71.319672	14	94	28	3	80	0.0375000
NODE_300768_length_221_cov_71.319672	14	94	30	5	80	0.0625000
NODE_300768_length_221_cov_71.319672	14	94	35	1	80	0.0125000
NODE_300768_length_221_cov_71.319672	14	94	37	1	80	0.0125000
NODE_300768_length_221_cov_71.319672	14	94	39	1	80	0.0125000
NODE_300768_length_221_cov_71.319672	14	94	49	1	80	0.0125000
NODE_300768_length_221_cov_71.319672	14	94	52	1	80	0.0125000
NODE_300768_length_221_cov_71.319672	14	94	71	3	80	0.0375000
NODE_300768_length_221_cov_71.319672	14	94	73	2	80	0.0250000
NODE_300768_length_221_cov_71.319672	14	94	75	1	80	0.0125000
NODE_300768_length_221_cov_71.319672	14	94	78	1	80	0.0125000
NODE_300768_length_221_cov_71.319672	14	94	81	1	80	0.0125000
NODE_300768_length_221_cov_71.319672	14	94	82	3	80	0.0375000
NODE_300768_length_221_cov_71.319672	14	94	84	6	80	0.0750000
NODE_300768_length_221_cov_71.319672	14	94	87	2	80	0.0250000
NODE_300768_length_221_cov_71.319672	14	94	88	1	80	0.0125000
NODE_300768_length_221_cov_71.319672	14	94	95	2	80	0.0250000
NODE_300768_length_221_cov_71.319672	14	94	97	2	80	0.0250000
NODE_300768_length_221_cov_71.319672	14	94	98	6	80	0.0750000
NODE_300768_length_221_cov_71.319672	14	94	100	25	80	0.3125000
NODE_300768_length_221_cov_71.319672	14	94	101	4	80	0.0500000
NODE_300800_length_220_cov_42.206612	3	74	4	4	71	0.0563380
NODE_300800_length_220_cov_42.206612	3	74	6	19	71	0.2676056
NODE_300800_length_220_cov_42.206612	3	74	7	1	71	0.0140845
NODE_300800_length_220_cov_42.206612	3	74	8	6	71	0.0845070
NODE_300800_length_220_cov_42.206612	3	74	9	3	71	0.0422535
NODE_300800_length_220_cov_42.206612	3	74	13	2	71	0.0281690
NODE_300800_length_220_cov_42.206612	3	74	15	4	71	0.0563380
NODE_300800_length_220_cov_42.206612	3	74	17	9	71	0.1267606
NODE_300800_length_220_cov_42.206612	3	74	18	16	71	0.2253521
NODE_300800_length_220_cov_42.206612	3	74	21	2	71	0.0281690
NODE_300800_length_220_cov_42.206612	3	74	22	4	71	0.0563380
NODE_300800_length_220_cov_42.206612	3	74	24	1	71	0.0140845
NODE_300800_length_220_cov_42.206612	8	74	6	18	66	0.2727273
NODE_300800_length_220_cov_42.206612	8	74	7	1	66	0.0151515
NODE_300800_length_220_cov_42.206612	8	74	8	6	66	0.0909091
NODE_300800_length_220_cov_42.206612	8	74	9	3	66	0.0454545
NODE_300800_length_220_cov_42.206612	8	74	13	2	66	0.0303030
NODE_300800_length_220_cov_42.206612	8	74	15	4	66	0.0606061
NODE_300800_length_220_cov_42.206612	8	74	17	9	66	0.1363636
NODE_300800_length_220_cov_42.206612	8	74	18	16	66	0.2424242
NODE_300800_length_220_cov_42.206612	8	74	21	2	66	0.0303030
NODE_300800_length_220_cov_42.206612	8	74	22	4	66	0.0606061
NODE_300800_length_220_cov_42.206612	8	74	24	1	66	0.0151515
NODE_300800_length_220_cov_42.206612	47	98	17	4	51	0.0784314
NODE_300800_length_220_cov_42.206612	47	98	18	16	51	0.3137255
NODE_300800_length_220_cov_42.206612	47	98	21	2	51	0.0392157
NODE_300800_length_220_cov_42.206612	47	98	22	4	51	0.0784314
NODE_300800_length_220_cov_42.206612	47	98	24	25	51	0.4901961
NODE_300800_length_220_cov_42.206612	47	98	17	4	51	0.0784314
NODE_300800_length_220_cov_42.206612	47	98	18	16	51	0.3137255
NODE_300800_length_220_cov_42.206612	47	98	21	2	51	0.0392157
NODE_300800_length_220_cov_42.206612	47	98	22	4	51	0.0784314
NODE_300800_length_220_cov_42.206612	47	98	24	25	51	0.4901961
NODE_300800_length_220_cov_42.206612	47	98	17	4	51	0.0784314
NODE_300800_length_220_cov_42.206612	47	98	18	16	51	0.3137255
NODE_300800_length_220_cov_42.206612	47	98	21	2	51	0.0392157
NODE_300800_length_220_cov_42.206612	47	98	22	4	51	0.0784314
NODE_300800_length_220_cov_42.206612	47	98	24	25	51	0.4901961
NODE_300874_length_218_cov_244.773109	128	203	10	10	75	0.1333333
NODE_300874_length_218_cov_244.773109	128	203	12	4	75	0.0533333
NODE_300874_length_218_cov_244.773109	128	203	16	1	75	0.0133333
NODE_300874_length_218_cov_244.773109	128	203	19	19	75	0.2533333
NODE_300874_length_218_cov_244.773109	128	203	22	1	75	0.0133333
NODE_300874_length_218_cov_244.773109	128	203	24	2	75	0.0266667
NODE_300874_length_218_cov_244.773109	128	203	26	1	75	0.0133333
NODE_300874_length_218_cov_244.773109	128	203	30	1	75	0.0133333
NODE_300874_length_218_cov_244.773109	128	203	38	2	75	0.0266667
NODE_300874_length_218_cov_244.773109	128	203	40	1	75	0.0133333
NODE_300874_length_218_cov_244.773109	128	203	44	1	75	0.0133333
NODE_300874_length_218_cov_244.773109	128	203	46	1	75	0.0133333
NODE_300874_length_218_cov_244.773109	128	203	48	14	75	0.1866667
NODE_300874_length_218_cov_244.773109	128	203	52	3	75	0.0400000
NODE_300874_length_218_cov_244.773109	128	203	62	2	75	0.0266667
NODE_300874_length_218_cov_244.773109	128	203	68	1	75	0.0133333
NODE_300874_length_218_cov_244.773109	128	203	74	2	75	0.0266667
NODE_300874_length_218_cov_244.773109	128	203	76	9	75	0.1200000
NODE_300874_length_218_cov_244.773109	176	218	2	1	42	0.0238095
NODE_300874_length_218_cov_244.773109	176	218	4	7	42	0.1666667
NODE_300874_length_218_cov_244.773109	176	218	6	1	42	0.0238095
NODE_300874_length_218_cov_244.773109	176	218	9	1	42	0.0238095
NODE_300874_length_218_cov_244.773109	176	218	10	15	42	0.3571429
NODE_300874_length_218_cov_244.773109	176	218	12	4	42	0.0952381
NODE_300874_length_218_cov_244.773109	176	218	16	1	42	0.0238095
NODE_300874_length_218_cov_244.773109	176	218	19	12	42	0.2857143
NODE_300915_length_217_cov_2.144068	14	49	0	35	35	1.0000000
NODE_300915_length_217_cov_2.144068	132	167	0	4	35	0.1142857
NODE_300915_length_217_cov_2.144068	132	167	4	31	35	0.8857143
NODE_300924_length_216_cov_215.410256	0	63	0	20	63	0.3174603
NODE_300924_length_216_cov_215.410256	0	63	4	6	63	0.0952381
NODE_300924_length_216_cov_215.410256	0	63	8	3	63	0.0476190
NODE_300924_length_216_cov_215.410256	0	63	10	2	63	0.0317460
NODE_300924_length_216_cov_215.410256	0	63	14	32	63	0.5079365
NODE_300924_length_216_cov_215.410256	36	102	14	31	66	0.4696970
NODE_300924_length_216_cov_215.410256	36	102	16	9	66	0.1363636
NODE_300924_length_216_cov_215.410256	36	102	18	26	66	0.3939394
NODE_300925_length_216_cov_51.940171	164	216	0	52	52	1.0000000
NODE_300953_length_215_cov_14.784483	0	50	0	50	50	1.0000000
NODE_300953_length_215_cov_14.784483	23	103	0	80	80	1.0000000
NODE_300984_length_214_cov_144.165217	0	62	0	12	62	0.1935484
NODE_300984_length_214_cov_144.165217	0	62	4	50	62	0.8064516
NODE_300984_length_214_cov_144.165217	0	62	0	12	62	0.1935484
NODE_300984_length_214_cov_144.165217	0	62	4	50	62	0.8064516
NODE_300984_length_214_cov_144.165217	35	115	4	28	80	0.3500000
NODE_300984_length_214_cov_144.165217	35	115	8	17	80	0.2125000
NODE_300984_length_214_cov_144.165217	35	115	16	8	80	0.1000000
NODE_300984_length_214_cov_144.165217	35	115	18	10	80	0.1250000
NODE_300984_length_214_cov_144.165217	35	115	22	17	80	0.2125000
NODE_300984_length_214_cov_144.165217	35	115	4	28	80	0.3500000
NODE_300984_length_214_cov_144.165217	35	115	8	17	80	0.2125000
NODE_300984_length_214_cov_144.165217	35	115	16	8	80	0.1000000
NODE_300984_length_214_cov_144.165217	35	115	18	10	80	0.1250000
NODE_300984_length_214_cov_144.165217	35	115	22	17	80	0.2125000
NODE_300984_length_214_cov_144.165217	35	115	4	28	80	0.3500000
NODE_300984_length_214_cov_144.165217	35	115	8	17	80	0.2125000
NODE_300984_length_214_cov_144.165217	35	115	16	8	80	0.1000000
NODE_300984_length_214_cov_144.165217	35	115	18	10	80	0.1250000
NODE_300984_length_214_cov_144.165217	35	115	22	17	80	0.2125000
NODE_300984_length_214_cov_144.165217	111	191	2	12	80	0.1500000
NODE_300984_length_214_cov_144.165217	111	191	6	5	80	0.0625000
NODE_300984_length_214_cov_144.165217	111	191	10	9	80	0.1125000
NODE_300984_length_214_cov_144.165217	111	191	18	43	80	0.5375000
NODE_300984_length_214_cov_144.165217	111	191	22	11	80	0.1375000
NODE_300984_length_214_cov_144.165217	111	191	2	12	80	0.1500000
NODE_300984_length_214_cov_144.165217	111	191	6	5	80	0.0625000
NODE_300984_length_214_cov_144.165217	111	191	10	9	80	0.1125000
NODE_300984_length_214_cov_144.165217	111	191	18	43	80	0.5375000
NODE_300984_length_214_cov_144.165217	111	191	22	11	80	0.1375000
NODE_300984_length_214_cov_144.165217	111	191	2	12	80	0.1500000
NODE_300984_length_214_cov_144.165217	111	191	6	5	80	0.0625000
NODE_300984_length_214_cov_144.165217	111	191	10	9	80	0.1125000
NODE_300984_length_214_cov_144.165217	111	191	18	43	80	0.5375000
NODE_300984_length_214_cov_144.165217	111	191	22	11	80	0.1375000
NODE_300984_length_214_cov_144.165217	164	214	2	35	50	0.7000000
NODE_300984_length_214_cov_144.165217	164	214	6	5	50	0.1000000
NODE_300984_length_214_cov_144.165217	164	214	10	9	50	0.1800000
NODE_300984_length_214_cov_144.165217	164	214	18	1	50	0.0200000
NODE_300984_length_214_cov_144.165217	164	214	2	35	50	0.7000000
NODE_300984_length_214_cov_144.165217	164	214	6	5	50	0.1000000
NODE_300984_length_214_cov_144.165217	164	214	10	9	50	0.1800000
NODE_300984_length_214_cov_144.165217	164	214	18	1	50	0.0200000
NODE_300984_length_214_cov_144.165217	164	214	2	35	50	0.7000000
NODE_300984_length_214_cov_144.165217	164	214	6	5	50	0.1000000
NODE_300984_length_214_cov_144.165217	164	214	10	9	50	0.1800000
NODE_300984_length_214_cov_144.165217	164	214	18	1	50	0.0200000
NODE_301068_length_211_cov_39.571429	4	84	0	80	80	1.0000000
NODE_301169_length_208_cov_45.238532	3	59	0	56	56	1.0000000
NODE_301169_length_208_cov_45.238532	35	112	0	77	77	1.0000000
NODE_301170_length_208_cov_35.229358	76	156	0	80	80	1.0000000
NODE_301179_length_207_cov_341.324074	33	113	2	80	80	1.0000000
NODE_301179_length_207_cov_341.324074	86	166	0	25	80	0.3125000
NODE_301179_length_207_cov_341.324074	86	166	2	55	80	0.6875000
NODE_301248_length_205_cov_64.179245	6	77	2	63	71	0.8873239
NODE_301248_length_205_cov_64.179245	6	77	4	8	71	0.1126761
NODE_301248_length_205_cov_64.179245	11	77	2	58	66	0.8787879
NODE_301248_length_205_cov_64.179245	11	77	4	8	66	0.1212121
NODE_301248_length_205_cov_64.179245	50	98	2	19	48	0.3958333
NODE_301248_length_205_cov_64.179245	50	98	4	26	48	0.5416667
NODE_301248_length_205_cov_64.179245	50	98	6	3	48	0.0625000
NODE_301248_length_205_cov_64.179245	50	98	2	19	48	0.3958333
NODE_301248_length_205_cov_64.179245	50	98	4	26	48	0.5416667
NODE_301248_length_205_cov_64.179245	50	98	6	3	48	0.0625000
NODE_301248_length_205_cov_64.179245	50	98	2	19	48	0.3958333
NODE_301248_length_205_cov_64.179245	50	98	4	26	48	0.5416667
NODE_301248_length_205_cov_64.179245	50	98	6	3	48	0.0625000
NODE_301281_length_204_cov_183.390476	119	199	73	4	80	0.0500000
NODE_301281_length_204_cov_183.390476	119	199	77	1	80	0.0125000
NODE_301281_length_204_cov_183.390476	119	199	80	1	80	0.0125000
NODE_301281_length_204_cov_183.390476	119	199	94	1	80	0.0125000
NODE_301281_length_204_cov_183.390476	119	199	102	5	80	0.0625000
NODE_301281_length_204_cov_183.390476	119	199	116	1	80	0.0125000
NODE_301281_length_204_cov_183.390476	119	199	117	1	80	0.0125000
NODE_301281_length_204_cov_183.390476	119	199	134	1	80	0.0125000
NODE_301281_length_204_cov_183.390476	119	199	140	1	80	0.0125000
NODE_301281_length_204_cov_183.390476	119	199	143	1	80	0.0125000
NODE_301281_length_204_cov_183.390476	119	199	144	6	80	0.0750000
NODE_301281_length_204_cov_183.390476	119	199	148	1	80	0.0125000
NODE_301281_length_204_cov_183.390476	119	199	151	3	80	0.0375000
NODE_301281_length_204_cov_183.390476	119	199	154	1	80	0.0125000
NODE_301281_length_204_cov_183.390476	119	199	161	2	80	0.0250000
NODE_301281_length_204_cov_183.390476	119	199	163	4	80	0.0500000
NODE_301281_length_204_cov_183.390476	119	199	164	2	80	0.0250000
NODE_301281_length_204_cov_183.390476	119	199	169	3	80	0.0375000
NODE_301281_length_204_cov_183.390476	119	199	171	1	80	0.0125000
NODE_301281_length_204_cov_183.390476	119	199	178	1	80	0.0125000
NODE_301281_length_204_cov_183.390476	119	199	185	1	80	0.0125000
NODE_301281_length_204_cov_183.390476	119	199	186	1	80	0.0125000
NODE_301281_length_204_cov_183.390476	119	199	187	1	80	0.0125000
NODE_301281_length_204_cov_183.390476	119	199	189	1	80	0.0125000
NODE_301281_length_204_cov_183.390476	119	199	190	2	80	0.0250000
NODE_301281_length_204_cov_183.390476	119	199	192	3	80	0.0375000
NODE_301281_length_204_cov_183.390476	119	199	194	2	80	0.0250000
NODE_301281_length_204_cov_183.390476	119	199	195	2	80	0.0250000
NODE_301281_length_204_cov_183.390476	119	199	197	1	80	0.0125000
NODE_301281_length_204_cov_183.390476	119	199	201	3	80	0.0375000
NODE_301281_length_204_cov_183.390476	119	199	205	2	80	0.0250000
NODE_301281_length_204_cov_183.390476	119	199	207	1	80	0.0125000
NODE_301281_length_204_cov_183.390476	119	199	209	5	80	0.0625000
NODE_301281_length_204_cov_183.390476	119	199	212	2	80	0.0250000
NODE_301281_length_204_cov_183.390476	119	199	214	4	80	0.0500000
NODE_301281_length_204_cov_183.390476	119	199	216	7	80	0.0875000
NODE_301281_length_204_cov_183.390476	119	199	218	1	80	0.0125000
NODE_301281_length_204_cov_183.390476	172	194	80	1	22	0.0454545
NODE_301281_length_204_cov_183.390476	172	194	94	1	22	0.0454545
NODE_301281_length_204_cov_183.390476	172	194	102	5	22	0.2272727
NODE_301281_length_204_cov_183.390476	172	194	116	1	22	0.0454545
NODE_301281_length_204_cov_183.390476	172	194	117	1	22	0.0454545
NODE_301281_length_204_cov_183.390476	172	194	134	1	22	0.0454545
NODE_301281_length_204_cov_183.390476	172	194	140	1	22	0.0454545
NODE_301281_length_204_cov_183.390476	172	194	143	1	22	0.0454545
NODE_301281_length_204_cov_183.390476	172	194	144	6	22	0.2727273
NODE_301281_length_204_cov_183.390476	172	194	148	1	22	0.0454545
NODE_301281_length_204_cov_183.390476	172	194	151	3	22	0.1363636
NODE_301283_length_204_cov_80.095238	10	90	2	2	80	0.0250000
NODE_301283_length_204_cov_80.095238	10	90	3	78	80	0.9750000
NODE_301283_length_204_cov_80.095238	63	143	1	2	80	0.0250000
NODE_301283_length_204_cov_80.095238	63	143	2	7	80	0.0875000
NODE_301283_length_204_cov_80.095238	63	143	3	71	80	0.8875000
NODE_301345_length_202_cov_123.184466	0	64	24	1	64	0.0156250
NODE_301345_length_202_cov_123.184466	0	64	29	2	64	0.0312500
NODE_301345_length_202_cov_123.184466	0	64	34	2	64	0.0312500
NODE_301345_length_202_cov_123.184466	0	64	38	2	64	0.0312500
NODE_301345_length_202_cov_123.184466	0	64	42	1	64	0.0156250
NODE_301345_length_202_cov_123.184466	0	64	44	1	64	0.0156250
NODE_301345_length_202_cov_123.184466	0	64	45	1	64	0.0156250
NODE_301345_length_202_cov_123.184466	0	64	47	1	64	0.0156250
NODE_301345_length_202_cov_123.184466	0	64	52	1	64	0.0156250
NODE_301345_length_202_cov_123.184466	0	64	59	1	64	0.0156250
NODE_301345_length_202_cov_123.184466	0	64	62	1	64	0.0156250
NODE_301345_length_202_cov_123.184466	0	64	72	2	64	0.0312500
NODE_301345_length_202_cov_123.184466	0	64	74	1	64	0.0156250
NODE_301345_length_202_cov_123.184466	0	64	83	1	64	0.0156250
NODE_301345_length_202_cov_123.184466	0	64	100	1	64	0.0156250
NODE_301345_length_202_cov_123.184466	0	64	102	1	64	0.0156250
NODE_301345_length_202_cov_123.184466	0	64	106	1	64	0.0156250
NODE_301345_length_202_cov_123.184466	0	64	115	1	64	0.0156250
NODE_301345_length_202_cov_123.184466	0	64	117	1	64	0.0156250
NODE_301345_length_202_cov_123.184466	0	64	128	1	64	0.0156250
NODE_301345_length_202_cov_123.184466	0	64	135	1	64	0.0156250
NODE_301345_length_202_cov_123.184466	0	64	140	1	64	0.0156250
NODE_301345_length_202_cov_123.184466	0	64	145	2	64	0.0312500
NODE_301345_length_202_cov_123.184466	0	64	146	1	64	0.0156250
NODE_301345_length_202_cov_123.184466	0	64	151	1	64	0.0156250
NODE_301345_length_202_cov_123.184466	0	64	162	1	64	0.0156250
NODE_301345_length_202_cov_123.184466	0	64	164	1	64	0.0156250
NODE_301345_length_202_cov_123.184466	0	64	175	1	64	0.0156250
NODE_301345_length_202_cov_123.184466	0	64	179	1	64	0.0156250
NODE_301345_length_202_cov_123.184466	0	64	185	1	64	0.0156250
NODE_301345_length_202_cov_123.184466	0	64	189	1	64	0.0156250
NODE_301345_length_202_cov_123.184466	0	64	199	1	64	0.0156250
NODE_301345_length_202_cov_123.184466	0	64	205	1	64	0.0156250
NODE_301345_length_202_cov_123.184466	0	64	210	1	64	0.0156250
NODE_301345_length_202_cov_123.184466	0	64	215	1	64	0.0156250
NODE_301345_length_202_cov_123.184466	0	64	217	1	64	0.0156250
NODE_301345_length_202_cov_123.184466	0	64	223	1	64	0.0156250
NODE_301345_length_202_cov_123.184466	0	64	226	1	64	0.0156250
NODE_301345_length_202_cov_123.184466	0	64	232	1	64	0.0156250
NODE_301345_length_202_cov_123.184466	0	64	242	1	64	0.0156250
NODE_301345_length_202_cov_123.184466	0	64	243	1	64	0.0156250
NODE_301345_length_202_cov_123.184466	0	64	248	1	64	0.0156250
NODE_301345_length_202_cov_123.184466	0	64	258	1	64	0.0156250
NODE_301345_length_202_cov_123.184466	0	64	283	2	64	0.0312500
NODE_301345_length_202_cov_123.184466	0	64	286	1	64	0.0156250
NODE_301345_length_202_cov_123.184466	0	64	291	1	64	0.0156250
NODE_301345_length_202_cov_123.184466	0	64	314	1	64	0.0156250
NODE_301345_length_202_cov_123.184466	0	64	317	1	64	0.0156250
NODE_301345_length_202_cov_123.184466	0	64	334	1	64	0.0156250
NODE_301345_length_202_cov_123.184466	0	64	337	1	64	0.0156250
NODE_301345_length_202_cov_123.184466	0	64	342	1	64	0.0156250
NODE_301345_length_202_cov_123.184466	0	64	343	1	64	0.0156250
NODE_301345_length_202_cov_123.184466	0	64	346	1	64	0.0156250
NODE_301345_length_202_cov_123.184466	0	64	355	1	64	0.0156250
NODE_301345_length_202_cov_123.184466	0	64	357	1	64	0.0156250
NODE_301345_length_202_cov_123.184466	0	64	372	1	64	0.0156250
NODE_301345_length_202_cov_123.184466	0	64	374	1	64	0.0156250
NODE_301345_length_202_cov_123.184466	0	64	376	1	64	0.0156250
NODE_301345_length_202_cov_123.184466	31	72	164	1	41	0.0243902
NODE_301345_length_202_cov_123.184466	31	72	175	1	41	0.0243902
NODE_301345_length_202_cov_123.184466	31	72	179	1	41	0.0243902
NODE_301345_length_202_cov_123.184466	31	72	185	1	41	0.0243902
NODE_301345_length_202_cov_123.184466	31	72	189	1	41	0.0243902
NODE_301345_length_202_cov_123.184466	31	72	199	1	41	0.0243902
NODE_301345_length_202_cov_123.184466	31	72	205	1	41	0.0243902
NODE_301345_length_202_cov_123.184466	31	72	210	1	41	0.0243902
NODE_301345_length_202_cov_123.184466	31	72	215	1	41	0.0243902
NODE_301345_length_202_cov_123.184466	31	72	217	1	41	0.0243902
NODE_301345_length_202_cov_123.184466	31	72	223	1	41	0.0243902
NODE_301345_length_202_cov_123.184466	31	72	226	1	41	0.0243902
NODE_301345_length_202_cov_123.184466	31	72	232	1	41	0.0243902
NODE_301345_length_202_cov_123.184466	31	72	242	1	41	0.0243902
NODE_301345_length_202_cov_123.184466	31	72	243	1	41	0.0243902
NODE_301345_length_202_cov_123.184466	31	72	248	1	41	0.0243902
NODE_301345_length_202_cov_123.184466	31	72	258	1	41	0.0243902
NODE_301345_length_202_cov_123.184466	31	72	283	2	41	0.0487805
NODE_301345_length_202_cov_123.184466	31	72	286	1	41	0.0243902
NODE_301345_length_202_cov_123.184466	31	72	291	1	41	0.0243902
NODE_301345_length_202_cov_123.184466	31	72	314	1	41	0.0243902
NODE_301345_length_202_cov_123.184466	31	72	317	1	41	0.0243902
NODE_301345_length_202_cov_123.184466	31	72	334	1	41	0.0243902
NODE_301345_length_202_cov_123.184466	31	72	337	1	41	0.0243902
NODE_301345_length_202_cov_123.184466	31	72	342	1	41	0.0243902
NODE_301345_length_202_cov_123.184466	31	72	343	1	41	0.0243902
NODE_301345_length_202_cov_123.184466	31	72	346	1	41	0.0243902
NODE_301345_length_202_cov_123.184466	31	72	355	1	41	0.0243902
NODE_301345_length_202_cov_123.184466	31	72	357	1	41	0.0243902
NODE_301345_length_202_cov_123.184466	31	72	372	1	41	0.0243902
NODE_301345_length_202_cov_123.184466	31	72	374	1	41	0.0243902
NODE_301345_length_202_cov_123.184466	31	72	376	1	41	0.0243902
NODE_301345_length_202_cov_123.184466	31	72	383	1	41	0.0243902
NODE_301345_length_202_cov_123.184466	31	72	394	1	41	0.0243902
NODE_301345_length_202_cov_123.184466	31	72	413	1	41	0.0243902
NODE_301345_length_202_cov_123.184466	31	72	422	1	41	0.0243902
NODE_301345_length_202_cov_123.184466	31	72	428	1	41	0.0243902
NODE_301345_length_202_cov_123.184466	31	72	432	1	41	0.0243902
NODE_301345_length_202_cov_123.184466	31	72	434	1	41	0.0243902
NODE_301345_length_202_cov_123.184466	31	72	446	1	41	0.0243902
NODE_301370_length_201_cov_56.323529	133	201	0	23	68	0.3382353
NODE_301370_length_201_cov_56.323529	133	201	2	45	68	0.6617647
NODE_301371_length_201_cov_50.647059	44	99	50	1	55	0.0181818
NODE_301371_length_201_cov_50.647059	44	99	54	1	55	0.0181818
NODE_301371_length_201_cov_50.647059	44	99	58	4	55	0.0727273
NODE_301371_length_201_cov_50.647059	44	99	62	1	55	0.0181818
NODE_301371_length_201_cov_50.647059	44	99	64	3	55	0.0545455
NODE_301371_length_201_cov_50.647059	44	99	65	2	55	0.0363636
NODE_301371_length_201_cov_50.647059	44	99	66	3	55	0.0545455
NODE_301371_length_201_cov_50.647059	44	99	70	1	55	0.0181818
NODE_301371_length_201_cov_50.647059	44	99	72	8	55	0.1454545
NODE_301371_length_201_cov_50.647059	44	99	80	2	55	0.0363636
NODE_301371_length_201_cov_50.647059	44	99	82	2	55	0.0363636
NODE_301371_length_201_cov_50.647059	44	99	84	3	55	0.0545455
NODE_301371_length_201_cov_50.647059	44	99	88	11	55	0.2000000
NODE_301371_length_201_cov_50.647059	44	99	92	10	55	0.1818182
NODE_301371_length_201_cov_50.647059	44	99	94	3	55	0.0545455
NODE_301371_length_201_cov_50.647059	136	201	4	6	65	0.0923077
NODE_301371_length_201_cov_50.647059	136	201	6	1	65	0.0153846
NODE_301371_length_201_cov_50.647059	136	201	19	1	65	0.0153846
NODE_301371_length_201_cov_50.647059	136	201	21	9	65	0.1384615
NODE_301371_length_201_cov_50.647059	136	201	25	2	65	0.0307692
NODE_301371_length_201_cov_50.647059	136	201	29	1	65	0.0153846
NODE_301371_length_201_cov_50.647059	136	201	31	3	65	0.0461538
NODE_301371_length_201_cov_50.647059	136	201	35	7	65	0.1076923
NODE_301371_length_201_cov_50.647059	136	201	37	11	65	0.1692308
NODE_301371_length_201_cov_50.647059	136	201	41	7	65	0.1076923
NODE_301371_length_201_cov_50.647059	136	201	43	1	65	0.0153846
NODE_301371_length_201_cov_50.647059	136	201	47	3	65	0.0461538
NODE_301371_length_201_cov_50.647059	136	201	49	6	65	0.0923077
NODE_301371_length_201_cov_50.647059	136	201	51	1	65	0.0153846
NODE_301371_length_201_cov_50.647059	136	201	53	6	65	0.0923077
NODE_301371_length_201_cov_50.647059	136	201	4	6	65	0.0923077
NODE_301371_length_201_cov_50.647059	136	201	6	1	65	0.0153846
NODE_301371_length_201_cov_50.647059	136	201	19	1	65	0.0153846
NODE_301371_length_201_cov_50.647059	136	201	21	9	65	0.1384615
NODE_301371_length_201_cov_50.647059	136	201	25	2	65	0.0307692
NODE_301371_length_201_cov_50.647059	136	201	29	1	65	0.0153846
NODE_301371_length_201_cov_50.647059	136	201	31	3	65	0.0461538
NODE_301371_length_201_cov_50.647059	136	201	35	7	65	0.1076923
NODE_301371_length_201_cov_50.647059	136	201	37	11	65	0.1692308
NODE_301371_length_201_cov_50.647059	136	201	41	7	65	0.1076923
NODE_301371_length_201_cov_50.647059	136	201	43	1	65	0.0153846
NODE_301371_length_201_cov_50.647059	136	201	47	3	65	0.0461538
NODE_301371_length_201_cov_50.647059	136	201	49	6	65	0.0923077
NODE_301371_length_201_cov_50.647059	136	201	51	1	65	0.0153846
NODE_301371_length_201_cov_50.647059	136	201	53	6	65	0.0923077
NODE_301371_length_201_cov_50.647059	136	201	4	6	65	0.0923077
NODE_301371_length_201_cov_50.647059	136	201	6	1	65	0.0153846
NODE_301371_length_201_cov_50.647059	136	201	19	1	65	0.0153846
NODE_301371_length_201_cov_50.647059	136	201	21	9	65	0.1384615
NODE_301371_length_201_cov_50.647059	136	201	25	2	65	0.0307692
NODE_301371_length_201_cov_50.647059	136	201	29	1	65	0.0153846
NODE_301371_length_201_cov_50.647059	136	201	31	3	65	0.0461538
NODE_301371_length_201_cov_50.647059	136	201	35	7	65	0.1076923
NODE_301371_length_201_cov_50.647059	136	201	37	11	65	0.1692308
NODE_301371_length_201_cov_50.647059	136	201	41	7	65	0.1076923
NODE_301371_length_201_cov_50.647059	136	201	43	1	65	0.0153846
NODE_301371_length_201_cov_50.647059	136	201	47	3	65	0.0461538
NODE_301371_length_201_cov_50.647059	136	201	49	6	65	0.0923077
NODE_301371_length_201_cov_50.647059	136	201	51	1	65	0.0153846
NODE_301371_length_201_cov_50.647059	136	201	53	6	65	0.0923077
NODE_301371_length_201_cov_50.647059	136	201	4	6	65	0.0923077
NODE_301371_length_201_cov_50.647059	136	201	6	1	65	0.0153846
NODE_301371_length_201_cov_50.647059	136	201	19	1	65	0.0153846
NODE_301371_length_201_cov_50.647059	136	201	21	9	65	0.1384615
NODE_301371_length_201_cov_50.647059	136	201	25	2	65	0.0307692
NODE_301371_length_201_cov_50.647059	136	201	29	1	65	0.0153846
NODE_301371_length_201_cov_50.647059	136	201	31	3	65	0.0461538
NODE_301371_length_201_cov_50.647059	136	201	35	7	65	0.1076923
NODE_301371_length_201_cov_50.647059	136	201	37	11	65	0.1692308
NODE_301371_length_201_cov_50.647059	136	201	41	7	65	0.1076923
NODE_301371_length_201_cov_50.647059	136	201	43	1	65	0.0153846
NODE_301371_length_201_cov_50.647059	136	201	47	3	65	0.0461538
NODE_301371_length_201_cov_50.647059	136	201	49	6	65	0.0923077
NODE_301371_length_201_cov_50.647059	136	201	51	1	65	0.0153846
NODE_301371_length_201_cov_50.647059	136	201	53	6	65	0.0923077
NODE_301405_length_200_cov_29.118812	0	73	21	2	73	0.0273973
NODE_301405_length_200_cov_29.118812	0	73	22	1	73	0.0136986
NODE_301405_length_200_cov_29.118812	0	73	26	2	73	0.0273973
NODE_301405_length_200_cov_29.118812	0	73	30	3	73	0.0410959
NODE_301405_length_200_cov_29.118812	0	73	35	4	73	0.0547945
NODE_301405_length_200_cov_29.118812	0	73	36	2	73	0.0273973
NODE_301405_length_200_cov_29.118812	0	73	37	1	73	0.0136986
NODE_301405_length_200_cov_29.118812	0	73	39	1	73	0.0136986
NODE_301405_length_200_cov_29.118812	0	73	41	2	73	0.0273973
NODE_301405_length_200_cov_29.118812	0	73	45	2	73	0.0273973
NODE_301405_length_200_cov_29.118812	0	73	47	7	73	0.0958904
NODE_301405_length_200_cov_29.118812	0	73	49	6	73	0.0821918
NODE_301405_length_200_cov_29.118812	0	73	51	4	73	0.0547945
NODE_301405_length_200_cov_29.118812	0	73	53	10	73	0.1369863
NODE_301405_length_200_cov_29.118812	0	73	55	26	73	0.3561644
NODE_301419_length_199_cov_768.700000	94	142	483	8	48	0.1666667
NODE_301419_length_199_cov_768.700000	94	142	485	1	48	0.0208333
NODE_301419_length_199_cov_768.700000	94	142	487	1	48	0.0208333
NODE_301419_length_199_cov_768.700000	94	142	495	4	48	0.0833333
NODE_301419_length_199_cov_768.700000	94	142	497	3	48	0.0625000
NODE_301419_length_199_cov_768.700000	94	142	499	2	48	0.0416667
NODE_301419_length_199_cov_768.700000	94	142	501	4	48	0.0833333
NODE_301419_length_199_cov_768.700000	94	142	505	4	48	0.0833333
NODE_301419_length_199_cov_768.700000	94	142	509	5	48	0.1041667
NODE_301419_length_199_cov_768.700000	94	142	510	4	48	0.0833333
NODE_301419_length_199_cov_768.700000	94	142	511	1	48	0.0208333
NODE_301419_length_199_cov_768.700000	94	142	512	2	48	0.0416667
NODE_301419_length_199_cov_768.700000	94	142	514	2	48	0.0416667
NODE_301419_length_199_cov_768.700000	94	142	515	1	48	0.0208333
NODE_301419_length_199_cov_768.700000	94	142	516	6	48	0.1250000
NODE_301419_length_199_cov_768.700000	115	186	123	1	71	0.0140845
NODE_301419_length_199_cov_768.700000	115	186	127	1	71	0.0140845
NODE_301419_length_199_cov_768.700000	115	186	145	1	71	0.0140845
NODE_301419_length_199_cov_768.700000	115	186	149	1	71	0.0140845
NODE_301419_length_199_cov_768.700000	115	186	151	1	71	0.0140845
NODE_301419_length_199_cov_768.700000	115	186	164	1	71	0.0140845
NODE_301419_length_199_cov_768.700000	115	186	170	1	71	0.0140845
NODE_301419_length_199_cov_768.700000	115	186	177	1	71	0.0140845
NODE_301419_length_199_cov_768.700000	115	186	190	1	71	0.0140845
NODE_301419_length_199_cov_768.700000	115	186	210	1	71	0.0140845
NODE_301419_length_199_cov_768.700000	115	186	215	1	71	0.0140845
NODE_301419_length_199_cov_768.700000	115	186	231	1	71	0.0140845
NODE_301419_length_199_cov_768.700000	115	186	250	2	71	0.0281690
NODE_301419_length_199_cov_768.700000	115	186	263	1	71	0.0140845
NODE_301419_length_199_cov_768.700000	115	186	267	2	71	0.0281690
NODE_301419_length_199_cov_768.700000	115	186	282	1	71	0.0140845
NODE_301419_length_199_cov_768.700000	115	186	283	1	71	0.0140845
NODE_301419_length_199_cov_768.700000	115	186	288	1	71	0.0140845
NODE_301419_length_199_cov_768.700000	115	186	290	1	71	0.0140845
NODE_301419_length_199_cov_768.700000	115	186	301	1	71	0.0140845
NODE_301419_length_199_cov_768.700000	115	186	313	1	71	0.0140845
NODE_301419_length_199_cov_768.700000	115	186	335	1	71	0.0140845
NODE_301419_length_199_cov_768.700000	115	186	346	1	71	0.0140845
NODE_301419_length_199_cov_768.700000	115	186	353	1	71	0.0140845
NODE_301419_length_199_cov_768.700000	115	186	355	1	71	0.0140845
NODE_301419_length_199_cov_768.700000	115	186	361	1	71	0.0140845
NODE_301419_length_199_cov_768.700000	115	186	367	1	71	0.0140845
NODE_301419_length_199_cov_768.700000	115	186	379	1	71	0.0140845
NODE_301419_length_199_cov_768.700000	115	186	389	1	71	0.0140845
NODE_301419_length_199_cov_768.700000	115	186	405	1	71	0.0140845
NODE_301419_length_199_cov_768.700000	115	186	417	2	71	0.0281690
NODE_301419_length_199_cov_768.700000	115	186	421	1	71	0.0140845
NODE_301419_length_199_cov_768.700000	115	186	432	1	71	0.0140845
NODE_301419_length_199_cov_768.700000	115	186	440	1	71	0.0140845
NODE_301419_length_199_cov_768.700000	115	186	447	1	71	0.0140845
NODE_301419_length_199_cov_768.700000	115	186	453	1	71	0.0140845
NODE_301419_length_199_cov_768.700000	115	186	465	1	71	0.0140845
NODE_301419_length_199_cov_768.700000	115	186	469	1	71	0.0140845
NODE_301419_length_199_cov_768.700000	115	186	471	1	71	0.0140845
NODE_301419_length_199_cov_768.700000	115	186	475	1	71	0.0140845
NODE_301419_length_199_cov_768.700000	115	186	481	1	71	0.0140845
NODE_301419_length_199_cov_768.700000	115	186	483	8	71	0.1126761
NODE_301419_length_199_cov_768.700000	115	186	485	1	71	0.0140845
NODE_301419_length_199_cov_768.700000	115	186	487	1	71	0.0140845
NODE_301419_length_199_cov_768.700000	115	186	495	4	71	0.0563380
NODE_301419_length_199_cov_768.700000	115	186	497	3	71	0.0422535
NODE_301419_length_199_cov_768.700000	115	186	499	1	71	0.0140845
NODE_301419_length_199_cov_768.700000	115	186	501	4	71	0.0563380
NODE_301419_length_199_cov_768.700000	115	186	505	4	71	0.0563380
NODE_301419_length_199_cov_768.700000	115	186	509	1	71	0.0140845
NODE_301420_length_199_cov_702.860000	3	78	63	1	75	0.0133333
NODE_301420_length_199_cov_702.860000	3	78	81	1	75	0.0133333
NODE_301420_length_199_cov_702.860000	3	78	85	2	75	0.0266667
NODE_301420_length_199_cov_702.860000	3	78	87	3	75	0.0400000
NODE_301420_length_199_cov_702.860000	3	78	91	1	75	0.0133333
NODE_301420_length_199_cov_702.860000	3	78	93	2	75	0.0266667
NODE_301420_length_199_cov_702.860000	3	78	97	1	75	0.0133333
NODE_301420_length_199_cov_702.860000	3	78	98	1	75	0.0133333
NODE_301420_length_199_cov_702.860000	3	78	112	1	75	0.0133333
NODE_301420_length_199_cov_702.860000	3	78	114	1	75	0.0133333
NODE_301420_length_199_cov_702.860000	3	78	122	1	75	0.0133333
NODE_301420_length_199_cov_702.860000	3	78	124	1	75	0.0133333
NODE_301420_length_199_cov_702.860000	3	78	126	1	75	0.0133333
NODE_301420_length_199_cov_702.860000	3	78	128	1	75	0.0133333
NODE_301420_length_199_cov_702.860000	3	78	148	1	75	0.0133333
NODE_301420_length_199_cov_702.860000	3	78	158	2	75	0.0266667
NODE_301420_length_199_cov_702.860000	3	78	160	1	75	0.0133333
NODE_301420_length_199_cov_702.860000	3	78	164	1	75	0.0133333
NODE_301420_length_199_cov_702.860000	3	78	175	1	75	0.0133333
NODE_301420_length_199_cov_702.860000	3	78	214	1	75	0.0133333
NODE_301420_length_199_cov_702.860000	3	78	226	1	75	0.0133333
NODE_301420_length_199_cov_702.860000	3	78	227	1	75	0.0133333
NODE_301420_length_199_cov_702.860000	3	78	247	1	75	0.0133333
NODE_301420_length_199_cov_702.860000	3	78	263	1	75	0.0133333
NODE_301420_length_199_cov_702.860000	3	78	269	1	75	0.0133333
NODE_301420_length_199_cov_702.860000	3	78	285	1	75	0.0133333
NODE_301420_length_199_cov_702.860000	3	78	289	1	75	0.0133333
NODE_301420_length_199_cov_702.860000	3	78	293	1	75	0.0133333
NODE_301420_length_199_cov_702.860000	3	78	299	1	75	0.0133333
NODE_301420_length_199_cov_702.860000	3	78	308	1	75	0.0133333
NODE_301420_length_199_cov_702.860000	3	78	321	1	75	0.0133333
NODE_301420_length_199_cov_702.860000	3	78	323	1	75	0.0133333
NODE_301420_length_199_cov_702.860000	3	78	327	1	75	0.0133333
NODE_301420_length_199_cov_702.860000	3	78	329	1	75	0.0133333
NODE_301420_length_199_cov_702.860000	3	78	333	1	75	0.0133333
NODE_301420_length_199_cov_702.860000	3	78	337	1	75	0.0133333
NODE_301420_length_199_cov_702.860000	3	78	339	1	75	0.0133333
NODE_301420_length_199_cov_702.860000	3	78	341	1	75	0.0133333
NODE_301420_length_199_cov_702.860000	3	78	343	1	75	0.0133333
NODE_301420_length_199_cov_702.860000	3	78	353	2	75	0.0266667
NODE_301420_length_199_cov_702.860000	3	78	389	3	75	0.0400000
NODE_301420_length_199_cov_702.860000	3	78	415	1	75	0.0133333
NODE_301420_length_199_cov_702.860000	3	78	419	1	75	0.0133333
NODE_301420_length_199_cov_702.860000	3	78	428	1	75	0.0133333
NODE_301420_length_199_cov_702.860000	3	78	438	4	75	0.0533333
NODE_301420_length_199_cov_702.860000	3	78	448	2	75	0.0266667
NODE_301420_length_199_cov_702.860000	3	78	461	1	75	0.0133333
NODE_301420_length_199_cov_702.860000	3	78	479	1	75	0.0133333
NODE_301420_length_199_cov_702.860000	3	78	483	3	75	0.0400000
NODE_301420_length_199_cov_702.860000	3	78	487	1	75	0.0133333
NODE_301420_length_199_cov_702.860000	3	78	497	1	75	0.0133333
NODE_301420_length_199_cov_702.860000	3	78	499	1	75	0.0133333
NODE_301420_length_199_cov_702.860000	3	78	510	2	75	0.0266667
NODE_301420_length_199_cov_702.860000	3	78	512	1	75	0.0133333
NODE_301420_length_199_cov_702.860000	3	78	514	1	75	0.0133333
NODE_301420_length_199_cov_702.860000	3	78	516	3	75	0.0400000
NODE_301420_length_199_cov_702.860000	3	78	520	1	75	0.0133333
NODE_301420_length_199_cov_702.860000	3	78	521	1	75	0.0133333
NODE_301420_length_199_cov_702.860000	51	131	355	1	80	0.0125000
NODE_301420_length_199_cov_702.860000	51	131	359	1	80	0.0125000
NODE_301420_length_199_cov_702.860000	51	131	374	2	80	0.0250000
NODE_301420_length_199_cov_702.860000	51	131	377	1	80	0.0125000
NODE_301420_length_199_cov_702.860000	51	131	384	1	80	0.0125000
NODE_301420_length_199_cov_702.860000	51	131	386	1	80	0.0125000
NODE_301420_length_199_cov_702.860000	51	131	389	1	80	0.0125000
NODE_301420_length_199_cov_702.860000	51	131	408	1	80	0.0125000
NODE_301420_length_199_cov_702.860000	51	131	415	1	80	0.0125000
NODE_301420_length_199_cov_702.860000	51	131	416	1	80	0.0125000
NODE_301420_length_199_cov_702.860000	51	131	419	1	80	0.0125000
NODE_301420_length_199_cov_702.860000	51	131	428	1	80	0.0125000
NODE_301420_length_199_cov_702.860000	51	131	429	1	80	0.0125000
NODE_301420_length_199_cov_702.860000	51	131	438	4	80	0.0500000
NODE_301420_length_199_cov_702.860000	51	131	441	1	80	0.0125000
NODE_301420_length_199_cov_702.860000	51	131	448	3	80	0.0375000
NODE_301420_length_199_cov_702.860000	51	131	461	1	80	0.0125000
NODE_301420_length_199_cov_702.860000	51	131	474	1	80	0.0125000
NODE_301420_length_199_cov_702.860000	51	131	475	1	80	0.0125000
NODE_301420_length_199_cov_702.860000	51	131	477	1	80	0.0125000
NODE_301420_length_199_cov_702.860000	51	131	479	1	80	0.0125000
NODE_301420_length_199_cov_702.860000	51	131	483	3	80	0.0375000
NODE_301420_length_199_cov_702.860000	51	131	487	1	80	0.0125000
NODE_301420_length_199_cov_702.860000	51	131	495	1	80	0.0125000
NODE_301420_length_199_cov_702.860000	51	131	497	1	80	0.0125000
NODE_301420_length_199_cov_702.860000	51	131	499	1	80	0.0125000
NODE_301420_length_199_cov_702.860000	51	131	509	1	80	0.0125000
NODE_301420_length_199_cov_702.860000	51	131	510	2	80	0.0250000
NODE_301420_length_199_cov_702.860000	51	131	512	1	80	0.0125000
NODE_301420_length_199_cov_702.860000	51	131	514	1	80	0.0125000
NODE_301420_length_199_cov_702.860000	51	131	516	3	80	0.0375000
NODE_301420_length_199_cov_702.860000	51	131	519	1	80	0.0125000
NODE_301420_length_199_cov_702.860000	51	131	520	1	80	0.0125000
NODE_301420_length_199_cov_702.860000	51	131	521	2	80	0.0250000
NODE_301420_length_199_cov_702.860000	51	131	527	1	80	0.0125000
NODE_301420_length_199_cov_702.860000	51	131	529	2	80	0.0250000
NODE_301420_length_199_cov_702.860000	51	131	533	1	80	0.0125000
NODE_301420_length_199_cov_702.860000	51	131	535	3	80	0.0375000
NODE_301420_length_199_cov_702.860000	51	131	537	1	80	0.0125000
NODE_301420_length_199_cov_702.860000	51	131	539	1	80	0.0125000
NODE_301420_length_199_cov_702.860000	51	131	541	1	80	0.0125000
NODE_301420_length_199_cov_702.860000	51	131	549	2	80	0.0250000
NODE_301420_length_199_cov_702.860000	51	131	553	3	80	0.0375000
NODE_301420_length_199_cov_702.860000	51	131	557	4	80	0.0500000
NODE_301420_length_199_cov_702.860000	51	131	559	1	80	0.0125000
NODE_301420_length_199_cov_702.860000	51	131	561	2	80	0.0250000
NODE_301420_length_199_cov_702.860000	51	131	563	12	80	0.1500000
NODE_301421_length_199_cov_670.570000	22	52	976	1	30	0.0333333
NODE_301421_length_199_cov_670.570000	22	52	1008	1	30	0.0333333
NODE_301421_length_199_cov_670.570000	22	52	1054	1	30	0.0333333
NODE_301421_length_199_cov_670.570000	22	52	1103	1	30	0.0333333
NODE_301421_length_199_cov_670.570000	22	52	1164	1	30	0.0333333
NODE_301421_length_199_cov_670.570000	22	52	1186	1	30	0.0333333
NODE_301421_length_199_cov_670.570000	22	52	1228	1	30	0.0333333
NODE_301421_length_199_cov_670.570000	22	52	1236	1	30	0.0333333
NODE_301421_length_199_cov_670.570000	22	52	1251	1	30	0.0333333
NODE_301421_length_199_cov_670.570000	22	52	1262	1	30	0.0333333
NODE_301421_length_199_cov_670.570000	22	52	1264	1	30	0.0333333
NODE_301421_length_199_cov_670.570000	22	52	1286	1	30	0.0333333
NODE_301421_length_199_cov_670.570000	22	52	1321	1	30	0.0333333
NODE_301421_length_199_cov_670.570000	22	52	1379	1	30	0.0333333
NODE_301421_length_199_cov_670.570000	22	52	1423	1	30	0.0333333
NODE_301421_length_199_cov_670.570000	22	52	1433	1	30	0.0333333
NODE_301421_length_199_cov_670.570000	22	52	1466	1	30	0.0333333
NODE_301421_length_199_cov_670.570000	22	52	1489	1	30	0.0333333
NODE_301421_length_199_cov_670.570000	22	52	1519	1	30	0.0333333
NODE_301421_length_199_cov_670.570000	22	52	1550	1	30	0.0333333
NODE_301421_length_199_cov_670.570000	22	52	1572	1	30	0.0333333
NODE_301421_length_199_cov_670.570000	22	52	1576	2	30	0.0666667
NODE_301421_length_199_cov_670.570000	22	52	1589	1	30	0.0333333
NODE_301421_length_199_cov_670.570000	22	52	1596	1	30	0.0333333
NODE_301421_length_199_cov_670.570000	22	52	1620	1	30	0.0333333
NODE_301421_length_199_cov_670.570000	22	52	1623	1	30	0.0333333
NODE_301421_length_199_cov_670.570000	22	52	1664	1	30	0.0333333
NODE_301421_length_199_cov_670.570000	22	52	1686	1	30	0.0333333
NODE_301421_length_199_cov_670.570000	22	52	1688	1	30	0.0333333
NODE_301421_length_199_cov_670.570000	25	105	1103	1	80	0.0125000
NODE_301421_length_199_cov_670.570000	25	105	1164	1	80	0.0125000
NODE_301421_length_199_cov_670.570000	25	105	1186	1	80	0.0125000
NODE_301421_length_199_cov_670.570000	25	105	1228	1	80	0.0125000
NODE_301421_length_199_cov_670.570000	25	105	1236	1	80	0.0125000
NODE_301421_length_199_cov_670.570000	25	105	1251	1	80	0.0125000
NODE_301421_length_199_cov_670.570000	25	105	1262	1	80	0.0125000
NODE_301421_length_199_cov_670.570000	25	105	1264	1	80	0.0125000
NODE_301421_length_199_cov_670.570000	25	105	1286	1	80	0.0125000
NODE_301421_length_199_cov_670.570000	25	105	1321	1	80	0.0125000
NODE_301421_length_199_cov_670.570000	25	105	1379	1	80	0.0125000
NODE_301421_length_199_cov_670.570000	25	105	1423	1	80	0.0125000
NODE_301421_length_199_cov_670.570000	25	105	1433	1	80	0.0125000
NODE_301421_length_199_cov_670.570000	25	105	1466	1	80	0.0125000
NODE_301421_length_199_cov_670.570000	25	105	1489	1	80	0.0125000
NODE_301421_length_199_cov_670.570000	25	105	1519	1	80	0.0125000
NODE_301421_length_199_cov_670.570000	25	105	1550	1	80	0.0125000
NODE_301421_length_199_cov_670.570000	25	105	1572	1	80	0.0125000
NODE_301421_length_199_cov_670.570000	25	105	1576	2	80	0.0250000
NODE_301421_length_199_cov_670.570000	25	105	1589	1	80	0.0125000
NODE_301421_length_199_cov_670.570000	25	105	1596	1	80	0.0125000
NODE_301421_length_199_cov_670.570000	25	105	1620	1	80	0.0125000
NODE_301421_length_199_cov_670.570000	25	105	1623	1	80	0.0125000
NODE_301421_length_199_cov_670.570000	25	105	1664	1	80	0.0125000
NODE_301421_length_199_cov_670.570000	25	105	1686	1	80	0.0125000
NODE_301421_length_199_cov_670.570000	25	105	1688	1	80	0.0125000
NODE_301421_length_199_cov_670.570000	25	105	1709	1	80	0.0125000
NODE_301421_length_199_cov_670.570000	25	105	1723	1	80	0.0125000
NODE_301421_length_199_cov_670.570000	25	105	1753	1	80	0.0125000
NODE_301421_length_199_cov_670.570000	25	105	1783	1	80	0.0125000
NODE_301421_length_199_cov_670.570000	25	105	1793	1	80	0.0125000
NODE_301421_length_199_cov_670.570000	25	105	1800	1	80	0.0125000
NODE_301421_length_199_cov_670.570000	25	105	1815	1	80	0.0125000
NODE_301421_length_199_cov_670.570000	25	105	1821	1	80	0.0125000
NODE_301421_length_199_cov_670.570000	25	105	1831	1	80	0.0125000
NODE_301421_length_199_cov_670.570000	25	105	1835	1	80	0.0125000
NODE_301421_length_199_cov_670.570000	25	105	1857	1	80	0.0125000
NODE_301421_length_199_cov_670.570000	25	105	1863	1	80	0.0125000
NODE_301421_length_199_cov_670.570000	25	105	1867	1	80	0.0125000
NODE_301421_length_199_cov_670.570000	25	105	1873	1	80	0.0125000
NODE_301421_length_199_cov_670.570000	25	105	1879	1	80	0.0125000
NODE_301421_length_199_cov_670.570000	25	105	1880	1	80	0.0125000
NODE_301421_length_199_cov_670.570000	25	105	1889	1	80	0.0125000
NODE_301421_length_199_cov_670.570000	25	105	1895	1	80	0.0125000
NODE_301421_length_199_cov_670.570000	25	105	1908	1	80	0.0125000
NODE_301421_length_199_cov_670.570000	25	105	1916	1	80	0.0125000
NODE_301421_length_199_cov_670.570000	25	105	1922	1	80	0.0125000
NODE_301421_length_199_cov_670.570000	25	105	1928	1	80	0.0125000
NODE_301421_length_199_cov_670.570000	25	105	1940	1	80	0.0125000
NODE_301421_length_199_cov_670.570000	25	105	1948	1	80	0.0125000
NODE_301421_length_199_cov_670.570000	25	105	1958	1	80	0.0125000
NODE_301421_length_199_cov_670.570000	25	105	1960	1	80	0.0125000
NODE_301421_length_199_cov_670.570000	25	105	1966	2	80	0.0250000
NODE_301421_length_199_cov_670.570000	25	105	1977	1	80	0.0125000
NODE_301421_length_199_cov_670.570000	25	105	1984	1	80	0.0125000
NODE_301421_length_199_cov_670.570000	25	105	1991	1	80	0.0125000
NODE_301421_length_199_cov_670.570000	25	105	1992	1	80	0.0125000
NODE_301421_length_199_cov_670.570000	25	105	1996	1	80	0.0125000
NODE_301421_length_199_cov_670.570000	25	105	2005	1	80	0.0125000
NODE_301421_length_199_cov_670.570000	25	105	2009	1	80	0.0125000
NODE_301421_length_199_cov_670.570000	25	105	2011	1	80	0.0125000
NODE_301421_length_199_cov_670.570000	25	105	2017	1	80	0.0125000
NODE_301421_length_199_cov_670.570000	25	105	2033	1	80	0.0125000
NODE_301421_length_199_cov_670.570000	25	105	2041	1	80	0.0125000
NODE_301421_length_199_cov_670.570000	25	105	2043	2	80	0.0250000
NODE_301421_length_199_cov_670.570000	25	105	2045	3	80	0.0375000
NODE_301421_length_199_cov_670.570000	25	105	2047	2	80	0.0250000
NODE_301421_length_199_cov_670.570000	25	105	2050	2	80	0.0250000
NODE_301421_length_199_cov_670.570000	25	105	2052	5	80	0.0625000
NODE_301430_length_199_cov_215.860000	3	75	8	6	72	0.0833333
NODE_301430_length_199_cov_215.860000	3	75	10	2	72	0.0277778
NODE_301430_length_199_cov_215.860000	3	75	11	1	72	0.0138889
NODE_301430_length_199_cov_215.860000	3	75	15	1	72	0.0138889
NODE_301430_length_199_cov_215.860000	3	75	17	4	72	0.0555556
NODE_301430_length_199_cov_215.860000	3	75	18	1	72	0.0138889
NODE_301430_length_199_cov_215.860000	3	75	19	3	72	0.0416667
NODE_301430_length_199_cov_215.860000	3	75	22	1	72	0.0138889
NODE_301430_length_199_cov_215.860000	3	75	32	2	72	0.0277778
NODE_301430_length_199_cov_215.860000	3	75	36	3	72	0.0416667
NODE_301430_length_199_cov_215.860000	3	75	39	1	72	0.0138889
NODE_301430_length_199_cov_215.860000	3	75	40	2	72	0.0277778
NODE_301430_length_199_cov_215.860000	3	75	42	1	72	0.0138889
NODE_301430_length_199_cov_215.860000	3	75	44	3	72	0.0416667
NODE_301430_length_199_cov_215.860000	3	75	48	1	72	0.0138889
NODE_301430_length_199_cov_215.860000	3	75	50	2	72	0.0277778
NODE_301430_length_199_cov_215.860000	3	75	52	1	72	0.0138889
NODE_301430_length_199_cov_215.860000	3	75	54	1	72	0.0138889
NODE_301430_length_199_cov_215.860000	3	75	68	2	72	0.0277778
NODE_301430_length_199_cov_215.860000	3	75	70	2	72	0.0277778
NODE_301430_length_199_cov_215.860000	3	75	74	1	72	0.0138889
NODE_301430_length_199_cov_215.860000	3	75	80	1	72	0.0138889
NODE_301430_length_199_cov_215.860000	3	75	82	1	72	0.0138889
NODE_301430_length_199_cov_215.860000	3	75	86	2	72	0.0277778
NODE_301430_length_199_cov_215.860000	3	75	92	2	72	0.0277778
NODE_301430_length_199_cov_215.860000	3	75	94	2	72	0.0277778
NODE_301430_length_199_cov_215.860000	3	75	98	4	72	0.0555556
NODE_301430_length_199_cov_215.860000	3	75	100	1	72	0.0138889
NODE_301430_length_199_cov_215.860000	3	75	102	2	72	0.0277778
NODE_301430_length_199_cov_215.860000	3	75	104	1	72	0.0138889
NODE_301430_length_199_cov_215.860000	3	75	106	3	72	0.0416667
NODE_301430_length_199_cov_215.860000	3	75	110	1	72	0.0138889
NODE_301430_length_199_cov_215.860000	3	75	112	1	72	0.0138889
NODE_301430_length_199_cov_215.860000	3	75	114	1	72	0.0138889
NODE_301430_length_199_cov_215.860000	3	75	116	1	72	0.0138889
NODE_301430_length_199_cov_215.860000	3	75	118	5	72	0.0694444
NODE_301430_length_199_cov_215.860000	3	75	120	3	72	0.0416667
NODE_301430_length_199_cov_215.860000	48	128	86	1	80	0.0125000
NODE_301430_length_199_cov_215.860000	48	128	88	4	80	0.0500000
NODE_301430_length_199_cov_215.860000	48	128	92	2	80	0.0250000
NODE_301430_length_199_cov_215.860000	48	128	94	2	80	0.0250000
NODE_301430_length_199_cov_215.860000	48	128	96	1	80	0.0125000
NODE_301430_length_199_cov_215.860000	48	128	98	7	80	0.0875000
NODE_301430_length_199_cov_215.860000	48	128	100	3	80	0.0375000
NODE_301430_length_199_cov_215.860000	48	128	102	4	80	0.0500000
NODE_301430_length_199_cov_215.860000	48	128	104	1	80	0.0125000
NODE_301430_length_199_cov_215.860000	48	128	106	3	80	0.0375000
NODE_301430_length_199_cov_215.860000	48	128	110	2	80	0.0250000
NODE_301430_length_199_cov_215.860000	48	128	112	5	80	0.0625000
NODE_301430_length_199_cov_215.860000	48	128	114	1	80	0.0125000
NODE_301430_length_199_cov_215.860000	48	128	116	4	80	0.0500000
NODE_301430_length_199_cov_215.860000	48	128	118	5	80	0.0625000
NODE_301430_length_199_cov_215.860000	48	128	120	18	80	0.2250000
NODE_301430_length_199_cov_215.860000	48	128	122	6	80	0.0750000
NODE_301430_length_199_cov_215.860000	48	128	124	3	80	0.0375000
NODE_301430_length_199_cov_215.860000	48	128	126	8	80	0.1000000
NODE_301432_length_199_cov_206.800000	120	199	0	22	79	0.2784810
NODE_301432_length_199_cov_206.800000	120	199	4	14	79	0.1772152
NODE_301432_length_199_cov_206.800000	120	199	6	43	79	0.5443038
NODE_301441_length_199_cov_131.120000	97	177	0	80	80	1.0000000
NODE_301448_length_199_cov_97.490000	4	77	10	9	73	0.1232877
NODE_301448_length_199_cov_97.490000	4	77	18	7	73	0.0958904
NODE_301448_length_199_cov_97.490000	4	77	20	2	73	0.0273973
NODE_301448_length_199_cov_97.490000	4	77	22	5	73	0.0684932
NODE_301448_length_199_cov_97.490000	4	77	24	5	73	0.0684932
NODE_301448_length_199_cov_97.490000	4	77	28	3	73	0.0410959
NODE_301448_length_199_cov_97.490000	4	77	30	3	73	0.0410959
NODE_301448_length_199_cov_97.490000	4	77	32	1	73	0.0136986
NODE_301448_length_199_cov_97.490000	4	77	34	2	73	0.0273973
NODE_301448_length_199_cov_97.490000	4	77	35	4	73	0.0547945
NODE_301448_length_199_cov_97.490000	4	77	39	2	73	0.0273973
NODE_301448_length_199_cov_97.490000	4	77	43	2	73	0.0273973
NODE_301448_length_199_cov_97.490000	4	77	45	9	73	0.1232877
NODE_301448_length_199_cov_97.490000	4	77	47	3	73	0.0410959
NODE_301448_length_199_cov_97.490000	4	77	51	4	73	0.0547945
NODE_301448_length_199_cov_97.490000	4	77	53	6	73	0.0821918
NODE_301448_length_199_cov_97.490000	4	77	54	1	73	0.0136986
NODE_301448_length_199_cov_97.490000	4	77	56	1	73	0.0136986
NODE_301448_length_199_cov_97.490000	4	77	58	4	73	0.0547945
NODE_301449_length_199_cov_96.090000	91	171	38	1	80	0.0125000
NODE_301449_length_199_cov_96.090000	91	171	44	1	80	0.0125000
NODE_301449_length_199_cov_96.090000	91	171	45	1	80	0.0125000
NODE_301449_length_199_cov_96.090000	91	171	52	1	80	0.0125000
NODE_301449_length_199_cov_96.090000	91	171	53	1	80	0.0125000
NODE_301449_length_199_cov_96.090000	91	171	62	1	80	0.0125000
NODE_301449_length_199_cov_96.090000	91	171	64	1	80	0.0125000
NODE_301449_length_199_cov_96.090000	91	171	72	1	80	0.0125000
NODE_301449_length_199_cov_96.090000	91	171	75	1	80	0.0125000
NODE_301449_length_199_cov_96.090000	91	171	79	2	80	0.0250000
NODE_301449_length_199_cov_96.090000	91	171	85	1	80	0.0125000
NODE_301449_length_199_cov_96.090000	91	171	89	4	80	0.0500000
NODE_301449_length_199_cov_96.090000	91	171	91	1	80	0.0125000
NODE_301449_length_199_cov_96.090000	91	171	109	1	80	0.0125000
NODE_301449_length_199_cov_96.090000	91	171	110	1	80	0.0125000
NODE_301449_length_199_cov_96.090000	91	171	111	1	80	0.0125000
NODE_301449_length_199_cov_96.090000	91	171	114	1	80	0.0125000
NODE_301449_length_199_cov_96.090000	91	171	115	1	80	0.0125000
NODE_301449_length_199_cov_96.090000	91	171	118	1	80	0.0125000
NODE_301449_length_199_cov_96.090000	91	171	120	1	80	0.0125000
NODE_301449_length_199_cov_96.090000	91	171	123	1	80	0.0125000
NODE_301449_length_199_cov_96.090000	91	171	129	3	80	0.0375000
NODE_301449_length_199_cov_96.090000	91	171	131	1	80	0.0125000
NODE_301449_length_199_cov_96.090000	91	171	133	2	80	0.0250000
NODE_301449_length_199_cov_96.090000	91	171	137	2	80	0.0250000
NODE_301449_length_199_cov_96.090000	91	171	139	2	80	0.0250000
NODE_301449_length_199_cov_96.090000	91	171	147	1	80	0.0125000
NODE_301449_length_199_cov_96.090000	91	171	157	3	80	0.0375000
NODE_301449_length_199_cov_96.090000	91	171	163	1	80	0.0125000
NODE_301449_length_199_cov_96.090000	91	171	167	1	80	0.0125000
NODE_301449_length_199_cov_96.090000	91	171	169	5	80	0.0625000
NODE_301449_length_199_cov_96.090000	91	171	175	1	80	0.0125000
NODE_301449_length_199_cov_96.090000	91	171	177	1	80	0.0125000
NODE_301449_length_199_cov_96.090000	91	171	178	1	80	0.0125000
NODE_301449_length_199_cov_96.090000	91	171	179	1	80	0.0125000
NODE_301449_length_199_cov_96.090000	91	171	181	2	80	0.0250000
NODE_301449_length_199_cov_96.090000	91	171	185	2	80	0.0250000
NODE_301449_length_199_cov_96.090000	91	171	189	6	80	0.0750000
NODE_301449_length_199_cov_96.090000	91	171	191	20	80	0.2500000
NODE_301455_length_199_cov_84.060000	44	75	24	3	31	0.0967742
NODE_301455_length_199_cov_84.060000	44	75	27	28	31	0.9032258
NODE_301456_length_199_cov_83.220000	0	64	0	64	64	1.0000000
NODE_301459_length_199_cov_80.390000	15	98	0	83	83	1.0000000
NODE_301469_length_199_cov_63.420000	128	194	3	1	66	0.0151515
NODE_301469_length_199_cov_63.420000	128	194	5	4	66	0.0606061
NODE_301469_length_199_cov_63.420000	128	194	6	2	66	0.0303030
NODE_301469_length_199_cov_63.420000	128	194	8	4	66	0.0606061
NODE_301469_length_199_cov_63.420000	128	194	10	3	66	0.0454545
NODE_301469_length_199_cov_63.420000	128	194	12	2	66	0.0303030
NODE_301469_length_199_cov_63.420000	128	194	14	1	66	0.0151515
NODE_301469_length_199_cov_63.420000	128	194	15	1	66	0.0151515
NODE_301469_length_199_cov_63.420000	128	194	17	6	66	0.0909091
NODE_301469_length_199_cov_63.420000	128	194	19	2	66	0.0303030
NODE_301469_length_199_cov_63.420000	128	194	26	1	66	0.0151515
NODE_301469_length_199_cov_63.420000	128	194	28	1	66	0.0151515
NODE_301469_length_199_cov_63.420000	128	194	37	3	66	0.0454545
NODE_301469_length_199_cov_63.420000	128	194	39	1	66	0.0151515
NODE_301469_length_199_cov_63.420000	128	194	41	2	66	0.0303030
NODE_301469_length_199_cov_63.420000	128	194	43	1	66	0.0151515
NODE_301469_length_199_cov_63.420000	128	194	46	1	66	0.0151515
NODE_301469_length_199_cov_63.420000	128	194	56	1	66	0.0151515
NODE_301469_length_199_cov_63.420000	128	194	60	1	66	0.0151515
NODE_301469_length_199_cov_63.420000	128	194	62	1	66	0.0151515
NODE_301469_length_199_cov_63.420000	128	194	63	1	66	0.0151515
NODE_301469_length_199_cov_63.420000	128	194	66	1	66	0.0151515
NODE_301469_length_199_cov_63.420000	128	194	67	1	66	0.0151515
NODE_301469_length_199_cov_63.420000	128	194	75	1	66	0.0151515
NODE_301469_length_199_cov_63.420000	128	194	76	1	66	0.0151515
NODE_301469_length_199_cov_63.420000	128	194	80	1	66	0.0151515
NODE_301469_length_199_cov_63.420000	128	194	81	1	66	0.0151515
NODE_301469_length_199_cov_63.420000	128	194	87	1	66	0.0151515
NODE_301469_length_199_cov_63.420000	128	194	96	1	66	0.0151515
NODE_301469_length_199_cov_63.420000	128	194	97	2	66	0.0303030
NODE_301469_length_199_cov_63.420000	128	194	98	1	66	0.0151515
NODE_301469_length_199_cov_63.420000	128	194	100	1	66	0.0151515
NODE_301469_length_199_cov_63.420000	128	194	102	2	66	0.0303030
NODE_301469_length_199_cov_63.420000	128	194	105	2	66	0.0303030
NODE_301469_length_199_cov_63.420000	128	194	107	1	66	0.0151515
NODE_301469_length_199_cov_63.420000	128	194	113	4	66	0.0606061
NODE_301469_length_199_cov_63.420000	128	194	117	1	66	0.0151515
NODE_301469_length_199_cov_63.420000	128	194	120	1	66	0.0151515
NODE_301469_length_199_cov_63.420000	128	194	122	1	66	0.0151515
NODE_301469_length_199_cov_63.420000	128	194	126	1	66	0.0151515
NODE_301469_length_199_cov_63.420000	128	194	131	1	66	0.0151515
NODE_301477_length_199_cov_58.660000	18	85	0	59	67	0.8805970
NODE_301477_length_199_cov_58.660000	18	85	8	8	67	0.1194030
NODE_301484_length_199_cov_50.350000	102	183	0	81	81	1.0000000
NODE_301485_length_199_cov_49.630000	5	47	0	42	42	1.0000000
NODE_301485_length_199_cov_49.630000	100	163	0	63	63	1.0000000
NODE_301485_length_199_cov_49.630000	100	163	0	63	63	1.0000000
NODE_301485_length_199_cov_49.630000	100	163	0	63	63	1.0000000
NODE_301485_length_199_cov_49.630000	136	185	0	49	49	1.0000000
NODE_301485_length_199_cov_49.630000	153	199	0	46	46	1.0000000
NODE_301491_length_199_cov_40.000000	0	66	0	13	66	0.1969697
NODE_301491_length_199_cov_40.000000	0	66	4	7	66	0.1060606
NODE_301491_length_199_cov_40.000000	0	66	6	5	66	0.0757576
NODE_301491_length_199_cov_40.000000	0	66	12	2	66	0.0303030
NODE_301491_length_199_cov_40.000000	0	66	14	5	66	0.0757576
NODE_301491_length_199_cov_40.000000	0	66	16	3	66	0.0454545
NODE_301491_length_199_cov_40.000000	0	66	18	3	66	0.0454545
NODE_301491_length_199_cov_40.000000	0	66	20	1	66	0.0151515
NODE_301491_length_199_cov_40.000000	0	66	28	3	66	0.0454545
NODE_301491_length_199_cov_40.000000	0	66	30	13	66	0.1969697
NODE_301491_length_199_cov_40.000000	0	66	32	3	66	0.0454545
NODE_301491_length_199_cov_40.000000	0	66	37	1	66	0.0151515
NODE_301491_length_199_cov_40.000000	0	66	38	3	66	0.0454545
NODE_301491_length_199_cov_40.000000	0	66	41	4	66	0.0606061
NODE_301491_length_199_cov_40.000000	34	114	16	1	80	0.0125000
NODE_301491_length_199_cov_40.000000	34	114	18	3	80	0.0375000
NODE_301491_length_199_cov_40.000000	34	114	20	1	80	0.0125000
NODE_301491_length_199_cov_40.000000	34	114	28	3	80	0.0375000
NODE_301491_length_199_cov_40.000000	34	114	30	13	80	0.1625000
NODE_301491_length_199_cov_40.000000	34	114	32	3	80	0.0375000
NODE_301491_length_199_cov_40.000000	34	114	37	1	80	0.0125000
NODE_301491_length_199_cov_40.000000	34	114	38	3	80	0.0375000
NODE_301491_length_199_cov_40.000000	34	114	41	9	80	0.1125000
NODE_301491_length_199_cov_40.000000	34	114	42	20	80	0.2500000
NODE_301491_length_199_cov_40.000000	34	114	44	23	80	0.2875000
NODE_301491_length_199_cov_40.000000	39	61	28	3	22	0.1363636
NODE_301491_length_199_cov_40.000000	39	61	30	13	22	0.5909091
NODE_301491_length_199_cov_40.000000	39	61	32	3	22	0.1363636
NODE_301491_length_199_cov_40.000000	39	61	37	1	22	0.0454545
NODE_301491_length_199_cov_40.000000	39	61	38	2	22	0.0909091
NODE_301498_length_199_cov_31.400000	3	77	0	8	74	0.1081081
NODE_301498_length_199_cov_31.400000	3	77	1	8	74	0.1081081
NODE_301498_length_199_cov_31.400000	3	77	2	58	74	0.7837838
NODE_301498_length_199_cov_31.400000	76	153	2	12	77	0.1558442
NODE_301498_length_199_cov_31.400000	76	153	4	2	77	0.0259740
NODE_301498_length_199_cov_31.400000	76	153	6	5	77	0.0649351
NODE_301498_length_199_cov_31.400000	76	153	8	58	77	0.7532467
NODE_301498_length_199_cov_31.400000	76	153	2	12	77	0.1558442
NODE_301498_length_199_cov_31.400000	76	153	4	2	77	0.0259740
NODE_301498_length_199_cov_31.400000	76	153	6	5	77	0.0649351
NODE_301498_length_199_cov_31.400000	76	153	8	58	77	0.7532467
NODE_301498_length_199_cov_31.400000	76	153	2	12	77	0.1558442
NODE_301498_length_199_cov_31.400000	76	153	4	2	77	0.0259740
NODE_301498_length_199_cov_31.400000	76	153	6	5	77	0.0649351
NODE_301498_length_199_cov_31.400000	76	153	8	58	77	0.7532467
NODE_301498_length_199_cov_31.400000	126	192	0	3	66	0.0454545
NODE_301498_length_199_cov_31.400000	126	192	2	18	66	0.2727273
NODE_301498_length_199_cov_31.400000	126	192	3	9	66	0.1363636
NODE_301498_length_199_cov_31.400000	126	192	6	3	66	0.0454545
NODE_301498_length_199_cov_31.400000	126	192	8	33	66	0.5000000
NODE_301498_length_199_cov_31.400000	129	199	0	10	70	0.1428571
NODE_301498_length_199_cov_31.400000	129	199	2	18	70	0.2571429
NODE_301498_length_199_cov_31.400000	129	199	3	9	70	0.1285714
NODE_301498_length_199_cov_31.400000	129	199	6	3	70	0.0428571
NODE_301498_length_199_cov_31.400000	129	199	8	30	70	0.4285714
NODE_301498_length_199_cov_31.400000	131	199	0	10	68	0.1470588
NODE_301498_length_199_cov_31.400000	131	199	2	18	68	0.2647059
NODE_301498_length_199_cov_31.400000	131	199	3	9	68	0.1323529
NODE_301498_length_199_cov_31.400000	131	199	6	3	68	0.0441176
NODE_301498_length_199_cov_31.400000	131	199	8	28	68	0.4117647
NODE_301500_length_199_cov_30.140000	118	198	0	6	80	0.0750000
NODE_301500_length_199_cov_30.140000	118	198	6	74	80	0.9250000
NODE_301500_length_199_cov_30.140000	118	198	0	6	80	0.0750000
NODE_301500_length_199_cov_30.140000	118	198	6	74	80	0.9250000
NODE_301500_length_199_cov_30.140000	118	198	0	6	80	0.0750000
NODE_301500_length_199_cov_30.140000	118	198	6	74	80	0.9250000
NODE_301500_length_199_cov_30.140000	118	198	0	6	80	0.0750000
NODE_301500_length_199_cov_30.140000	118	198	6	74	80	0.9250000
NODE_301500_length_199_cov_30.140000	118	198	0	6	80	0.0750000
NODE_301500_length_199_cov_30.140000	118	198	6	74	80	0.9250000
NODE_301500_length_199_cov_30.140000	127	198	0	6	71	0.0845070
NODE_301500_length_199_cov_30.140000	127	198	6	65	71	0.9154930
NODE_301581_length_197_cov_41.265306	0	70	0	70	70	1.0000000
NODE_301611_length_196_cov_101.855670	72	136	94	1	64	0.0156250
NODE_301611_length_196_cov_101.855670	72	136	96	3	64	0.0468750
NODE_301611_length_196_cov_101.855670	72	136	98	1	64	0.0156250
NODE_301611_length_196_cov_101.855670	72	136	102	1	64	0.0156250
NODE_301611_length_196_cov_101.855670	72	136	106	1	64	0.0156250
NODE_301611_length_196_cov_101.855670	72	136	107	3	64	0.0468750
NODE_301611_length_196_cov_101.855670	72	136	116	2	64	0.0312500
NODE_301611_length_196_cov_101.855670	72	136	122	4	64	0.0625000
NODE_301611_length_196_cov_101.855670	72	136	123	1	64	0.0156250
NODE_301611_length_196_cov_101.855670	72	136	126	1	64	0.0156250
NODE_301611_length_196_cov_101.855670	72	136	129	2	64	0.0312500
NODE_301611_length_196_cov_101.855670	72	136	131	1	64	0.0156250
NODE_301611_length_196_cov_101.855670	72	136	132	1	64	0.0156250
NODE_301611_length_196_cov_101.855670	72	136	133	7	64	0.1093750
NODE_301611_length_196_cov_101.855670	72	136	134	3	64	0.0468750
NODE_301611_length_196_cov_101.855670	72	136	135	1	64	0.0156250
NODE_301611_length_196_cov_101.855670	72	136	136	8	64	0.1250000
NODE_301611_length_196_cov_101.855670	72	136	137	3	64	0.0468750
NODE_301611_length_196_cov_101.855670	72	136	138	20	64	0.3125000
NODE_301611_length_196_cov_101.855670	72	136	94	1	64	0.0156250
NODE_301611_length_196_cov_101.855670	72	136	96	3	64	0.0468750
NODE_301611_length_196_cov_101.855670	72	136	98	1	64	0.0156250
NODE_301611_length_196_cov_101.855670	72	136	102	1	64	0.0156250
NODE_301611_length_196_cov_101.855670	72	136	106	1	64	0.0156250
NODE_301611_length_196_cov_101.855670	72	136	107	3	64	0.0468750
NODE_301611_length_196_cov_101.855670	72	136	116	2	64	0.0312500
NODE_301611_length_196_cov_101.855670	72	136	122	4	64	0.0625000
NODE_301611_length_196_cov_101.855670	72	136	123	1	64	0.0156250
NODE_301611_length_196_cov_101.855670	72	136	126	1	64	0.0156250
NODE_301611_length_196_cov_101.855670	72	136	129	2	64	0.0312500
NODE_301611_length_196_cov_101.855670	72	136	131	1	64	0.0156250
NODE_301611_length_196_cov_101.855670	72	136	132	1	64	0.0156250
NODE_301611_length_196_cov_101.855670	72	136	133	7	64	0.1093750
NODE_301611_length_196_cov_101.855670	72	136	134	3	64	0.0468750
NODE_301611_length_196_cov_101.855670	72	136	135	1	64	0.0156250
NODE_301611_length_196_cov_101.855670	72	136	136	8	64	0.1250000
NODE_301611_length_196_cov_101.855670	72	136	137	3	64	0.0468750
NODE_301611_length_196_cov_101.855670	72	136	138	20	64	0.3125000
NODE_301611_length_196_cov_101.855670	109	169	2	1	60	0.0166667
NODE_301611_length_196_cov_101.855670	109	169	6	1	60	0.0166667
NODE_301611_length_196_cov_101.855670	109	169	12	6	60	0.1000000
NODE_301611_length_196_cov_101.855670	109	169	20	4	60	0.0666667
NODE_301611_length_196_cov_101.855670	109	169	23	1	60	0.0166667
NODE_301611_length_196_cov_101.855670	109	169	25	5	60	0.0833333
NODE_301611_length_196_cov_101.855670	109	169	29	1	60	0.0166667
NODE_301611_length_196_cov_101.855670	109	169	30	2	60	0.0333333
NODE_301611_length_196_cov_101.855670	109	169	58	1	60	0.0166667
NODE_301611_length_196_cov_101.855670	109	169	68	1	60	0.0166667
NODE_301611_length_196_cov_101.855670	109	169	72	6	60	0.1000000
NODE_301611_length_196_cov_101.855670	109	169	76	1	60	0.0166667
NODE_301611_length_196_cov_101.855670	109	169	80	1	60	0.0166667
NODE_301611_length_196_cov_101.855670	109	169	87	1	60	0.0166667
NODE_301611_length_196_cov_101.855670	109	169	90	1	60	0.0166667
NODE_301611_length_196_cov_101.855670	109	169	94	1	60	0.0166667
NODE_301611_length_196_cov_101.855670	109	169	96	3	60	0.0500000
NODE_301611_length_196_cov_101.855670	109	169	98	1	60	0.0166667
NODE_301611_length_196_cov_101.855670	109	169	102	1	60	0.0166667
NODE_301611_length_196_cov_101.855670	109	169	106	1	60	0.0166667
NODE_301611_length_196_cov_101.855670	109	169	107	3	60	0.0500000
NODE_301611_length_196_cov_101.855670	109	169	116	2	60	0.0333333
NODE_301611_length_196_cov_101.855670	109	169	122	4	60	0.0666667
NODE_301611_length_196_cov_101.855670	109	169	126	1	60	0.0166667
NODE_301611_length_196_cov_101.855670	109	169	129	2	60	0.0333333
NODE_301611_length_196_cov_101.855670	109	169	131	1	60	0.0166667
NODE_301611_length_196_cov_101.855670	109	169	133	1	60	0.0166667
NODE_301611_length_196_cov_101.855670	109	169	134	3	60	0.0500000
NODE_301611_length_196_cov_101.855670	109	169	136	3	60	0.0500000
NODE_301613_length_196_cov_100.618557	129	196	11	1	67	0.0149254
NODE_301613_length_196_cov_100.618557	129	196	13	3	67	0.0447761
NODE_301613_length_196_cov_100.618557	129	196	19	3	67	0.0447761
NODE_301613_length_196_cov_100.618557	129	196	23	3	67	0.0447761
NODE_301613_length_196_cov_100.618557	129	196	24	4	67	0.0597015
NODE_301613_length_196_cov_100.618557	129	196	26	1	67	0.0149254
NODE_301613_length_196_cov_100.618557	129	196	30	2	67	0.0298507
NODE_301613_length_196_cov_100.618557	129	196	34	1	67	0.0149254
NODE_301613_length_196_cov_100.618557	129	196	35	2	67	0.0298507
NODE_301613_length_196_cov_100.618557	129	196	39	2	67	0.0298507
NODE_301613_length_196_cov_100.618557	129	196	41	3	67	0.0447761
NODE_301613_length_196_cov_100.618557	129	196	43	6	67	0.0895522
NODE_301613_length_196_cov_100.618557	129	196	45	4	67	0.0597015
NODE_301613_length_196_cov_100.618557	129	196	49	3	67	0.0447761
NODE_301613_length_196_cov_100.618557	129	196	51	2	67	0.0298507
NODE_301613_length_196_cov_100.618557	129	196	53	1	67	0.0149254
NODE_301613_length_196_cov_100.618557	129	196	55	2	67	0.0298507
NODE_301613_length_196_cov_100.618557	129	196	57	17	67	0.2537313
NODE_301613_length_196_cov_100.618557	129	196	59	3	67	0.0447761
NODE_301613_length_196_cov_100.618557	129	196	63	1	67	0.0149254
NODE_301613_length_196_cov_100.618557	129	196	65	2	67	0.0298507
NODE_301613_length_196_cov_100.618557	129	196	67	1	67	0.0149254
NODE_301618_length_196_cov_67.268041	8	88	5	9	80	0.1125000
NODE_301618_length_196_cov_67.268041	8	88	6	2	80	0.0250000
NODE_301618_length_196_cov_67.268041	8	88	8	13	80	0.1625000
NODE_301618_length_196_cov_67.268041	8	88	10	5	80	0.0625000
NODE_301618_length_196_cov_67.268041	8	88	11	27	80	0.3375000
NODE_301618_length_196_cov_67.268041	8	88	12	3	80	0.0375000
NODE_301618_length_196_cov_67.268041	8	88	14	21	80	0.2625000
NODE_301618_length_196_cov_67.268041	61	124	11	3	63	0.0476190
NODE_301618_length_196_cov_67.268041	61	124	12	3	63	0.0476190
NODE_301618_length_196_cov_67.268041	61	124	14	57	63	0.9047619
NODE_301629_length_196_cov_40.195876	101	184	0	8	83	0.0963855
NODE_301629_length_196_cov_40.195876	101	184	4	20	83	0.2409639
NODE_301629_length_196_cov_40.195876	101	184	6	1	83	0.0120482
NODE_301629_length_196_cov_40.195876	101	184	8	41	83	0.4939759
NODE_301629_length_196_cov_40.195876	101	184	10	13	83	0.1566265
NODE_301704_length_194_cov_63.252632	12	78	6	13	66	0.1969697
NODE_301704_length_194_cov_63.252632	12	78	7	1	66	0.0151515
NODE_301704_length_194_cov_63.252632	12	78	9	2	66	0.0303030
NODE_301704_length_194_cov_63.252632	12	78	10	5	66	0.0757576
NODE_301704_length_194_cov_63.252632	12	78	15	2	66	0.0303030
NODE_301704_length_194_cov_63.252632	12	78	19	1	66	0.0151515
NODE_301704_length_194_cov_63.252632	12	78	27	1	66	0.0151515
NODE_301704_length_194_cov_63.252632	12	78	35	9	66	0.1363636
NODE_301704_length_194_cov_63.252632	12	78	36	2	66	0.0303030
NODE_301704_length_194_cov_63.252632	12	78	37	3	66	0.0454545
NODE_301704_length_194_cov_63.252632	12	78	43	6	66	0.0909091
NODE_301704_length_194_cov_63.252632	12	78	45	1	66	0.0151515
NODE_301704_length_194_cov_63.252632	12	78	51	1	66	0.0151515
NODE_301704_length_194_cov_63.252632	12	78	53	4	66	0.0606061
NODE_301704_length_194_cov_63.252632	12	78	58	4	66	0.0606061
NODE_301704_length_194_cov_63.252632	12	78	68	3	66	0.0454545
NODE_301704_length_194_cov_63.252632	12	78	70	1	66	0.0151515
NODE_301704_length_194_cov_63.252632	12	78	72	1	66	0.0151515
NODE_301704_length_194_cov_63.252632	12	78	83	6	66	0.0909091
NODE_301704_length_194_cov_63.252632	51	112	43	6	61	0.0983607
NODE_301704_length_194_cov_63.252632	51	112	45	1	61	0.0163934
NODE_301704_length_194_cov_63.252632	51	112	51	1	61	0.0163934
NODE_301704_length_194_cov_63.252632	51	112	53	4	61	0.0655738
NODE_301704_length_194_cov_63.252632	51	112	58	4	61	0.0655738
NODE_301704_length_194_cov_63.252632	51	112	68	3	61	0.0491803
NODE_301704_length_194_cov_63.252632	51	112	70	1	61	0.0163934
NODE_301704_length_194_cov_63.252632	51	112	72	1	61	0.0163934
NODE_301704_length_194_cov_63.252632	51	112	82	16	61	0.2622951
NODE_301704_length_194_cov_63.252632	51	112	83	24	61	0.3934426
NODE_301704_length_194_cov_63.252632	51	99	43	6	48	0.1250000
NODE_301704_length_194_cov_63.252632	51	99	45	1	48	0.0208333
NODE_301704_length_194_cov_63.252632	51	99	51	1	48	0.0208333
NODE_301704_length_194_cov_63.252632	51	99	53	4	48	0.0833333
NODE_301704_length_194_cov_63.252632	51	99	58	4	48	0.0833333
NODE_301704_length_194_cov_63.252632	51	99	68	3	48	0.0625000
NODE_301704_length_194_cov_63.252632	51	99	70	1	48	0.0208333
NODE_301704_length_194_cov_63.252632	51	99	72	1	48	0.0208333
NODE_301704_length_194_cov_63.252632	51	99	82	12	48	0.2500000
NODE_301704_length_194_cov_63.252632	51	99	83	15	48	0.3125000
NODE_301704_length_194_cov_63.252632	51	112	43	6	61	0.0983607
NODE_301704_length_194_cov_63.252632	51	112	45	1	61	0.0163934
NODE_301704_length_194_cov_63.252632	51	112	51	1	61	0.0163934
NODE_301704_length_194_cov_63.252632	51	112	53	4	61	0.0655738
NODE_301704_length_194_cov_63.252632	51	112	58	4	61	0.0655738
NODE_301704_length_194_cov_63.252632	51	112	68	3	61	0.0491803
NODE_301704_length_194_cov_63.252632	51	112	70	1	61	0.0163934
NODE_301704_length_194_cov_63.252632	51	112	72	1	61	0.0163934
NODE_301704_length_194_cov_63.252632	51	112	82	16	61	0.2622951
NODE_301704_length_194_cov_63.252632	51	112	83	24	61	0.3934426
NODE_301708_length_194_cov_35.010526	95	162	10	16	67	0.2388060
NODE_301708_length_194_cov_35.010526	95	162	16	5	67	0.0746269
NODE_301708_length_194_cov_35.010526	95	162	19	1	67	0.0149254
NODE_301708_length_194_cov_35.010526	95	162	23	15	67	0.2238806
NODE_301708_length_194_cov_35.010526	95	162	24	30	67	0.4477612
NODE_301708_length_194_cov_35.010526	95	162	10	16	67	0.2388060
NODE_301708_length_194_cov_35.010526	95	162	16	5	67	0.0746269
NODE_301708_length_194_cov_35.010526	95	162	19	1	67	0.0149254
NODE_301708_length_194_cov_35.010526	95	162	23	15	67	0.2238806
NODE_301708_length_194_cov_35.010526	95	162	24	30	67	0.4477612
NODE_301708_length_194_cov_35.010526	135	184	0	7	49	0.1428571
NODE_301708_length_194_cov_35.010526	135	184	8	4	49	0.0816327
NODE_301708_length_194_cov_35.010526	135	184	10	27	49	0.5510204
NODE_301708_length_194_cov_35.010526	135	184	16	5	49	0.1020408
NODE_301708_length_194_cov_35.010526	135	184	19	1	49	0.0204082
NODE_301708_length_194_cov_35.010526	135	184	23	5	49	0.1020408
NODE_301714_length_194_cov_9.978947	153	194	0	41	41	1.0000000
NODE_301727_length_193_cov_117.170213	21	93	51	1	72	0.0138889
NODE_301727_length_193_cov_117.170213	21	93	53	1	72	0.0138889
NODE_301727_length_193_cov_117.170213	21	93	59	2	72	0.0277778
NODE_301727_length_193_cov_117.170213	21	93	63	2	72	0.0277778
NODE_301727_length_193_cov_117.170213	21	93	71	2	72	0.0277778
NODE_301727_length_193_cov_117.170213	21	93	73	2	72	0.0277778
NODE_301727_length_193_cov_117.170213	21	93	74	2	72	0.0277778
NODE_301727_length_193_cov_117.170213	21	93	76	4	72	0.0555556
NODE_301727_length_193_cov_117.170213	21	93	78	1	72	0.0138889
NODE_301727_length_193_cov_117.170213	21	93	79	1	72	0.0138889
NODE_301727_length_193_cov_117.170213	21	93	93	2	72	0.0277778
NODE_301727_length_193_cov_117.170213	21	93	101	1	72	0.0138889
NODE_301727_length_193_cov_117.170213	21	93	106	1	72	0.0138889
NODE_301727_length_193_cov_117.170213	21	93	109	1	72	0.0138889
NODE_301727_length_193_cov_117.170213	21	93	120	1	72	0.0138889
NODE_301727_length_193_cov_117.170213	21	93	121	1	72	0.0138889
NODE_301727_length_193_cov_117.170213	21	93	131	1	72	0.0138889
NODE_301727_length_193_cov_117.170213	21	93	136	2	72	0.0277778
NODE_301727_length_193_cov_117.170213	21	93	140	1	72	0.0138889
NODE_301727_length_193_cov_117.170213	21	93	152	2	72	0.0277778
NODE_301727_length_193_cov_117.170213	21	93	158	2	72	0.0277778
NODE_301727_length_193_cov_117.170213	21	93	161	1	72	0.0138889
NODE_301727_length_193_cov_117.170213	21	93	163	1	72	0.0138889
NODE_301727_length_193_cov_117.170213	21	93	165	1	72	0.0138889
NODE_301727_length_193_cov_117.170213	21	93	170	1	72	0.0138889
NODE_301727_length_193_cov_117.170213	21	93	175	2	72	0.0277778
NODE_301727_length_193_cov_117.170213	21	93	179	1	72	0.0138889
NODE_301727_length_193_cov_117.170213	21	93	185	1	72	0.0138889
NODE_301727_length_193_cov_117.170213	21	93	191	1	72	0.0138889
NODE_301727_length_193_cov_117.170213	21	93	196	1	72	0.0138889
NODE_301727_length_193_cov_117.170213	21	93	201	2	72	0.0277778
NODE_301727_length_193_cov_117.170213	21	93	203	6	72	0.0833333
NODE_301727_length_193_cov_117.170213	21	93	208	4	72	0.0555556
NODE_301727_length_193_cov_117.170213	21	93	212	2	72	0.0277778
NODE_301727_length_193_cov_117.170213	21	93	214	1	72	0.0138889
NODE_301727_length_193_cov_117.170213	21	93	216	2	72	0.0277778
NODE_301727_length_193_cov_117.170213	21	93	218	1	72	0.0138889
NODE_301727_length_193_cov_117.170213	21	93	220	11	72	0.1527778
NODE_301727_length_193_cov_117.170213	41	121	101	1	80	0.0125000
NODE_301727_length_193_cov_117.170213	41	121	106	1	80	0.0125000
NODE_301727_length_193_cov_117.170213	41	121	109	1	80	0.0125000
NODE_301727_length_193_cov_117.170213	41	121	120	1	80	0.0125000
NODE_301727_length_193_cov_117.170213	41	121	121	1	80	0.0125000
NODE_301727_length_193_cov_117.170213	41	121	131	1	80	0.0125000
NODE_301727_length_193_cov_117.170213	41	121	136	2	80	0.0250000
NODE_301727_length_193_cov_117.170213	41	121	140	1	80	0.0125000
NODE_301727_length_193_cov_117.170213	41	121	152	2	80	0.0250000
NODE_301727_length_193_cov_117.170213	41	121	158	2	80	0.0250000
NODE_301727_length_193_cov_117.170213	41	121	161	1	80	0.0125000
NODE_301727_length_193_cov_117.170213	41	121	163	1	80	0.0125000
NODE_301727_length_193_cov_117.170213	41	121	165	1	80	0.0125000
NODE_301727_length_193_cov_117.170213	41	121	170	1	80	0.0125000
NODE_301727_length_193_cov_117.170213	41	121	175	2	80	0.0250000
NODE_301727_length_193_cov_117.170213	41	121	179	1	80	0.0125000
NODE_301727_length_193_cov_117.170213	41	121	185	1	80	0.0125000
NODE_301727_length_193_cov_117.170213	41	121	191	1	80	0.0125000
NODE_301727_length_193_cov_117.170213	41	121	196	1	80	0.0125000
NODE_301727_length_193_cov_117.170213	41	121	201	2	80	0.0250000
NODE_301727_length_193_cov_117.170213	41	121	203	6	80	0.0750000
NODE_301727_length_193_cov_117.170213	41	121	204	2	80	0.0250000
NODE_301727_length_193_cov_117.170213	41	121	208	5	80	0.0625000
NODE_301727_length_193_cov_117.170213	41	121	210	2	80	0.0250000
NODE_301727_length_193_cov_117.170213	41	121	212	2	80	0.0250000
NODE_301727_length_193_cov_117.170213	41	121	214	4	80	0.0500000
NODE_301727_length_193_cov_117.170213	41	121	216	2	80	0.0250000
NODE_301727_length_193_cov_117.170213	41	121	218	4	80	0.0500000
NODE_301727_length_193_cov_117.170213	41	121	220	28	80	0.3500000
NODE_301729_length_193_cov_54.734043	108	188	20	4	80	0.0500000
NODE_301729_length_193_cov_54.734043	108	188	22	6	80	0.0750000
NODE_301729_length_193_cov_54.734043	108	188	38	1	80	0.0125000
NODE_301729_length_193_cov_54.734043	108	188	40	1	80	0.0125000
NODE_301729_length_193_cov_54.734043	108	188	44	2	80	0.0250000
NODE_301729_length_193_cov_54.734043	108	188	48	7	80	0.0875000
NODE_301729_length_193_cov_54.734043	108	188	56	6	80	0.0750000
NODE_301729_length_193_cov_54.734043	108	188	58	1	80	0.0125000
NODE_301729_length_193_cov_54.734043	108	188	62	6	80	0.0750000
NODE_301729_length_193_cov_54.734043	108	188	64	6	80	0.0750000
NODE_301729_length_193_cov_54.734043	108	188	66	1	80	0.0125000
NODE_301729_length_193_cov_54.734043	108	188	72	4	80	0.0500000
NODE_301729_length_193_cov_54.734043	108	188	76	6	80	0.0750000
NODE_301729_length_193_cov_54.734043	108	188	79	5	80	0.0625000
NODE_301729_length_193_cov_54.734043	108	188	81	10	80	0.1250000
NODE_301729_length_193_cov_54.734043	108	188	82	14	80	0.1750000
NODE_301729_length_193_cov_54.734043	161	183	22	5	22	0.2272727
NODE_301729_length_193_cov_54.734043	161	183	38	1	22	0.0454545
NODE_301729_length_193_cov_54.734043	161	183	40	1	22	0.0454545
NODE_301729_length_193_cov_54.734043	161	183	44	2	22	0.0909091
NODE_301729_length_193_cov_54.734043	161	183	48	7	22	0.3181818
NODE_301729_length_193_cov_54.734043	161	183	56	6	22	0.2727273
NODE_301735_length_193_cov_30.638298	108	188	8	80	80	1.0000000
NODE_301735_length_193_cov_30.638298	161	183	8	22	22	1.0000000
NODE_301737_length_193_cov_29.968085	0	45	2	16	45	0.3555556
NODE_301737_length_193_cov_29.968085	0	45	8	2	45	0.0444444
NODE_301737_length_193_cov_29.968085	0	45	10	2	45	0.0444444
NODE_301737_length_193_cov_29.968085	0	45	20	5	45	0.1111111
NODE_301737_length_193_cov_29.968085	0	45	30	3	45	0.0666667
NODE_301737_length_193_cov_29.968085	0	45	32	2	45	0.0444444
NODE_301737_length_193_cov_29.968085	0	45	36	6	45	0.1333333
NODE_301737_length_193_cov_29.968085	0	45	42	6	45	0.1333333
NODE_301737_length_193_cov_29.968085	0	45	50	3	45	0.0666667
NODE_301737_length_193_cov_29.968085	8	57	2	8	49	0.1632653
NODE_301737_length_193_cov_29.968085	8	57	8	2	49	0.0408163
NODE_301737_length_193_cov_29.968085	8	57	10	2	49	0.0408163
NODE_301737_length_193_cov_29.968085	8	57	20	5	49	0.1020408
NODE_301737_length_193_cov_29.968085	8	57	30	3	49	0.0612245
NODE_301737_length_193_cov_29.968085	8	57	32	2	49	0.0408163
NODE_301737_length_193_cov_29.968085	8	57	36	6	49	0.1224490
NODE_301737_length_193_cov_29.968085	8	57	42	6	49	0.1224490
NODE_301737_length_193_cov_29.968085	8	57	50	3	49	0.0612245
NODE_301737_length_193_cov_29.968085	8	57	52	1	49	0.0204082
NODE_301737_length_193_cov_29.968085	8	57	56	4	49	0.0816327
NODE_301737_length_193_cov_29.968085	8	57	58	1	49	0.0204082
NODE_301737_length_193_cov_29.968085	8	57	64	1	49	0.0204082
NODE_301737_length_193_cov_29.968085	8	57	67	1	49	0.0204082
NODE_301737_length_193_cov_29.968085	8	57	69	1	49	0.0204082
NODE_301737_length_193_cov_29.968085	8	57	71	3	49	0.0612245
NODE_301737_length_193_cov_29.968085	30	98	36	6	68	0.0882353
NODE_301737_length_193_cov_29.968085	30	98	42	6	68	0.0882353
NODE_301737_length_193_cov_29.968085	30	98	50	3	68	0.0441176
NODE_301737_length_193_cov_29.968085	30	98	52	1	68	0.0147059
NODE_301737_length_193_cov_29.968085	30	98	56	4	68	0.0588235
NODE_301737_length_193_cov_29.968085	30	98	58	1	68	0.0147059
NODE_301737_length_193_cov_29.968085	30	98	64	1	68	0.0147059
NODE_301737_length_193_cov_29.968085	30	98	67	1	68	0.0147059
NODE_301737_length_193_cov_29.968085	30	98	69	1	68	0.0147059
NODE_301737_length_193_cov_29.968085	30	98	71	8	68	0.1176471
NODE_301737_length_193_cov_29.968085	30	98	77	2	68	0.0294118
NODE_301737_length_193_cov_29.968085	30	98	79	11	68	0.1617647
NODE_301737_length_193_cov_29.968085	30	98	81	7	68	0.1029412
NODE_301737_length_193_cov_29.968085	30	98	83	16	68	0.2352941
NODE_301737_length_193_cov_29.968085	30	98	36	6	68	0.0882353
NODE_301737_length_193_cov_29.968085	30	98	42	6	68	0.0882353
NODE_301737_length_193_cov_29.968085	30	98	50	3	68	0.0441176
NODE_301737_length_193_cov_29.968085	30	98	52	1	68	0.0147059
NODE_301737_length_193_cov_29.968085	30	98	56	4	68	0.0588235
NODE_301737_length_193_cov_29.968085	30	98	58	1	68	0.0147059
NODE_301737_length_193_cov_29.968085	30	98	64	1	68	0.0147059
NODE_301737_length_193_cov_29.968085	30	98	67	1	68	0.0147059
NODE_301737_length_193_cov_29.968085	30	98	69	1	68	0.0147059
NODE_301737_length_193_cov_29.968085	30	98	71	8	68	0.1176471
NODE_301737_length_193_cov_29.968085	30	98	77	2	68	0.0294118
NODE_301737_length_193_cov_29.968085	30	98	79	11	68	0.1617647
NODE_301737_length_193_cov_29.968085	30	98	81	7	68	0.1029412
NODE_301737_length_193_cov_29.968085	30	98	83	16	68	0.2352941
NODE_301737_length_193_cov_29.968085	30	98	36	6	68	0.0882353
NODE_301737_length_193_cov_29.968085	30	98	42	6	68	0.0882353
NODE_301737_length_193_cov_29.968085	30	98	50	3	68	0.0441176
NODE_301737_length_193_cov_29.968085	30	98	52	1	68	0.0147059
NODE_301737_length_193_cov_29.968085	30	98	56	4	68	0.0588235
NODE_301737_length_193_cov_29.968085	30	98	58	1	68	0.0147059
NODE_301737_length_193_cov_29.968085	30	98	64	1	68	0.0147059
NODE_301737_length_193_cov_29.968085	30	98	67	1	68	0.0147059
NODE_301737_length_193_cov_29.968085	30	98	69	1	68	0.0147059
NODE_301737_length_193_cov_29.968085	30	98	71	8	68	0.1176471
NODE_301737_length_193_cov_29.968085	30	98	77	2	68	0.0294118
NODE_301737_length_193_cov_29.968085	30	98	79	11	68	0.1617647
NODE_301737_length_193_cov_29.968085	30	98	81	7	68	0.1029412
NODE_301737_length_193_cov_29.968085	30	98	83	16	68	0.2352941
NODE_301737_length_193_cov_29.968085	146	188	3	3	42	0.0714286
NODE_301737_length_193_cov_29.968085	146	188	5	5	42	0.1190476
NODE_301737_length_193_cov_29.968085	146	188	7	5	42	0.1190476
NODE_301737_length_193_cov_29.968085	146	188	13	1	42	0.0238095
NODE_301737_length_193_cov_29.968085	146	188	15	5	42	0.1190476
NODE_301737_length_193_cov_29.968085	146	188	21	3	42	0.0714286
NODE_301737_length_193_cov_29.968085	146	188	29	1	42	0.0238095
NODE_301737_length_193_cov_29.968085	146	188	33	4	42	0.0952381
NODE_301737_length_193_cov_29.968085	146	188	41	5	42	0.1190476
NODE_301737_length_193_cov_29.968085	146	188	45	3	42	0.0714286
NODE_301737_length_193_cov_29.968085	146	188	49	1	42	0.0238095
NODE_301737_length_193_cov_29.968085	146	188	55	2	42	0.0476190
NODE_301737_length_193_cov_29.968085	146	188	57	3	42	0.0714286
NODE_301737_length_193_cov_29.968085	146	188	59	1	42	0.0238095
NODE_301776_length_192_cov_160.258065	0	76	9	4	76	0.0526316
NODE_301776_length_192_cov_160.258065	0	76	11	2	76	0.0263158
NODE_301776_length_192_cov_160.258065	0	76	13	1	76	0.0131579
NODE_301776_length_192_cov_160.258065	0	76	17	1	76	0.0131579
NODE_301776_length_192_cov_160.258065	0	76	21	1	76	0.0131579
NODE_301776_length_192_cov_160.258065	0	76	99	1	76	0.0131579
NODE_301776_length_192_cov_160.258065	0	76	106	1	76	0.0131579
NODE_301776_length_192_cov_160.258065	0	76	119	1	76	0.0131579
NODE_301776_length_192_cov_160.258065	0	76	121	1	76	0.0131579
NODE_301776_length_192_cov_160.258065	0	76	123	2	76	0.0263158
NODE_301776_length_192_cov_160.258065	0	76	126	2	76	0.0263158
NODE_301776_length_192_cov_160.258065	0	76	128	1	76	0.0131579
NODE_301776_length_192_cov_160.258065	0	76	130	1	76	0.0131579
NODE_301776_length_192_cov_160.258065	0	76	138	1	76	0.0131579
NODE_301776_length_192_cov_160.258065	0	76	141	1	76	0.0131579
NODE_301776_length_192_cov_160.258065	0	76	144	1	76	0.0131579
NODE_301776_length_192_cov_160.258065	0	76	152	1	76	0.0131579
NODE_301776_length_192_cov_160.258065	0	76	155	1	76	0.0131579
NODE_301776_length_192_cov_160.258065	0	76	156	1	76	0.0131579
NODE_301776_length_192_cov_160.258065	0	76	171	1	76	0.0131579
NODE_301776_length_192_cov_160.258065	0	76	173	2	76	0.0263158
NODE_301776_length_192_cov_160.258065	0	76	177	1	76	0.0131579
NODE_301776_length_192_cov_160.258065	0	76	181	1	76	0.0131579
NODE_301776_length_192_cov_160.258065	0	76	187	1	76	0.0131579
NODE_301776_length_192_cov_160.258065	0	76	192	1	76	0.0131579
NODE_301776_length_192_cov_160.258065	0	76	196	1	76	0.0131579
NODE_301776_length_192_cov_160.258065	0	76	203	1	76	0.0131579
NODE_301776_length_192_cov_160.258065	0	76	207	1	76	0.0131579
NODE_301776_length_192_cov_160.258065	0	76	209	1	76	0.0131579
NODE_301776_length_192_cov_160.258065	0	76	210	1	76	0.0131579
NODE_301776_length_192_cov_160.258065	0	76	213	1	76	0.0131579
NODE_301776_length_192_cov_160.258065	0	76	217	1	76	0.0131579
NODE_301776_length_192_cov_160.258065	0	76	223	1	76	0.0131579
NODE_301776_length_192_cov_160.258065	0	76	234	2	76	0.0263158
NODE_301776_length_192_cov_160.258065	0	76	242	2	76	0.0263158
NODE_301776_length_192_cov_160.258065	0	76	253	1	76	0.0131579
NODE_301776_length_192_cov_160.258065	0	76	254	1	76	0.0131579
NODE_301776_length_192_cov_160.258065	0	76	273	1	76	0.0131579
NODE_301776_length_192_cov_160.258065	0	76	276	1	76	0.0131579
NODE_301776_length_192_cov_160.258065	0	76	278	2	76	0.0263158
NODE_301776_length_192_cov_160.258065	0	76	279	1	76	0.0131579
NODE_301776_length_192_cov_160.258065	0	76	281	1	76	0.0131579
NODE_301776_length_192_cov_160.258065	0	76	285	1	76	0.0131579
NODE_301776_length_192_cov_160.258065	0	76	289	1	76	0.0131579
NODE_301776_length_192_cov_160.258065	0	76	297	1	76	0.0131579
NODE_301776_length_192_cov_160.258065	0	76	302	1	76	0.0131579
NODE_301776_length_192_cov_160.258065	0	76	308	1	76	0.0131579
NODE_301776_length_192_cov_160.258065	0	76	314	1	76	0.0131579
NODE_301776_length_192_cov_160.258065	0	76	318	1	76	0.0131579
NODE_301776_length_192_cov_160.258065	0	76	330	2	76	0.0263158
NODE_301776_length_192_cov_160.258065	0	76	340	1	76	0.0131579
NODE_301776_length_192_cov_160.258065	0	76	346	1	76	0.0131579
NODE_301776_length_192_cov_160.258065	0	76	355	1	76	0.0131579
NODE_301776_length_192_cov_160.258065	0	76	362	1	76	0.0131579
NODE_301776_length_192_cov_160.258065	0	76	372	1	76	0.0131579
NODE_301776_length_192_cov_160.258065	0	76	380	1	76	0.0131579
NODE_301776_length_192_cov_160.258065	0	76	393	1	76	0.0131579
NODE_301776_length_192_cov_160.258065	0	76	399	1	76	0.0131579
NODE_301776_length_192_cov_160.258065	0	76	414	1	76	0.0131579
NODE_301776_length_192_cov_160.258065	0	76	417	1	76	0.0131579
NODE_301776_length_192_cov_160.258065	0	76	425	1	76	0.0131579
NODE_301776_length_192_cov_160.258065	0	76	428	1	76	0.0131579
NODE_301776_length_192_cov_160.258065	0	76	454	1	76	0.0131579
NODE_301776_length_192_cov_160.258065	0	76	456	2	76	0.0263158
NODE_301825_length_191_cov_92.913043	81	144	0	63	63	1.0000000
NODE_301855_length_190_cov_112.285714	8	91	0	83	83	1.0000000
NODE_301859_length_190_cov_41.373626	92	172	16	9	80	0.1125000
NODE_301859_length_190_cov_41.373626	92	172	24	4	80	0.0500000
NODE_301859_length_190_cov_41.373626	92	172	26	4	80	0.0500000
NODE_301859_length_190_cov_41.373626	92	172	28	3	80	0.0375000
NODE_301859_length_190_cov_41.373626	92	172	30	5	80	0.0625000
NODE_301859_length_190_cov_41.373626	92	172	36	6	80	0.0750000
NODE_301859_length_190_cov_41.373626	92	172	40	3	80	0.0375000
NODE_301859_length_190_cov_41.373626	92	172	44	7	80	0.0875000
NODE_301859_length_190_cov_41.373626	92	172	46	11	80	0.1375000
NODE_301859_length_190_cov_41.373626	92	172	48	28	80	0.3500000
NODE_301859_length_190_cov_41.373626	145	190	0	4	45	0.0888889
NODE_301859_length_190_cov_41.373626	145	190	1	1	45	0.0222222
NODE_301859_length_190_cov_41.373626	145	190	2	1	45	0.0222222
NODE_301859_length_190_cov_41.373626	145	190	3	5	45	0.1111111
NODE_301859_length_190_cov_41.373626	145	190	8	2	45	0.0444444
NODE_301859_length_190_cov_41.373626	145	190	12	2	45	0.0444444
NODE_301859_length_190_cov_41.373626	145	190	16	12	45	0.2666667
NODE_301859_length_190_cov_41.373626	145	190	24	4	45	0.0888889
NODE_301859_length_190_cov_41.373626	145	190	26	4	45	0.0888889
NODE_301859_length_190_cov_41.373626	145	190	28	3	45	0.0666667
NODE_301859_length_190_cov_41.373626	145	190	30	5	45	0.1111111
NODE_301859_length_190_cov_41.373626	145	190	36	2	45	0.0444444
NODE_301880_length_189_cov_234.500000	19	88	0	69	69	1.0000000
NODE_301882_length_189_cov_192.211111	134	186	0	33	52	0.6346154
NODE_301882_length_189_cov_192.211111	134	186	4	19	52	0.3653846
NODE_301885_length_189_cov_70.600000	19	88	0	69	69	1.0000000
NODE_301885_length_189_cov_70.600000	72	156	0	84	84	1.0000000
NODE_301886_length_189_cov_63.455556	70	150	125	4	80	0.0500000
NODE_301886_length_189_cov_63.455556	70	150	126	3	80	0.0375000
NODE_301886_length_189_cov_63.455556	70	150	130	1	80	0.0125000
NODE_301886_length_189_cov_63.455556	70	150	131	9	80	0.1125000
NODE_301886_length_189_cov_63.455556	70	150	133	2	80	0.0250000
NODE_301886_length_189_cov_63.455556	70	150	137	3	80	0.0375000
NODE_301886_length_189_cov_63.455556	70	150	141	4	80	0.0500000
NODE_301886_length_189_cov_63.455556	70	150	143	1	80	0.0125000
NODE_301886_length_189_cov_63.455556	70	150	147	1	80	0.0125000
NODE_301886_length_189_cov_63.455556	70	150	151	4	80	0.0500000
NODE_301886_length_189_cov_63.455556	70	150	160	4	80	0.0500000
NODE_301886_length_189_cov_63.455556	70	150	162	1	80	0.0125000
NODE_301886_length_189_cov_63.455556	70	150	164	1	80	0.0125000
NODE_301886_length_189_cov_63.455556	70	150	172	2	80	0.0250000
NODE_301886_length_189_cov_63.455556	70	150	174	1	80	0.0125000
NODE_301886_length_189_cov_63.455556	70	150	176	1	80	0.0125000
NODE_301886_length_189_cov_63.455556	70	150	184	2	80	0.0250000
NODE_301886_length_189_cov_63.455556	70	150	186	3	80	0.0375000
NODE_301886_length_189_cov_63.455556	70	150	188	1	80	0.0125000
NODE_301886_length_189_cov_63.455556	70	150	198	1	80	0.0125000
NODE_301886_length_189_cov_63.455556	70	150	200	1	80	0.0125000
NODE_301886_length_189_cov_63.455556	70	150	204	3	80	0.0375000
NODE_301886_length_189_cov_63.455556	70	150	205	2	80	0.0250000
NODE_301886_length_189_cov_63.455556	70	150	206	1	80	0.0125000
NODE_301886_length_189_cov_63.455556	70	150	207	1	80	0.0125000
NODE_301886_length_189_cov_63.455556	70	150	210	4	80	0.0500000
NODE_301886_length_189_cov_63.455556	70	150	213	2	80	0.0250000
NODE_301886_length_189_cov_63.455556	70	150	216	1	80	0.0125000
NODE_301886_length_189_cov_63.455556	70	150	217	16	80	0.2000000
NODE_301886_length_189_cov_63.455556	70	141	131	8	71	0.1126761
NODE_301886_length_189_cov_63.455556	70	141	133	2	71	0.0281690
NODE_301886_length_189_cov_63.455556	70	141	137	3	71	0.0422535
NODE_301886_length_189_cov_63.455556	70	141	141	4	71	0.0563380
NODE_301886_length_189_cov_63.455556	70	141	143	1	71	0.0140845
NODE_301886_length_189_cov_63.455556	70	141	147	1	71	0.0140845
NODE_301886_length_189_cov_63.455556	70	141	151	4	71	0.0563380
NODE_301886_length_189_cov_63.455556	70	141	160	4	71	0.0563380
NODE_301886_length_189_cov_63.455556	70	141	162	1	71	0.0140845
NODE_301886_length_189_cov_63.455556	70	141	164	1	71	0.0140845
NODE_301886_length_189_cov_63.455556	70	141	172	2	71	0.0281690
NODE_301886_length_189_cov_63.455556	70	141	174	1	71	0.0140845
NODE_301886_length_189_cov_63.455556	70	141	176	1	71	0.0140845
NODE_301886_length_189_cov_63.455556	70	141	184	2	71	0.0281690
NODE_301886_length_189_cov_63.455556	70	141	186	3	71	0.0422535
NODE_301886_length_189_cov_63.455556	70	141	188	1	71	0.0140845
NODE_301886_length_189_cov_63.455556	70	141	198	1	71	0.0140845
NODE_301886_length_189_cov_63.455556	70	141	200	1	71	0.0140845
NODE_301886_length_189_cov_63.455556	70	141	204	3	71	0.0422535
NODE_301886_length_189_cov_63.455556	70	141	205	2	71	0.0281690
NODE_301886_length_189_cov_63.455556	70	141	206	1	71	0.0140845
NODE_301886_length_189_cov_63.455556	70	141	207	1	71	0.0140845
NODE_301886_length_189_cov_63.455556	70	141	210	4	71	0.0563380
NODE_301886_length_189_cov_63.455556	70	141	213	2	71	0.0281690
NODE_301886_length_189_cov_63.455556	70	141	216	1	71	0.0140845
NODE_301886_length_189_cov_63.455556	70	141	217	16	71	0.2253521
NODE_301891_length_189_cov_43.600000	0	73	6	4	73	0.0547945
NODE_301891_length_189_cov_43.600000	0	73	10	1	73	0.0136986
NODE_301891_length_189_cov_43.600000	0	73	11	1	73	0.0136986
NODE_301891_length_189_cov_43.600000	0	73	13	1	73	0.0136986
NODE_301891_length_189_cov_43.600000	0	73	15	1	73	0.0136986
NODE_301891_length_189_cov_43.600000	0	73	17	3	73	0.0410959
NODE_301891_length_189_cov_43.600000	0	73	23	3	73	0.0410959
NODE_301891_length_189_cov_43.600000	0	73	27	1	73	0.0136986
NODE_301891_length_189_cov_43.600000	0	73	31	2	73	0.0273973
NODE_301891_length_189_cov_43.600000	0	73	35	1	73	0.0136986
NODE_301891_length_189_cov_43.600000	0	73	37	1	73	0.0136986
NODE_301891_length_189_cov_43.600000	0	73	39	1	73	0.0136986
NODE_301891_length_189_cov_43.600000	0	73	41	3	73	0.0410959
NODE_301891_length_189_cov_43.600000	0	73	45	1	73	0.0136986
NODE_301891_length_189_cov_43.600000	0	73	49	1	73	0.0136986
NODE_301891_length_189_cov_43.600000	0	73	52	1	73	0.0136986
NODE_301891_length_189_cov_43.600000	0	73	54	1	73	0.0136986
NODE_301891_length_189_cov_43.600000	0	73	56	1	73	0.0136986
NODE_301891_length_189_cov_43.600000	0	73	57	1	73	0.0136986
NODE_301891_length_189_cov_43.600000	0	73	63	2	73	0.0273973
NODE_301891_length_189_cov_43.600000	0	73	67	1	73	0.0136986
NODE_301891_length_189_cov_43.600000	0	73	71	2	73	0.0273973
NODE_301891_length_189_cov_43.600000	0	73	73	1	73	0.0136986
NODE_301891_length_189_cov_43.600000	0	73	75	3	73	0.0410959
NODE_301891_length_189_cov_43.600000	0	73	79	1	73	0.0136986
NODE_301891_length_189_cov_43.600000	0	73	81	1	73	0.0136986
NODE_301891_length_189_cov_43.600000	0	73	83	1	73	0.0136986
NODE_301891_length_189_cov_43.600000	0	73	93	6	73	0.0821918
NODE_301891_length_189_cov_43.600000	0	73	95	3	73	0.0410959
NODE_301891_length_189_cov_43.600000	0	73	96	5	73	0.0684932
NODE_301891_length_189_cov_43.600000	0	73	102	4	73	0.0547945
NODE_301891_length_189_cov_43.600000	0	73	104	1	73	0.0136986
NODE_301891_length_189_cov_43.600000	0	73	106	2	73	0.0273973
NODE_301891_length_189_cov_43.600000	0	73	108	1	73	0.0136986
NODE_301891_length_189_cov_43.600000	0	73	110	3	73	0.0410959
NODE_301891_length_189_cov_43.600000	0	73	112	4	73	0.0547945
NODE_301891_length_189_cov_43.600000	0	73	114	3	73	0.0410959
NODE_301940_length_188_cov_2021.561798	108	188	54	1	80	0.0125000
NODE_301940_length_188_cov_2021.561798	108	188	60	1	80	0.0125000
NODE_301940_length_188_cov_2021.561798	108	188	67	1	80	0.0125000
NODE_301940_length_188_cov_2021.561798	108	188	81	1	80	0.0125000
NODE_301940_length_188_cov_2021.561798	108	188	122	1	80	0.0125000
NODE_301940_length_188_cov_2021.561798	108	188	145	1	80	0.0125000
NODE_301940_length_188_cov_2021.561798	108	188	208	1	80	0.0125000
NODE_301940_length_188_cov_2021.561798	108	188	213	1	80	0.0125000
NODE_301940_length_188_cov_2021.561798	108	188	218	1	80	0.0125000
NODE_301940_length_188_cov_2021.561798	108	188	224	1	80	0.0125000
NODE_301940_length_188_cov_2021.561798	108	188	243	1	80	0.0125000
NODE_301940_length_188_cov_2021.561798	108	188	249	1	80	0.0125000
NODE_301940_length_188_cov_2021.561798	108	188	259	1	80	0.0125000
NODE_301940_length_188_cov_2021.561798	108	188	270	1	80	0.0125000
NODE_301940_length_188_cov_2021.561798	108	188	327	1	80	0.0125000
NODE_301940_length_188_cov_2021.561798	108	188	338	2	80	0.0250000
NODE_301940_length_188_cov_2021.561798	108	188	339	1	80	0.0125000
NODE_301940_length_188_cov_2021.561798	108	188	359	1	80	0.0125000
NODE_301940_length_188_cov_2021.561798	108	188	362	3	80	0.0375000
NODE_301940_length_188_cov_2021.561798	108	188	379	1	80	0.0125000
NODE_301940_length_188_cov_2021.561798	108	188	409	1	80	0.0125000
NODE_301940_length_188_cov_2021.561798	108	188	424	2	80	0.0250000
NODE_301940_length_188_cov_2021.561798	108	188	444	1	80	0.0125000
NODE_301940_length_188_cov_2021.561798	108	188	462	1	80	0.0125000
NODE_301940_length_188_cov_2021.561798	108	188	484	1	80	0.0125000
NODE_301940_length_188_cov_2021.561798	108	188	498	1	80	0.0125000
NODE_301940_length_188_cov_2021.561798	108	188	502	1	80	0.0125000
NODE_301940_length_188_cov_2021.561798	108	188	504	1	80	0.0125000
NODE_301940_length_188_cov_2021.561798	108	188	506	1	80	0.0125000
NODE_301940_length_188_cov_2021.561798	108	188	515	1	80	0.0125000
NODE_301940_length_188_cov_2021.561798	108	188	520	1	80	0.0125000
NODE_301940_length_188_cov_2021.561798	108	188	536	1	80	0.0125000
NODE_301940_length_188_cov_2021.561798	108	188	549	1	80	0.0125000
NODE_301940_length_188_cov_2021.561798	108	188	555	2	80	0.0250000
NODE_301940_length_188_cov_2021.561798	108	188	562	1	80	0.0125000
NODE_301940_length_188_cov_2021.561798	108	188	573	1	80	0.0125000
NODE_301940_length_188_cov_2021.561798	108	188	592	1	80	0.0125000
NODE_301940_length_188_cov_2021.561798	108	188	596	1	80	0.0125000
NODE_301940_length_188_cov_2021.561798	108	188	604	1	80	0.0125000
NODE_301940_length_188_cov_2021.561798	108	188	622	1	80	0.0125000
NODE_301940_length_188_cov_2021.561798	108	188	630	1	80	0.0125000
NODE_301940_length_188_cov_2021.561798	108	188	634	2	80	0.0250000
NODE_301940_length_188_cov_2021.561798	108	188	636	1	80	0.0125000
NODE_301940_length_188_cov_2021.561798	108	188	640	1	80	0.0125000
NODE_301940_length_188_cov_2021.561798	108	188	643	1	80	0.0125000
NODE_301940_length_188_cov_2021.561798	108	188	651	1	80	0.0125000
NODE_301940_length_188_cov_2021.561798	108	188	653	1	80	0.0125000
NODE_301940_length_188_cov_2021.561798	108	188	660	3	80	0.0375000
NODE_301940_length_188_cov_2021.561798	108	188	661	1	80	0.0125000
NODE_301940_length_188_cov_2021.561798	108	188	667	1	80	0.0125000
NODE_301940_length_188_cov_2021.561798	108	188	677	1	80	0.0125000
NODE_301940_length_188_cov_2021.561798	108	188	680	2	80	0.0250000
NODE_301940_length_188_cov_2021.561798	108	188	684	1	80	0.0125000
NODE_301940_length_188_cov_2021.561798	108	188	686	2	80	0.0250000
NODE_301940_length_188_cov_2021.561798	108	188	691	1	80	0.0125000
NODE_301940_length_188_cov_2021.561798	108	188	692	1	80	0.0125000
NODE_301940_length_188_cov_2021.561798	108	188	699	1	80	0.0125000
NODE_301940_length_188_cov_2021.561798	108	188	703	1	80	0.0125000
NODE_301940_length_188_cov_2021.561798	108	188	705	1	80	0.0125000
NODE_301940_length_188_cov_2021.561798	108	188	707	1	80	0.0125000
NODE_301940_length_188_cov_2021.561798	108	188	711	1	80	0.0125000
NODE_301940_length_188_cov_2021.561798	108	188	712	1	80	0.0125000
NODE_301940_length_188_cov_2021.561798	108	188	720	2	80	0.0250000
NODE_301940_length_188_cov_2021.561798	108	188	724	3	80	0.0375000
NODE_301940_length_188_cov_2021.561798	108	188	726	2	80	0.0250000
NODE_301940_length_188_cov_2021.561798	108	188	728	1	80	0.0125000
NODE_301940_length_188_cov_2021.561798	161	183	145	1	22	0.0454545
NODE_301940_length_188_cov_2021.561798	161	183	208	1	22	0.0454545
NODE_301940_length_188_cov_2021.561798	161	183	213	1	22	0.0454545
NODE_301940_length_188_cov_2021.561798	161	183	218	1	22	0.0454545
NODE_301940_length_188_cov_2021.561798	161	183	224	1	22	0.0454545
NODE_301940_length_188_cov_2021.561798	161	183	243	1	22	0.0454545
NODE_301940_length_188_cov_2021.561798	161	183	249	1	22	0.0454545
NODE_301940_length_188_cov_2021.561798	161	183	259	1	22	0.0454545
NODE_301940_length_188_cov_2021.561798	161	183	270	1	22	0.0454545
NODE_301940_length_188_cov_2021.561798	161	183	327	1	22	0.0454545
NODE_301940_length_188_cov_2021.561798	161	183	338	2	22	0.0909091
NODE_301940_length_188_cov_2021.561798	161	183	339	1	22	0.0454545
NODE_301940_length_188_cov_2021.561798	161	183	359	1	22	0.0454545
NODE_301940_length_188_cov_2021.561798	161	183	362	3	22	0.1363636
NODE_301940_length_188_cov_2021.561798	161	183	379	1	22	0.0454545
NODE_301940_length_188_cov_2021.561798	161	183	409	1	22	0.0454545
NODE_301940_length_188_cov_2021.561798	161	183	424	2	22	0.0909091
NODE_301940_length_188_cov_2021.561798	161	183	444	1	22	0.0454545
NODE_301952_length_188_cov_37.988764	0	50	0	32	50	0.6400000
NODE_301952_length_188_cov_37.988764	0	50	2	2	50	0.0400000
NODE_301952_length_188_cov_37.988764	0	50	4	16	50	0.3200000
NODE_301980_length_187_cov_71.170455	124	155	0	31	31	1.0000000
NODE_301981_length_187_cov_56.000000	72	136	130	4	64	0.0625000
NODE_301981_length_187_cov_56.000000	72	136	138	2	64	0.0312500
NODE_301981_length_187_cov_56.000000	72	136	144	1	64	0.0156250
NODE_301981_length_187_cov_56.000000	72	136	146	1	64	0.0156250
NODE_301981_length_187_cov_56.000000	72	136	168	1	64	0.0156250
NODE_301981_length_187_cov_56.000000	72	136	170	1	64	0.0156250
NODE_301981_length_187_cov_56.000000	72	136	177	1	64	0.0156250
NODE_301981_length_187_cov_56.000000	72	136	180	1	64	0.0156250
NODE_301981_length_187_cov_56.000000	72	136	182	1	64	0.0156250
NODE_301981_length_187_cov_56.000000	72	136	188	1	64	0.0156250
NODE_301981_length_187_cov_56.000000	72	136	190	1	64	0.0156250
NODE_301981_length_187_cov_56.000000	72	136	192	1	64	0.0156250
NODE_301981_length_187_cov_56.000000	72	136	196	1	64	0.0156250
NODE_301981_length_187_cov_56.000000	72	136	198	1	64	0.0156250
NODE_301981_length_187_cov_56.000000	72	136	200	1	64	0.0156250
NODE_301981_length_187_cov_56.000000	72	136	202	1	64	0.0156250
NODE_301981_length_187_cov_56.000000	72	136	208	3	64	0.0468750
NODE_301981_length_187_cov_56.000000	72	136	210	3	64	0.0468750
NODE_301981_length_187_cov_56.000000	72	136	212	1	64	0.0156250
NODE_301981_length_187_cov_56.000000	72	136	216	8	64	0.1250000
NODE_301981_length_187_cov_56.000000	72	136	218	29	64	0.4531250
NODE_301981_length_187_cov_56.000000	72	136	130	4	64	0.0625000
NODE_301981_length_187_cov_56.000000	72	136	138	2	64	0.0312500
NODE_301981_length_187_cov_56.000000	72	136	144	1	64	0.0156250
NODE_301981_length_187_cov_56.000000	72	136	146	1	64	0.0156250
NODE_301981_length_187_cov_56.000000	72	136	168	1	64	0.0156250
NODE_301981_length_187_cov_56.000000	72	136	170	1	64	0.0156250
NODE_301981_length_187_cov_56.000000	72	136	177	1	64	0.0156250
NODE_301981_length_187_cov_56.000000	72	136	180	1	64	0.0156250
NODE_301981_length_187_cov_56.000000	72	136	182	1	64	0.0156250
NODE_301981_length_187_cov_56.000000	72	136	188	1	64	0.0156250
NODE_301981_length_187_cov_56.000000	72	136	190	1	64	0.0156250
NODE_301981_length_187_cov_56.000000	72	136	192	1	64	0.0156250
NODE_301981_length_187_cov_56.000000	72	136	196	1	64	0.0156250
NODE_301981_length_187_cov_56.000000	72	136	198	1	64	0.0156250
NODE_301981_length_187_cov_56.000000	72	136	200	1	64	0.0156250
NODE_301981_length_187_cov_56.000000	72	136	202	1	64	0.0156250
NODE_301981_length_187_cov_56.000000	72	136	208	3	64	0.0468750
NODE_301981_length_187_cov_56.000000	72	136	210	3	64	0.0468750
NODE_301981_length_187_cov_56.000000	72	136	212	1	64	0.0156250
NODE_301981_length_187_cov_56.000000	72	136	216	8	64	0.1250000
NODE_301981_length_187_cov_56.000000	72	136	218	29	64	0.4531250
NODE_301981_length_187_cov_56.000000	109	175	17	1	66	0.0151515
NODE_301981_length_187_cov_56.000000	109	175	20	2	66	0.0303030
NODE_301981_length_187_cov_56.000000	109	175	22	3	66	0.0454545
NODE_301981_length_187_cov_56.000000	109	175	29	2	66	0.0303030
NODE_301981_length_187_cov_56.000000	109	175	35	1	66	0.0151515
NODE_301981_length_187_cov_56.000000	109	175	37	1	66	0.0151515
NODE_301981_length_187_cov_56.000000	109	175	39	1	66	0.0151515
NODE_301981_length_187_cov_56.000000	109	175	41	4	66	0.0606061
NODE_301981_length_187_cov_56.000000	109	175	43	3	66	0.0454545
NODE_301981_length_187_cov_56.000000	109	175	53	1	66	0.0151515
NODE_301981_length_187_cov_56.000000	109	175	55	1	66	0.0151515
NODE_301981_length_187_cov_56.000000	109	175	60	1	66	0.0151515
NODE_301981_length_187_cov_56.000000	109	175	62	1	66	0.0151515
NODE_301981_length_187_cov_56.000000	109	175	67	1	66	0.0151515
NODE_301981_length_187_cov_56.000000	109	175	68	2	66	0.0303030
NODE_301981_length_187_cov_56.000000	109	175	70	2	66	0.0303030
NODE_301981_length_187_cov_56.000000	109	175	74	1	66	0.0151515
NODE_301981_length_187_cov_56.000000	109	175	77	1	66	0.0151515
NODE_301981_length_187_cov_56.000000	109	175	85	1	66	0.0151515
NODE_301981_length_187_cov_56.000000	109	175	92	1	66	0.0151515
NODE_301981_length_187_cov_56.000000	109	175	94	3	66	0.0454545
NODE_301981_length_187_cov_56.000000	109	175	98	3	66	0.0454545
NODE_301981_length_187_cov_56.000000	109	175	104	1	66	0.0151515
NODE_301981_length_187_cov_56.000000	109	175	116	1	66	0.0151515
NODE_301981_length_187_cov_56.000000	109	175	130	4	66	0.0606061
NODE_301981_length_187_cov_56.000000	109	175	138	2	66	0.0303030
NODE_301981_length_187_cov_56.000000	109	175	144	1	66	0.0151515
NODE_301981_length_187_cov_56.000000	109	175	146	1	66	0.0151515
NODE_301981_length_187_cov_56.000000	109	175	168	1	66	0.0151515
NODE_301981_length_187_cov_56.000000	109	175	170	1	66	0.0151515
NODE_301981_length_187_cov_56.000000	109	175	177	1	66	0.0151515
NODE_301981_length_187_cov_56.000000	109	175	180	1	66	0.0151515
NODE_301981_length_187_cov_56.000000	109	175	182	1	66	0.0151515
NODE_301981_length_187_cov_56.000000	109	175	188	1	66	0.0151515
NODE_301981_length_187_cov_56.000000	109	175	190	1	66	0.0151515
NODE_301981_length_187_cov_56.000000	109	175	192	1	66	0.0151515
NODE_301981_length_187_cov_56.000000	109	175	196	1	66	0.0151515
NODE_301981_length_187_cov_56.000000	109	175	198	1	66	0.0151515
NODE_301981_length_187_cov_56.000000	109	175	200	1	66	0.0151515
NODE_301981_length_187_cov_56.000000	109	175	202	1	66	0.0151515
NODE_301981_length_187_cov_56.000000	109	175	210	2	66	0.0303030
NODE_301981_length_187_cov_56.000000	109	175	216	1	66	0.0151515
NODE_301981_length_187_cov_56.000000	109	175	218	4	66	0.0606061
NODE_301981_length_187_cov_56.000000	109	180	11	1	71	0.0140845
NODE_301981_length_187_cov_56.000000	109	180	14	2	71	0.0281690
NODE_301981_length_187_cov_56.000000	109	180	15	2	71	0.0281690
NODE_301981_length_187_cov_56.000000	109	180	17	1	71	0.0140845
NODE_301981_length_187_cov_56.000000	109	180	20	2	71	0.0281690
NODE_301981_length_187_cov_56.000000	109	180	22	3	71	0.0422535
NODE_301981_length_187_cov_56.000000	109	180	29	2	71	0.0281690
NODE_301981_length_187_cov_56.000000	109	180	35	1	71	0.0140845
NODE_301981_length_187_cov_56.000000	109	180	37	1	71	0.0140845
NODE_301981_length_187_cov_56.000000	109	180	39	1	71	0.0140845
NODE_301981_length_187_cov_56.000000	109	180	41	4	71	0.0563380
NODE_301981_length_187_cov_56.000000	109	180	43	3	71	0.0422535
NODE_301981_length_187_cov_56.000000	109	180	53	1	71	0.0140845
NODE_301981_length_187_cov_56.000000	109	180	55	1	71	0.0140845
NODE_301981_length_187_cov_56.000000	109	180	60	1	71	0.0140845
NODE_301981_length_187_cov_56.000000	109	180	62	1	71	0.0140845
NODE_301981_length_187_cov_56.000000	109	180	67	1	71	0.0140845
NODE_301981_length_187_cov_56.000000	109	180	68	2	71	0.0281690
NODE_301981_length_187_cov_56.000000	109	180	70	2	71	0.0281690
NODE_301981_length_187_cov_56.000000	109	180	74	1	71	0.0140845
NODE_301981_length_187_cov_56.000000	109	180	77	1	71	0.0140845
NODE_301981_length_187_cov_56.000000	109	180	85	1	71	0.0140845
NODE_301981_length_187_cov_56.000000	109	180	92	1	71	0.0140845
NODE_301981_length_187_cov_56.000000	109	180	94	3	71	0.0422535
NODE_301981_length_187_cov_56.000000	109	180	98	3	71	0.0422535
NODE_301981_length_187_cov_56.000000	109	180	104	1	71	0.0140845
NODE_301981_length_187_cov_56.000000	109	180	116	1	71	0.0140845
NODE_301981_length_187_cov_56.000000	109	180	130	4	71	0.0563380
NODE_301981_length_187_cov_56.000000	109	180	138	2	71	0.0281690
NODE_301981_length_187_cov_56.000000	109	180	144	1	71	0.0140845
NODE_301981_length_187_cov_56.000000	109	180	146	1	71	0.0140845
NODE_301981_length_187_cov_56.000000	109	180	168	1	71	0.0140845
NODE_301981_length_187_cov_56.000000	109	180	170	1	71	0.0140845
NODE_301981_length_187_cov_56.000000	109	180	177	1	71	0.0140845
NODE_301981_length_187_cov_56.000000	109	180	180	1	71	0.0140845
NODE_301981_length_187_cov_56.000000	109	180	182	1	71	0.0140845
NODE_301981_length_187_cov_56.000000	109	180	188	1	71	0.0140845
NODE_301981_length_187_cov_56.000000	109	180	190	1	71	0.0140845
NODE_301981_length_187_cov_56.000000	109	180	192	1	71	0.0140845
NODE_301981_length_187_cov_56.000000	109	180	196	1	71	0.0140845
NODE_301981_length_187_cov_56.000000	109	180	198	1	71	0.0140845
NODE_301981_length_187_cov_56.000000	109	180	200	1	71	0.0140845
NODE_301981_length_187_cov_56.000000	109	180	202	1	71	0.0140845
NODE_301981_length_187_cov_56.000000	109	180	210	2	71	0.0281690
NODE_301981_length_187_cov_56.000000	109	180	216	1	71	0.0140845
NODE_301981_length_187_cov_56.000000	109	180	218	4	71	0.0563380
NODE_301986_length_187_cov_37.397727	4	57	4	12	53	0.2264151
NODE_301986_length_187_cov_37.397727	4	57	6	2	53	0.0377358
NODE_301986_length_187_cov_37.397727	4	57	10	7	53	0.1320755
NODE_301986_length_187_cov_37.397727	4	57	13	3	53	0.0566038
NODE_301986_length_187_cov_37.397727	4	57	17	1	53	0.0188679
NODE_301986_length_187_cov_37.397727	4	57	18	1	53	0.0188679
NODE_301986_length_187_cov_37.397727	4	57	24	1	53	0.0188679
NODE_301986_length_187_cov_37.397727	4	57	28	4	53	0.0754717
NODE_301986_length_187_cov_37.397727	4	57	32	1	53	0.0188679
NODE_301986_length_187_cov_37.397727	4	57	38	2	53	0.0377358
NODE_301986_length_187_cov_37.397727	4	57	40	2	53	0.0377358
NODE_301986_length_187_cov_37.397727	4	57	44	1	53	0.0188679
NODE_301986_length_187_cov_37.397727	4	57	46	2	53	0.0377358
NODE_301986_length_187_cov_37.397727	4	57	48	3	53	0.0566038
NODE_301986_length_187_cov_37.397727	4	57	51	3	53	0.0566038
NODE_301986_length_187_cov_37.397727	4	57	61	1	53	0.0188679
NODE_301986_length_187_cov_37.397727	4	57	67	1	53	0.0188679
NODE_301986_length_187_cov_37.397727	4	57	73	1	53	0.0188679
NODE_301986_length_187_cov_37.397727	4	57	76	1	53	0.0188679
NODE_301986_length_187_cov_37.397727	4	57	77	1	53	0.0188679
NODE_301986_length_187_cov_37.397727	4	57	78	1	53	0.0188679
NODE_301986_length_187_cov_37.397727	4	57	82	1	53	0.0188679
NODE_301986_length_187_cov_37.397727	4	57	86	1	53	0.0188679
NODE_301986_length_187_cov_37.397727	12	78	4	4	66	0.0606061
NODE_301986_length_187_cov_37.397727	12	78	6	2	66	0.0303030
NODE_301986_length_187_cov_37.397727	12	78	10	7	66	0.1060606
NODE_301986_length_187_cov_37.397727	12	78	13	3	66	0.0454545
NODE_301986_length_187_cov_37.397727	12	78	17	1	66	0.0151515
NODE_301986_length_187_cov_37.397727	12	78	18	1	66	0.0151515
NODE_301986_length_187_cov_37.397727	12	78	24	1	66	0.0151515
NODE_301986_length_187_cov_37.397727	12	78	28	4	66	0.0606061
NODE_301986_length_187_cov_37.397727	12	78	32	1	66	0.0151515
NODE_301986_length_187_cov_37.397727	12	78	38	2	66	0.0303030
NODE_301986_length_187_cov_37.397727	12	78	40	2	66	0.0303030
NODE_301986_length_187_cov_37.397727	12	78	44	1	66	0.0151515
NODE_301986_length_187_cov_37.397727	12	78	46	2	66	0.0303030
NODE_301986_length_187_cov_37.397727	12	78	48	3	66	0.0454545
NODE_301986_length_187_cov_37.397727	12	78	51	3	66	0.0454545
NODE_301986_length_187_cov_37.397727	12	78	61	1	66	0.0151515
NODE_301986_length_187_cov_37.397727	12	78	67	1	66	0.0151515
NODE_301986_length_187_cov_37.397727	12	78	73	1	66	0.0151515
NODE_301986_length_187_cov_37.397727	12	78	76	1	66	0.0151515
NODE_301986_length_187_cov_37.397727	12	78	77	1	66	0.0151515
NODE_301986_length_187_cov_37.397727	12	78	78	1	66	0.0151515
NODE_301986_length_187_cov_37.397727	12	78	82	1	66	0.0151515
NODE_301986_length_187_cov_37.397727	12	78	86	1	66	0.0151515
NODE_301986_length_187_cov_37.397727	12	78	89	2	66	0.0303030
NODE_301986_length_187_cov_37.397727	12	78	98	2	66	0.0303030
NODE_301986_length_187_cov_37.397727	12	78	100	2	66	0.0303030
NODE_301986_length_187_cov_37.397727	12	78	104	1	66	0.0151515
NODE_301986_length_187_cov_37.397727	12	78	108	3	66	0.0454545
NODE_301986_length_187_cov_37.397727	12	78	110	1	66	0.0151515
NODE_301986_length_187_cov_37.397727	12	78	118	1	66	0.0151515
NODE_301986_length_187_cov_37.397727	12	78	120	1	66	0.0151515
NODE_301986_length_187_cov_37.397727	12	78	128	1	66	0.0151515
NODE_301986_length_187_cov_37.397727	12	78	130	1	66	0.0151515
NODE_301986_length_187_cov_37.397727	12	78	132	1	66	0.0151515
NODE_301986_length_187_cov_37.397727	12	78	134	3	66	0.0454545
NODE_301986_length_187_cov_37.397727	12	78	136	2	66	0.0303030
NODE_301986_length_187_cov_37.397727	51	112	73	1	61	0.0163934
NODE_301986_length_187_cov_37.397727	51	112	76	1	61	0.0163934
NODE_301986_length_187_cov_37.397727	51	112	77	1	61	0.0163934
NODE_301986_length_187_cov_37.397727	51	112	78	1	61	0.0163934
NODE_301986_length_187_cov_37.397727	51	112	82	1	61	0.0163934
NODE_301986_length_187_cov_37.397727	51	112	86	1	61	0.0163934
NODE_301986_length_187_cov_37.397727	51	112	89	2	61	0.0327869
NODE_301986_length_187_cov_37.397727	51	112	98	2	61	0.0327869
NODE_301986_length_187_cov_37.397727	51	112	100	2	61	0.0327869
NODE_301986_length_187_cov_37.397727	51	112	104	1	61	0.0163934
NODE_301986_length_187_cov_37.397727	51	112	108	3	61	0.0491803
NODE_301986_length_187_cov_37.397727	51	112	110	1	61	0.0163934
NODE_301986_length_187_cov_37.397727	51	112	118	1	61	0.0163934
NODE_301986_length_187_cov_37.397727	51	112	120	1	61	0.0163934
NODE_301986_length_187_cov_37.397727	51	112	128	1	61	0.0163934
NODE_301986_length_187_cov_37.397727	51	112	130	1	61	0.0163934
NODE_301986_length_187_cov_37.397727	51	112	132	1	61	0.0163934
NODE_301986_length_187_cov_37.397727	51	112	134	3	61	0.0491803
NODE_301986_length_187_cov_37.397727	51	112	136	6	61	0.0983607
NODE_301986_length_187_cov_37.397727	51	112	138	1	61	0.0163934
NODE_301986_length_187_cov_37.397727	51	112	140	6	61	0.0983607
NODE_301986_length_187_cov_37.397727	51	112	142	23	61	0.3770492
NODE_301986_length_187_cov_37.397727	51	114	73	1	63	0.0158730
NODE_301986_length_187_cov_37.397727	51	114	76	1	63	0.0158730
NODE_301986_length_187_cov_37.397727	51	114	77	1	63	0.0158730
NODE_301986_length_187_cov_37.397727	51	114	78	1	63	0.0158730
NODE_301986_length_187_cov_37.397727	51	114	82	1	63	0.0158730
NODE_301986_length_187_cov_37.397727	51	114	86	1	63	0.0158730
NODE_301986_length_187_cov_37.397727	51	114	89	2	63	0.0317460
NODE_301986_length_187_cov_37.397727	51	114	98	2	63	0.0317460
NODE_301986_length_187_cov_37.397727	51	114	100	2	63	0.0317460
NODE_301986_length_187_cov_37.397727	51	114	104	1	63	0.0158730
NODE_301986_length_187_cov_37.397727	51	114	108	3	63	0.0476190
NODE_301986_length_187_cov_37.397727	51	114	110	1	63	0.0158730
NODE_301986_length_187_cov_37.397727	51	114	118	1	63	0.0158730
NODE_301986_length_187_cov_37.397727	51	114	120	1	63	0.0158730
NODE_301986_length_187_cov_37.397727	51	114	128	1	63	0.0158730
NODE_301986_length_187_cov_37.397727	51	114	130	1	63	0.0158730
NODE_301986_length_187_cov_37.397727	51	114	132	1	63	0.0158730
NODE_301986_length_187_cov_37.397727	51	114	134	3	63	0.0476190
NODE_301986_length_187_cov_37.397727	51	114	136	6	63	0.0952381
NODE_301986_length_187_cov_37.397727	51	114	138	1	63	0.0158730
NODE_301986_length_187_cov_37.397727	51	114	140	8	63	0.1269841
NODE_301986_length_187_cov_37.397727	51	114	142	23	63	0.3650794
NODE_302020_length_186_cov_309.620690	20	104	0	84	84	1.0000000
NODE_302021_length_186_cov_295.505747	57	115	138	1	58	0.0172414
NODE_302021_length_186_cov_295.505747	57	115	142	3	58	0.0517241
NODE_302021_length_186_cov_295.505747	57	115	144	2	58	0.0344828
NODE_302021_length_186_cov_295.505747	57	115	154	1	58	0.0172414
NODE_302021_length_186_cov_295.505747	57	115	156	1	58	0.0172414
NODE_302021_length_186_cov_295.505747	57	115	159	1	58	0.0172414
NODE_302021_length_186_cov_295.505747	57	115	167	1	58	0.0172414
NODE_302021_length_186_cov_295.505747	57	115	168	1	58	0.0172414
NODE_302021_length_186_cov_295.505747	57	115	172	2	58	0.0344828
NODE_302021_length_186_cov_295.505747	57	115	174	9	58	0.1551724
NODE_302021_length_186_cov_295.505747	57	115	176	1	58	0.0172414
NODE_302021_length_186_cov_295.505747	57	115	177	1	58	0.0172414
NODE_302021_length_186_cov_295.505747	57	115	178	8	58	0.1379310
NODE_302021_length_186_cov_295.505747	57	115	180	6	58	0.1034483
NODE_302021_length_186_cov_295.505747	57	115	182	20	58	0.3448276
NODE_302021_length_186_cov_295.505747	101	168	60	3	67	0.0447761
NODE_302021_length_186_cov_295.505747	101	168	62	4	67	0.0597015
NODE_302021_length_186_cov_295.505747	101	168	70	1	67	0.0149254
NODE_302021_length_186_cov_295.505747	101	168	72	4	67	0.0597015
NODE_302021_length_186_cov_295.505747	101	168	84	10	67	0.1492537
NODE_302021_length_186_cov_295.505747	101	168	92	1	67	0.0149254
NODE_302021_length_186_cov_295.505747	101	168	93	2	67	0.0298507
NODE_302021_length_186_cov_295.505747	101	168	94	1	67	0.0149254
NODE_302021_length_186_cov_295.505747	101	168	102	1	67	0.0149254
NODE_302021_length_186_cov_295.505747	101	168	110	1	67	0.0149254
NODE_302021_length_186_cov_295.505747	101	168	112	7	67	0.1044776
NODE_302021_length_186_cov_295.505747	101	168	119	3	67	0.0447761
NODE_302021_length_186_cov_295.505747	101	168	127	1	67	0.0149254
NODE_302021_length_186_cov_295.505747	101	168	132	1	67	0.0149254
NODE_302021_length_186_cov_295.505747	101	168	139	2	67	0.0298507
NODE_302021_length_186_cov_295.505747	101	168	145	1	67	0.0149254
NODE_302021_length_186_cov_295.505747	101	168	147	1	67	0.0149254
NODE_302021_length_186_cov_295.505747	101	168	149	1	67	0.0149254
NODE_302021_length_186_cov_295.505747	101	168	155	1	67	0.0149254
NODE_302021_length_186_cov_295.505747	101	168	157	3	67	0.0447761
NODE_302021_length_186_cov_295.505747	101	168	161	1	67	0.0149254
NODE_302021_length_186_cov_295.505747	101	168	163	1	67	0.0149254
NODE_302021_length_186_cov_295.505747	101	168	169	1	67	0.0149254
NODE_302021_length_186_cov_295.505747	101	168	173	1	67	0.0149254
NODE_302021_length_186_cov_295.505747	101	168	174	9	67	0.1343284
NODE_302021_length_186_cov_295.505747	101	168	176	1	67	0.0149254
NODE_302021_length_186_cov_295.505747	101	168	177	1	67	0.0149254
NODE_302021_length_186_cov_295.505747	101	168	178	1	67	0.0149254
NODE_302021_length_186_cov_295.505747	101	168	180	1	67	0.0149254
NODE_302021_length_186_cov_295.505747	101	168	182	1	67	0.0149254
NODE_302025_length_186_cov_61.344828	38	118	38	1	80	0.0125000
NODE_302025_length_186_cov_61.344828	38	118	40	3	80	0.0375000
NODE_302025_length_186_cov_61.344828	38	118	42	1	80	0.0125000
NODE_302025_length_186_cov_61.344828	38	118	44	1	80	0.0125000
NODE_302025_length_186_cov_61.344828	38	118	50	2	80	0.0250000
NODE_302025_length_186_cov_61.344828	38	118	52	3	80	0.0375000
NODE_302025_length_186_cov_61.344828	38	118	56	4	80	0.0500000
NODE_302025_length_186_cov_61.344828	38	118	58	2	80	0.0250000
NODE_302025_length_186_cov_61.344828	38	118	60	3	80	0.0375000
NODE_302025_length_186_cov_61.344828	38	118	62	2	80	0.0250000
NODE_302025_length_186_cov_61.344828	38	118	66	12	80	0.1500000
NODE_302025_length_186_cov_61.344828	38	118	68	5	80	0.0625000
NODE_302025_length_186_cov_61.344828	38	118	70	11	80	0.1375000
NODE_302025_length_186_cov_61.344828	38	118	72	30	80	0.3750000
NODE_302025_length_186_cov_61.344828	91	171	28	2	80	0.0250000
NODE_302025_length_186_cov_61.344828	91	171	34	1	80	0.0125000
NODE_302025_length_186_cov_61.344828	91	171	38	2	80	0.0250000
NODE_302025_length_186_cov_61.344828	91	171	39	3	80	0.0375000
NODE_302025_length_186_cov_61.344828	91	171	40	1	80	0.0125000
NODE_302025_length_186_cov_61.344828	91	171	42	1	80	0.0125000
NODE_302025_length_186_cov_61.344828	91	171	50	7	80	0.0875000
NODE_302025_length_186_cov_61.344828	91	171	52	3	80	0.0375000
NODE_302025_length_186_cov_61.344828	91	171	54	5	80	0.0625000
NODE_302025_length_186_cov_61.344828	91	171	60	3	80	0.0375000
NODE_302025_length_186_cov_61.344828	91	171	62	6	80	0.0750000
NODE_302025_length_186_cov_61.344828	91	171	64	8	80	0.1000000
NODE_302025_length_186_cov_61.344828	91	171	66	1	80	0.0125000
NODE_302025_length_186_cov_61.344828	91	171	68	9	80	0.1125000
NODE_302025_length_186_cov_61.344828	91	171	70	12	80	0.1500000
NODE_302025_length_186_cov_61.344828	91	171	72	16	80	0.2000000
NODE_302201_length_182_cov_127.759036	6	52	45	1	46	0.0217391
NODE_302201_length_182_cov_127.759036	6	52	47	2	46	0.0434783
NODE_302201_length_182_cov_127.759036	6	52	49	2	46	0.0434783
NODE_302201_length_182_cov_127.759036	6	52	50	1	46	0.0217391
NODE_302201_length_182_cov_127.759036	6	52	52	1	46	0.0217391
NODE_302201_length_182_cov_127.759036	6	52	55	1	46	0.0217391
NODE_302201_length_182_cov_127.759036	6	52	56	1	46	0.0217391
NODE_302201_length_182_cov_127.759036	6	52	58	1	46	0.0217391
NODE_302201_length_182_cov_127.759036	6	52	59	3	46	0.0652174
NODE_302201_length_182_cov_127.759036	6	52	63	2	46	0.0434783
NODE_302201_length_182_cov_127.759036	6	52	65	2	46	0.0434783
NODE_302201_length_182_cov_127.759036	6	52	67	1	46	0.0217391
NODE_302201_length_182_cov_127.759036	6	52	68	2	46	0.0434783
NODE_302201_length_182_cov_127.759036	6	52	73	1	46	0.0217391
NODE_302201_length_182_cov_127.759036	6	52	75	3	46	0.0652174
NODE_302201_length_182_cov_127.759036	6	52	83	2	46	0.0434783
NODE_302201_length_182_cov_127.759036	6	52	85	2	46	0.0434783
NODE_302201_length_182_cov_127.759036	6	52	89	1	46	0.0217391
NODE_302201_length_182_cov_127.759036	6	52	91	1	46	0.0217391
NODE_302201_length_182_cov_127.759036	6	52	94	7	46	0.1521739
NODE_302201_length_182_cov_127.759036	6	52	95	2	46	0.0434783
NODE_302201_length_182_cov_127.759036	6	52	97	1	46	0.0217391
NODE_302201_length_182_cov_127.759036	6	52	100	4	46	0.0869565
NODE_302201_length_182_cov_127.759036	6	52	102	2	46	0.0434783
NODE_302201_length_182_cov_127.759036	59	105	126	1	46	0.0217391
NODE_302201_length_182_cov_127.759036	59	105	128	1	46	0.0217391
NODE_302201_length_182_cov_127.759036	59	105	131	1	46	0.0217391
NODE_302201_length_182_cov_127.759036	59	105	135	1	46	0.0217391
NODE_302201_length_182_cov_127.759036	59	105	137	5	46	0.1086956
NODE_302201_length_182_cov_127.759036	59	105	139	5	46	0.1086956
NODE_302201_length_182_cov_127.759036	59	105	141	5	46	0.1086956
NODE_302201_length_182_cov_127.759036	59	105	143	4	46	0.0869565
NODE_302201_length_182_cov_127.759036	59	105	147	23	46	0.5000000
NODE_302214_length_182_cov_29.421687	5	35	6	2	30	0.0666667
NODE_302214_length_182_cov_29.421687	5	35	10	2	30	0.0666667
NODE_302214_length_182_cov_29.421687	5	35	12	26	30	0.8666667
NODE_302214_length_182_cov_29.421687	8	88	10	1	80	0.0125000
NODE_302214_length_182_cov_29.421687	8	88	12	57	80	0.7125000
NODE_302214_length_182_cov_29.421687	8	88	14	5	80	0.0625000
NODE_302214_length_182_cov_29.421687	8	88	16	17	80	0.2125000
NODE_302236_length_181_cov_141.195122	1	60	0	11	59	0.1864407
NODE_302236_length_181_cov_141.195122	1	60	1	46	59	0.7796610
NODE_302236_length_181_cov_141.195122	1	60	2	2	59	0.0338983
NODE_302236_length_181_cov_141.195122	34	60	1	24	26	0.9230769
NODE_302236_length_181_cov_141.195122	34	60	2	2	26	0.0769231
NODE_302236_length_181_cov_141.195122	114	145	2	31	31	1.0000000
NODE_302285_length_180_cov_102.567901	6	75	33	1	69	0.0144928
NODE_302285_length_180_cov_102.567901	6	75	41	1	69	0.0144928
NODE_302285_length_180_cov_102.567901	6	75	44	4	69	0.0579710
NODE_302285_length_180_cov_102.567901	6	75	46	3	69	0.0434783
NODE_302285_length_180_cov_102.567901	6	75	48	1	69	0.0144928
NODE_302285_length_180_cov_102.567901	6	75	50	2	69	0.0289855
NODE_302285_length_180_cov_102.567901	6	75	54	1	69	0.0144928
NODE_302285_length_180_cov_102.567901	6	75	82	1	69	0.0144928
NODE_302285_length_180_cov_102.567901	6	75	83	1	69	0.0144928
NODE_302285_length_180_cov_102.567901	6	75	91	1	69	0.0144928
NODE_302285_length_180_cov_102.567901	6	75	92	1	69	0.0144928
NODE_302285_length_180_cov_102.567901	6	75	96	1	69	0.0144928
NODE_302285_length_180_cov_102.567901	6	75	97	1	69	0.0144928
NODE_302285_length_180_cov_102.567901	6	75	101	3	69	0.0434783
NODE_302285_length_180_cov_102.567901	6	75	103	1	69	0.0144928
NODE_302285_length_180_cov_102.567901	6	75	117	1	69	0.0144928
NODE_302285_length_180_cov_102.567901	6	75	126	1	69	0.0144928
NODE_302285_length_180_cov_102.567901	6	75	127	1	69	0.0144928
NODE_302285_length_180_cov_102.567901	6	75	131	1	69	0.0144928
NODE_302285_length_180_cov_102.567901	6	75	132	1	69	0.0144928
NODE_302285_length_180_cov_102.567901	6	75	136	1	69	0.0144928
NODE_302285_length_180_cov_102.567901	6	75	141	1	69	0.0144928
NODE_302285_length_180_cov_102.567901	6	75	161	1	69	0.0144928
NODE_302285_length_180_cov_102.567901	6	75	162	1	69	0.0144928
NODE_302285_length_180_cov_102.567901	6	75	164	1	69	0.0144928
NODE_302285_length_180_cov_102.567901	6	75	177	1	69	0.0144928
NODE_302285_length_180_cov_102.567901	6	75	185	1	69	0.0144928
NODE_302285_length_180_cov_102.567901	6	75	204	1	69	0.0144928
NODE_302285_length_180_cov_102.567901	6	75	211	1	69	0.0144928
NODE_302285_length_180_cov_102.567901	6	75	222	1	69	0.0144928
NODE_302285_length_180_cov_102.567901	6	75	225	1	69	0.0144928
NODE_302285_length_180_cov_102.567901	6	75	238	1	69	0.0144928
NODE_302285_length_180_cov_102.567901	6	75	246	1	69	0.0144928
NODE_302285_length_180_cov_102.567901	6	75	250	1	69	0.0144928
NODE_302285_length_180_cov_102.567901	6	75	257	1	69	0.0144928
NODE_302285_length_180_cov_102.567901	6	75	266	1	69	0.0144928
NODE_302285_length_180_cov_102.567901	6	75	284	1	69	0.0144928
NODE_302285_length_180_cov_102.567901	6	75	286	2	69	0.0289855
NODE_302285_length_180_cov_102.567901	6	75	290	1	69	0.0144928
NODE_302285_length_180_cov_102.567901	6	75	294	1	69	0.0144928
NODE_302285_length_180_cov_102.567901	6	75	298	1	69	0.0144928
NODE_302285_length_180_cov_102.567901	6	75	304	1	69	0.0144928
NODE_302285_length_180_cov_102.567901	6	75	307	1	69	0.0144928
NODE_302285_length_180_cov_102.567901	6	75	325	1	69	0.0144928
NODE_302285_length_180_cov_102.567901	6	75	329	1	69	0.0144928
NODE_302285_length_180_cov_102.567901	6	75	335	1	69	0.0144928
NODE_302285_length_180_cov_102.567901	6	75	337	1	69	0.0144928
NODE_302285_length_180_cov_102.567901	6	75	340	2	69	0.0289855
NODE_302285_length_180_cov_102.567901	6	75	342	1	69	0.0144928
NODE_302285_length_180_cov_102.567901	6	75	351	2	69	0.0289855
NODE_302285_length_180_cov_102.567901	6	75	357	1	69	0.0144928
NODE_302285_length_180_cov_102.567901	6	75	359	2	69	0.0289855
NODE_302285_length_180_cov_102.567901	6	75	361	4	69	0.0579710
NODE_302285_length_180_cov_102.567901	6	75	371	1	69	0.0144928
NODE_302363_length_178_cov_93.620253	81	112	6	31	31	1.0000000
NODE_302365_length_178_cov_62.696203	0	78	4	8	78	0.1025641
NODE_302365_length_178_cov_62.696203	0	78	7	1	78	0.0128205
NODE_302365_length_178_cov_62.696203	0	78	11	1	78	0.0128205
NODE_302365_length_178_cov_62.696203	0	78	15	3	78	0.0384615
NODE_302365_length_178_cov_62.696203	0	78	17	7	78	0.0897436
NODE_302365_length_178_cov_62.696203	0	78	18	1	78	0.0128205
NODE_302365_length_178_cov_62.696203	0	78	20	1	78	0.0128205
NODE_302365_length_178_cov_62.696203	0	78	22	7	78	0.0897436
NODE_302365_length_178_cov_62.696203	0	78	24	3	78	0.0384615
NODE_302365_length_178_cov_62.696203	0	78	31	1	78	0.0128205
NODE_302365_length_178_cov_62.696203	0	78	32	3	78	0.0384615
NODE_302365_length_178_cov_62.696203	0	78	34	3	78	0.0384615
NODE_302365_length_178_cov_62.696203	0	78	36	4	78	0.0512821
NODE_302365_length_178_cov_62.696203	0	78	37	7	78	0.0897436
NODE_302365_length_178_cov_62.696203	0	78	45	15	78	0.1923077
NODE_302365_length_178_cov_62.696203	0	78	47	4	78	0.0512821
NODE_302365_length_178_cov_62.696203	0	78	51	7	78	0.0897436
NODE_302365_length_178_cov_62.696203	0	78	52	2	78	0.0256410
NODE_302365_length_178_cov_62.696203	51	131	30	3	80	0.0375000
NODE_302365_length_178_cov_62.696203	51	131	32	3	80	0.0375000
NODE_302365_length_178_cov_62.696203	51	131	34	2	80	0.0250000
NODE_302365_length_178_cov_62.696203	51	131	39	5	80	0.0625000
NODE_302365_length_178_cov_62.696203	51	131	41	4	80	0.0500000
NODE_302365_length_178_cov_62.696203	51	131	43	1	80	0.0125000
NODE_302365_length_178_cov_62.696203	51	131	45	17	80	0.2125000
NODE_302365_length_178_cov_62.696203	51	131	47	11	80	0.1375000
NODE_302365_length_178_cov_62.696203	51	131	51	13	80	0.1625000
NODE_302365_length_178_cov_62.696203	51	131	52	21	80	0.2625000
NODE_302477_length_175_cov_116.684211	42	122	2	80	80	1.0000000
NODE_302477_length_175_cov_116.684211	95	175	0	50	80	0.6250000
NODE_302477_length_175_cov_116.684211	95	175	2	30	80	0.3750000
NODE_302482_length_175_cov_61.000000	81	121	354	1	40	0.0250000
NODE_302482_length_175_cov_61.000000	81	121	356	1	40	0.0250000
NODE_302482_length_175_cov_61.000000	81	121	362	1	40	0.0250000
NODE_302482_length_175_cov_61.000000	81	121	366	1	40	0.0250000
NODE_302482_length_175_cov_61.000000	81	121	368	1	40	0.0250000
NODE_302482_length_175_cov_61.000000	81	121	370	1	40	0.0250000
NODE_302482_length_175_cov_61.000000	81	121	376	1	40	0.0250000
NODE_302482_length_175_cov_61.000000	81	121	386	1	40	0.0250000
NODE_302482_length_175_cov_61.000000	81	121	388	1	40	0.0250000
NODE_302482_length_175_cov_61.000000	81	121	394	1	40	0.0250000
NODE_302482_length_175_cov_61.000000	81	121	396	1	40	0.0250000
NODE_302482_length_175_cov_61.000000	81	121	398	1	40	0.0250000
NODE_302482_length_175_cov_61.000000	81	121	408	1	40	0.0250000
NODE_302482_length_175_cov_61.000000	81	121	410	2	40	0.0500000
NODE_302482_length_175_cov_61.000000	81	121	412	1	40	0.0250000
NODE_302482_length_175_cov_61.000000	81	121	414	1	40	0.0250000
NODE_302482_length_175_cov_61.000000	81	121	420	1	40	0.0250000
NODE_302482_length_175_cov_61.000000	81	121	422	22	40	0.5500000
NODE_302538_length_174_cov_173.893333	53	93	487	1	40	0.0250000
NODE_302538_length_174_cov_173.893333	53	93	493	1	40	0.0250000
NODE_302538_length_174_cov_173.893333	53	93	507	1	40	0.0250000
NODE_302538_length_174_cov_173.893333	53	93	515	3	40	0.0750000
NODE_302538_length_174_cov_173.893333	53	93	517	1	40	0.0250000
NODE_302538_length_174_cov_173.893333	53	93	530	1	40	0.0250000
NODE_302538_length_174_cov_173.893333	53	93	532	1	40	0.0250000
NODE_302538_length_174_cov_173.893333	53	93	546	1	40	0.0250000
NODE_302538_length_174_cov_173.893333	53	93	560	1	40	0.0250000
NODE_302538_length_174_cov_173.893333	53	93	562	1	40	0.0250000
NODE_302538_length_174_cov_173.893333	53	93	581	2	40	0.0500000
NODE_302538_length_174_cov_173.893333	53	93	585	1	40	0.0250000
NODE_302538_length_174_cov_173.893333	53	93	587	1	40	0.0250000
NODE_302538_length_174_cov_173.893333	53	93	588	1	40	0.0250000
NODE_302538_length_174_cov_173.893333	53	93	600	1	40	0.0250000
NODE_302538_length_174_cov_173.893333	53	93	606	1	40	0.0250000
NODE_302538_length_174_cov_173.893333	53	93	612	2	40	0.0500000
NODE_302538_length_174_cov_173.893333	53	93	613	19	40	0.4750000
NODE_302543_length_174_cov_50.346667	91	161	16	3	70	0.0428571
NODE_302543_length_174_cov_50.346667	91	161	18	5	70	0.0714286
NODE_302543_length_174_cov_50.346667	91	161	19	2	70	0.0285714
NODE_302543_length_174_cov_50.346667	91	161	21	1	70	0.0142857
NODE_302543_length_174_cov_50.346667	91	161	23	3	70	0.0428571
NODE_302543_length_174_cov_50.346667	91	161	31	1	70	0.0142857
NODE_302543_length_174_cov_50.346667	91	161	35	2	70	0.0285714
NODE_302543_length_174_cov_50.346667	91	161	36	3	70	0.0428571
NODE_302543_length_174_cov_50.346667	91	161	37	1	70	0.0142857
NODE_302543_length_174_cov_50.346667	91	161	39	1	70	0.0142857
NODE_302543_length_174_cov_50.346667	91	161	41	1	70	0.0142857
NODE_302543_length_174_cov_50.346667	91	161	47	1	70	0.0142857
NODE_302543_length_174_cov_50.346667	91	161	48	3	70	0.0428571
NODE_302543_length_174_cov_50.346667	91	161	50	1	70	0.0142857
NODE_302543_length_174_cov_50.346667	91	161	54	1	70	0.0142857
NODE_302543_length_174_cov_50.346667	91	161	56	5	70	0.0714286
NODE_302543_length_174_cov_50.346667	91	161	58	4	70	0.0571429
NODE_302543_length_174_cov_50.346667	91	161	61	1	70	0.0142857
NODE_302543_length_174_cov_50.346667	91	161	62	4	70	0.0571429
NODE_302543_length_174_cov_50.346667	91	161	66	1	70	0.0142857
NODE_302543_length_174_cov_50.346667	91	161	70	2	70	0.0285714
NODE_302543_length_174_cov_50.346667	91	161	74	2	70	0.0285714
NODE_302543_length_174_cov_50.346667	91	161	80	2	70	0.0285714
NODE_302543_length_174_cov_50.346667	91	161	82	3	70	0.0428571
NODE_302543_length_174_cov_50.346667	91	161	84	17	70	0.2428571
NODE_302590_length_173_cov_184.351351	62	126	239	1	64	0.0156250
NODE_302590_length_173_cov_184.351351	62	126	241	1	64	0.0156250
NODE_302590_length_173_cov_184.351351	62	126	246	2	64	0.0312500
NODE_302590_length_173_cov_184.351351	62	126	252	1	64	0.0156250
NODE_302590_length_173_cov_184.351351	62	126	258	1	64	0.0156250
NODE_302590_length_173_cov_184.351351	62	126	262	1	64	0.0156250
NODE_302590_length_173_cov_184.351351	62	126	264	1	64	0.0156250
NODE_302590_length_173_cov_184.351351	62	126	266	2	64	0.0312500
NODE_302590_length_173_cov_184.351351	62	126	270	1	64	0.0156250
NODE_302590_length_173_cov_184.351351	62	126	272	1	64	0.0156250
NODE_302590_length_173_cov_184.351351	62	126	278	1	64	0.0156250
NODE_302590_length_173_cov_184.351351	62	126	284	1	64	0.0156250
NODE_302590_length_173_cov_184.351351	62	126	288	1	64	0.0156250
NODE_302590_length_173_cov_184.351351	62	126	292	1	64	0.0156250
NODE_302590_length_173_cov_184.351351	62	126	294	1	64	0.0156250
NODE_302590_length_173_cov_184.351351	62	126	309	2	64	0.0312500
NODE_302590_length_173_cov_184.351351	62	126	313	1	64	0.0156250
NODE_302590_length_173_cov_184.351351	62	126	315	1	64	0.0156250
NODE_302590_length_173_cov_184.351351	62	126	317	1	64	0.0156250
NODE_302590_length_173_cov_184.351351	62	126	318	6	64	0.0937500
NODE_302590_length_173_cov_184.351351	62	126	319	17	64	0.2656250
NODE_302590_length_173_cov_184.351351	62	126	320	19	64	0.2968750
NODE_302590_length_173_cov_184.351351	62	126	239	1	64	0.0156250
NODE_302590_length_173_cov_184.351351	62	126	241	1	64	0.0156250
NODE_302590_length_173_cov_184.351351	62	126	246	2	64	0.0312500
NODE_302590_length_173_cov_184.351351	62	126	252	1	64	0.0156250
NODE_302590_length_173_cov_184.351351	62	126	258	1	64	0.0156250
NODE_302590_length_173_cov_184.351351	62	126	262	1	64	0.0156250
NODE_302590_length_173_cov_184.351351	62	126	264	1	64	0.0156250
NODE_302590_length_173_cov_184.351351	62	126	266	2	64	0.0312500
NODE_302590_length_173_cov_184.351351	62	126	270	1	64	0.0156250
NODE_302590_length_173_cov_184.351351	62	126	272	1	64	0.0156250
NODE_302590_length_173_cov_184.351351	62	126	278	1	64	0.0156250
NODE_302590_length_173_cov_184.351351	62	126	284	1	64	0.0156250
NODE_302590_length_173_cov_184.351351	62	126	288	1	64	0.0156250
NODE_302590_length_173_cov_184.351351	62	126	292	1	64	0.0156250
NODE_302590_length_173_cov_184.351351	62	126	294	1	64	0.0156250
NODE_302590_length_173_cov_184.351351	62	126	309	2	64	0.0312500
NODE_302590_length_173_cov_184.351351	62	126	313	1	64	0.0156250
NODE_302590_length_173_cov_184.351351	62	126	315	1	64	0.0156250
NODE_302590_length_173_cov_184.351351	62	126	317	1	64	0.0156250
NODE_302590_length_173_cov_184.351351	62	126	318	6	64	0.0937500
NODE_302590_length_173_cov_184.351351	62	126	319	17	64	0.2656250
NODE_302590_length_173_cov_184.351351	62	126	320	19	64	0.2968750
NODE_302590_length_173_cov_184.351351	62	126	239	1	64	0.0156250
NODE_302590_length_173_cov_184.351351	62	126	241	1	64	0.0156250
NODE_302590_length_173_cov_184.351351	62	126	246	2	64	0.0312500
NODE_302590_length_173_cov_184.351351	62	126	252	1	64	0.0156250
NODE_302590_length_173_cov_184.351351	62	126	258	1	64	0.0156250
NODE_302590_length_173_cov_184.351351	62	126	262	1	64	0.0156250
NODE_302590_length_173_cov_184.351351	62	126	264	1	64	0.0156250
NODE_302590_length_173_cov_184.351351	62	126	266	2	64	0.0312500
NODE_302590_length_173_cov_184.351351	62	126	270	1	64	0.0156250
NODE_302590_length_173_cov_184.351351	62	126	272	1	64	0.0156250
NODE_302590_length_173_cov_184.351351	62	126	278	1	64	0.0156250
NODE_302590_length_173_cov_184.351351	62	126	284	1	64	0.0156250
NODE_302590_length_173_cov_184.351351	62	126	288	1	64	0.0156250
NODE_302590_length_173_cov_184.351351	62	126	292	1	64	0.0156250
NODE_302590_length_173_cov_184.351351	62	126	294	1	64	0.0156250
NODE_302590_length_173_cov_184.351351	62	126	309	2	64	0.0312500
NODE_302590_length_173_cov_184.351351	62	126	313	1	64	0.0156250
NODE_302590_length_173_cov_184.351351	62	126	315	1	64	0.0156250
NODE_302590_length_173_cov_184.351351	62	126	317	1	64	0.0156250
NODE_302590_length_173_cov_184.351351	62	126	318	6	64	0.0937500
NODE_302590_length_173_cov_184.351351	62	126	319	17	64	0.2656250
NODE_302590_length_173_cov_184.351351	62	126	320	19	64	0.2968750
NODE_302590_length_173_cov_184.351351	62	126	239	1	64	0.0156250
NODE_302590_length_173_cov_184.351351	62	126	241	1	64	0.0156250
NODE_302590_length_173_cov_184.351351	62	126	246	2	64	0.0312500
NODE_302590_length_173_cov_184.351351	62	126	252	1	64	0.0156250
NODE_302590_length_173_cov_184.351351	62	126	258	1	64	0.0156250
NODE_302590_length_173_cov_184.351351	62	126	262	1	64	0.0156250
NODE_302590_length_173_cov_184.351351	62	126	264	1	64	0.0156250
NODE_302590_length_173_cov_184.351351	62	126	266	2	64	0.0312500
NODE_302590_length_173_cov_184.351351	62	126	270	1	64	0.0156250
NODE_302590_length_173_cov_184.351351	62	126	272	1	64	0.0156250
NODE_302590_length_173_cov_184.351351	62	126	278	1	64	0.0156250
NODE_302590_length_173_cov_184.351351	62	126	284	1	64	0.0156250
NODE_302590_length_173_cov_184.351351	62	126	288	1	64	0.0156250
NODE_302590_length_173_cov_184.351351	62	126	292	1	64	0.0156250
NODE_302590_length_173_cov_184.351351	62	126	294	1	64	0.0156250
NODE_302590_length_173_cov_184.351351	62	126	309	2	64	0.0312500
NODE_302590_length_173_cov_184.351351	62	126	313	1	64	0.0156250
NODE_302590_length_173_cov_184.351351	62	126	315	1	64	0.0156250
NODE_302590_length_173_cov_184.351351	62	126	317	1	64	0.0156250
NODE_302590_length_173_cov_184.351351	62	126	318	6	64	0.0937500
NODE_302590_length_173_cov_184.351351	62	126	319	17	64	0.2656250
NODE_302590_length_173_cov_184.351351	62	126	320	19	64	0.2968750
NODE_302590_length_173_cov_184.351351	99	165	52	2	66	0.0303030
NODE_302590_length_173_cov_184.351351	99	165	53	2	66	0.0303030
NODE_302590_length_173_cov_184.351351	99	165	69	2	66	0.0303030
NODE_302590_length_173_cov_184.351351	99	165	71	2	66	0.0303030
NODE_302590_length_173_cov_184.351351	99	165	73	2	66	0.0303030
NODE_302590_length_173_cov_184.351351	99	165	79	1	66	0.0151515
NODE_302590_length_173_cov_184.351351	99	165	85	1	66	0.0151515
NODE_302590_length_173_cov_184.351351	99	165	89	5	66	0.0757576
NODE_302590_length_173_cov_184.351351	99	165	98	1	66	0.0151515
NODE_302590_length_173_cov_184.351351	99	165	102	1	66	0.0151515
NODE_302590_length_173_cov_184.351351	99	165	109	1	66	0.0151515
NODE_302590_length_173_cov_184.351351	99	165	122	1	66	0.0151515
NODE_302590_length_173_cov_184.351351	99	165	130	1	66	0.0151515
NODE_302590_length_173_cov_184.351351	99	165	132	1	66	0.0151515
NODE_302590_length_173_cov_184.351351	99	165	138	2	66	0.0303030
NODE_302590_length_173_cov_184.351351	99	165	140	1	66	0.0151515
NODE_302590_length_173_cov_184.351351	99	165	144	1	66	0.0151515
NODE_302590_length_173_cov_184.351351	99	165	148	2	66	0.0303030
NODE_302590_length_173_cov_184.351351	99	165	150	1	66	0.0151515
NODE_302590_length_173_cov_184.351351	99	165	156	2	66	0.0303030
NODE_302590_length_173_cov_184.351351	99	165	160	1	66	0.0151515
NODE_302590_length_173_cov_184.351351	99	165	166	2	66	0.0303030
NODE_302590_length_173_cov_184.351351	99	165	178	1	66	0.0151515
NODE_302590_length_173_cov_184.351351	99	165	185	1	66	0.0151515
NODE_302590_length_173_cov_184.351351	99	165	204	1	66	0.0151515
NODE_302590_length_173_cov_184.351351	99	165	226	1	66	0.0151515
NODE_302590_length_173_cov_184.351351	99	165	239	1	66	0.0151515
NODE_302590_length_173_cov_184.351351	99	165	241	1	66	0.0151515
NODE_302590_length_173_cov_184.351351	99	165	246	2	66	0.0303030
NODE_302590_length_173_cov_184.351351	99	165	252	1	66	0.0151515
NODE_302590_length_173_cov_184.351351	99	165	258	1	66	0.0151515
NODE_302590_length_173_cov_184.351351	99	165	262	1	66	0.0151515
NODE_302590_length_173_cov_184.351351	99	165	264	1	66	0.0151515
NODE_302590_length_173_cov_184.351351	99	165	266	2	66	0.0303030
NODE_302590_length_173_cov_184.351351	99	165	270	1	66	0.0151515
NODE_302590_length_173_cov_184.351351	99	165	272	1	66	0.0151515
NODE_302590_length_173_cov_184.351351	99	165	278	1	66	0.0151515
NODE_302590_length_173_cov_184.351351	99	165	284	1	66	0.0151515
NODE_302590_length_173_cov_184.351351	99	165	288	1	66	0.0151515
NODE_302590_length_173_cov_184.351351	99	165	292	1	66	0.0151515
NODE_302590_length_173_cov_184.351351	99	165	294	1	66	0.0151515
NODE_302590_length_173_cov_184.351351	99	165	309	2	66	0.0303030
NODE_302590_length_173_cov_184.351351	99	165	313	1	66	0.0151515
NODE_302590_length_173_cov_184.351351	99	165	315	1	66	0.0151515
NODE_302590_length_173_cov_184.351351	99	165	317	1	66	0.0151515
NODE_302590_length_173_cov_184.351351	99	165	319	5	66	0.0757576
NODE_302590_length_173_cov_184.351351	99	170	31	1	71	0.0140845
NODE_302590_length_173_cov_184.351351	99	170	32	1	71	0.0140845
NODE_302590_length_173_cov_184.351351	99	170	48	3	71	0.0422535
NODE_302590_length_173_cov_184.351351	99	170	52	2	71	0.0281690
NODE_302590_length_173_cov_184.351351	99	170	53	2	71	0.0281690
NODE_302590_length_173_cov_184.351351	99	170	69	2	71	0.0281690
NODE_302590_length_173_cov_184.351351	99	170	71	2	71	0.0281690
NODE_302590_length_173_cov_184.351351	99	170	73	2	71	0.0281690
NODE_302590_length_173_cov_184.351351	99	170	79	1	71	0.0140845
NODE_302590_length_173_cov_184.351351	99	170	85	1	71	0.0140845
NODE_302590_length_173_cov_184.351351	99	170	89	5	71	0.0704225
NODE_302590_length_173_cov_184.351351	99	170	98	1	71	0.0140845
NODE_302590_length_173_cov_184.351351	99	170	102	1	71	0.0140845
NODE_302590_length_173_cov_184.351351	99	170	109	1	71	0.0140845
NODE_302590_length_173_cov_184.351351	99	170	122	1	71	0.0140845
NODE_302590_length_173_cov_184.351351	99	170	130	1	71	0.0140845
NODE_302590_length_173_cov_184.351351	99	170	132	1	71	0.0140845
NODE_302590_length_173_cov_184.351351	99	170	138	2	71	0.0281690
NODE_302590_length_173_cov_184.351351	99	170	140	1	71	0.0140845
NODE_302590_length_173_cov_184.351351	99	170	144	1	71	0.0140845
NODE_302590_length_173_cov_184.351351	99	170	148	2	71	0.0281690
NODE_302590_length_173_cov_184.351351	99	170	150	1	71	0.0140845
NODE_302590_length_173_cov_184.351351	99	170	156	2	71	0.0281690
NODE_302590_length_173_cov_184.351351	99	170	160	1	71	0.0140845
NODE_302590_length_173_cov_184.351351	99	170	166	2	71	0.0281690
NODE_302590_length_173_cov_184.351351	99	170	178	1	71	0.0140845
NODE_302590_length_173_cov_184.351351	99	170	185	1	71	0.0140845
NODE_302590_length_173_cov_184.351351	99	170	204	1	71	0.0140845
NODE_302590_length_173_cov_184.351351	99	170	226	1	71	0.0140845
NODE_302590_length_173_cov_184.351351	99	170	239	1	71	0.0140845
NODE_302590_length_173_cov_184.351351	99	170	241	1	71	0.0140845
NODE_302590_length_173_cov_184.351351	99	170	246	2	71	0.0281690
NODE_302590_length_173_cov_184.351351	99	170	252	1	71	0.0140845
NODE_302590_length_173_cov_184.351351	99	170	258	1	71	0.0140845
NODE_302590_length_173_cov_184.351351	99	170	262	1	71	0.0140845
NODE_302590_length_173_cov_184.351351	99	170	264	1	71	0.0140845
NODE_302590_length_173_cov_184.351351	99	170	266	2	71	0.0281690
NODE_302590_length_173_cov_184.351351	99	170	270	1	71	0.0140845
NODE_302590_length_173_cov_184.351351	99	170	272	1	71	0.0140845
NODE_302590_length_173_cov_184.351351	99	170	278	1	71	0.0140845
NODE_302590_length_173_cov_184.351351	99	170	284	1	71	0.0140845
NODE_302590_length_173_cov_184.351351	99	170	288	1	71	0.0140845
NODE_302590_length_173_cov_184.351351	99	170	292	1	71	0.0140845
NODE_302590_length_173_cov_184.351351	99	170	294	1	71	0.0140845
NODE_302590_length_173_cov_184.351351	99	170	309	2	71	0.0281690
NODE_302590_length_173_cov_184.351351	99	170	313	1	71	0.0140845
NODE_302590_length_173_cov_184.351351	99	170	315	1	71	0.0140845
NODE_302590_length_173_cov_184.351351	99	170	317	1	71	0.0140845
NODE_302590_length_173_cov_184.351351	99	170	319	5	71	0.0704225
NODE_302590_length_173_cov_184.351351	115	173	23	2	58	0.0344828
NODE_302590_length_173_cov_184.351351	115	173	29	1	58	0.0172414
NODE_302590_length_173_cov_184.351351	115	173	31	1	58	0.0172414
NODE_302590_length_173_cov_184.351351	115	173	32	1	58	0.0172414
NODE_302590_length_173_cov_184.351351	115	173	48	3	58	0.0517241
NODE_302590_length_173_cov_184.351351	115	173	52	2	58	0.0344828
NODE_302590_length_173_cov_184.351351	115	173	53	2	58	0.0344828
NODE_302590_length_173_cov_184.351351	115	173	69	2	58	0.0344828
NODE_302590_length_173_cov_184.351351	115	173	71	2	58	0.0344828
NODE_302590_length_173_cov_184.351351	115	173	73	2	58	0.0344828
NODE_302590_length_173_cov_184.351351	115	173	79	1	58	0.0172414
NODE_302590_length_173_cov_184.351351	115	173	85	1	58	0.0172414
NODE_302590_length_173_cov_184.351351	115	173	89	5	58	0.0862069
NODE_302590_length_173_cov_184.351351	115	173	98	1	58	0.0172414
NODE_302590_length_173_cov_184.351351	115	173	102	1	58	0.0172414
NODE_302590_length_173_cov_184.351351	115	173	109	1	58	0.0172414
NODE_302590_length_173_cov_184.351351	115	173	122	1	58	0.0172414
NODE_302590_length_173_cov_184.351351	115	173	130	1	58	0.0172414
NODE_302590_length_173_cov_184.351351	115	173	132	1	58	0.0172414
NODE_302590_length_173_cov_184.351351	115	173	138	2	58	0.0344828
NODE_302590_length_173_cov_184.351351	115	173	140	1	58	0.0172414
NODE_302590_length_173_cov_184.351351	115	173	144	1	58	0.0172414
NODE_302590_length_173_cov_184.351351	115	173	148	2	58	0.0344828
NODE_302590_length_173_cov_184.351351	115	173	150	1	58	0.0172414
NODE_302590_length_173_cov_184.351351	115	173	156	2	58	0.0344828
NODE_302590_length_173_cov_184.351351	115	173	160	1	58	0.0172414
NODE_302590_length_173_cov_184.351351	115	173	166	2	58	0.0344828
NODE_302590_length_173_cov_184.351351	115	173	178	1	58	0.0172414
NODE_302590_length_173_cov_184.351351	115	173	185	1	58	0.0172414
NODE_302590_length_173_cov_184.351351	115	173	204	1	58	0.0172414
NODE_302590_length_173_cov_184.351351	115	173	226	1	58	0.0172414
NODE_302590_length_173_cov_184.351351	115	173	239	1	58	0.0172414
NODE_302590_length_173_cov_184.351351	115	173	241	1	58	0.0172414
NODE_302590_length_173_cov_184.351351	115	173	246	2	58	0.0344828
NODE_302590_length_173_cov_184.351351	115	173	252	1	58	0.0172414
NODE_302590_length_173_cov_184.351351	115	173	258	1	58	0.0172414
NODE_302590_length_173_cov_184.351351	115	173	262	1	58	0.0172414
NODE_302590_length_173_cov_184.351351	115	173	264	1	58	0.0172414
NODE_302590_length_173_cov_184.351351	115	173	266	2	58	0.0344828
NODE_302590_length_173_cov_184.351351	115	173	270	1	58	0.0172414
NODE_302596_length_173_cov_58.472973	0	78	9	2	78	0.0256410
NODE_302596_length_173_cov_58.472973	0	78	10	2	78	0.0256410
NODE_302596_length_173_cov_58.472973	0	78	12	3	78	0.0384615
NODE_302596_length_173_cov_58.472973	0	78	15	1	78	0.0128205
NODE_302596_length_173_cov_58.472973	0	78	17	1	78	0.0128205
NODE_302596_length_173_cov_58.472973	0	78	23	1	78	0.0128205
NODE_302596_length_173_cov_58.472973	0	78	26	1	78	0.0128205
NODE_302596_length_173_cov_58.472973	0	78	28	2	78	0.0256410
NODE_302596_length_173_cov_58.472973	0	78	37	3	78	0.0384615
NODE_302596_length_173_cov_58.472973	0	78	45	1	78	0.0128205
NODE_302596_length_173_cov_58.472973	0	78	46	6	78	0.0769231
NODE_302596_length_173_cov_58.472973	0	78	56	2	78	0.0256410
NODE_302596_length_173_cov_58.472973	0	78	60	2	78	0.0256410
NODE_302596_length_173_cov_58.472973	0	78	62	2	78	0.0256410
NODE_302596_length_173_cov_58.472973	0	78	64	2	78	0.0256410
NODE_302596_length_173_cov_58.472973	0	78	65	1	78	0.0128205
NODE_302596_length_173_cov_58.472973	0	78	66	1	78	0.0128205
NODE_302596_length_173_cov_58.472973	0	78	68	1	78	0.0128205
NODE_302596_length_173_cov_58.472973	0	78	70	2	78	0.0256410
NODE_302596_length_173_cov_58.472973	0	78	71	2	78	0.0256410
NODE_302596_length_173_cov_58.472973	0	78	74	1	78	0.0128205
NODE_302596_length_173_cov_58.472973	0	78	76	3	78	0.0384615
NODE_302596_length_173_cov_58.472973	0	78	78	4	78	0.0512821
NODE_302596_length_173_cov_58.472973	0	78	84	2	78	0.0256410
NODE_302596_length_173_cov_58.472973	0	78	86	1	78	0.0128205
NODE_302596_length_173_cov_58.472973	0	78	90	3	78	0.0384615
NODE_302596_length_173_cov_58.472973	0	78	94	4	78	0.0512821
NODE_302596_length_173_cov_58.472973	0	78	96	1	78	0.0128205
NODE_302596_length_173_cov_58.472973	0	78	98	1	78	0.0128205
NODE_302596_length_173_cov_58.472973	0	78	99	1	78	0.0128205
NODE_302596_length_173_cov_58.472973	0	78	101	1	78	0.0128205
NODE_302596_length_173_cov_58.472973	0	78	105	3	78	0.0384615
NODE_302596_length_173_cov_58.472973	0	78	107	2	78	0.0256410
NODE_302596_length_173_cov_58.472973	0	78	109	1	78	0.0128205
NODE_302596_length_173_cov_58.472973	0	78	113	3	78	0.0384615
NODE_302596_length_173_cov_58.472973	0	78	117	9	78	0.1153846
NODE_302597_length_173_cov_57.148649	101	142	80	1	41	0.0243902
NODE_302597_length_173_cov_57.148649	101	142	84	1	41	0.0243902
NODE_302597_length_173_cov_57.148649	101	142	86	1	41	0.0243902
NODE_302597_length_173_cov_57.148649	101	142	94	2	41	0.0487805
NODE_302597_length_173_cov_57.148649	101	142	96	1	41	0.0243902
NODE_302597_length_173_cov_57.148649	101	142	100	1	41	0.0243902
NODE_302597_length_173_cov_57.148649	101	142	105	2	41	0.0487805
NODE_302597_length_173_cov_57.148649	101	142	109	1	41	0.0243902
NODE_302597_length_173_cov_57.148649	101	142	113	2	41	0.0487805
NODE_302597_length_173_cov_57.148649	101	142	115	3	41	0.0731707
NODE_302597_length_173_cov_57.148649	101	142	116	2	41	0.0487805
NODE_302597_length_173_cov_57.148649	101	142	120	1	41	0.0243902
NODE_302597_length_173_cov_57.148649	101	142	124	1	41	0.0243902
NODE_302597_length_173_cov_57.148649	101	142	128	2	41	0.0487805
NODE_302597_length_173_cov_57.148649	101	142	130	2	41	0.0487805
NODE_302597_length_173_cov_57.148649	101	142	132	2	41	0.0487805
NODE_302597_length_173_cov_57.148649	101	142	136	2	41	0.0487805
NODE_302597_length_173_cov_57.148649	101	142	140	1	41	0.0243902
NODE_302597_length_173_cov_57.148649	101	142	144	1	41	0.0243902
NODE_302597_length_173_cov_57.148649	101	142	146	1	41	0.0243902
NODE_302597_length_173_cov_57.148649	101	142	150	2	41	0.0487805
NODE_302597_length_173_cov_57.148649	101	142	154	1	41	0.0243902
NODE_302597_length_173_cov_57.148649	101	142	156	1	41	0.0243902
NODE_302597_length_173_cov_57.148649	101	142	160	2	41	0.0487805
NODE_302597_length_173_cov_57.148649	101	142	164	5	41	0.1219512
NODE_302597_length_173_cov_57.148649	109	173	17	1	64	0.0156250
NODE_302597_length_173_cov_57.148649	109	173	23	2	64	0.0312500
NODE_302597_length_173_cov_57.148649	109	173	29	2	64	0.0312500
NODE_302597_length_173_cov_57.148649	109	173	30	1	64	0.0156250
NODE_302597_length_173_cov_57.148649	109	173	32	2	64	0.0312500
NODE_302597_length_173_cov_57.148649	109	173	34	1	64	0.0156250
NODE_302597_length_173_cov_57.148649	109	173	38	1	64	0.0156250
NODE_302597_length_173_cov_57.148649	109	173	40	1	64	0.0156250
NODE_302597_length_173_cov_57.148649	109	173	44	1	64	0.0156250
NODE_302597_length_173_cov_57.148649	109	173	45	2	64	0.0312500
NODE_302597_length_173_cov_57.148649	109	173	49	2	64	0.0312500
NODE_302597_length_173_cov_57.148649	109	173	50	1	64	0.0156250
NODE_302597_length_173_cov_57.148649	109	173	54	1	64	0.0156250
NODE_302597_length_173_cov_57.148649	109	173	58	1	64	0.0156250
NODE_302597_length_173_cov_57.148649	109	173	59	3	64	0.0468750
NODE_302597_length_173_cov_57.148649	109	173	60	1	64	0.0156250
NODE_302597_length_173_cov_57.148649	109	173	64	1	64	0.0156250
NODE_302597_length_173_cov_57.148649	109	173	66	2	64	0.0312500
NODE_302597_length_173_cov_57.148649	109	173	68	1	64	0.0156250
NODE_302597_length_173_cov_57.148649	109	173	70	1	64	0.0156250
NODE_302597_length_173_cov_57.148649	109	173	72	1	64	0.0156250
NODE_302597_length_173_cov_57.148649	109	173	74	1	64	0.0156250
NODE_302597_length_173_cov_57.148649	109	173	80	2	64	0.0312500
NODE_302597_length_173_cov_57.148649	109	173	84	1	64	0.0156250
NODE_302597_length_173_cov_57.148649	109	173	86	1	64	0.0156250
NODE_302597_length_173_cov_57.148649	109	173	94	2	64	0.0312500
NODE_302597_length_173_cov_57.148649	109	173	96	1	64	0.0156250
NODE_302597_length_173_cov_57.148649	109	173	100	1	64	0.0156250
NODE_302597_length_173_cov_57.148649	109	173	105	2	64	0.0312500
NODE_302597_length_173_cov_57.148649	109	173	109	1	64	0.0156250
NODE_302597_length_173_cov_57.148649	109	173	113	2	64	0.0312500
NODE_302597_length_173_cov_57.148649	109	173	115	3	64	0.0468750
NODE_302597_length_173_cov_57.148649	109	173	116	2	64	0.0312500
NODE_302597_length_173_cov_57.148649	109	173	120	1	64	0.0156250
NODE_302597_length_173_cov_57.148649	109	173	124	1	64	0.0156250
NODE_302597_length_173_cov_57.148649	109	173	128	2	64	0.0312500
NODE_302597_length_173_cov_57.148649	109	173	130	2	64	0.0312500
NODE_302597_length_173_cov_57.148649	109	173	132	2	64	0.0312500
NODE_302597_length_173_cov_57.148649	109	173	136	2	64	0.0312500
NODE_302597_length_173_cov_57.148649	109	173	140	1	64	0.0156250
NODE_302597_length_173_cov_57.148649	109	173	144	1	64	0.0156250
NODE_302597_length_173_cov_57.148649	109	173	146	1	64	0.0156250
NODE_302597_length_173_cov_57.148649	109	173	150	2	64	0.0312500
NODE_302597_length_173_cov_57.148649	109	173	154	1	64	0.0156250
NODE_302686_length_171_cov_218.666667	12	90	3	3	78	0.0384615
NODE_302686_length_171_cov_218.666667	12	90	5	2	78	0.0256410
NODE_302686_length_171_cov_218.666667	12	90	11	4	78	0.0512821
NODE_302686_length_171_cov_218.666667	12	90	37	9	78	0.1153846
NODE_302686_length_171_cov_218.666667	12	90	43	4	78	0.0512821
NODE_302686_length_171_cov_218.666667	12	90	47	7	78	0.0897436
NODE_302686_length_171_cov_218.666667	12	90	48	1	78	0.0128205
NODE_302686_length_171_cov_218.666667	12	90	50	8	78	0.1025641
NODE_302686_length_171_cov_218.666667	12	90	52	1	78	0.0128205
NODE_302686_length_171_cov_218.666667	12	90	53	3	78	0.0384615
NODE_302686_length_171_cov_218.666667	12	90	55	2	78	0.0256410
NODE_302686_length_171_cov_218.666667	12	90	56	6	78	0.0769231
NODE_302686_length_171_cov_218.666667	12	90	58	28	78	0.3589744
NODE_302686_length_171_cov_218.666667	12	90	3	3	78	0.0384615
NODE_302686_length_171_cov_218.666667	12	90	5	2	78	0.0256410
NODE_302686_length_171_cov_218.666667	12	90	11	4	78	0.0512821
NODE_302686_length_171_cov_218.666667	12	90	37	9	78	0.1153846
NODE_302686_length_171_cov_218.666667	12	90	43	4	78	0.0512821
NODE_302686_length_171_cov_218.666667	12	90	47	7	78	0.0897436
NODE_302686_length_171_cov_218.666667	12	90	48	1	78	0.0128205
NODE_302686_length_171_cov_218.666667	12	90	50	8	78	0.1025641
NODE_302686_length_171_cov_218.666667	12	90	52	1	78	0.0128205
NODE_302686_length_171_cov_218.666667	12	90	53	3	78	0.0384615
NODE_302686_length_171_cov_218.666667	12	90	55	2	78	0.0256410
NODE_302686_length_171_cov_218.666667	12	90	56	6	78	0.0769231
NODE_302686_length_171_cov_218.666667	12	90	58	28	78	0.3589744
NODE_302686_length_171_cov_218.666667	21	90	37	9	69	0.1304348
NODE_302686_length_171_cov_218.666667	21	90	43	4	69	0.0579710
NODE_302686_length_171_cov_218.666667	21	90	47	7	69	0.1014493
NODE_302686_length_171_cov_218.666667	21	90	48	1	69	0.0144928
NODE_302686_length_171_cov_218.666667	21	90	50	8	69	0.1159420
NODE_302686_length_171_cov_218.666667	21	90	52	1	69	0.0144928
NODE_302686_length_171_cov_218.666667	21	90	53	3	69	0.0434783
NODE_302686_length_171_cov_218.666667	21	90	55	2	69	0.0289855
NODE_302686_length_171_cov_218.666667	21	90	56	6	69	0.0869565
NODE_302686_length_171_cov_218.666667	21	90	58	28	69	0.4057971
NODE_302689_length_171_cov_110.194444	81	161	0	21	80	0.2625000
NODE_302689_length_171_cov_110.194444	81	161	3	6	80	0.0750000
NODE_302689_length_171_cov_110.194444	81	161	8	2	80	0.0250000
NODE_302689_length_171_cov_110.194444	81	161	9	7	80	0.0875000
NODE_302689_length_171_cov_110.194444	81	161	12	11	80	0.1375000
NODE_302689_length_171_cov_110.194444	81	161	16	33	80	0.4125000
NODE_302689_length_171_cov_110.194444	81	152	0	12	71	0.1690141
NODE_302689_length_171_cov_110.194444	81	152	3	6	71	0.0845070
NODE_302689_length_171_cov_110.194444	81	152	8	2	71	0.0281690
NODE_302689_length_171_cov_110.194444	81	152	9	7	71	0.0985916
NODE_302689_length_171_cov_110.194444	81	152	12	11	71	0.1549296
NODE_302689_length_171_cov_110.194444	81	152	16	33	71	0.4647887
NODE_302691_length_171_cov_86.013889	106	171	0	17	65	0.2615385
NODE_302691_length_171_cov_86.013889	106	171	2	19	65	0.2923077
NODE_302691_length_171_cov_86.013889	106	171	4	16	65	0.2461538
NODE_302691_length_171_cov_86.013889	106	171	6	13	65	0.2000000
NODE_302697_length_171_cov_46.430556	0	59	10	1	59	0.0169492
NODE_302697_length_171_cov_46.430556	0	59	15	1	59	0.0169492
NODE_302697_length_171_cov_46.430556	0	59	18	1	59	0.0169492
NODE_302697_length_171_cov_46.430556	0	59	22	1	59	0.0169492
NODE_302697_length_171_cov_46.430556	0	59	24	3	59	0.0508475
NODE_302697_length_171_cov_46.430556	0	59	32	1	59	0.0169492
NODE_302697_length_171_cov_46.430556	0	59	35	1	59	0.0169492
NODE_302697_length_171_cov_46.430556	0	59	37	2	59	0.0338983
NODE_302697_length_171_cov_46.430556	0	59	38	2	59	0.0338983
NODE_302697_length_171_cov_46.430556	0	59	41	2	59	0.0338983
NODE_302697_length_171_cov_46.430556	0	59	46	1	59	0.0169492
NODE_302697_length_171_cov_46.430556	0	59	48	1	59	0.0169492
NODE_302697_length_171_cov_46.430556	0	59	55	2	59	0.0338983
NODE_302697_length_171_cov_46.430556	0	59	57	1	59	0.0169492
NODE_302697_length_171_cov_46.430556	0	59	58	2	59	0.0338983
NODE_302697_length_171_cov_46.430556	0	59	65	1	59	0.0169492
NODE_302697_length_171_cov_46.430556	0	59	67	1	59	0.0169492
NODE_302697_length_171_cov_46.430556	0	59	71	1	59	0.0169492
NODE_302697_length_171_cov_46.430556	0	59	75	1	59	0.0169492
NODE_302697_length_171_cov_46.430556	0	59	77	1	59	0.0169492
NODE_302697_length_171_cov_46.430556	0	59	79	1	59	0.0169492
NODE_302697_length_171_cov_46.430556	0	59	83	2	59	0.0338983
NODE_302697_length_171_cov_46.430556	0	59	109	1	59	0.0169492
NODE_302697_length_171_cov_46.430556	0	59	111	1	59	0.0169492
NODE_302697_length_171_cov_46.430556	0	59	113	1	59	0.0169492
NODE_302697_length_171_cov_46.430556	0	59	131	1	59	0.0169492
NODE_302697_length_171_cov_46.430556	0	59	149	1	59	0.0169492
NODE_302697_length_171_cov_46.430556	0	59	170	1	59	0.0169492
NODE_302697_length_171_cov_46.430556	0	59	194	1	59	0.0169492
NODE_302697_length_171_cov_46.430556	0	59	198	1	59	0.0169492
NODE_302697_length_171_cov_46.430556	0	59	211	1	59	0.0169492
NODE_302697_length_171_cov_46.430556	0	59	213	1	59	0.0169492
NODE_302697_length_171_cov_46.430556	0	59	221	1	59	0.0169492
NODE_302697_length_171_cov_46.430556	0	59	225	3	59	0.0508475
NODE_302697_length_171_cov_46.430556	0	59	230	1	59	0.0169492
NODE_302697_length_171_cov_46.430556	0	59	236	1	59	0.0169492
NODE_302697_length_171_cov_46.430556	0	59	240	2	59	0.0338983
NODE_302697_length_171_cov_46.430556	0	59	243	2	59	0.0338983
NODE_302697_length_171_cov_46.430556	0	59	249	1	59	0.0169492
NODE_302697_length_171_cov_46.430556	0	59	255	1	59	0.0169492
NODE_302697_length_171_cov_46.430556	0	59	257	1	59	0.0169492
NODE_302697_length_171_cov_46.430556	0	59	261	1	59	0.0169492
NODE_302697_length_171_cov_46.430556	0	59	265	2	59	0.0338983
NODE_302697_length_171_cov_46.430556	0	59	269	1	59	0.0169492
NODE_302697_length_171_cov_46.430556	0	59	272	1	59	0.0169492
NODE_302697_length_171_cov_46.430556	0	59	283	1	59	0.0169492
NODE_302697_length_171_cov_46.430556	32	98	113	1	66	0.0151515
NODE_302697_length_171_cov_46.430556	32	98	131	1	66	0.0151515
NODE_302697_length_171_cov_46.430556	32	98	149	1	66	0.0151515
NODE_302697_length_171_cov_46.430556	32	98	170	1	66	0.0151515
NODE_302697_length_171_cov_46.430556	32	98	194	1	66	0.0151515
NODE_302697_length_171_cov_46.430556	32	98	198	1	66	0.0151515
NODE_302697_length_171_cov_46.430556	32	98	211	1	66	0.0151515
NODE_302697_length_171_cov_46.430556	32	98	213	1	66	0.0151515
NODE_302697_length_171_cov_46.430556	32	98	221	1	66	0.0151515
NODE_302697_length_171_cov_46.430556	32	98	225	3	66	0.0454545
NODE_302697_length_171_cov_46.430556	32	98	230	1	66	0.0151515
NODE_302697_length_171_cov_46.430556	32	98	236	1	66	0.0151515
NODE_302697_length_171_cov_46.430556	32	98	240	2	66	0.0303030
NODE_302697_length_171_cov_46.430556	32	98	243	2	66	0.0303030
NODE_302697_length_171_cov_46.430556	32	98	249	1	66	0.0151515
NODE_302697_length_171_cov_46.430556	32	98	255	1	66	0.0151515
NODE_302697_length_171_cov_46.430556	32	98	257	1	66	0.0151515
NODE_302697_length_171_cov_46.430556	32	98	261	1	66	0.0151515
NODE_302697_length_171_cov_46.430556	32	98	265	2	66	0.0303030
NODE_302697_length_171_cov_46.430556	32	98	269	1	66	0.0151515
NODE_302697_length_171_cov_46.430556	32	98	272	1	66	0.0151515
NODE_302697_length_171_cov_46.430556	32	98	283	1	66	0.0151515
NODE_302697_length_171_cov_46.430556	32	98	287	1	66	0.0151515
NODE_302697_length_171_cov_46.430556	32	98	288	1	66	0.0151515
NODE_302697_length_171_cov_46.430556	32	98	290	2	66	0.0303030
NODE_302697_length_171_cov_46.430556	32	98	294	5	66	0.0757576
NODE_302697_length_171_cov_46.430556	32	98	296	1	66	0.0151515
NODE_302697_length_171_cov_46.430556	32	98	298	29	66	0.4393939
NODE_302700_length_171_cov_40.069444	13	87	0	74	74	1.0000000
NODE_302702_length_171_cov_33.319444	84	158	10	4	74	0.0540541
NODE_302702_length_171_cov_33.319444	84	158	14	37	74	0.5000000
NODE_302702_length_171_cov_33.319444	84	158	20	1	74	0.0135135
NODE_302702_length_171_cov_33.319444	84	158	22	5	74	0.0675676
NODE_302702_length_171_cov_33.319444	84	158	26	6	74	0.0810811
NODE_302702_length_171_cov_33.319444	84	158	32	21	74	0.2837838
NODE_302764_length_170_cov_217.422535	10	90	21	1	80	0.0125000
NODE_302764_length_170_cov_217.422535	10	90	31	1	80	0.0125000
NODE_302764_length_170_cov_217.422535	10	90	33	2	80	0.0250000
NODE_302764_length_170_cov_217.422535	10	90	35	4	80	0.0500000
NODE_302764_length_170_cov_217.422535	10	90	36	1	80	0.0125000
NODE_302764_length_170_cov_217.422535	10	90	43	1	80	0.0125000
NODE_302764_length_170_cov_217.422535	10	90	44	2	80	0.0250000
NODE_302764_length_170_cov_217.422535	10	90	46	1	80	0.0125000
NODE_302764_length_170_cov_217.422535	10	90	47	1	80	0.0125000
NODE_302764_length_170_cov_217.422535	10	90	49	1	80	0.0125000
NODE_302764_length_170_cov_217.422535	10	90	53	4	80	0.0500000
NODE_302764_length_170_cov_217.422535	10	90	55	1	80	0.0125000
NODE_302764_length_170_cov_217.422535	10	90	63	1	80	0.0125000
NODE_302764_length_170_cov_217.422535	10	90	72	2	80	0.0250000
NODE_302764_length_170_cov_217.422535	10	90	73	1	80	0.0125000
NODE_302764_length_170_cov_217.422535	10	90	83	3	80	0.0375000
NODE_302764_length_170_cov_217.422535	10	90	87	1	80	0.0125000
NODE_302764_length_170_cov_217.422535	10	90	88	4	80	0.0500000
NODE_302764_length_170_cov_217.422535	10	90	97	1	80	0.0125000
NODE_302764_length_170_cov_217.422535	10	90	101	1	80	0.0125000
NODE_302764_length_170_cov_217.422535	10	90	105	1	80	0.0125000
NODE_302764_length_170_cov_217.422535	10	90	107	2	80	0.0250000
NODE_302764_length_170_cov_217.422535	10	90	111	1	80	0.0125000
NODE_302764_length_170_cov_217.422535	10	90	117	1	80	0.0125000
NODE_302764_length_170_cov_217.422535	10	90	119	3	80	0.0375000
NODE_302764_length_170_cov_217.422535	10	90	126	1	80	0.0125000
NODE_302764_length_170_cov_217.422535	10	90	135	1	80	0.0125000
NODE_302764_length_170_cov_217.422535	10	90	143	1	80	0.0125000
NODE_302764_length_170_cov_217.422535	10	90	144	1	80	0.0125000
NODE_302764_length_170_cov_217.422535	10	90	150	1	80	0.0125000
NODE_302764_length_170_cov_217.422535	10	90	152	1	80	0.0125000
NODE_302764_length_170_cov_217.422535	10	90	159	2	80	0.0250000
NODE_302764_length_170_cov_217.422535	10	90	163	3	80	0.0375000
NODE_302764_length_170_cov_217.422535	10	90	165	4	80	0.0500000
NODE_302764_length_170_cov_217.422535	10	90	170	1	80	0.0125000
NODE_302764_length_170_cov_217.422535	10	90	172	22	80	0.2750000
NODE_302764_length_170_cov_217.422535	10	90	21	1	80	0.0125000
NODE_302764_length_170_cov_217.422535	10	90	31	1	80	0.0125000
NODE_302764_length_170_cov_217.422535	10	90	33	2	80	0.0250000
NODE_302764_length_170_cov_217.422535	10	90	35	4	80	0.0500000
NODE_302764_length_170_cov_217.422535	10	90	36	1	80	0.0125000
NODE_302764_length_170_cov_217.422535	10	90	43	1	80	0.0125000
NODE_302764_length_170_cov_217.422535	10	90	44	2	80	0.0250000
NODE_302764_length_170_cov_217.422535	10	90	46	1	80	0.0125000
NODE_302764_length_170_cov_217.422535	10	90	47	1	80	0.0125000
NODE_302764_length_170_cov_217.422535	10	90	49	1	80	0.0125000
NODE_302764_length_170_cov_217.422535	10	90	53	4	80	0.0500000
NODE_302764_length_170_cov_217.422535	10	90	55	1	80	0.0125000
NODE_302764_length_170_cov_217.422535	10	90	63	1	80	0.0125000
NODE_302764_length_170_cov_217.422535	10	90	72	2	80	0.0250000
NODE_302764_length_170_cov_217.422535	10	90	73	1	80	0.0125000
NODE_302764_length_170_cov_217.422535	10	90	83	3	80	0.0375000
NODE_302764_length_170_cov_217.422535	10	90	87	1	80	0.0125000
NODE_302764_length_170_cov_217.422535	10	90	88	4	80	0.0500000
NODE_302764_length_170_cov_217.422535	10	90	97	1	80	0.0125000
NODE_302764_length_170_cov_217.422535	10	90	101	1	80	0.0125000
NODE_302764_length_170_cov_217.422535	10	90	105	1	80	0.0125000
NODE_302764_length_170_cov_217.422535	10	90	107	2	80	0.0250000
NODE_302764_length_170_cov_217.422535	10	90	111	1	80	0.0125000
NODE_302764_length_170_cov_217.422535	10	90	117	1	80	0.0125000
NODE_302764_length_170_cov_217.422535	10	90	119	3	80	0.0375000
NODE_302764_length_170_cov_217.422535	10	90	126	1	80	0.0125000
NODE_302764_length_170_cov_217.422535	10	90	135	1	80	0.0125000
NODE_302764_length_170_cov_217.422535	10	90	143	1	80	0.0125000
NODE_302764_length_170_cov_217.422535	10	90	144	1	80	0.0125000
NODE_302764_length_170_cov_217.422535	10	90	150	1	80	0.0125000
NODE_302764_length_170_cov_217.422535	10	90	152	1	80	0.0125000
NODE_302764_length_170_cov_217.422535	10	90	159	2	80	0.0250000
NODE_302764_length_170_cov_217.422535	10	90	163	3	80	0.0375000
NODE_302764_length_170_cov_217.422535	10	90	165	4	80	0.0500000
NODE_302764_length_170_cov_217.422535	10	90	170	1	80	0.0125000
NODE_302764_length_170_cov_217.422535	10	90	172	22	80	0.2750000
NODE_302764_length_170_cov_217.422535	10	90	21	1	80	0.0125000
NODE_302764_length_170_cov_217.422535	10	90	31	1	80	0.0125000
NODE_302764_length_170_cov_217.422535	10	90	33	2	80	0.0250000
NODE_302764_length_170_cov_217.422535	10	90	35	4	80	0.0500000
NODE_302764_length_170_cov_217.422535	10	90	36	1	80	0.0125000
NODE_302764_length_170_cov_217.422535	10	90	43	1	80	0.0125000
NODE_302764_length_170_cov_217.422535	10	90	44	2	80	0.0250000
NODE_302764_length_170_cov_217.422535	10	90	46	1	80	0.0125000
NODE_302764_length_170_cov_217.422535	10	90	47	1	80	0.0125000
NODE_302764_length_170_cov_217.422535	10	90	49	1	80	0.0125000
NODE_302764_length_170_cov_217.422535	10	90	53	4	80	0.0500000
NODE_302764_length_170_cov_217.422535	10	90	55	1	80	0.0125000
NODE_302764_length_170_cov_217.422535	10	90	63	1	80	0.0125000
NODE_302764_length_170_cov_217.422535	10	90	72	2	80	0.0250000
NODE_302764_length_170_cov_217.422535	10	90	73	1	80	0.0125000
NODE_302764_length_170_cov_217.422535	10	90	83	3	80	0.0375000
NODE_302764_length_170_cov_217.422535	10	90	87	1	80	0.0125000
NODE_302764_length_170_cov_217.422535	10	90	88	4	80	0.0500000
NODE_302764_length_170_cov_217.422535	10	90	97	1	80	0.0125000
NODE_302764_length_170_cov_217.422535	10	90	101	1	80	0.0125000
NODE_302764_length_170_cov_217.422535	10	90	105	1	80	0.0125000
NODE_302764_length_170_cov_217.422535	10	90	107	2	80	0.0250000
NODE_302764_length_170_cov_217.422535	10	90	111	1	80	0.0125000
NODE_302764_length_170_cov_217.422535	10	90	117	1	80	0.0125000
NODE_302764_length_170_cov_217.422535	10	90	119	3	80	0.0375000
NODE_302764_length_170_cov_217.422535	10	90	126	1	80	0.0125000
NODE_302764_length_170_cov_217.422535	10	90	135	1	80	0.0125000
NODE_302764_length_170_cov_217.422535	10	90	143	1	80	0.0125000
NODE_302764_length_170_cov_217.422535	10	90	144	1	80	0.0125000
NODE_302764_length_170_cov_217.422535	10	90	150	1	80	0.0125000
NODE_302764_length_170_cov_217.422535	10	90	152	1	80	0.0125000
NODE_302764_length_170_cov_217.422535	10	90	159	2	80	0.0250000
NODE_302764_length_170_cov_217.422535	10	90	163	3	80	0.0375000
NODE_302764_length_170_cov_217.422535	10	90	165	4	80	0.0500000
NODE_302764_length_170_cov_217.422535	10	90	170	1	80	0.0125000
NODE_302764_length_170_cov_217.422535	10	90	172	22	80	0.2750000
NODE_302764_length_170_cov_217.422535	10	90	21	1	80	0.0125000
NODE_302764_length_170_cov_217.422535	10	90	31	1	80	0.0125000
NODE_302764_length_170_cov_217.422535	10	90	33	2	80	0.0250000
NODE_302764_length_170_cov_217.422535	10	90	35	4	80	0.0500000
NODE_302764_length_170_cov_217.422535	10	90	36	1	80	0.0125000
NODE_302764_length_170_cov_217.422535	10	90	43	1	80	0.0125000
NODE_302764_length_170_cov_217.422535	10	90	44	2	80	0.0250000
NODE_302764_length_170_cov_217.422535	10	90	46	1	80	0.0125000
NODE_302764_length_170_cov_217.422535	10	90	47	1	80	0.0125000
NODE_302764_length_170_cov_217.422535	10	90	49	1	80	0.0125000
NODE_302764_length_170_cov_217.422535	10	90	53	4	80	0.0500000
NODE_302764_length_170_cov_217.422535	10	90	55	1	80	0.0125000
NODE_302764_length_170_cov_217.422535	10	90	63	1	80	0.0125000
NODE_302764_length_170_cov_217.422535	10	90	72	2	80	0.0250000
NODE_302764_length_170_cov_217.422535	10	90	73	1	80	0.0125000
NODE_302764_length_170_cov_217.422535	10	90	83	3	80	0.0375000
NODE_302764_length_170_cov_217.422535	10	90	87	1	80	0.0125000
NODE_302764_length_170_cov_217.422535	10	90	88	4	80	0.0500000
NODE_302764_length_170_cov_217.422535	10	90	97	1	80	0.0125000
NODE_302764_length_170_cov_217.422535	10	90	101	1	80	0.0125000
NODE_302764_length_170_cov_217.422535	10	90	105	1	80	0.0125000
NODE_302764_length_170_cov_217.422535	10	90	107	2	80	0.0250000
NODE_302764_length_170_cov_217.422535	10	90	111	1	80	0.0125000
NODE_302764_length_170_cov_217.422535	10	90	117	1	80	0.0125000
NODE_302764_length_170_cov_217.422535	10	90	119	3	80	0.0375000
NODE_302764_length_170_cov_217.422535	10	90	126	1	80	0.0125000
NODE_302764_length_170_cov_217.422535	10	90	135	1	80	0.0125000
NODE_302764_length_170_cov_217.422535	10	90	143	1	80	0.0125000
NODE_302764_length_170_cov_217.422535	10	90	144	1	80	0.0125000
NODE_302764_length_170_cov_217.422535	10	90	150	1	80	0.0125000
NODE_302764_length_170_cov_217.422535	10	90	152	1	80	0.0125000
NODE_302764_length_170_cov_217.422535	10	90	159	2	80	0.0250000
NODE_302764_length_170_cov_217.422535	10	90	163	3	80	0.0375000
NODE_302764_length_170_cov_217.422535	10	90	165	4	80	0.0500000
NODE_302764_length_170_cov_217.422535	10	90	170	1	80	0.0125000
NODE_302764_length_170_cov_217.422535	10	90	172	22	80	0.2750000
NODE_302764_length_170_cov_217.422535	10	90	21	1	80	0.0125000
NODE_302764_length_170_cov_217.422535	10	90	31	1	80	0.0125000
NODE_302764_length_170_cov_217.422535	10	90	33	2	80	0.0250000
NODE_302764_length_170_cov_217.422535	10	90	35	4	80	0.0500000
NODE_302764_length_170_cov_217.422535	10	90	36	1	80	0.0125000
NODE_302764_length_170_cov_217.422535	10	90	43	1	80	0.0125000
NODE_302764_length_170_cov_217.422535	10	90	44	2	80	0.0250000
NODE_302764_length_170_cov_217.422535	10	90	46	1	80	0.0125000
NODE_302764_length_170_cov_217.422535	10	90	47	1	80	0.0125000
NODE_302764_length_170_cov_217.422535	10	90	49	1	80	0.0125000
NODE_302764_length_170_cov_217.422535	10	90	53	4	80	0.0500000
NODE_302764_length_170_cov_217.422535	10	90	55	1	80	0.0125000
NODE_302764_length_170_cov_217.422535	10	90	63	1	80	0.0125000
NODE_302764_length_170_cov_217.422535	10	90	72	2	80	0.0250000
NODE_302764_length_170_cov_217.422535	10	90	73	1	80	0.0125000
NODE_302764_length_170_cov_217.422535	10	90	83	3	80	0.0375000
NODE_302764_length_170_cov_217.422535	10	90	87	1	80	0.0125000
NODE_302764_length_170_cov_217.422535	10	90	88	4	80	0.0500000
NODE_302764_length_170_cov_217.422535	10	90	97	1	80	0.0125000
NODE_302764_length_170_cov_217.422535	10	90	101	1	80	0.0125000
NODE_302764_length_170_cov_217.422535	10	90	105	1	80	0.0125000
NODE_302764_length_170_cov_217.422535	10	90	107	2	80	0.0250000
NODE_302764_length_170_cov_217.422535	10	90	111	1	80	0.0125000
NODE_302764_length_170_cov_217.422535	10	90	117	1	80	0.0125000
NODE_302764_length_170_cov_217.422535	10	90	119	3	80	0.0375000
NODE_302764_length_170_cov_217.422535	10	90	126	1	80	0.0125000
NODE_302764_length_170_cov_217.422535	10	90	135	1	80	0.0125000
NODE_302764_length_170_cov_217.422535	10	90	143	1	80	0.0125000
NODE_302764_length_170_cov_217.422535	10	90	144	1	80	0.0125000
NODE_302764_length_170_cov_217.422535	10	90	150	1	80	0.0125000
NODE_302764_length_170_cov_217.422535	10	90	152	1	80	0.0125000
NODE_302764_length_170_cov_217.422535	10	90	159	2	80	0.0250000
NODE_302764_length_170_cov_217.422535	10	90	163	3	80	0.0375000
NODE_302764_length_170_cov_217.422535	10	90	165	4	80	0.0500000
NODE_302764_length_170_cov_217.422535	10	90	170	1	80	0.0125000
NODE_302764_length_170_cov_217.422535	10	90	172	22	80	0.2750000
NODE_302764_length_170_cov_217.422535	19	90	43	1	71	0.0140845
NODE_302764_length_170_cov_217.422535	19	90	44	2	71	0.0281690
NODE_302764_length_170_cov_217.422535	19	90	46	1	71	0.0140845
NODE_302764_length_170_cov_217.422535	19	90	47	1	71	0.0140845
NODE_302764_length_170_cov_217.422535	19	90	49	1	71	0.0140845
NODE_302764_length_170_cov_217.422535	19	90	53	4	71	0.0563380
NODE_302764_length_170_cov_217.422535	19	90	55	1	71	0.0140845
NODE_302764_length_170_cov_217.422535	19	90	63	1	71	0.0140845
NODE_302764_length_170_cov_217.422535	19	90	72	2	71	0.0281690
NODE_302764_length_170_cov_217.422535	19	90	73	1	71	0.0140845
NODE_302764_length_170_cov_217.422535	19	90	83	3	71	0.0422535
NODE_302764_length_170_cov_217.422535	19	90	87	1	71	0.0140845
NODE_302764_length_170_cov_217.422535	19	90	88	4	71	0.0563380
NODE_302764_length_170_cov_217.422535	19	90	97	1	71	0.0140845
NODE_302764_length_170_cov_217.422535	19	90	101	1	71	0.0140845
NODE_302764_length_170_cov_217.422535	19	90	105	1	71	0.0140845
NODE_302764_length_170_cov_217.422535	19	90	107	2	71	0.0281690
NODE_302764_length_170_cov_217.422535	19	90	111	1	71	0.0140845
NODE_302764_length_170_cov_217.422535	19	90	117	1	71	0.0140845
NODE_302764_length_170_cov_217.422535	19	90	119	3	71	0.0422535
NODE_302764_length_170_cov_217.422535	19	90	126	1	71	0.0140845
NODE_302764_length_170_cov_217.422535	19	90	135	1	71	0.0140845
NODE_302764_length_170_cov_217.422535	19	90	143	1	71	0.0140845
NODE_302764_length_170_cov_217.422535	19	90	144	1	71	0.0140845
NODE_302764_length_170_cov_217.422535	19	90	150	1	71	0.0140845
NODE_302764_length_170_cov_217.422535	19	90	152	1	71	0.0140845
NODE_302764_length_170_cov_217.422535	19	90	159	2	71	0.0281690
NODE_302764_length_170_cov_217.422535	19	90	163	3	71	0.0422535
NODE_302764_length_170_cov_217.422535	19	90	165	4	71	0.0563380
NODE_302764_length_170_cov_217.422535	19	90	170	1	71	0.0140845
NODE_302764_length_170_cov_217.422535	19	90	172	22	71	0.3098592
NODE_302764_length_170_cov_217.422535	63	126	154	5	63	0.0793651
NODE_302764_length_170_cov_217.422535	63	126	156	1	63	0.0158730
NODE_302764_length_170_cov_217.422535	63	126	160	1	63	0.0158730
NODE_302764_length_170_cov_217.422535	63	126	162	5	63	0.0793651
NODE_302764_length_170_cov_217.422535	63	126	165	4	63	0.0634921
NODE_302764_length_170_cov_217.422535	63	126	166	8	63	0.1269841
NODE_302764_length_170_cov_217.422535	63	126	170	1	63	0.0158730
NODE_302764_length_170_cov_217.422535	63	126	172	38	63	0.6031746
NODE_302764_length_170_cov_217.422535	63	126	154	5	63	0.0793651
NODE_302764_length_170_cov_217.422535	63	126	156	1	63	0.0158730
NODE_302764_length_170_cov_217.422535	63	126	160	1	63	0.0158730
NODE_302764_length_170_cov_217.422535	63	126	162	5	63	0.0793651
NODE_302764_length_170_cov_217.422535	63	126	165	4	63	0.0634921
NODE_302764_length_170_cov_217.422535	63	126	166	8	63	0.1269841
NODE_302764_length_170_cov_217.422535	63	126	170	1	63	0.0158730
NODE_302764_length_170_cov_217.422535	63	126	172	38	63	0.6031746
NODE_302768_length_170_cov_102.816901	23	86	43	1	63	0.0158730
NODE_302768_length_170_cov_102.816901	23	86	45	2	63	0.0317460
NODE_302768_length_170_cov_102.816901	23	86	49	1	63	0.0158730
NODE_302768_length_170_cov_102.816901	23	86	58	2	63	0.0317460
NODE_302768_length_170_cov_102.816901	23	86	60	6	63	0.0952381
NODE_302768_length_170_cov_102.816901	23	86	62	4	63	0.0634921
NODE_302768_length_170_cov_102.816901	23	86	70	1	63	0.0158730
NODE_302768_length_170_cov_102.816901	23	86	72	3	63	0.0476190
NODE_302768_length_170_cov_102.816901	23	86	73	7	63	0.1111111
NODE_302768_length_170_cov_102.816901	23	86	77	1	63	0.0158730
NODE_302768_length_170_cov_102.816901	23	86	79	1	63	0.0158730
NODE_302768_length_170_cov_102.816901	23	86	81	17	63	0.2698413
NODE_302768_length_170_cov_102.816901	23	86	82	17	63	0.2698413
NODE_302806_length_169_cov_47.757143	70	150	78	1	80	0.0125000
NODE_302806_length_169_cov_47.757143	70	150	86	1	80	0.0125000
NODE_302806_length_169_cov_47.757143	70	150	88	1	80	0.0125000
NODE_302806_length_169_cov_47.757143	70	150	90	3	80	0.0375000
NODE_302806_length_169_cov_47.757143	70	150	92	13	80	0.1625000
NODE_302806_length_169_cov_47.757143	70	150	95	1	80	0.0125000
NODE_302806_length_169_cov_47.757143	70	150	101	2	80	0.0250000
NODE_302806_length_169_cov_47.757143	70	150	103	13	80	0.1625000
NODE_302806_length_169_cov_47.757143	70	150	105	3	80	0.0375000
NODE_302806_length_169_cov_47.757143	70	150	111	3	80	0.0375000
NODE_302806_length_169_cov_47.757143	70	150	119	2	80	0.0250000
NODE_302806_length_169_cov_47.757143	70	150	123	11	80	0.1375000
NODE_302806_length_169_cov_47.757143	70	150	124	26	80	0.3250000
NODE_302869_length_168_cov_10.391304	66	99	0	33	33	1.0000000
NODE_302869_length_168_cov_10.391304	135	168	0	33	33	1.0000000
NODE_302966_length_166_cov_401.149254	31	109	90	2	78	0.0256410
NODE_302966_length_166_cov_401.149254	31	109	92	2	78	0.0256410
NODE_302966_length_166_cov_401.149254	31	109	94	1	78	0.0128205
NODE_302966_length_166_cov_401.149254	31	109	96	1	78	0.0128205
NODE_302966_length_166_cov_401.149254	31	109	105	1	78	0.0128205
NODE_302966_length_166_cov_401.149254	31	109	106	1	78	0.0128205
NODE_302966_length_166_cov_401.149254	31	109	110	4	78	0.0512821
NODE_302966_length_166_cov_401.149254	31	109	118	3	78	0.0384615
NODE_302966_length_166_cov_401.149254	31	109	122	1	78	0.0128205
NODE_302966_length_166_cov_401.149254	31	109	124	1	78	0.0128205
NODE_302966_length_166_cov_401.149254	31	109	128	1	78	0.0128205
NODE_302966_length_166_cov_401.149254	31	109	132	2	78	0.0256410
NODE_302966_length_166_cov_401.149254	31	109	136	1	78	0.0128205
NODE_302966_length_166_cov_401.149254	31	109	138	1	78	0.0128205
NODE_302966_length_166_cov_401.149254	31	109	140	4	78	0.0512821
NODE_302966_length_166_cov_401.149254	31	109	143	1	78	0.0128205
NODE_302966_length_166_cov_401.149254	31	109	144	6	78	0.0769231
NODE_302966_length_166_cov_401.149254	31	109	151	1	78	0.0128205
NODE_302966_length_166_cov_401.149254	31	109	152	1	78	0.0128205
NODE_302966_length_166_cov_401.149254	31	109	154	43	78	0.5512820
NODE_302966_length_166_cov_401.149254	82	157	20	5	75	0.0666667
NODE_302966_length_166_cov_401.149254	82	157	22	2	75	0.0266667
NODE_302966_length_166_cov_401.149254	82	157	30	1	75	0.0133333
NODE_302966_length_166_cov_401.149254	82	157	32	1	75	0.0133333
NODE_302966_length_166_cov_401.149254	82	157	42	1	75	0.0133333
NODE_302966_length_166_cov_401.149254	82	157	50	3	75	0.0400000
NODE_302966_length_166_cov_401.149254	82	157	52	4	75	0.0533333
NODE_302966_length_166_cov_401.149254	82	157	58	3	75	0.0400000
NODE_302966_length_166_cov_401.149254	82	157	69	1	75	0.0133333
NODE_302966_length_166_cov_401.149254	82	157	74	1	75	0.0133333
NODE_302966_length_166_cov_401.149254	82	157	76	1	75	0.0133333
NODE_302966_length_166_cov_401.149254	82	157	80	2	75	0.0266667
NODE_302966_length_166_cov_401.149254	82	157	90	3	75	0.0400000
NODE_302966_length_166_cov_401.149254	82	157	96	6	75	0.0800000
NODE_302966_length_166_cov_401.149254	82	157	106	2	75	0.0266667
NODE_302966_length_166_cov_401.149254	82	157	112	2	75	0.0266667
NODE_302966_length_166_cov_401.149254	82	157	114	2	75	0.0266667
NODE_302966_length_166_cov_401.149254	82	157	116	1	75	0.0133333
NODE_302966_length_166_cov_401.149254	82	157	120	1	75	0.0133333
NODE_302966_length_166_cov_401.149254	82	157	124	1	75	0.0133333
NODE_302966_length_166_cov_401.149254	82	157	126	1	75	0.0133333
NODE_302966_length_166_cov_401.149254	82	157	130	1	75	0.0133333
NODE_302966_length_166_cov_401.149254	82	157	132	2	75	0.0266667
NODE_302966_length_166_cov_401.149254	82	157	144	4	75	0.0533333
NODE_302966_length_166_cov_401.149254	82	157	151	1	75	0.0133333
NODE_302966_length_166_cov_401.149254	82	157	152	1	75	0.0133333
NODE_302966_length_166_cov_401.149254	82	157	154	22	75	0.2933333
NODE_302974_length_166_cov_123.223881	46	97	8	51	51	1.0000000
NODE_303071_length_164_cov_154.076923	0	75	0	75	75	1.0000000
NODE_303071_length_164_cov_154.076923	48	128	0	80	80	1.0000000
NODE_303074_length_164_cov_69.369231	0	64	6	64	64	1.0000000
NODE_303079_length_164_cov_43.923077	36	100	99	5	64	0.0781250
NODE_303079_length_164_cov_43.923077	36	100	101	3	64	0.0468750
NODE_303079_length_164_cov_43.923077	36	100	103	11	64	0.1718750
NODE_303079_length_164_cov_43.923077	36	100	121	5	64	0.0781250
NODE_303079_length_164_cov_43.923077	36	100	122	6	64	0.0937500
NODE_303079_length_164_cov_43.923077	36	100	123	17	64	0.2656250
NODE_303079_length_164_cov_43.923077	36	100	124	17	64	0.2656250
NODE_303079_length_164_cov_43.923077	36	100	99	5	64	0.0781250
NODE_303079_length_164_cov_43.923077	36	100	101	3	64	0.0468750
NODE_303079_length_164_cov_43.923077	36	100	103	11	64	0.1718750
NODE_303079_length_164_cov_43.923077	36	100	121	5	64	0.0781250
NODE_303079_length_164_cov_43.923077	36	100	122	6	64	0.0937500
NODE_303079_length_164_cov_43.923077	36	100	123	17	64	0.2656250
NODE_303079_length_164_cov_43.923077	36	100	124	17	64	0.2656250
NODE_303079_length_164_cov_43.923077	73	153	82	1	80	0.0125000
NODE_303079_length_164_cov_43.923077	73	153	83	1	80	0.0125000
NODE_303079_length_164_cov_43.923077	73	153	91	1	80	0.0125000
NODE_303079_length_164_cov_43.923077	73	153	95	1	80	0.0125000
NODE_303079_length_164_cov_43.923077	73	153	97	3	80	0.0375000
NODE_303079_length_164_cov_43.923077	73	153	99	2	80	0.0250000
NODE_303079_length_164_cov_43.923077	73	153	101	1	80	0.0125000
NODE_303079_length_164_cov_43.923077	73	153	102	5	80	0.0625000
NODE_303079_length_164_cov_43.923077	73	153	106	4	80	0.0500000
NODE_303079_length_164_cov_43.923077	73	153	108	4	80	0.0500000
NODE_303079_length_164_cov_43.923077	73	153	110	14	80	0.1750000
NODE_303079_length_164_cov_43.923077	73	153	113	1	80	0.0125000
NODE_303079_length_164_cov_43.923077	73	153	115	1	80	0.0125000
NODE_303079_length_164_cov_43.923077	73	153	116	1	80	0.0125000
NODE_303079_length_164_cov_43.923077	73	153	118	7	80	0.0875000
NODE_303079_length_164_cov_43.923077	73	153	120	1	80	0.0125000
NODE_303079_length_164_cov_43.923077	73	153	122	11	80	0.1375000
NODE_303079_length_164_cov_43.923077	73	153	123	5	80	0.0625000
NODE_303079_length_164_cov_43.923077	73	153	124	16	80	0.2000000
NODE_303079_length_164_cov_43.923077	73	153	82	1	80	0.0125000
NODE_303079_length_164_cov_43.923077	73	153	83	1	80	0.0125000
NODE_303079_length_164_cov_43.923077	73	153	91	1	80	0.0125000
NODE_303079_length_164_cov_43.923077	73	153	95	1	80	0.0125000
NODE_303079_length_164_cov_43.923077	73	153	97	3	80	0.0375000
NODE_303079_length_164_cov_43.923077	73	153	99	2	80	0.0250000
NODE_303079_length_164_cov_43.923077	73	153	101	1	80	0.0125000
NODE_303079_length_164_cov_43.923077	73	153	102	5	80	0.0625000
NODE_303079_length_164_cov_43.923077	73	153	106	4	80	0.0500000
NODE_303079_length_164_cov_43.923077	73	153	108	4	80	0.0500000
NODE_303079_length_164_cov_43.923077	73	153	110	14	80	0.1750000
NODE_303079_length_164_cov_43.923077	73	153	113	1	80	0.0125000
NODE_303079_length_164_cov_43.923077	73	153	115	1	80	0.0125000
NODE_303079_length_164_cov_43.923077	73	153	116	1	80	0.0125000
NODE_303079_length_164_cov_43.923077	73	153	118	7	80	0.0875000
NODE_303079_length_164_cov_43.923077	73	153	120	1	80	0.0125000
NODE_303079_length_164_cov_43.923077	73	153	122	11	80	0.1375000
NODE_303079_length_164_cov_43.923077	73	153	123	5	80	0.0625000
NODE_303079_length_164_cov_43.923077	73	153	124	16	80	0.2000000
NODE_303079_length_164_cov_43.923077	73	153	82	1	80	0.0125000
NODE_303079_length_164_cov_43.923077	73	153	83	1	80	0.0125000
NODE_303079_length_164_cov_43.923077	73	153	91	1	80	0.0125000
NODE_303079_length_164_cov_43.923077	73	153	95	1	80	0.0125000
NODE_303079_length_164_cov_43.923077	73	153	97	3	80	0.0375000
NODE_303079_length_164_cov_43.923077	73	153	99	2	80	0.0250000
NODE_303079_length_164_cov_43.923077	73	153	101	1	80	0.0125000
NODE_303079_length_164_cov_43.923077	73	153	102	5	80	0.0625000
NODE_303079_length_164_cov_43.923077	73	153	106	4	80	0.0500000
NODE_303079_length_164_cov_43.923077	73	153	108	4	80	0.0500000
NODE_303079_length_164_cov_43.923077	73	153	110	14	80	0.1750000
NODE_303079_length_164_cov_43.923077	73	153	113	1	80	0.0125000
NODE_303079_length_164_cov_43.923077	73	153	115	1	80	0.0125000
NODE_303079_length_164_cov_43.923077	73	153	116	1	80	0.0125000
NODE_303079_length_164_cov_43.923077	73	153	118	7	80	0.0875000
NODE_303079_length_164_cov_43.923077	73	153	120	1	80	0.0125000
NODE_303079_length_164_cov_43.923077	73	153	122	11	80	0.1375000
NODE_303079_length_164_cov_43.923077	73	153	123	5	80	0.0625000
NODE_303079_length_164_cov_43.923077	73	153	124	16	80	0.2000000
NODE_303079_length_164_cov_43.923077	73	153	82	1	80	0.0125000
NODE_303079_length_164_cov_43.923077	73	153	83	1	80	0.0125000
NODE_303079_length_164_cov_43.923077	73	153	91	1	80	0.0125000
NODE_303079_length_164_cov_43.923077	73	153	95	1	80	0.0125000
NODE_303079_length_164_cov_43.923077	73	153	97	3	80	0.0375000
NODE_303079_length_164_cov_43.923077	73	153	99	2	80	0.0250000
NODE_303079_length_164_cov_43.923077	73	153	101	1	80	0.0125000
NODE_303079_length_164_cov_43.923077	73	153	102	5	80	0.0625000
NODE_303079_length_164_cov_43.923077	73	153	106	4	80	0.0500000
NODE_303079_length_164_cov_43.923077	73	153	108	4	80	0.0500000
NODE_303079_length_164_cov_43.923077	73	153	110	14	80	0.1750000
NODE_303079_length_164_cov_43.923077	73	153	113	1	80	0.0125000
NODE_303079_length_164_cov_43.923077	73	153	115	1	80	0.0125000
NODE_303079_length_164_cov_43.923077	73	153	116	1	80	0.0125000
NODE_303079_length_164_cov_43.923077	73	153	118	7	80	0.0875000
NODE_303079_length_164_cov_43.923077	73	153	120	1	80	0.0125000
NODE_303079_length_164_cov_43.923077	73	153	122	11	80	0.1375000
NODE_303079_length_164_cov_43.923077	73	153	123	5	80	0.0625000
NODE_303079_length_164_cov_43.923077	73	153	124	16	80	0.2000000
NODE_303079_length_164_cov_43.923077	73	153	82	1	80	0.0125000
NODE_303079_length_164_cov_43.923077	73	153	83	1	80	0.0125000
NODE_303079_length_164_cov_43.923077	73	153	91	1	80	0.0125000
NODE_303079_length_164_cov_43.923077	73	153	95	1	80	0.0125000
NODE_303079_length_164_cov_43.923077	73	153	97	3	80	0.0375000
NODE_303079_length_164_cov_43.923077	73	153	99	2	80	0.0250000
NODE_303079_length_164_cov_43.923077	73	153	101	1	80	0.0125000
NODE_303079_length_164_cov_43.923077	73	153	102	5	80	0.0625000
NODE_303079_length_164_cov_43.923077	73	153	106	4	80	0.0500000
NODE_303079_length_164_cov_43.923077	73	153	108	4	80	0.0500000
NODE_303079_length_164_cov_43.923077	73	153	110	14	80	0.1750000
NODE_303079_length_164_cov_43.923077	73	153	113	1	80	0.0125000
NODE_303079_length_164_cov_43.923077	73	153	115	1	80	0.0125000
NODE_303079_length_164_cov_43.923077	73	153	116	1	80	0.0125000
NODE_303079_length_164_cov_43.923077	73	153	118	7	80	0.0875000
NODE_303079_length_164_cov_43.923077	73	153	120	1	80	0.0125000
NODE_303079_length_164_cov_43.923077	73	153	122	11	80	0.1375000
NODE_303079_length_164_cov_43.923077	73	153	123	5	80	0.0625000
NODE_303079_length_164_cov_43.923077	73	153	124	16	80	0.2000000
NODE_303079_length_164_cov_43.923077	73	144	101	1	71	0.0140845
NODE_303079_length_164_cov_43.923077	73	144	102	5	71	0.0704225
NODE_303079_length_164_cov_43.923077	73	144	106	4	71	0.0563380
NODE_303079_length_164_cov_43.923077	73	144	108	4	71	0.0563380
NODE_303079_length_164_cov_43.923077	73	144	110	14	71	0.1971831
NODE_303079_length_164_cov_43.923077	73	144	113	1	71	0.0140845
NODE_303079_length_164_cov_43.923077	73	144	115	1	71	0.0140845
NODE_303079_length_164_cov_43.923077	73	144	116	1	71	0.0140845
NODE_303079_length_164_cov_43.923077	73	144	118	7	71	0.0985916
NODE_303079_length_164_cov_43.923077	73	144	120	1	71	0.0140845
NODE_303079_length_164_cov_43.923077	73	144	122	11	71	0.1549296
NODE_303079_length_164_cov_43.923077	73	144	123	5	71	0.0704225
NODE_303079_length_164_cov_43.923077	73	144	124	16	71	0.2253521
NODE_303135_length_163_cov_480.593750	0	40	4	2	40	0.0500000
NODE_303135_length_163_cov_480.593750	0	40	6	1	40	0.0250000
NODE_303135_length_163_cov_480.593750	0	40	8	2	40	0.0500000
NODE_303135_length_163_cov_480.593750	0	40	10	2	40	0.0500000
NODE_303135_length_163_cov_480.593750	0	40	12	1	40	0.0250000
NODE_303135_length_163_cov_480.593750	0	40	14	1	40	0.0250000
NODE_303135_length_163_cov_480.593750	0	40	16	4	40	0.1000000
NODE_303135_length_163_cov_480.593750	0	40	24	8	40	0.2000000
NODE_303135_length_163_cov_480.593750	0	40	28	2	40	0.0500000
NODE_303135_length_163_cov_480.593750	0	40	30	1	40	0.0250000
NODE_303135_length_163_cov_480.593750	0	40	32	1	40	0.0250000
NODE_303135_length_163_cov_480.593750	0	40	34	8	40	0.2000000
NODE_303135_length_163_cov_480.593750	0	40	36	1	40	0.0250000
NODE_303135_length_163_cov_480.593750	0	40	38	3	40	0.0750000
NODE_303135_length_163_cov_480.593750	0	40	42	1	40	0.0250000
NODE_303135_length_163_cov_480.593750	0	40	44	2	40	0.0500000
NODE_303136_length_163_cov_368.000000	24	96	129	3	72	0.0416667
NODE_303136_length_163_cov_368.000000	24	96	133	1	72	0.0138889
NODE_303136_length_163_cov_368.000000	24	96	135	1	72	0.0138889
NODE_303136_length_163_cov_368.000000	24	96	137	1	72	0.0138889
NODE_303136_length_163_cov_368.000000	24	96	139	1	72	0.0138889
NODE_303136_length_163_cov_368.000000	24	96	145	1	72	0.0138889
NODE_303136_length_163_cov_368.000000	24	96	147	1	72	0.0138889
NODE_303136_length_163_cov_368.000000	24	96	149	1	72	0.0138889
NODE_303136_length_163_cov_368.000000	24	96	153	1	72	0.0138889
NODE_303136_length_163_cov_368.000000	24	96	157	2	72	0.0277778
NODE_303136_length_163_cov_368.000000	24	96	161	2	72	0.0277778
NODE_303136_length_163_cov_368.000000	24	96	167	3	72	0.0416667
NODE_303136_length_163_cov_368.000000	24	96	169	1	72	0.0138889
NODE_303136_length_163_cov_368.000000	24	96	173	1	72	0.0138889
NODE_303136_length_163_cov_368.000000	24	96	179	2	72	0.0277778
NODE_303136_length_163_cov_368.000000	24	96	181	2	72	0.0277778
NODE_303136_length_163_cov_368.000000	24	96	185	1	72	0.0138889
NODE_303136_length_163_cov_368.000000	24	96	187	1	72	0.0138889
NODE_303136_length_163_cov_368.000000	24	96	189	1	72	0.0138889
NODE_303136_length_163_cov_368.000000	24	96	191	1	72	0.0138889
NODE_303136_length_163_cov_368.000000	24	96	197	1	72	0.0138889
NODE_303136_length_163_cov_368.000000	24	96	201	34	72	0.4722222
NODE_303136_length_163_cov_368.000000	24	96	202	9	72	0.1250000
NODE_303138_length_163_cov_319.843750	0	68	0	1	68	0.0147059
NODE_303138_length_163_cov_319.843750	0	68	4	2	68	0.0294118
NODE_303138_length_163_cov_319.843750	0	68	8	2	68	0.0294118
NODE_303138_length_163_cov_319.843750	0	68	10	1	68	0.0147059
NODE_303138_length_163_cov_319.843750	0	68	12	2	68	0.0294118
NODE_303138_length_163_cov_319.843750	0	68	18	1	68	0.0147059
NODE_303138_length_163_cov_319.843750	0	68	23	3	68	0.0441176
NODE_303138_length_163_cov_319.843750	0	68	25	4	68	0.0588235
NODE_303138_length_163_cov_319.843750	0	68	26	2	68	0.0294118
NODE_303138_length_163_cov_319.843750	0	68	28	7	68	0.1029412
NODE_303138_length_163_cov_319.843750	0	68	30	2	68	0.0294118
NODE_303138_length_163_cov_319.843750	0	68	32	1	68	0.0147059
NODE_303138_length_163_cov_319.843750	0	68	34	1	68	0.0147059
NODE_303138_length_163_cov_319.843750	0	68	38	1	68	0.0147059
NODE_303138_length_163_cov_319.843750	0	68	40	7	68	0.1029412
NODE_303138_length_163_cov_319.843750	0	68	42	1	68	0.0147059
NODE_303138_length_163_cov_319.843750	0	68	46	15	68	0.2205882
NODE_303138_length_163_cov_319.843750	0	68	48	2	68	0.0294118
NODE_303138_length_163_cov_319.843750	0	68	50	1	68	0.0147059
NODE_303138_length_163_cov_319.843750	0	68	52	2	68	0.0294118
NODE_303138_length_163_cov_319.843750	0	68	56	2	68	0.0294118
NODE_303138_length_163_cov_319.843750	0	68	58	8	68	0.1176471
NODE_303139_length_163_cov_198.078125	34	109	64	4	75	0.0533333
NODE_303139_length_163_cov_198.078125	34	109	65	4	75	0.0533333
NODE_303139_length_163_cov_198.078125	34	109	66	67	75	0.8933333
NODE_303139_length_163_cov_198.078125	34	114	62	5	80	0.0625000
NODE_303139_length_163_cov_198.078125	34	114	64	4	80	0.0500000
NODE_303139_length_163_cov_198.078125	34	114	65	4	80	0.0500000
NODE_303139_length_163_cov_198.078125	34	114	66	67	80	0.8375000
NODE_303139_length_163_cov_198.078125	35	110	62	1	75	0.0133333
NODE_303139_length_163_cov_198.078125	35	110	64	4	75	0.0533333
NODE_303139_length_163_cov_198.078125	35	110	65	3	75	0.0400000
NODE_303139_length_163_cov_198.078125	35	110	66	67	75	0.8933333
NODE_303139_length_163_cov_198.078125	87	163	0	10	76	0.1315790
NODE_303139_length_163_cov_198.078125	87	163	16	1	76	0.0131579
NODE_303139_length_163_cov_198.078125	87	163	20	10	76	0.1315790
NODE_303139_length_163_cov_198.078125	87	163	22	2	76	0.0263158
NODE_303139_length_163_cov_198.078125	87	163	30	1	76	0.0131579
NODE_303139_length_163_cov_198.078125	87	163	36	6	76	0.0789474
NODE_303139_length_163_cov_198.078125	87	163	40	6	76	0.0789474
NODE_303139_length_163_cov_198.078125	87	163	42	1	76	0.0131579
NODE_303139_length_163_cov_198.078125	87	163	56	4	76	0.0526316
NODE_303139_length_163_cov_198.078125	87	163	62	13	76	0.1710526
NODE_303139_length_163_cov_198.078125	87	163	64	4	76	0.0526316
NODE_303139_length_163_cov_198.078125	87	163	66	18	76	0.2368421
NODE_303139_length_163_cov_198.078125	87	163	0	10	76	0.1315790
NODE_303139_length_163_cov_198.078125	87	163	16	1	76	0.0131579
NODE_303139_length_163_cov_198.078125	87	163	20	10	76	0.1315790
NODE_303139_length_163_cov_198.078125	87	163	22	2	76	0.0263158
NODE_303139_length_163_cov_198.078125	87	163	30	1	76	0.0131579
NODE_303139_length_163_cov_198.078125	87	163	36	6	76	0.0789474
NODE_303139_length_163_cov_198.078125	87	163	40	6	76	0.0789474
NODE_303139_length_163_cov_198.078125	87	163	42	1	76	0.0131579
NODE_303139_length_163_cov_198.078125	87	163	56	4	76	0.0526316
NODE_303139_length_163_cov_198.078125	87	163	62	13	76	0.1710526
NODE_303139_length_163_cov_198.078125	87	163	64	4	76	0.0526316
NODE_303139_length_163_cov_198.078125	87	163	66	18	76	0.2368421
NODE_303139_length_163_cov_198.078125	87	163	0	10	76	0.1315790
NODE_303139_length_163_cov_198.078125	87	163	16	1	76	0.0131579
NODE_303139_length_163_cov_198.078125	87	163	20	10	76	0.1315790
NODE_303139_length_163_cov_198.078125	87	163	22	2	76	0.0263158
NODE_303139_length_163_cov_198.078125	87	163	30	1	76	0.0131579
NODE_303139_length_163_cov_198.078125	87	163	36	6	76	0.0789474
NODE_303139_length_163_cov_198.078125	87	163	40	6	76	0.0789474
NODE_303139_length_163_cov_198.078125	87	163	42	1	76	0.0131579
NODE_303139_length_163_cov_198.078125	87	163	56	4	76	0.0526316
NODE_303139_length_163_cov_198.078125	87	163	62	13	76	0.1710526
NODE_303139_length_163_cov_198.078125	87	163	64	4	76	0.0526316
NODE_303139_length_163_cov_198.078125	87	163	66	18	76	0.2368421
NODE_303231_length_162_cov_421.047619	7	56	26	1	49	0.0204082
NODE_303231_length_162_cov_421.047619	7	56	27	3	49	0.0612245
NODE_303231_length_162_cov_421.047619	7	56	32	2	49	0.0408163
NODE_303231_length_162_cov_421.047619	7	56	33	2	49	0.0408163
NODE_303231_length_162_cov_421.047619	7	56	48	2	49	0.0408163
NODE_303231_length_162_cov_421.047619	7	56	56	1	49	0.0204082
NODE_303231_length_162_cov_421.047619	7	56	72	1	49	0.0204082
NODE_303231_length_162_cov_421.047619	7	56	88	1	49	0.0204082
NODE_303231_length_162_cov_421.047619	7	56	90	1	49	0.0204082
NODE_303231_length_162_cov_421.047619	7	56	95	1	49	0.0204082
NODE_303231_length_162_cov_421.047619	7	56	103	1	49	0.0204082
NODE_303231_length_162_cov_421.047619	7	56	105	2	49	0.0408163
NODE_303231_length_162_cov_421.047619	7	56	107	1	49	0.0204082
NODE_303231_length_162_cov_421.047619	7	56	109	2	49	0.0408163
NODE_303231_length_162_cov_421.047619	7	56	111	1	49	0.0204082
NODE_303231_length_162_cov_421.047619	7	56	131	1	49	0.0204082
NODE_303231_length_162_cov_421.047619	7	56	132	3	49	0.0612245
NODE_303231_length_162_cov_421.047619	7	56	144	1	49	0.0204082
NODE_303231_length_162_cov_421.047619	7	56	146	1	49	0.0204082
NODE_303231_length_162_cov_421.047619	7	56	156	1	49	0.0204082
NODE_303231_length_162_cov_421.047619	7	56	158	1	49	0.0204082
NODE_303231_length_162_cov_421.047619	7	56	166	2	49	0.0408163
NODE_303231_length_162_cov_421.047619	7	56	176	1	49	0.0204082
NODE_303231_length_162_cov_421.047619	7	56	179	1	49	0.0204082
NODE_303231_length_162_cov_421.047619	7	56	193	1	49	0.0204082
NODE_303231_length_162_cov_421.047619	7	56	195	1	49	0.0204082
NODE_303231_length_162_cov_421.047619	7	56	201	2	49	0.0408163
NODE_303231_length_162_cov_421.047619	7	56	204	1	49	0.0204082
NODE_303231_length_162_cov_421.047619	7	56	206	3	49	0.0612245
NODE_303231_length_162_cov_421.047619	7	56	214	2	49	0.0408163
NODE_303231_length_162_cov_421.047619	7	56	222	2	49	0.0408163
NODE_303231_length_162_cov_421.047619	7	56	224	2	49	0.0408163
NODE_303231_length_162_cov_421.047619	7	56	226	1	49	0.0204082
NODE_303231_length_162_cov_421.047619	29	90	131	1	61	0.0163934
NODE_303231_length_162_cov_421.047619	29	90	132	3	61	0.0491803
NODE_303231_length_162_cov_421.047619	29	90	144	1	61	0.0163934
NODE_303231_length_162_cov_421.047619	29	90	146	1	61	0.0163934
NODE_303231_length_162_cov_421.047619	29	90	156	1	61	0.0163934
NODE_303231_length_162_cov_421.047619	29	90	158	1	61	0.0163934
NODE_303231_length_162_cov_421.047619	29	90	166	2	61	0.0327869
NODE_303231_length_162_cov_421.047619	29	90	176	1	61	0.0163934
NODE_303231_length_162_cov_421.047619	29	90	179	1	61	0.0163934
NODE_303231_length_162_cov_421.047619	29	90	193	1	61	0.0163934
NODE_303231_length_162_cov_421.047619	29	90	195	1	61	0.0163934
NODE_303231_length_162_cov_421.047619	29	90	201	2	61	0.0327869
NODE_303231_length_162_cov_421.047619	29	90	204	1	61	0.0163934
NODE_303231_length_162_cov_421.047619	29	90	206	3	61	0.0491803
NODE_303231_length_162_cov_421.047619	29	90	214	2	61	0.0327869
NODE_303231_length_162_cov_421.047619	29	90	222	2	61	0.0327869
NODE_303231_length_162_cov_421.047619	29	90	224	2	61	0.0327869
NODE_303231_length_162_cov_421.047619	29	90	225	4	61	0.0655738
NODE_303231_length_162_cov_421.047619	29	90	226	31	61	0.5081967
NODE_303231_length_162_cov_421.047619	29	92	131	1	63	0.0158730
NODE_303231_length_162_cov_421.047619	29	92	132	3	63	0.0476190
NODE_303231_length_162_cov_421.047619	29	92	144	1	63	0.0158730
NODE_303231_length_162_cov_421.047619	29	92	146	1	63	0.0158730
NODE_303231_length_162_cov_421.047619	29	92	156	1	63	0.0158730
NODE_303231_length_162_cov_421.047619	29	92	158	1	63	0.0158730
NODE_303231_length_162_cov_421.047619	29	92	166	2	63	0.0317460
NODE_303231_length_162_cov_421.047619	29	92	176	1	63	0.0158730
NODE_303231_length_162_cov_421.047619	29	92	179	1	63	0.0158730
NODE_303231_length_162_cov_421.047619	29	92	193	1	63	0.0158730
NODE_303231_length_162_cov_421.047619	29	92	195	1	63	0.0158730
NODE_303231_length_162_cov_421.047619	29	92	201	2	63	0.0317460
NODE_303231_length_162_cov_421.047619	29	92	204	1	63	0.0158730
NODE_303231_length_162_cov_421.047619	29	92	206	3	63	0.0476190
NODE_303231_length_162_cov_421.047619	29	92	214	2	63	0.0317460
NODE_303231_length_162_cov_421.047619	29	92	222	2	63	0.0317460
NODE_303231_length_162_cov_421.047619	29	92	224	2	63	0.0317460
NODE_303231_length_162_cov_421.047619	29	92	225	4	63	0.0634921
NODE_303231_length_162_cov_421.047619	29	92	226	33	63	0.5238096
NODE_303231_length_162_cov_421.047619	29	92	131	1	63	0.0158730
NODE_303231_length_162_cov_421.047619	29	92	132	3	63	0.0476190
NODE_303231_length_162_cov_421.047619	29	92	144	1	63	0.0158730
NODE_303231_length_162_cov_421.047619	29	92	146	1	63	0.0158730
NODE_303231_length_162_cov_421.047619	29	92	156	1	63	0.0158730
NODE_303231_length_162_cov_421.047619	29	92	158	1	63	0.0158730
NODE_303231_length_162_cov_421.047619	29	92	166	2	63	0.0317460
NODE_303231_length_162_cov_421.047619	29	92	176	1	63	0.0158730
NODE_303231_length_162_cov_421.047619	29	92	179	1	63	0.0158730
NODE_303231_length_162_cov_421.047619	29	92	193	1	63	0.0158730
NODE_303231_length_162_cov_421.047619	29	92	195	1	63	0.0158730
NODE_303231_length_162_cov_421.047619	29	92	201	2	63	0.0317460
NODE_303231_length_162_cov_421.047619	29	92	204	1	63	0.0158730
NODE_303231_length_162_cov_421.047619	29	92	206	3	63	0.0476190
NODE_303231_length_162_cov_421.047619	29	92	214	2	63	0.0317460
NODE_303231_length_162_cov_421.047619	29	92	222	2	63	0.0317460
NODE_303231_length_162_cov_421.047619	29	92	224	2	63	0.0317460
NODE_303231_length_162_cov_421.047619	29	92	225	4	63	0.0634921
NODE_303231_length_162_cov_421.047619	29	92	226	33	63	0.5238096
NODE_303231_length_162_cov_421.047619	29	92	131	1	63	0.0158730
NODE_303231_length_162_cov_421.047619	29	92	132	3	63	0.0476190
NODE_303231_length_162_cov_421.047619	29	92	144	1	63	0.0158730
NODE_303231_length_162_cov_421.047619	29	92	146	1	63	0.0158730
NODE_303231_length_162_cov_421.047619	29	92	156	1	63	0.0158730
NODE_303231_length_162_cov_421.047619	29	92	158	1	63	0.0158730
NODE_303231_length_162_cov_421.047619	29	92	166	2	63	0.0317460
NODE_303231_length_162_cov_421.047619	29	92	176	1	63	0.0158730
NODE_303231_length_162_cov_421.047619	29	92	179	1	63	0.0158730
NODE_303231_length_162_cov_421.047619	29	92	193	1	63	0.0158730
NODE_303231_length_162_cov_421.047619	29	92	195	1	63	0.0158730
NODE_303231_length_162_cov_421.047619	29	92	201	2	63	0.0317460
NODE_303231_length_162_cov_421.047619	29	92	204	1	63	0.0158730
NODE_303231_length_162_cov_421.047619	29	92	206	3	63	0.0476190
NODE_303231_length_162_cov_421.047619	29	92	214	2	63	0.0317460
NODE_303231_length_162_cov_421.047619	29	92	222	2	63	0.0317460
NODE_303231_length_162_cov_421.047619	29	92	224	2	63	0.0317460
NODE_303231_length_162_cov_421.047619	29	92	225	4	63	0.0634921
NODE_303231_length_162_cov_421.047619	29	92	226	33	63	0.5238096
NODE_303250_length_162_cov_45.380952	63	127	44	16	64	0.2500000
NODE_303250_length_162_cov_45.380952	63	127	46	48	64	0.7500000
NODE_303250_length_162_cov_45.380952	63	127	44	16	64	0.2500000
NODE_303250_length_162_cov_45.380952	63	127	46	48	64	0.7500000
NODE_303250_length_162_cov_45.380952	100	162	0	4	62	0.0645161
NODE_303250_length_162_cov_45.380952	100	162	6	6	62	0.0967742
NODE_303250_length_162_cov_45.380952	100	162	8	3	62	0.0483871
NODE_303250_length_162_cov_45.380952	100	162	10	2	62	0.0322581
NODE_303250_length_162_cov_45.380952	100	162	11	4	62	0.0645161
NODE_303250_length_162_cov_45.380952	100	162	15	1	62	0.0161290
NODE_303250_length_162_cov_45.380952	100	162	19	1	62	0.0161290
NODE_303250_length_162_cov_45.380952	100	162	22	7	62	0.1129032
NODE_303250_length_162_cov_45.380952	100	162	26	1	62	0.0161290
NODE_303250_length_162_cov_45.380952	100	162	30	5	62	0.0806452
NODE_303250_length_162_cov_45.380952	100	162	34	1	62	0.0161290
NODE_303250_length_162_cov_45.380952	100	162	44	16	62	0.2580645
NODE_303250_length_162_cov_45.380952	100	162	46	11	62	0.1774193
NODE_303301_length_161_cov_1483.177419	51	131	112	2	80	0.0250000
NODE_303301_length_161_cov_1483.177419	51	131	122	6	80	0.0750000
NODE_303301_length_161_cov_1483.177419	51	131	124	1	80	0.0125000
NODE_303301_length_161_cov_1483.177419	51	131	126	6	80	0.0750000
NODE_303301_length_161_cov_1483.177419	51	131	128	2	80	0.0250000
NODE_303301_length_161_cov_1483.177419	51	131	130	1	80	0.0125000
NODE_303301_length_161_cov_1483.177419	51	131	134	1	80	0.0125000
NODE_303301_length_161_cov_1483.177419	51	131	136	5	80	0.0625000
NODE_303301_length_161_cov_1483.177419	51	131	138	5	80	0.0625000
NODE_303301_length_161_cov_1483.177419	51	131	140	4	80	0.0500000
NODE_303301_length_161_cov_1483.177419	51	131	144	1	80	0.0125000
NODE_303301_length_161_cov_1483.177419	51	131	146	1	80	0.0125000
NODE_303301_length_161_cov_1483.177419	51	131	151	1	80	0.0125000
NODE_303301_length_161_cov_1483.177419	51	131	152	44	80	0.5500000
NODE_303301_length_161_cov_1483.177419	104	161	22	2	57	0.0350877
NODE_303301_length_161_cov_1483.177419	104	161	25	2	57	0.0350877
NODE_303301_length_161_cov_1483.177419	104	161	27	1	57	0.0175439
NODE_303301_length_161_cov_1483.177419	104	161	32	1	57	0.0175439
NODE_303301_length_161_cov_1483.177419	104	161	38	1	57	0.0175439
NODE_303301_length_161_cov_1483.177419	104	161	40	1	57	0.0175439
NODE_303301_length_161_cov_1483.177419	104	161	44	1	57	0.0175439
NODE_303301_length_161_cov_1483.177419	104	161	46	1	57	0.0175439
NODE_303301_length_161_cov_1483.177419	104	161	52	1	57	0.0175439
NODE_303301_length_161_cov_1483.177419	104	161	54	1	57	0.0175439
NODE_303301_length_161_cov_1483.177419	104	161	56	1	57	0.0175439
NODE_303301_length_161_cov_1483.177419	104	161	60	1	57	0.0175439
NODE_303301_length_161_cov_1483.177419	104	161	62	1	57	0.0175439
NODE_303301_length_161_cov_1483.177419	104	161	64	1	57	0.0175439
NODE_303301_length_161_cov_1483.177419	104	161	66	2	57	0.0350877
NODE_303301_length_161_cov_1483.177419	104	161	68	1	57	0.0175439
NODE_303301_length_161_cov_1483.177419	104	161	70	1	57	0.0175439
NODE_303301_length_161_cov_1483.177419	104	161	76	1	57	0.0175439
NODE_303301_length_161_cov_1483.177419	104	161	78	1	57	0.0175439
NODE_303301_length_161_cov_1483.177419	104	161	82	1	57	0.0175439
NODE_303301_length_161_cov_1483.177419	104	161	92	1	57	0.0175439
NODE_303301_length_161_cov_1483.177419	104	161	106	1	57	0.0175439
NODE_303301_length_161_cov_1483.177419	104	161	108	1	57	0.0175439
NODE_303301_length_161_cov_1483.177419	104	161	110	1	57	0.0175439
NODE_303301_length_161_cov_1483.177419	104	161	114	1	57	0.0175439
NODE_303301_length_161_cov_1483.177419	104	161	115	1	57	0.0175439
NODE_303301_length_161_cov_1483.177419	104	161	119	1	57	0.0175439
NODE_303301_length_161_cov_1483.177419	104	161	122	6	57	0.1052632
NODE_303301_length_161_cov_1483.177419	104	161	124	1	57	0.0175439
NODE_303301_length_161_cov_1483.177419	104	161	126	5	57	0.0877193
NODE_303301_length_161_cov_1483.177419	104	161	128	1	57	0.0175439
NODE_303301_length_161_cov_1483.177419	104	161	130	1	57	0.0175439
NODE_303301_length_161_cov_1483.177419	104	161	134	1	57	0.0175439
NODE_303301_length_161_cov_1483.177419	104	161	136	4	57	0.0701754
NODE_303301_length_161_cov_1483.177419	104	161	138	4	57	0.0701754
NODE_303301_length_161_cov_1483.177419	104	161	140	4	57	0.0701754
NODE_303312_length_161_cov_71.500000	33	110	0	10	77	0.1298701
NODE_303312_length_161_cov_71.500000	33	110	2	4	77	0.0519481
NODE_303312_length_161_cov_71.500000	33	110	8	7	77	0.0909091
NODE_303312_length_161_cov_71.500000	33	110	14	56	77	0.7272727
NODE_303312_length_161_cov_71.500000	33	110	0	10	77	0.1298701
NODE_303312_length_161_cov_71.500000	33	110	2	4	77	0.0519481
NODE_303312_length_161_cov_71.500000	33	110	8	7	77	0.0909091
NODE_303312_length_161_cov_71.500000	33	110	14	56	77	0.7272727
NODE_303312_length_161_cov_71.500000	33	110	0	10	77	0.1298701
NODE_303312_length_161_cov_71.500000	33	110	2	4	77	0.0519481
NODE_303312_length_161_cov_71.500000	33	110	8	7	77	0.0909091
NODE_303312_length_161_cov_71.500000	33	110	14	56	77	0.7272727
NODE_303312_length_161_cov_71.500000	33	110	0	10	77	0.1298701
NODE_303312_length_161_cov_71.500000	33	110	2	4	77	0.0519481
NODE_303312_length_161_cov_71.500000	33	110	8	7	77	0.0909091
NODE_303312_length_161_cov_71.500000	33	110	14	56	77	0.7272727
NODE_303312_length_161_cov_71.500000	83	149	12	1	66	0.0151515
NODE_303312_length_161_cov_71.500000	83	149	14	65	66	0.9848485
NODE_303312_length_161_cov_71.500000	83	161	0	8	78	0.1025641
NODE_303312_length_161_cov_71.500000	83	161	6	1	78	0.0128205
NODE_303312_length_161_cov_71.500000	83	161	12	4	78	0.0512821
NODE_303312_length_161_cov_71.500000	83	161	14	65	78	0.8333333
NODE_303312_length_161_cov_71.500000	86	161	0	8	75	0.1066667
NODE_303312_length_161_cov_71.500000	86	161	6	1	75	0.0133333
NODE_303312_length_161_cov_71.500000	86	161	12	4	75	0.0533333
NODE_303312_length_161_cov_71.500000	86	161	14	62	75	0.8266667
NODE_303312_length_161_cov_71.500000	86	161	0	8	75	0.1066667
NODE_303312_length_161_cov_71.500000	86	161	6	1	75	0.0133333
NODE_303312_length_161_cov_71.500000	86	161	12	4	75	0.0533333
NODE_303312_length_161_cov_71.500000	86	161	14	62	75	0.8266667
NODE_303312_length_161_cov_71.500000	88	161	0	8	73	0.1095890
NODE_303312_length_161_cov_71.500000	88	161	6	1	73	0.0136986
NODE_303312_length_161_cov_71.500000	88	161	12	4	73	0.0547945
NODE_303312_length_161_cov_71.500000	88	161	14	60	73	0.8219178
NODE_303321_length_161_cov_29.758065	0	80	10	10	80	0.1250000
NODE_303321_length_161_cov_29.758065	0	80	14	6	80	0.0750000
NODE_303321_length_161_cov_29.758065	0	80	16	1	80	0.0125000
NODE_303321_length_161_cov_29.758065	0	80	18	3	80	0.0375000
NODE_303321_length_161_cov_29.758065	0	80	20	1	80	0.0125000
NODE_303321_length_161_cov_29.758065	0	80	23	7	80	0.0875000
NODE_303321_length_161_cov_29.758065	0	80	25	4	80	0.0500000
NODE_303321_length_161_cov_29.758065	0	80	27	11	80	0.1375000
NODE_303321_length_161_cov_29.758065	0	80	33	8	80	0.1000000
NODE_303321_length_161_cov_29.758065	0	80	35	4	80	0.0500000
NODE_303321_length_161_cov_29.758065	0	80	37	2	80	0.0250000
NODE_303321_length_161_cov_29.758065	0	80	39	1	80	0.0125000
NODE_303321_length_161_cov_29.758065	0	80	41	9	80	0.1125000
NODE_303321_length_161_cov_29.758065	0	80	42	13	80	0.1625000
NODE_303381_length_160_cov_143.573770	45	125	14	7	80	0.0875000
NODE_303381_length_160_cov_143.573770	45	125	16	1	80	0.0125000
NODE_303381_length_160_cov_143.573770	45	125	18	10	80	0.1250000
NODE_303381_length_160_cov_143.573770	45	125	20	62	80	0.7750000
NODE_303381_length_160_cov_143.573770	93	160	0	21	67	0.3134328
NODE_303381_length_160_cov_143.573770	93	160	3	1	67	0.0149254
NODE_303381_length_160_cov_143.573770	93	160	5	3	67	0.0447761
NODE_303381_length_160_cov_143.573770	93	160	6	2	67	0.0298507
NODE_303381_length_160_cov_143.573770	93	160	8	3	67	0.0447761
NODE_303381_length_160_cov_143.573770	93	160	10	3	67	0.0447761
NODE_303381_length_160_cov_143.573770	93	160	14	9	67	0.1343284
NODE_303381_length_160_cov_143.573770	93	160	16	1	67	0.0149254
NODE_303381_length_160_cov_143.573770	93	160	18	2	67	0.0298507
NODE_303381_length_160_cov_143.573770	93	160	20	22	67	0.3283582
NODE_303381_length_160_cov_143.573770	98	120	14	2	22	0.0909091
NODE_303381_length_160_cov_143.573770	98	120	16	1	22	0.0454545
NODE_303381_length_160_cov_143.573770	98	120	18	2	22	0.0909091
NODE_303381_length_160_cov_143.573770	98	120	20	17	22	0.7727273
NODE_303388_length_160_cov_58.245902	0	45	0	1	45	0.0222222
NODE_303388_length_160_cov_58.245902	0	45	2	5	45	0.1111111
NODE_303388_length_160_cov_58.245902	0	45	4	1	45	0.0222222
NODE_303388_length_160_cov_58.245902	0	45	8	1	45	0.0222222
NODE_303388_length_160_cov_58.245902	0	45	12	9	45	0.2000000
NODE_303388_length_160_cov_58.245902	0	45	13	2	45	0.0444444
NODE_303388_length_160_cov_58.245902	0	45	15	7	45	0.1555556
NODE_303388_length_160_cov_58.245902	0	45	17	1	45	0.0222222
NODE_303388_length_160_cov_58.245902	0	45	22	2	45	0.0444444
NODE_303388_length_160_cov_58.245902	0	45	24	3	45	0.0666667
NODE_303388_length_160_cov_58.245902	0	45	26	7	45	0.1555556
NODE_303388_length_160_cov_58.245902	0	45	32	6	45	0.1333333
NODE_303431_length_159_cov_182.016667	71	156	13	2	85	0.0235294
NODE_303431_length_159_cov_182.016667	71	156	14	3	85	0.0352941
NODE_303431_length_159_cov_182.016667	71	156	16	9	85	0.1058824
NODE_303431_length_159_cov_182.016667	71	156	21	1	85	0.0117647
NODE_303431_length_159_cov_182.016667	71	156	22	1	85	0.0117647
NODE_303431_length_159_cov_182.016667	71	156	30	6	85	0.0705882
NODE_303431_length_159_cov_182.016667	71	156	38	2	85	0.0235294
NODE_303431_length_159_cov_182.016667	71	156	40	2	85	0.0235294
NODE_303431_length_159_cov_182.016667	71	156	41	33	85	0.3882353
NODE_303431_length_159_cov_182.016667	71	156	42	26	85	0.3058824
NODE_303431_length_159_cov_182.016667	71	156	13	2	85	0.0235294
NODE_303431_length_159_cov_182.016667	71	156	14	3	85	0.0352941
NODE_303431_length_159_cov_182.016667	71	156	16	9	85	0.1058824
NODE_303431_length_159_cov_182.016667	71	156	21	1	85	0.0117647
NODE_303431_length_159_cov_182.016667	71	156	22	1	85	0.0117647
NODE_303431_length_159_cov_182.016667	71	156	30	6	85	0.0705882
NODE_303431_length_159_cov_182.016667	71	156	38	2	85	0.0235294
NODE_303431_length_159_cov_182.016667	71	156	40	2	85	0.0235294
NODE_303431_length_159_cov_182.016667	71	156	41	33	85	0.3882353
NODE_303431_length_159_cov_182.016667	71	156	42	26	85	0.3058824
NODE_303431_length_159_cov_182.016667	71	156	13	2	85	0.0235294
NODE_303431_length_159_cov_182.016667	71	156	14	3	85	0.0352941
NODE_303431_length_159_cov_182.016667	71	156	16	9	85	0.1058824
NODE_303431_length_159_cov_182.016667	71	156	21	1	85	0.0117647
NODE_303431_length_159_cov_182.016667	71	156	22	1	85	0.0117647
NODE_303431_length_159_cov_182.016667	71	156	30	6	85	0.0705882
NODE_303431_length_159_cov_182.016667	71	156	38	2	85	0.0235294
NODE_303431_length_159_cov_182.016667	71	156	40	2	85	0.0235294
NODE_303431_length_159_cov_182.016667	71	156	41	33	85	0.3882353
NODE_303431_length_159_cov_182.016667	71	156	42	26	85	0.3058824
NODE_303440_length_159_cov_85.750000	0	43	2	2	43	0.0465116
NODE_303440_length_159_cov_85.750000	0	43	4	4	43	0.0930233
NODE_303440_length_159_cov_85.750000	0	43	6	5	43	0.1162791
NODE_303440_length_159_cov_85.750000	0	43	10	1	43	0.0232558
NODE_303440_length_159_cov_85.750000	0	43	14	2	43	0.0465116
NODE_303440_length_159_cov_85.750000	0	43	15	5	43	0.1162791
NODE_303440_length_159_cov_85.750000	0	43	21	3	43	0.0697674
NODE_303440_length_159_cov_85.750000	0	43	23	12	43	0.2790698
NODE_303440_length_159_cov_85.750000	0	43	25	4	43	0.0930233
NODE_303440_length_159_cov_85.750000	0	43	26	5	43	0.1162791
NODE_303440_length_159_cov_85.750000	16	97	15	3	81	0.0370370
NODE_303440_length_159_cov_85.750000	16	97	21	3	81	0.0370370
NODE_303440_length_159_cov_85.750000	16	97	23	12	81	0.1481481
NODE_303440_length_159_cov_85.750000	16	97	25	4	81	0.0493827
NODE_303440_length_159_cov_85.750000	16	97	26	11	81	0.1358025
NODE_303440_length_159_cov_85.750000	16	97	28	6	81	0.0740741
NODE_303440_length_159_cov_85.750000	16	97	34	1	81	0.0123457
NODE_303440_length_159_cov_85.750000	16	97	36	1	81	0.0123457
NODE_303440_length_159_cov_85.750000	16	97	37	27	81	0.3333333
NODE_303440_length_159_cov_85.750000	16	97	38	13	81	0.1604938
NODE_303440_length_159_cov_85.750000	65	145	12	1	80	0.0125000
NODE_303440_length_159_cov_85.750000	65	145	16	7	80	0.0875000
NODE_303440_length_159_cov_85.750000	65	145	18	17	80	0.2125000
NODE_303440_length_159_cov_85.750000	65	145	19	3	80	0.0375000
NODE_303440_length_159_cov_85.750000	65	145	21	5	80	0.0625000
NODE_303440_length_159_cov_85.750000	65	145	23	2	80	0.0250000
NODE_303440_length_159_cov_85.750000	65	145	25	1	80	0.0125000
NODE_303440_length_159_cov_85.750000	65	145	27	3	80	0.0375000
NODE_303440_length_159_cov_85.750000	65	145	29	3	80	0.0375000
NODE_303440_length_159_cov_85.750000	65	145	31	1	80	0.0125000
NODE_303440_length_159_cov_85.750000	65	145	37	32	80	0.4000000
NODE_303440_length_159_cov_85.750000	65	145	38	5	80	0.0625000
NODE_303440_length_159_cov_85.750000	70	92	37	22	22	1.0000000
NODE_303546_length_158_cov_119.813559	34	77	42	2	43	0.0465116
NODE_303546_length_158_cov_119.813559	34	77	44	2	43	0.0465116
NODE_303546_length_158_cov_119.813559	34	77	46	5	43	0.1162791
NODE_303546_length_158_cov_119.813559	34	77	48	4	43	0.0930233
NODE_303546_length_158_cov_119.813559	34	77	50	1	43	0.0232558
NODE_303546_length_158_cov_119.813559	34	77	52	2	43	0.0465116
NODE_303546_length_158_cov_119.813559	34	77	56	2	43	0.0465116
NODE_303546_length_158_cov_119.813559	34	77	58	25	43	0.5813953
NODE_303546_length_158_cov_119.813559	78	113	50	5	35	0.1428571
NODE_303546_length_158_cov_119.813559	78	113	53	1	35	0.0285714
NODE_303546_length_158_cov_119.813559	78	113	54	4	35	0.1142857
NODE_303546_length_158_cov_119.813559	78	113	56	1	35	0.0285714
NODE_303546_length_158_cov_119.813559	78	113	58	24	35	0.6857143
NODE_303546_length_158_cov_119.813559	123	158	4	6	35	0.1714286
NODE_303546_length_158_cov_119.813559	123	158	6	7	35	0.2000000
NODE_303546_length_158_cov_119.813559	123	158	12	11	35	0.3142857
NODE_303546_length_158_cov_119.813559	123	158	16	4	35	0.1142857
NODE_303546_length_158_cov_119.813559	123	158	18	1	35	0.0285714
NODE_303546_length_158_cov_119.813559	123	158	20	1	35	0.0285714
NODE_303546_length_158_cov_119.813559	123	158	21	1	35	0.0285714
NODE_303546_length_158_cov_119.813559	123	158	22	3	35	0.0857143
NODE_303546_length_158_cov_119.813559	123	158	26	1	35	0.0285714
NODE_303552_length_158_cov_70.135593	5	82	4	39	77	0.5064935
NODE_303552_length_158_cov_70.135593	5	82	8	4	77	0.0519481
NODE_303552_length_158_cov_70.135593	5	82	10	34	77	0.4415585
NODE_303552_length_158_cov_70.135593	5	82	4	39	77	0.5064935
NODE_303552_length_158_cov_70.135593	5	82	8	4	77	0.0519481
NODE_303552_length_158_cov_70.135593	5	82	10	34	77	0.4415585
NODE_303552_length_158_cov_70.135593	81	155	0	5	74	0.0675676
NODE_303552_length_158_cov_70.135593	81	155	4	2	74	0.0270270
NODE_303552_length_158_cov_70.135593	81	155	8	8	74	0.1081081
NODE_303552_length_158_cov_70.135593	81	155	10	59	74	0.7972973
NODE_303555_length_158_cov_63.559322	80	151	13	5	71	0.0704225
NODE_303555_length_158_cov_63.559322	80	151	17	6	71	0.0845070
NODE_303555_length_158_cov_63.559322	80	151	19	2	71	0.0281690
NODE_303555_length_158_cov_63.559322	80	151	21	1	71	0.0140845
NODE_303555_length_158_cov_63.559322	80	151	27	5	71	0.0704225
NODE_303555_length_158_cov_63.559322	80	151	29	4	71	0.0563380
NODE_303555_length_158_cov_63.559322	80	151	34	13	71	0.1830986
NODE_303555_length_158_cov_63.559322	80	151	43	1	71	0.0140845
NODE_303555_length_158_cov_63.559322	80	151	44	4	71	0.0563380
NODE_303555_length_158_cov_63.559322	80	151	46	3	71	0.0422535
NODE_303555_length_158_cov_63.559322	80	151	50	2	71	0.0281690
NODE_303555_length_158_cov_63.559322	80	151	52	25	71	0.3521127
NODE_303556_length_158_cov_61.203390	2	66	67	1	64	0.0156250
NODE_303556_length_158_cov_61.203390	2	66	79	1	64	0.0156250
NODE_303556_length_158_cov_61.203390	2	66	80	1	64	0.0156250
NODE_303556_length_158_cov_61.203390	2	66	83	1	64	0.0156250
NODE_303556_length_158_cov_61.203390	2	66	89	1	64	0.0156250
NODE_303556_length_158_cov_61.203390	2	66	97	1	64	0.0156250
NODE_303556_length_158_cov_61.203390	2	66	102	2	64	0.0312500
NODE_303556_length_158_cov_61.203390	2	66	104	2	64	0.0312500
NODE_303556_length_158_cov_61.203390	2	66	105	1	64	0.0156250
NODE_303556_length_158_cov_61.203390	2	66	118	1	64	0.0156250
NODE_303556_length_158_cov_61.203390	2	66	128	1	64	0.0156250
NODE_303556_length_158_cov_61.203390	2	66	135	1	64	0.0156250
NODE_303556_length_158_cov_61.203390	2	66	141	2	64	0.0312500
NODE_303556_length_158_cov_61.203390	2	66	145	1	64	0.0156250
NODE_303556_length_158_cov_61.203390	2	66	165	1	64	0.0156250
NODE_303556_length_158_cov_61.203390	2	66	168	1	64	0.0156250
NODE_303556_length_158_cov_61.203390	2	66	182	1	64	0.0156250
NODE_303556_length_158_cov_61.203390	2	66	188	1	64	0.0156250
NODE_303556_length_158_cov_61.203390	2	66	198	1	64	0.0156250
NODE_303556_length_158_cov_61.203390	2	66	205	2	64	0.0312500
NODE_303556_length_158_cov_61.203390	2	66	207	1	64	0.0156250
NODE_303556_length_158_cov_61.203390	2	66	247	1	64	0.0156250
NODE_303556_length_158_cov_61.203390	2	66	253	1	64	0.0156250
NODE_303556_length_158_cov_61.203390	2	66	259	1	64	0.0156250
NODE_303556_length_158_cov_61.203390	2	66	263	1	64	0.0156250
NODE_303556_length_158_cov_61.203390	2	66	272	1	64	0.0156250
NODE_303556_length_158_cov_61.203390	2	66	278	3	64	0.0468750
NODE_303556_length_158_cov_61.203390	2	66	282	3	64	0.0468750
NODE_303556_length_158_cov_61.203390	2	66	284	2	64	0.0312500
NODE_303556_length_158_cov_61.203390	2	66	290	1	64	0.0156250
NODE_303556_length_158_cov_61.203390	2	66	292	1	64	0.0156250
NODE_303556_length_158_cov_61.203390	2	66	302	1	64	0.0156250
NODE_303556_length_158_cov_61.203390	2	66	311	1	64	0.0156250
NODE_303556_length_158_cov_61.203390	2	66	325	1	64	0.0156250
NODE_303556_length_158_cov_61.203390	2	66	341	1	64	0.0156250
NODE_303556_length_158_cov_61.203390	2	66	344	1	64	0.0156250
NODE_303556_length_158_cov_61.203390	2	66	346	1	64	0.0156250
NODE_303556_length_158_cov_61.203390	2	66	347	1	64	0.0156250
NODE_303556_length_158_cov_61.203390	2	66	356	3	64	0.0468750
NODE_303556_length_158_cov_61.203390	2	66	358	1	64	0.0156250
NODE_303556_length_158_cov_61.203390	2	66	362	2	64	0.0312500
NODE_303556_length_158_cov_61.203390	2	66	366	11	64	0.1718750
NODE_303556_length_158_cov_61.203390	2	66	67	1	64	0.0156250
NODE_303556_length_158_cov_61.203390	2	66	79	1	64	0.0156250
NODE_303556_length_158_cov_61.203390	2	66	80	1	64	0.0156250
NODE_303556_length_158_cov_61.203390	2	66	83	1	64	0.0156250
NODE_303556_length_158_cov_61.203390	2	66	89	1	64	0.0156250
NODE_303556_length_158_cov_61.203390	2	66	97	1	64	0.0156250
NODE_303556_length_158_cov_61.203390	2	66	102	2	64	0.0312500
NODE_303556_length_158_cov_61.203390	2	66	104	2	64	0.0312500
NODE_303556_length_158_cov_61.203390	2	66	105	1	64	0.0156250
NODE_303556_length_158_cov_61.203390	2	66	118	1	64	0.0156250
NODE_303556_length_158_cov_61.203390	2	66	128	1	64	0.0156250
NODE_303556_length_158_cov_61.203390	2	66	135	1	64	0.0156250
NODE_303556_length_158_cov_61.203390	2	66	141	2	64	0.0312500
NODE_303556_length_158_cov_61.203390	2	66	145	1	64	0.0156250
NODE_303556_length_158_cov_61.203390	2	66	165	1	64	0.0156250
NODE_303556_length_158_cov_61.203390	2	66	168	1	64	0.0156250
NODE_303556_length_158_cov_61.203390	2	66	182	1	64	0.0156250
NODE_303556_length_158_cov_61.203390	2	66	188	1	64	0.0156250
NODE_303556_length_158_cov_61.203390	2	66	198	1	64	0.0156250
NODE_303556_length_158_cov_61.203390	2	66	205	2	64	0.0312500
NODE_303556_length_158_cov_61.203390	2	66	207	1	64	0.0156250
NODE_303556_length_158_cov_61.203390	2	66	247	1	64	0.0156250
NODE_303556_length_158_cov_61.203390	2	66	253	1	64	0.0156250
NODE_303556_length_158_cov_61.203390	2	66	259	1	64	0.0156250
NODE_303556_length_158_cov_61.203390	2	66	263	1	64	0.0156250
NODE_303556_length_158_cov_61.203390	2	66	272	1	64	0.0156250
NODE_303556_length_158_cov_61.203390	2	66	278	3	64	0.0468750
NODE_303556_length_158_cov_61.203390	2	66	282	3	64	0.0468750
NODE_303556_length_158_cov_61.203390	2	66	284	2	64	0.0312500
NODE_303556_length_158_cov_61.203390	2	66	290	1	64	0.0156250
NODE_303556_length_158_cov_61.203390	2	66	292	1	64	0.0156250
NODE_303556_length_158_cov_61.203390	2	66	302	1	64	0.0156250
NODE_303556_length_158_cov_61.203390	2	66	311	1	64	0.0156250
NODE_303556_length_158_cov_61.203390	2	66	325	1	64	0.0156250
NODE_303556_length_158_cov_61.203390	2	66	341	1	64	0.0156250
NODE_303556_length_158_cov_61.203390	2	66	344	1	64	0.0156250
NODE_303556_length_158_cov_61.203390	2	66	346	1	64	0.0156250
NODE_303556_length_158_cov_61.203390	2	66	347	1	64	0.0156250
NODE_303556_length_158_cov_61.203390	2	66	356	3	64	0.0468750
NODE_303556_length_158_cov_61.203390	2	66	358	1	64	0.0156250
NODE_303556_length_158_cov_61.203390	2	66	362	2	64	0.0312500
NODE_303556_length_158_cov_61.203390	2	66	366	11	64	0.1718750
NODE_303556_length_158_cov_61.203390	2	66	67	1	64	0.0156250
NODE_303556_length_158_cov_61.203390	2	66	79	1	64	0.0156250
NODE_303556_length_158_cov_61.203390	2	66	80	1	64	0.0156250
NODE_303556_length_158_cov_61.203390	2	66	83	1	64	0.0156250
NODE_303556_length_158_cov_61.203390	2	66	89	1	64	0.0156250
NODE_303556_length_158_cov_61.203390	2	66	97	1	64	0.0156250
NODE_303556_length_158_cov_61.203390	2	66	102	2	64	0.0312500
NODE_303556_length_158_cov_61.203390	2	66	104	2	64	0.0312500
NODE_303556_length_158_cov_61.203390	2	66	105	1	64	0.0156250
NODE_303556_length_158_cov_61.203390	2	66	118	1	64	0.0156250
NODE_303556_length_158_cov_61.203390	2	66	128	1	64	0.0156250
NODE_303556_length_158_cov_61.203390	2	66	135	1	64	0.0156250
NODE_303556_length_158_cov_61.203390	2	66	141	2	64	0.0312500
NODE_303556_length_158_cov_61.203390	2	66	145	1	64	0.0156250
NODE_303556_length_158_cov_61.203390	2	66	165	1	64	0.0156250
NODE_303556_length_158_cov_61.203390	2	66	168	1	64	0.0156250
NODE_303556_length_158_cov_61.203390	2	66	182	1	64	0.0156250
NODE_303556_length_158_cov_61.203390	2	66	188	1	64	0.0156250
NODE_303556_length_158_cov_61.203390	2	66	198	1	64	0.0156250
NODE_303556_length_158_cov_61.203390	2	66	205	2	64	0.0312500
NODE_303556_length_158_cov_61.203390	2	66	207	1	64	0.0156250
NODE_303556_length_158_cov_61.203390	2	66	247	1	64	0.0156250
NODE_303556_length_158_cov_61.203390	2	66	253	1	64	0.0156250
NODE_303556_length_158_cov_61.203390	2	66	259	1	64	0.0156250
NODE_303556_length_158_cov_61.203390	2	66	263	1	64	0.0156250
NODE_303556_length_158_cov_61.203390	2	66	272	1	64	0.0156250
NODE_303556_length_158_cov_61.203390	2	66	278	3	64	0.0468750
NODE_303556_length_158_cov_61.203390	2	66	282	3	64	0.0468750
NODE_303556_length_158_cov_61.203390	2	66	284	2	64	0.0312500
NODE_303556_length_158_cov_61.203390	2	66	290	1	64	0.0156250
NODE_303556_length_158_cov_61.203390	2	66	292	1	64	0.0156250
NODE_303556_length_158_cov_61.203390	2	66	302	1	64	0.0156250
NODE_303556_length_158_cov_61.203390	2	66	311	1	64	0.0156250
NODE_303556_length_158_cov_61.203390	2	66	325	1	64	0.0156250
NODE_303556_length_158_cov_61.203390	2	66	341	1	64	0.0156250
NODE_303556_length_158_cov_61.203390	2	66	344	1	64	0.0156250
NODE_303556_length_158_cov_61.203390	2	66	346	1	64	0.0156250
NODE_303556_length_158_cov_61.203390	2	66	347	1	64	0.0156250
NODE_303556_length_158_cov_61.203390	2	66	356	3	64	0.0468750
NODE_303556_length_158_cov_61.203390	2	66	358	1	64	0.0156250
NODE_303556_length_158_cov_61.203390	2	66	362	2	64	0.0312500
NODE_303556_length_158_cov_61.203390	2	66	366	11	64	0.1718750
NODE_303556_length_158_cov_61.203390	39	119	284	1	80	0.0125000
NODE_303556_length_158_cov_61.203390	39	119	290	1	80	0.0125000
NODE_303556_length_158_cov_61.203390	39	119	292	1	80	0.0125000
NODE_303556_length_158_cov_61.203390	39	119	302	1	80	0.0125000
NODE_303556_length_158_cov_61.203390	39	119	308	1	80	0.0125000
NODE_303556_length_158_cov_61.203390	39	119	311	1	80	0.0125000
NODE_303556_length_158_cov_61.203390	39	119	312	1	80	0.0125000
NODE_303556_length_158_cov_61.203390	39	119	314	2	80	0.0250000
NODE_303556_length_158_cov_61.203390	39	119	324	1	80	0.0125000
NODE_303556_length_158_cov_61.203390	39	119	325	1	80	0.0125000
NODE_303556_length_158_cov_61.203390	39	119	328	1	80	0.0125000
NODE_303556_length_158_cov_61.203390	39	119	340	1	80	0.0125000
NODE_303556_length_158_cov_61.203390	39	119	341	1	80	0.0125000
NODE_303556_length_158_cov_61.203390	39	119	344	2	80	0.0250000
NODE_303556_length_158_cov_61.203390	39	119	346	1	80	0.0125000
NODE_303556_length_158_cov_61.203390	39	119	347	1	80	0.0125000
NODE_303556_length_158_cov_61.203390	39	119	350	1	80	0.0125000
NODE_303556_length_158_cov_61.203390	39	119	352	1	80	0.0125000
NODE_303556_length_158_cov_61.203390	39	119	354	4	80	0.0500000
NODE_303556_length_158_cov_61.203390	39	119	355	1	80	0.0125000
NODE_303556_length_158_cov_61.203390	39	119	356	3	80	0.0375000
NODE_303556_length_158_cov_61.203390	39	119	358	1	80	0.0125000
NODE_303556_length_158_cov_61.203390	39	119	360	1	80	0.0125000
NODE_303556_length_158_cov_61.203390	39	119	362	4	80	0.0500000
NODE_303556_length_158_cov_61.203390	39	119	364	14	80	0.1750000
NODE_303556_length_158_cov_61.203390	39	119	365	7	80	0.0875000
NODE_303556_length_158_cov_61.203390	39	119	366	18	80	0.2250000
NODE_303556_length_158_cov_61.203390	39	119	367	7	80	0.0875000
NODE_303563_length_158_cov_40.271186	43	107	63	7	64	0.1093750
NODE_303563_length_158_cov_40.271186	43	107	64	3	64	0.0468750
NODE_303563_length_158_cov_40.271186	43	107	66	54	64	0.8437500
NODE_303563_length_158_cov_40.271186	80	151	10	13	71	0.1830986
NODE_303563_length_158_cov_40.271186	80	151	14	4	71	0.0563380
NODE_303563_length_158_cov_40.271186	80	151	16	1	71	0.0140845
NODE_303563_length_158_cov_40.271186	80	151	18	7	71	0.0985916
NODE_303563_length_158_cov_40.271186	80	151	22	5	71	0.0704225
NODE_303563_length_158_cov_40.271186	80	151	24	2	71	0.0281690
NODE_303563_length_158_cov_40.271186	80	151	26	1	71	0.0140845
NODE_303563_length_158_cov_40.271186	80	151	32	2	71	0.0281690
NODE_303563_length_158_cov_40.271186	80	151	34	4	71	0.0563380
NODE_303563_length_158_cov_40.271186	80	151	42	1	71	0.0140845
NODE_303563_length_158_cov_40.271186	80	151	58	1	71	0.0140845
NODE_303563_length_158_cov_40.271186	80	151	62	3	71	0.0422535
NODE_303563_length_158_cov_40.271186	80	151	66	27	71	0.3802817
NODE_303566_length_158_cov_29.661017	0	61	0	30	61	0.4918033
NODE_303566_length_158_cov_29.661017	0	61	2	31	61	0.5081967
NODE_303566_length_158_cov_29.661017	34	64	2	30	30	1.0000000
NODE_303605_length_157_cov_1488.586207	57	138	268	1	81	0.0123457
NODE_303605_length_157_cov_1488.586207	57	138	283	1	81	0.0123457
NODE_303605_length_157_cov_1488.586207	57	138	287	1	81	0.0123457
NODE_303605_length_157_cov_1488.586207	57	138	305	1	81	0.0123457
NODE_303605_length_157_cov_1488.586207	57	138	326	1	81	0.0123457
NODE_303605_length_157_cov_1488.586207	57	138	348	1	81	0.0123457
NODE_303605_length_157_cov_1488.586207	57	138	375	1	81	0.0123457
NODE_303605_length_157_cov_1488.586207	57	138	410	1	81	0.0123457
NODE_303605_length_157_cov_1488.586207	57	138	440	1	81	0.0123457
NODE_303605_length_157_cov_1488.586207	57	138	443	1	81	0.0123457
NODE_303605_length_157_cov_1488.586207	57	138	458	1	81	0.0123457
NODE_303605_length_157_cov_1488.586207	57	138	487	1	81	0.0123457
NODE_303605_length_157_cov_1488.586207	57	138	506	1	81	0.0123457
NODE_303605_length_157_cov_1488.586207	57	138	523	1	81	0.0123457
NODE_303605_length_157_cov_1488.586207	57	138	529	1	81	0.0123457
NODE_303605_length_157_cov_1488.586207	57	138	531	1	81	0.0123457
NODE_303605_length_157_cov_1488.586207	57	138	542	1	81	0.0123457
NODE_303605_length_157_cov_1488.586207	57	138	552	1	81	0.0123457
NODE_303605_length_157_cov_1488.586207	57	138	560	1	81	0.0123457
NODE_303605_length_157_cov_1488.586207	57	138	565	1	81	0.0123457
NODE_303605_length_157_cov_1488.586207	57	138	573	2	81	0.0246914
NODE_303605_length_157_cov_1488.586207	57	138	578	1	81	0.0123457
NODE_303605_length_157_cov_1488.586207	57	138	580	1	81	0.0123457
NODE_303605_length_157_cov_1488.586207	57	138	589	1	81	0.0123457
NODE_303605_length_157_cov_1488.586207	57	138	597	1	81	0.0123457
NODE_303605_length_157_cov_1488.586207	57	138	601	1	81	0.0123457
NODE_303605_length_157_cov_1488.586207	57	138	609	1	81	0.0123457
NODE_303605_length_157_cov_1488.586207	57	138	615	1	81	0.0123457
NODE_303605_length_157_cov_1488.586207	57	138	619	4	81	0.0493827
NODE_303605_length_157_cov_1488.586207	57	138	620	15	81	0.1851852
NODE_303605_length_157_cov_1488.586207	57	138	621	3	81	0.0370370
NODE_303605_length_157_cov_1488.586207	57	138	622	1	81	0.0123457
NODE_303605_length_157_cov_1488.586207	57	138	623	2	81	0.0246914
NODE_303605_length_157_cov_1488.586207	57	138	624	1	81	0.0123457
NODE_303605_length_157_cov_1488.586207	57	138	625	3	81	0.0370370
NODE_303605_length_157_cov_1488.586207	57	138	627	4	81	0.0493827
NODE_303605_length_157_cov_1488.586207	57	138	628	8	81	0.0987654
NODE_303605_length_157_cov_1488.586207	57	138	629	11	81	0.1358025
NODE_303605_length_157_cov_1488.586207	111	157	9	1	46	0.0217391
NODE_303605_length_157_cov_1488.586207	111	157	20	1	46	0.0217391
NODE_303605_length_157_cov_1488.586207	111	157	27	2	46	0.0434783
NODE_303605_length_157_cov_1488.586207	111	157	33	1	46	0.0217391
NODE_303605_length_157_cov_1488.586207	111	157	40	1	46	0.0217391
NODE_303605_length_157_cov_1488.586207	111	157	47	1	46	0.0217391
NODE_303605_length_157_cov_1488.586207	111	157	71	1	46	0.0217391
NODE_303605_length_157_cov_1488.586207	111	157	96	1	46	0.0217391
NODE_303605_length_157_cov_1488.586207	111	157	103	1	46	0.0217391
NODE_303605_length_157_cov_1488.586207	111	157	119	1	46	0.0217391
NODE_303605_length_157_cov_1488.586207	111	157	137	1	46	0.0217391
NODE_303605_length_157_cov_1488.586207	111	157	152	1	46	0.0217391
NODE_303605_length_157_cov_1488.586207	111	157	165	1	46	0.0217391
NODE_303605_length_157_cov_1488.586207	111	157	167	1	46	0.0217391
NODE_303605_length_157_cov_1488.586207	111	157	177	1	46	0.0217391
NODE_303605_length_157_cov_1488.586207	111	157	189	1	46	0.0217391
NODE_303605_length_157_cov_1488.586207	111	157	210	1	46	0.0217391
NODE_303605_length_157_cov_1488.586207	111	157	248	1	46	0.0217391
NODE_303605_length_157_cov_1488.586207	111	157	268	1	46	0.0217391
NODE_303605_length_157_cov_1488.586207	111	157	283	1	46	0.0217391
NODE_303605_length_157_cov_1488.586207	111	157	287	1	46	0.0217391
NODE_303605_length_157_cov_1488.586207	111	157	305	1	46	0.0217391
NODE_303605_length_157_cov_1488.586207	111	157	326	1	46	0.0217391
NODE_303605_length_157_cov_1488.586207	111	157	348	1	46	0.0217391
NODE_303605_length_157_cov_1488.586207	111	157	375	1	46	0.0217391
NODE_303605_length_157_cov_1488.586207	111	157	410	1	46	0.0217391
NODE_303605_length_157_cov_1488.586207	111	157	440	1	46	0.0217391
NODE_303605_length_157_cov_1488.586207	111	157	443	1	46	0.0217391
NODE_303605_length_157_cov_1488.586207	111	157	458	1	46	0.0217391
NODE_303605_length_157_cov_1488.586207	111	157	487	1	46	0.0217391
NODE_303605_length_157_cov_1488.586207	111	157	506	1	46	0.0217391
NODE_303605_length_157_cov_1488.586207	111	157	523	1	46	0.0217391
NODE_303605_length_157_cov_1488.586207	111	157	529	1	46	0.0217391
NODE_303605_length_157_cov_1488.586207	111	157	531	1	46	0.0217391
NODE_303605_length_157_cov_1488.586207	111	157	542	1	46	0.0217391
NODE_303605_length_157_cov_1488.586207	111	157	552	1	46	0.0217391
NODE_303605_length_157_cov_1488.586207	111	157	560	1	46	0.0217391
NODE_303605_length_157_cov_1488.586207	111	157	565	1	46	0.0217391
NODE_303605_length_157_cov_1488.586207	111	157	573	2	46	0.0434783
NODE_303605_length_157_cov_1488.586207	111	157	578	1	46	0.0217391
NODE_303605_length_157_cov_1488.586207	111	157	580	1	46	0.0217391
NODE_303605_length_157_cov_1488.586207	111	157	589	1	46	0.0217391
NODE_303605_length_157_cov_1488.586207	111	157	597	1	46	0.0217391
NODE_303605_length_157_cov_1488.586207	111	157	601	1	46	0.0217391
NODE_303606_length_157_cov_295.896552	32	78	22	2	46	0.0434783
NODE_303606_length_157_cov_295.896552	32	78	24	4	46	0.0869565
NODE_303606_length_157_cov_295.896552	32	78	28	4	46	0.0869565
NODE_303606_length_157_cov_295.896552	32	78	30	2	46	0.0434783
NODE_303606_length_157_cov_295.896552	32	78	32	5	46	0.1086956
NODE_303606_length_157_cov_295.896552	32	78	34	1	46	0.0217391
NODE_303606_length_157_cov_295.896552	32	78	36	3	46	0.0652174
NODE_303606_length_157_cov_295.896552	32	78	38	25	46	0.5434783
NODE_303608_length_157_cov_161.689655	0	59	0	18	59	0.3050847
NODE_303608_length_157_cov_161.689655	0	59	2	16	59	0.2711864
NODE_303608_length_157_cov_161.689655	0	59	12	20	59	0.3389831
NODE_303608_length_157_cov_161.689655	0	59	16	5	59	0.0847458
NODE_303608_length_157_cov_161.689655	0	59	0	18	59	0.3050847
NODE_303608_length_157_cov_161.689655	0	59	2	16	59	0.2711864
NODE_303608_length_157_cov_161.689655	0	59	12	20	59	0.3389831
NODE_303608_length_157_cov_161.689655	0	59	16	5	59	0.0847458
NODE_303608_length_157_cov_161.689655	55	135	10	20	80	0.2500000
NODE_303608_length_157_cov_161.689655	55	135	12	1	80	0.0125000
NODE_303608_length_157_cov_161.689655	55	135	16	59	80	0.7375000
NODE_303608_length_157_cov_161.689655	55	135	10	20	80	0.2500000
NODE_303608_length_157_cov_161.689655	55	135	12	1	80	0.0125000
NODE_303608_length_157_cov_161.689655	55	135	16	59	80	0.7375000
NODE_303608_length_157_cov_161.689655	108	157	0	21	49	0.4285714
NODE_303608_length_157_cov_161.689655	108	157	10	21	49	0.4285714
NODE_303608_length_157_cov_161.689655	108	157	12	1	49	0.0204082
NODE_303608_length_157_cov_161.689655	108	157	16	6	49	0.1224490
NODE_303608_length_157_cov_161.689655	113	157	0	21	44	0.4772727
NODE_303608_length_157_cov_161.689655	113	157	10	21	44	0.4772727
NODE_303608_length_157_cov_161.689655	113	157	12	1	44	0.0227273
NODE_303608_length_157_cov_161.689655	113	157	16	1	44	0.0227273
NODE_303677_length_156_cov_100.491228	0	41	0	14	41	0.3414634
NODE_303677_length_156_cov_100.491228	0	41	3	1	41	0.0243902
NODE_303677_length_156_cov_100.491228	0	41	5	1	41	0.0243902
NODE_303677_length_156_cov_100.491228	0	41	9	2	41	0.0487805
NODE_303677_length_156_cov_100.491228	0	41	13	2	41	0.0487805
NODE_303677_length_156_cov_100.491228	0	41	15	2	41	0.0487805
NODE_303677_length_156_cov_100.491228	0	41	17	6	41	0.1463415
NODE_303677_length_156_cov_100.491228	0	41	19	13	41	0.3170732
NODE_303677_length_156_cov_100.491228	21	94	15	1	73	0.0136986
NODE_303677_length_156_cov_100.491228	21	94	17	6	73	0.0821918
NODE_303677_length_156_cov_100.491228	21	94	19	22	73	0.3013699
NODE_303677_length_156_cov_100.491228	21	94	21	44	73	0.6027398
NODE_303688_length_156_cov_37.368421	24	81	0	1	57	0.0175439
NODE_303688_length_156_cov_37.368421	24	81	2	2	57	0.0350877
NODE_303688_length_156_cov_37.368421	24	81	4	6	57	0.1052632
NODE_303688_length_156_cov_37.368421	24	81	6	1	57	0.0175439
NODE_303688_length_156_cov_37.368421	24	81	8	14	57	0.2456140
NODE_303688_length_156_cov_37.368421	24	81	10	3	57	0.0526316
NODE_303688_length_156_cov_37.368421	24	81	14	30	57	0.5263158
NODE_303688_length_156_cov_37.368421	54	134	14	80	80	1.0000000
NODE_303700_length_156_cov_9.543860	2	48	0	46	46	1.0000000
NODE_303700_length_156_cov_9.543860	59	105	0	46	46	1.0000000
NODE_303752_length_155_cov_56.750000	27	102	0	75	75	1.0000000
NODE_303752_length_155_cov_56.750000	80	155	0	75	75	1.0000000
NODE_304022_length_153_cov_0.944444	5	48	0	10	43	0.2325581
NODE_304022_length_153_cov_0.944444	5	48	2	33	43	0.7674419
NODE_304022_length_153_cov_0.944444	37	86	2	49	49	1.0000000
NODE_304022_length_153_cov_0.944444	59	102	2	43	43	1.0000000
NODE_304022_length_153_cov_0.944444	91	140	0	29	49	0.5918368
NODE_304022_length_153_cov_0.944444	91	140	2	20	49	0.4081633
NODE_304022_length_153_cov_0.944444	113	153	0	40	40	1.0000000
NODE_304027_length_152_cov_195.396226	9	89	0	80	80	1.0000000
NODE_304027_length_152_cov_195.396226	9	89	0	80	80	1.0000000
NODE_304027_length_152_cov_195.396226	85	149	0	64	64	1.0000000
NODE_304027_length_152_cov_195.396226	85	152	0	67	67	1.0000000
NODE_304027_length_152_cov_195.396226	85	152	0	67	67	1.0000000
NODE_304027_length_152_cov_195.396226	85	152	0	67	67	1.0000000
NODE_304030_length_152_cov_68.094340	99	150	2	51	51	1.0000000
NODE_304112_length_151_cov_541.615385	19	88	18	6	69	0.0869565
NODE_304112_length_151_cov_541.615385	19	88	22	3	69	0.0434783
NODE_304112_length_151_cov_541.615385	19	88	26	4	69	0.0579710
NODE_304112_length_151_cov_541.615385	19	88	34	1	69	0.0144928
NODE_304112_length_151_cov_541.615385	19	88	36	3	69	0.0434783
NODE_304112_length_151_cov_541.615385	19	88	38	1	69	0.0144928
NODE_304112_length_151_cov_541.615385	19	88	40	1	69	0.0144928
NODE_304112_length_151_cov_541.615385	19	88	42	1	69	0.0144928
NODE_304112_length_151_cov_541.615385	19	88	44	2	69	0.0289855
NODE_304112_length_151_cov_541.615385	19	88	52	1	69	0.0144928
NODE_304112_length_151_cov_541.615385	19	88	66	46	69	0.6666667
NODE_304112_length_151_cov_541.615385	72	149	6	1	77	0.0129870
NODE_304112_length_151_cov_541.615385	72	149	12	3	77	0.0389610
NODE_304112_length_151_cov_541.615385	72	149	14	6	77	0.0779221
NODE_304112_length_151_cov_541.615385	72	149	24	1	77	0.0129870
NODE_304112_length_151_cov_541.615385	72	149	26	1	77	0.0129870
NODE_304112_length_151_cov_541.615385	72	149	29	2	77	0.0259740
NODE_304112_length_151_cov_541.615385	72	149	33	1	77	0.0129870
NODE_304112_length_151_cov_541.615385	72	149	37	2	77	0.0259740
NODE_304112_length_151_cov_541.615385	72	149	39	6	77	0.0779221
NODE_304112_length_151_cov_541.615385	72	149	40	1	77	0.0129870
NODE_304112_length_151_cov_541.615385	72	149	44	1	77	0.0129870
NODE_304112_length_151_cov_541.615385	72	149	48	4	77	0.0519481
NODE_304112_length_151_cov_541.615385	72	149	50	2	77	0.0259740
NODE_304112_length_151_cov_541.615385	72	149	54	1	77	0.0129870
NODE_304112_length_151_cov_541.615385	72	149	56	1	77	0.0129870
NODE_304112_length_151_cov_541.615385	72	149	60	8	77	0.1038961
NODE_304112_length_151_cov_541.615385	72	149	64	1	77	0.0129870
NODE_304112_length_151_cov_541.615385	72	149	66	35	77	0.4545455
NODE_304229_length_150_cov_88.647059	51	102	0	51	51	1.0000000
NODE_304472_length_148_cov_34.183673	23	99	70	1	76	0.0131579
NODE_304472_length_148_cov_34.183673	23	99	72	1	76	0.0131579
NODE_304472_length_148_cov_34.183673	23	99	76	1	76	0.0131579
NODE_304472_length_148_cov_34.183673	23	99	84	1	76	0.0131579
NODE_304472_length_148_cov_34.183673	23	99	88	1	76	0.0131579
NODE_304472_length_148_cov_34.183673	23	99	94	1	76	0.0131579
NODE_304472_length_148_cov_34.183673	23	99	99	1	76	0.0131579
NODE_304472_length_148_cov_34.183673	23	99	105	1	76	0.0131579
NODE_304472_length_148_cov_34.183673	23	99	111	1	76	0.0131579
NODE_304472_length_148_cov_34.183673	23	99	113	1	76	0.0131579
NODE_304472_length_148_cov_34.183673	23	99	117	3	76	0.0394737
NODE_304472_length_148_cov_34.183673	23	99	125	2	76	0.0263158
NODE_304472_length_148_cov_34.183673	23	99	129	1	76	0.0131579
NODE_304472_length_148_cov_34.183673	23	99	131	2	76	0.0263158
NODE_304472_length_148_cov_34.183673	23	99	133	2	76	0.0263158
NODE_304472_length_148_cov_34.183673	23	99	135	56	76	0.7368421
NODE_304570_length_147_cov_472.354167	0	55	4	1	55	0.0181818
NODE_304570_length_147_cov_472.354167	0	55	6	1	55	0.0181818
NODE_304570_length_147_cov_472.354167	0	55	14	1	55	0.0181818
NODE_304570_length_147_cov_472.354167	0	55	18	1	55	0.0181818
NODE_304570_length_147_cov_472.354167	0	55	26	2	55	0.0363636
NODE_304570_length_147_cov_472.354167	0	55	27	1	55	0.0181818
NODE_304570_length_147_cov_472.354167	0	55	28	1	55	0.0181818
NODE_304570_length_147_cov_472.354167	0	55	30	1	55	0.0181818
NODE_304570_length_147_cov_472.354167	0	55	32	1	55	0.0181818
NODE_304570_length_147_cov_472.354167	0	55	35	1	55	0.0181818
NODE_304570_length_147_cov_472.354167	0	55	39	1	55	0.0181818
NODE_304570_length_147_cov_472.354167	0	55	43	2	55	0.0363636
NODE_304570_length_147_cov_472.354167	0	55	47	1	55	0.0181818
NODE_304570_length_147_cov_472.354167	0	55	61	1	55	0.0181818
NODE_304570_length_147_cov_472.354167	0	55	67	1	55	0.0181818
NODE_304570_length_147_cov_472.354167	0	55	75	1	55	0.0181818
NODE_304570_length_147_cov_472.354167	0	55	77	3	55	0.0545455
NODE_304570_length_147_cov_472.354167	0	55	79	1	55	0.0181818
NODE_304570_length_147_cov_472.354167	0	55	81	2	55	0.0363636
NODE_304570_length_147_cov_472.354167	0	55	87	9	55	0.1636364
NODE_304570_length_147_cov_472.354167	0	55	92	7	55	0.1272727
NODE_304570_length_147_cov_472.354167	0	55	94	2	55	0.0363636
NODE_304570_length_147_cov_472.354167	0	55	96	3	55	0.0545455
NODE_304570_length_147_cov_472.354167	0	55	98	10	55	0.1818182
NODE_304570_length_147_cov_472.354167	12	89	43	2	77	0.0259740
NODE_304570_length_147_cov_472.354167	12	89	47	1	77	0.0129870
NODE_304570_length_147_cov_472.354167	12	89	61	1	77	0.0129870
NODE_304570_length_147_cov_472.354167	12	89	67	1	77	0.0129870
NODE_304570_length_147_cov_472.354167	12	89	75	1	77	0.0129870
NODE_304570_length_147_cov_472.354167	12	89	77	3	77	0.0389610
NODE_304570_length_147_cov_472.354167	12	89	79	1	77	0.0129870
NODE_304570_length_147_cov_472.354167	12	89	81	2	77	0.0259740
NODE_304570_length_147_cov_472.354167	12	89	87	9	77	0.1168831
NODE_304570_length_147_cov_472.354167	12	89	92	7	77	0.0909091
NODE_304570_length_147_cov_472.354167	12	89	94	2	77	0.0259740
NODE_304570_length_147_cov_472.354167	12	89	96	3	77	0.0389610
NODE_304570_length_147_cov_472.354167	12	89	98	44	77	0.5714286
NODE_304570_length_147_cov_472.354167	65	137	14	2	72	0.0277778
NODE_304570_length_147_cov_472.354167	65	137	16	1	72	0.0138889
NODE_304570_length_147_cov_472.354167	65	137	20	1	72	0.0138889
NODE_304570_length_147_cov_472.354167	65	137	25	1	72	0.0138889
NODE_304570_length_147_cov_472.354167	65	137	28	1	72	0.0138889
NODE_304570_length_147_cov_472.354167	65	137	32	1	72	0.0138889
NODE_304570_length_147_cov_472.354167	65	137	34	1	72	0.0138889
NODE_304570_length_147_cov_472.354167	65	137	36	2	72	0.0277778
NODE_304570_length_147_cov_472.354167	65	137	38	1	72	0.0138889
NODE_304570_length_147_cov_472.354167	65	137	46	6	72	0.0833333
NODE_304570_length_147_cov_472.354167	65	137	54	1	72	0.0138889
NODE_304570_length_147_cov_472.354167	65	137	62	1	72	0.0138889
NODE_304570_length_147_cov_472.354167	65	137	66	2	72	0.0277778
NODE_304570_length_147_cov_472.354167	65	137	68	1	72	0.0138889
NODE_304570_length_147_cov_472.354167	65	137	70	1	72	0.0138889
NODE_304570_length_147_cov_472.354167	65	137	74	2	72	0.0277778
NODE_304570_length_147_cov_472.354167	65	137	78	2	72	0.0277778
NODE_304570_length_147_cov_472.354167	65	137	80	1	72	0.0138889
NODE_304570_length_147_cov_472.354167	65	137	82	1	72	0.0138889
NODE_304570_length_147_cov_472.354167	65	137	94	3	72	0.0416667
NODE_304570_length_147_cov_472.354167	65	137	96	2	72	0.0277778
NODE_304570_length_147_cov_472.354167	65	137	97	2	72	0.0277778
NODE_304570_length_147_cov_472.354167	65	137	98	36	72	0.5000000
NODE_304572_length_147_cov_229.729167	7	56	16	1	49	0.0204082
NODE_304572_length_147_cov_229.729167	7	56	18	1	49	0.0204082
NODE_304572_length_147_cov_229.729167	7	56	30	2	49	0.0408163
NODE_304572_length_147_cov_229.729167	7	56	34	2	49	0.0408163
NODE_304572_length_147_cov_229.729167	7	56	36	1	49	0.0204082
NODE_304572_length_147_cov_229.729167	7	56	40	3	49	0.0612245
NODE_304572_length_147_cov_229.729167	7	56	44	1	49	0.0204082
NODE_304572_length_147_cov_229.729167	7	56	48	2	49	0.0408163
NODE_304572_length_147_cov_229.729167	7	56	49	4	49	0.0816327
NODE_304572_length_147_cov_229.729167	7	56	59	3	49	0.0612245
NODE_304572_length_147_cov_229.729167	7	56	69	1	49	0.0204082
NODE_304572_length_147_cov_229.729167	7	56	72	3	49	0.0612245
NODE_304572_length_147_cov_229.729167	7	56	74	2	49	0.0408163
NODE_304572_length_147_cov_229.729167	7	56	80	2	49	0.0408163
NODE_304572_length_147_cov_229.729167	7	56	82	1	49	0.0204082
NODE_304572_length_147_cov_229.729167	7	56	83	1	49	0.0204082
NODE_304572_length_147_cov_229.729167	7	56	85	1	49	0.0204082
NODE_304572_length_147_cov_229.729167	7	56	89	1	49	0.0204082
NODE_304572_length_147_cov_229.729167	7	56	91	1	49	0.0204082
NODE_304572_length_147_cov_229.729167	7	56	97	6	49	0.1224490
NODE_304572_length_147_cov_229.729167	7	56	98	10	49	0.2040816
NODE_304572_length_147_cov_229.729167	29	93	72	2	64	0.0312500
NODE_304572_length_147_cov_229.729167	29	93	74	2	64	0.0312500
NODE_304572_length_147_cov_229.729167	29	93	80	2	64	0.0312500
NODE_304572_length_147_cov_229.729167	29	93	82	1	64	0.0156250
NODE_304572_length_147_cov_229.729167	29	93	83	1	64	0.0156250
NODE_304572_length_147_cov_229.729167	29	93	85	1	64	0.0156250
NODE_304572_length_147_cov_229.729167	29	93	89	1	64	0.0156250
NODE_304572_length_147_cov_229.729167	29	93	91	1	64	0.0156250
NODE_304572_length_147_cov_229.729167	29	93	97	6	64	0.0937500
NODE_304572_length_147_cov_229.729167	29	93	98	47	64	0.7343750
NODE_304572_length_147_cov_229.729167	29	93	72	2	64	0.0312500
NODE_304572_length_147_cov_229.729167	29	93	74	2	64	0.0312500
NODE_304572_length_147_cov_229.729167	29	93	80	2	64	0.0312500
NODE_304572_length_147_cov_229.729167	29	93	82	1	64	0.0156250
NODE_304572_length_147_cov_229.729167	29	93	83	1	64	0.0156250
NODE_304572_length_147_cov_229.729167	29	93	85	1	64	0.0156250
NODE_304572_length_147_cov_229.729167	29	93	89	1	64	0.0156250
NODE_304572_length_147_cov_229.729167	29	93	91	1	64	0.0156250
NODE_304572_length_147_cov_229.729167	29	93	97	6	64	0.0937500
NODE_304572_length_147_cov_229.729167	29	93	98	47	64	0.7343750
NODE_304572_length_147_cov_229.729167	29	93	72	2	64	0.0312500
NODE_304572_length_147_cov_229.729167	29	93	74	2	64	0.0312500
NODE_304572_length_147_cov_229.729167	29	93	80	2	64	0.0312500
NODE_304572_length_147_cov_229.729167	29	93	82	1	64	0.0156250
NODE_304572_length_147_cov_229.729167	29	93	83	1	64	0.0156250
NODE_304572_length_147_cov_229.729167	29	93	85	1	64	0.0156250
NODE_304572_length_147_cov_229.729167	29	93	89	1	64	0.0156250
NODE_304572_length_147_cov_229.729167	29	93	91	1	64	0.0156250
NODE_304572_length_147_cov_229.729167	29	93	97	6	64	0.0937500
NODE_304572_length_147_cov_229.729167	29	93	98	47	64	0.7343750
NODE_304573_length_147_cov_213.770833	37	117	0	80	80	1.0000000
NODE_304573_length_147_cov_213.770833	90	146	0	56	56	1.0000000
NODE_304697_length_146_cov_182.893617	1	60	0	27	59	0.4576271
NODE_304697_length_146_cov_182.893617	1	60	2	32	59	0.5423729
NODE_304697_length_146_cov_182.893617	34	60	2	26	26	1.0000000
NODE_304697_length_146_cov_182.893617	113	144	0	25	31	0.8064516
NODE_304697_length_146_cov_182.893617	113	144	2	6	31	0.1935484
NODE_304698_length_146_cov_152.808511	0	69	0	69	69	1.0000000
NODE_304698_length_146_cov_152.808511	42	122	0	80	80	1.0000000
NODE_304703_length_146_cov_89.808511	0	53	0	3	53	0.0566038
NODE_304703_length_146_cov_89.808511	0	53	2	50	53	0.9433962
NODE_304703_length_146_cov_89.808511	26	106	2	80	80	1.0000000
NODE_304703_length_146_cov_89.808511	74	146	0	26	72	0.3611111
NODE_304703_length_146_cov_89.808511	74	146	2	46	72	0.6388889
NODE_304703_length_146_cov_89.808511	79	101	2	22	22	1.0000000
NODE_304707_length_146_cov_57.446809	44	124	0	80	80	1.0000000
NODE_304708_length_146_cov_54.106383	0	69	0	69	69	1.0000000
NODE_304708_length_146_cov_54.106383	42	122	0	80	80	1.0000000
NODE_304710_length_146_cov_46.765957	3	83	0	80	80	1.0000000
NODE_304710_length_146_cov_46.765957	3	83	0	80	80	1.0000000
NODE_304710_length_146_cov_46.765957	3	83	0	80	80	1.0000000
NODE_304710_length_146_cov_46.765957	3	83	0	80	80	1.0000000
NODE_304710_length_146_cov_46.765957	3	83	0	80	80	1.0000000
NODE_304710_length_146_cov_46.765957	12	83	0	71	71	1.0000000
NODE_304710_length_146_cov_46.765957	56	136	0	80	80	1.0000000
NODE_304710_length_146_cov_46.765957	56	136	0	80	80	1.0000000
NODE_304711_length_146_cov_44.021277	0	69	0	15	69	0.2173913
NODE_304711_length_146_cov_44.021277	0	69	4	54	69	0.7826087
NODE_304711_length_146_cov_44.021277	42	122	4	80	80	1.0000000
NODE_304798_length_145_cov_1385.413043	0	69	86	1	69	0.0144928
NODE_304798_length_145_cov_1385.413043	0	69	90	1	69	0.0144928
NODE_304798_length_145_cov_1385.413043	0	69	101	1	69	0.0144928
NODE_304798_length_145_cov_1385.413043	0	69	115	2	69	0.0289855
NODE_304798_length_145_cov_1385.413043	0	69	128	1	69	0.0144928
NODE_304798_length_145_cov_1385.413043	0	69	141	2	69	0.0289855
NODE_304798_length_145_cov_1385.413043	0	69	145	1	69	0.0144928
NODE_304798_length_145_cov_1385.413043	0	69	147	1	69	0.0144928
NODE_304798_length_145_cov_1385.413043	0	69	161	1	69	0.0144928
NODE_304798_length_145_cov_1385.413043	0	69	166	1	69	0.0144928
NODE_304798_length_145_cov_1385.413043	0	69	203	1	69	0.0144928
NODE_304798_length_145_cov_1385.413043	0	69	209	1	69	0.0144928
NODE_304798_length_145_cov_1385.413043	0	69	221	1	69	0.0144928
NODE_304798_length_145_cov_1385.413043	0	69	230	1	69	0.0144928
NODE_304798_length_145_cov_1385.413043	0	69	239	1	69	0.0144928
NODE_304798_length_145_cov_1385.413043	0	69	262	1	69	0.0144928
NODE_304798_length_145_cov_1385.413043	0	69	271	1	69	0.0144928
NODE_304798_length_145_cov_1385.413043	0	69	285	1	69	0.0144928
NODE_304798_length_145_cov_1385.413043	0	69	291	1	69	0.0144928
NODE_304798_length_145_cov_1385.413043	0	69	295	1	69	0.0144928
NODE_304798_length_145_cov_1385.413043	0	69	317	4	69	0.0579710
NODE_304798_length_145_cov_1385.413043	0	69	319	1	69	0.0144928
NODE_304798_length_145_cov_1385.413043	0	69	325	1	69	0.0144928
NODE_304798_length_145_cov_1385.413043	0	69	326	1	69	0.0144928
NODE_304798_length_145_cov_1385.413043	0	69	339	1	69	0.0144928
NODE_304798_length_145_cov_1385.413043	0	69	349	1	69	0.0144928
NODE_304798_length_145_cov_1385.413043	0	69	377	1	69	0.0144928
NODE_304798_length_145_cov_1385.413043	0	69	381	1	69	0.0144928
NODE_304798_length_145_cov_1385.413043	0	69	431	1	69	0.0144928
NODE_304798_length_145_cov_1385.413043	0	69	434	1	69	0.0144928
NODE_304798_length_145_cov_1385.413043	0	69	436	1	69	0.0144928
NODE_304798_length_145_cov_1385.413043	0	69	440	2	69	0.0289855
NODE_304798_length_145_cov_1385.413043	0	69	450	1	69	0.0144928
NODE_304798_length_145_cov_1385.413043	0	69	460	1	69	0.0144928
NODE_304798_length_145_cov_1385.413043	0	69	487	1	69	0.0144928
NODE_304798_length_145_cov_1385.413043	0	69	499	1	69	0.0144928
NODE_304798_length_145_cov_1385.413043	0	69	518	1	69	0.0144928
NODE_304798_length_145_cov_1385.413043	0	69	534	1	69	0.0144928
NODE_304798_length_145_cov_1385.413043	0	69	535	20	69	0.2898551
NODE_304798_length_145_cov_1385.413043	0	69	536	4	69	0.0579710
NODE_304798_length_145_cov_1385.413043	0	69	537	1	69	0.0144928
NODE_304798_length_145_cov_1385.413043	42	122	379	1	80	0.0125000
NODE_304798_length_145_cov_1385.413043	42	122	388	1	80	0.0125000
NODE_304798_length_145_cov_1385.413043	42	122	401	1	80	0.0125000
NODE_304798_length_145_cov_1385.413043	42	122	411	1	80	0.0125000
NODE_304798_length_145_cov_1385.413043	42	122	414	1	80	0.0125000
NODE_304798_length_145_cov_1385.413043	42	122	418	1	80	0.0125000
NODE_304798_length_145_cov_1385.413043	42	122	430	1	80	0.0125000
NODE_304798_length_145_cov_1385.413043	42	122	452	1	80	0.0125000
NODE_304798_length_145_cov_1385.413043	42	122	458	1	80	0.0125000
NODE_304798_length_145_cov_1385.413043	42	122	487	1	80	0.0125000
NODE_304798_length_145_cov_1385.413043	42	122	492	1	80	0.0125000
NODE_304798_length_145_cov_1385.413043	42	122	502	1	80	0.0125000
NODE_304798_length_145_cov_1385.413043	42	122	508	2	80	0.0250000
NODE_304798_length_145_cov_1385.413043	42	122	514	1	80	0.0125000
NODE_304798_length_145_cov_1385.413043	42	122	518	1	80	0.0125000
NODE_304798_length_145_cov_1385.413043	42	122	520	1	80	0.0125000
NODE_304798_length_145_cov_1385.413043	42	122	522	1	80	0.0125000
NODE_304798_length_145_cov_1385.413043	42	122	530	2	80	0.0250000
NODE_304798_length_145_cov_1385.413043	42	122	534	1	80	0.0125000
NODE_304798_length_145_cov_1385.413043	42	122	535	20	80	0.2500000
NODE_304798_length_145_cov_1385.413043	42	122	536	5	80	0.0625000
NODE_304798_length_145_cov_1385.413043	42	122	537	1	80	0.0125000
NODE_304798_length_145_cov_1385.413043	42	122	538	20	80	0.2500000
NODE_304798_length_145_cov_1385.413043	42	122	539	10	80	0.1250000
NODE_304798_length_145_cov_1385.413043	42	122	540	3	80	0.0375000
NODE_304799_length_145_cov_880.369565	56	120	255	1	64	0.0156250
NODE_304799_length_145_cov_880.369565	56	120	259	3	64	0.0468750
NODE_304799_length_145_cov_880.369565	56	120	271	1	64	0.0156250
NODE_304799_length_145_cov_880.369565	56	120	274	1	64	0.0156250
NODE_304799_length_145_cov_880.369565	56	120	297	1	64	0.0156250
NODE_304799_length_145_cov_880.369565	56	120	303	1	64	0.0156250
NODE_304799_length_145_cov_880.369565	56	120	310	1	64	0.0156250
NODE_304799_length_145_cov_880.369565	56	120	311	1	64	0.0156250
NODE_304799_length_145_cov_880.369565	56	120	320	1	64	0.0156250
NODE_304799_length_145_cov_880.369565	56	120	323	1	64	0.0156250
NODE_304799_length_145_cov_880.369565	56	120	333	1	64	0.0156250
NODE_304799_length_145_cov_880.369565	56	120	334	1	64	0.0156250
NODE_304799_length_145_cov_880.369565	56	120	342	1	64	0.0156250
NODE_304799_length_145_cov_880.369565	56	120	346	2	64	0.0312500
NODE_304799_length_145_cov_880.369565	56	120	353	2	64	0.0312500
NODE_304799_length_145_cov_880.369565	56	120	355	3	64	0.0468750
NODE_304799_length_145_cov_880.369565	56	120	356	42	64	0.6562500
NODE_304799_length_145_cov_880.369565	56	120	255	1	64	0.0156250
NODE_304799_length_145_cov_880.369565	56	120	259	3	64	0.0468750
NODE_304799_length_145_cov_880.369565	56	120	271	1	64	0.0156250
NODE_304799_length_145_cov_880.369565	56	120	274	1	64	0.0156250
NODE_304799_length_145_cov_880.369565	56	120	297	1	64	0.0156250
NODE_304799_length_145_cov_880.369565	56	120	303	1	64	0.0156250
NODE_304799_length_145_cov_880.369565	56	120	310	1	64	0.0156250
NODE_304799_length_145_cov_880.369565	56	120	311	1	64	0.0156250
NODE_304799_length_145_cov_880.369565	56	120	320	1	64	0.0156250
NODE_304799_length_145_cov_880.369565	56	120	323	1	64	0.0156250
NODE_304799_length_145_cov_880.369565	56	120	333	1	64	0.0156250
NODE_304799_length_145_cov_880.369565	56	120	334	1	64	0.0156250
NODE_304799_length_145_cov_880.369565	56	120	342	1	64	0.0156250
NODE_304799_length_145_cov_880.369565	56	120	346	2	64	0.0312500
NODE_304799_length_145_cov_880.369565	56	120	353	2	64	0.0312500
NODE_304799_length_145_cov_880.369565	56	120	355	3	64	0.0468750
NODE_304799_length_145_cov_880.369565	56	120	356	42	64	0.6562500
NODE_304799_length_145_cov_880.369565	56	120	255	1	64	0.0156250
NODE_304799_length_145_cov_880.369565	56	120	259	3	64	0.0468750
NODE_304799_length_145_cov_880.369565	56	120	271	1	64	0.0156250
NODE_304799_length_145_cov_880.369565	56	120	274	1	64	0.0156250
NODE_304799_length_145_cov_880.369565	56	120	297	1	64	0.0156250
NODE_304799_length_145_cov_880.369565	56	120	303	1	64	0.0156250
NODE_304799_length_145_cov_880.369565	56	120	310	1	64	0.0156250
NODE_304799_length_145_cov_880.369565	56	120	311	1	64	0.0156250
NODE_304799_length_145_cov_880.369565	56	120	320	1	64	0.0156250
NODE_304799_length_145_cov_880.369565	56	120	323	1	64	0.0156250
NODE_304799_length_145_cov_880.369565	56	120	333	1	64	0.0156250
NODE_304799_length_145_cov_880.369565	56	120	334	1	64	0.0156250
NODE_304799_length_145_cov_880.369565	56	120	342	1	64	0.0156250
NODE_304799_length_145_cov_880.369565	56	120	346	2	64	0.0312500
NODE_304799_length_145_cov_880.369565	56	120	353	2	64	0.0312500
NODE_304799_length_145_cov_880.369565	56	120	355	3	64	0.0468750
NODE_304799_length_145_cov_880.369565	56	120	356	42	64	0.6562500
NODE_304799_length_145_cov_880.369565	93	142	32	1	49	0.0204082
NODE_304799_length_145_cov_880.369565	93	142	38	1	49	0.0204082
NODE_304799_length_145_cov_880.369565	93	142	50	1	49	0.0204082
NODE_304799_length_145_cov_880.369565	93	142	56	1	49	0.0204082
NODE_304799_length_145_cov_880.369565	93	142	61	1	49	0.0204082
NODE_304799_length_145_cov_880.369565	93	142	66	1	49	0.0204082
NODE_304799_length_145_cov_880.369565	93	142	79	1	49	0.0204082
NODE_304799_length_145_cov_880.369565	93	142	89	1	49	0.0204082
NODE_304799_length_145_cov_880.369565	93	142	111	1	49	0.0204082
NODE_304799_length_145_cov_880.369565	93	142	112	1	49	0.0204082
NODE_304799_length_145_cov_880.369565	93	142	122	1	49	0.0204082
NODE_304799_length_145_cov_880.369565	93	142	132	1	49	0.0204082
NODE_304799_length_145_cov_880.369565	93	142	147	1	49	0.0204082
NODE_304799_length_145_cov_880.369565	93	142	157	1	49	0.0204082
NODE_304799_length_145_cov_880.369565	93	142	168	1	49	0.0204082
NODE_304799_length_145_cov_880.369565	93	142	182	1	49	0.0204082
NODE_304799_length_145_cov_880.369565	93	142	195	1	49	0.0204082
NODE_304799_length_145_cov_880.369565	93	142	208	1	49	0.0204082
NODE_304799_length_145_cov_880.369565	93	142	221	1	49	0.0204082
NODE_304799_length_145_cov_880.369565	93	142	227	1	49	0.0204082
NODE_304799_length_145_cov_880.369565	93	142	240	1	49	0.0204082
NODE_304799_length_145_cov_880.369565	93	142	245	1	49	0.0204082
NODE_304799_length_145_cov_880.369565	93	142	255	1	49	0.0204082
NODE_304799_length_145_cov_880.369565	93	142	259	3	49	0.0612245
NODE_304799_length_145_cov_880.369565	93	142	271	1	49	0.0204082
NODE_304799_length_145_cov_880.369565	93	142	274	1	49	0.0204082
NODE_304799_length_145_cov_880.369565	93	142	297	1	49	0.0204082
NODE_304799_length_145_cov_880.369565	93	142	303	1	49	0.0204082
NODE_304799_length_145_cov_880.369565	93	142	310	1	49	0.0204082
NODE_304799_length_145_cov_880.369565	93	142	311	1	49	0.0204082
NODE_304799_length_145_cov_880.369565	93	142	320	1	49	0.0204082
NODE_304799_length_145_cov_880.369565	93	142	323	1	49	0.0204082
NODE_304799_length_145_cov_880.369565	93	142	333	1	49	0.0204082
NODE_304799_length_145_cov_880.369565	93	142	334	1	49	0.0204082
NODE_304799_length_145_cov_880.369565	93	142	342	1	49	0.0204082
NODE_304799_length_145_cov_880.369565	93	142	346	2	49	0.0408163
NODE_304799_length_145_cov_880.369565	93	142	353	2	49	0.0408163
NODE_304799_length_145_cov_880.369565	93	142	355	3	49	0.0612245
NODE_304799_length_145_cov_880.369565	93	142	356	5	49	0.1020408
NODE_304923_length_144_cov_46.155556	1	81	3	1	80	0.0125000
NODE_304923_length_144_cov_46.155556	1	81	7	1	80	0.0125000
NODE_304923_length_144_cov_46.155556	1	81	11	1	80	0.0125000
NODE_304923_length_144_cov_46.155556	1	81	15	1	80	0.0125000
NODE_304923_length_144_cov_46.155556	1	81	17	7	80	0.0875000
NODE_304923_length_144_cov_46.155556	1	81	18	7	80	0.0875000
NODE_304923_length_144_cov_46.155556	1	81	20	6	80	0.0750000
NODE_304923_length_144_cov_46.155556	1	81	24	3	80	0.0375000
NODE_304923_length_144_cov_46.155556	1	81	28	1	80	0.0125000
NODE_304923_length_144_cov_46.155556	1	81	30	3	80	0.0375000
NODE_304923_length_144_cov_46.155556	1	81	32	6	80	0.0750000
NODE_304923_length_144_cov_46.155556	1	81	35	1	80	0.0125000
NODE_304923_length_144_cov_46.155556	1	81	36	42	80	0.5250000
NODE_305208_length_142_cov_244.488372	0	52	7	1	52	0.0192308
NODE_305208_length_142_cov_244.488372	0	52	14	1	52	0.0192308
NODE_305208_length_142_cov_244.488372	0	52	20	1	52	0.0192308
NODE_305208_length_142_cov_244.488372	0	52	24	1	52	0.0192308
NODE_305208_length_142_cov_244.488372	0	52	31	1	52	0.0192308
NODE_305208_length_142_cov_244.488372	0	52	42	1	52	0.0192308
NODE_305208_length_142_cov_244.488372	0	52	45	1	52	0.0192308
NODE_305208_length_142_cov_244.488372	0	52	55	2	52	0.0384615
NODE_305208_length_142_cov_244.488372	0	52	56	1	52	0.0192308
NODE_305208_length_142_cov_244.488372	0	52	74	1	52	0.0192308
NODE_305208_length_142_cov_244.488372	0	52	76	1	52	0.0192308
NODE_305208_length_142_cov_244.488372	0	52	82	1	52	0.0192308
NODE_305208_length_142_cov_244.488372	0	52	84	1	52	0.0192308
NODE_305208_length_142_cov_244.488372	0	52	98	1	52	0.0192308
NODE_305208_length_142_cov_244.488372	0	52	104	1	52	0.0192308
NODE_305208_length_142_cov_244.488372	0	52	106	1	52	0.0192308
NODE_305208_length_142_cov_244.488372	0	52	116	1	52	0.0192308
NODE_305208_length_142_cov_244.488372	0	52	128	2	52	0.0384615
NODE_305208_length_142_cov_244.488372	0	52	130	1	52	0.0192308
NODE_305208_length_142_cov_244.488372	0	52	140	1	52	0.0192308
NODE_305208_length_142_cov_244.488372	0	52	146	2	52	0.0384615
NODE_305208_length_142_cov_244.488372	0	52	148	1	52	0.0192308
NODE_305208_length_142_cov_244.488372	0	52	152	1	52	0.0192308
NODE_305208_length_142_cov_244.488372	0	52	154	1	52	0.0192308
NODE_305208_length_142_cov_244.488372	0	52	170	1	52	0.0192308
NODE_305208_length_142_cov_244.488372	0	52	174	1	52	0.0192308
NODE_305208_length_142_cov_244.488372	0	52	176	3	52	0.0576923
NODE_305208_length_142_cov_244.488372	0	52	180	3	52	0.0576923
NODE_305208_length_142_cov_244.488372	0	52	198	1	52	0.0192308
NODE_305208_length_142_cov_244.488372	0	52	204	1	52	0.0192308
NODE_305208_length_142_cov_244.488372	0	52	208	1	52	0.0192308
NODE_305208_length_142_cov_244.488372	0	52	210	14	52	0.2692308
NODE_305229_length_142_cov_46.976744	1	65	12	4	64	0.0625000
NODE_305229_length_142_cov_46.976744	1	65	18	4	64	0.0625000
NODE_305229_length_142_cov_46.976744	1	65	22	5	64	0.0781250
NODE_305229_length_142_cov_46.976744	1	65	24	1	64	0.0156250
NODE_305229_length_142_cov_46.976744	1	65	28	4	64	0.0625000
NODE_305229_length_142_cov_46.976744	1	65	30	1	64	0.0156250
NODE_305229_length_142_cov_46.976744	1	65	32	1	64	0.0156250
NODE_305229_length_142_cov_46.976744	1	65	34	1	64	0.0156250
NODE_305229_length_142_cov_46.976744	1	65	40	3	64	0.0468750
NODE_305229_length_142_cov_46.976744	1	65	44	2	64	0.0312500
NODE_305229_length_142_cov_46.976744	1	65	46	13	64	0.2031250
NODE_305229_length_142_cov_46.976744	1	65	50	25	64	0.3906250
NODE_305229_length_142_cov_46.976744	1	65	12	4	64	0.0625000
NODE_305229_length_142_cov_46.976744	1	65	18	4	64	0.0625000
NODE_305229_length_142_cov_46.976744	1	65	22	5	64	0.0781250
NODE_305229_length_142_cov_46.976744	1	65	24	1	64	0.0156250
NODE_305229_length_142_cov_46.976744	1	65	28	4	64	0.0625000
NODE_305229_length_142_cov_46.976744	1	65	30	1	64	0.0156250
NODE_305229_length_142_cov_46.976744	1	65	32	1	64	0.0156250
NODE_305229_length_142_cov_46.976744	1	65	34	1	64	0.0156250
NODE_305229_length_142_cov_46.976744	1	65	40	3	64	0.0468750
NODE_305229_length_142_cov_46.976744	1	65	44	2	64	0.0312500
NODE_305229_length_142_cov_46.976744	1	65	46	13	64	0.2031250
NODE_305229_length_142_cov_46.976744	1	65	50	25	64	0.3906250
NODE_305229_length_142_cov_46.976744	1	65	12	4	64	0.0625000
NODE_305229_length_142_cov_46.976744	1	65	18	4	64	0.0625000
NODE_305229_length_142_cov_46.976744	1	65	22	5	64	0.0781250
NODE_305229_length_142_cov_46.976744	1	65	24	1	64	0.0156250
NODE_305229_length_142_cov_46.976744	1	65	28	4	64	0.0625000
NODE_305229_length_142_cov_46.976744	1	65	30	1	64	0.0156250
NODE_305229_length_142_cov_46.976744	1	65	32	1	64	0.0156250
NODE_305229_length_142_cov_46.976744	1	65	34	1	64	0.0156250
NODE_305229_length_142_cov_46.976744	1	65	40	3	64	0.0468750
NODE_305229_length_142_cov_46.976744	1	65	44	2	64	0.0312500
NODE_305229_length_142_cov_46.976744	1	65	46	13	64	0.2031250
NODE_305229_length_142_cov_46.976744	1	65	50	25	64	0.3906250
NODE_305230_length_142_cov_45.000000	0	69	2	8	69	0.1159420
NODE_305230_length_142_cov_45.000000	0	69	4	13	69	0.1884058
NODE_305230_length_142_cov_45.000000	0	69	6	4	69	0.0579710
NODE_305230_length_142_cov_45.000000	0	69	8	7	69	0.1014493
NODE_305230_length_142_cov_45.000000	0	69	10	37	69	0.5362319
NODE_305385_length_141_cov_178.785714	58	118	176	1	60	0.0166667
NODE_305385_length_141_cov_178.785714	58	118	183	1	60	0.0166667
NODE_305385_length_141_cov_178.785714	58	118	186	1	60	0.0166667
NODE_305385_length_141_cov_178.785714	58	118	188	1	60	0.0166667
NODE_305385_length_141_cov_178.785714	58	118	192	2	60	0.0333333
NODE_305385_length_141_cov_178.785714	58	118	194	1	60	0.0166667
NODE_305385_length_141_cov_178.785714	58	118	196	1	60	0.0166667
NODE_305385_length_141_cov_178.785714	58	118	200	4	60	0.0666667
NODE_305385_length_141_cov_178.785714	58	118	202	1	60	0.0166667
NODE_305385_length_141_cov_178.785714	58	118	204	1	60	0.0166667
NODE_305385_length_141_cov_178.785714	58	118	206	2	60	0.0333333
NODE_305385_length_141_cov_178.785714	58	118	207	22	60	0.3666667
NODE_305385_length_141_cov_178.785714	58	118	208	22	60	0.3666667
NODE_305398_length_141_cov_62.285714	26	106	0	80	80	1.0000000
NODE_305398_length_141_cov_62.285714	26	106	0	80	80	1.0000000
NODE_305398_length_141_cov_62.285714	26	97	0	71	71	1.0000000
NODE_305402_length_141_cov_41.142857	26	97	0	71	71	1.0000000
NODE_305600_length_140_cov_60.439024	8	88	4	27	80	0.3375000
NODE_305600_length_140_cov_60.439024	8	88	6	53	80	0.6625000
NODE_305600_length_140_cov_60.439024	8	88	4	27	80	0.3375000
NODE_305600_length_140_cov_60.439024	8	88	6	53	80	0.6625000
NODE_305600_length_140_cov_60.439024	8	88	4	27	80	0.3375000
NODE_305600_length_140_cov_60.439024	8	88	6	53	80	0.6625000
NODE_305600_length_140_cov_60.439024	8	88	4	27	80	0.3375000
NODE_305600_length_140_cov_60.439024	8	88	6	53	80	0.6625000
NODE_305600_length_140_cov_60.439024	8	88	4	27	80	0.3375000
NODE_305600_length_140_cov_60.439024	8	88	6	53	80	0.6625000
NODE_305616_length_140_cov_35.146341	22	102	0	14	80	0.1750000
NODE_305616_length_140_cov_35.146341	22	102	2	66	80	0.8250000
NODE_305616_length_140_cov_35.146341	75	105	2	30	30	1.0000000
NODE_305618_length_140_cov_34.048780	0	77	0	13	77	0.1688312
NODE_305618_length_140_cov_34.048780	0	77	4	2	77	0.0259740
NODE_305618_length_140_cov_34.048780	0	77	6	4	77	0.0519481
NODE_305618_length_140_cov_34.048780	0	77	8	58	77	0.7532467
NODE_305618_length_140_cov_34.048780	0	77	0	13	77	0.1688312
NODE_305618_length_140_cov_34.048780	0	77	4	2	77	0.0259740
NODE_305618_length_140_cov_34.048780	0	77	6	4	77	0.0519481
NODE_305618_length_140_cov_34.048780	0	77	8	58	77	0.7532467
NODE_305618_length_140_cov_34.048780	50	130	0	13	80	0.1625000
NODE_305618_length_140_cov_34.048780	50	130	6	9	80	0.1125000
NODE_305618_length_140_cov_34.048780	50	130	8	58	80	0.7250000
NODE_305618_length_140_cov_34.048780	50	130	0	13	80	0.1625000
NODE_305618_length_140_cov_34.048780	50	130	6	9	80	0.1125000
NODE_305618_length_140_cov_34.048780	50	130	8	58	80	0.7250000
NODE_305618_length_140_cov_34.048780	55	130	0	13	75	0.1733333
NODE_305618_length_140_cov_34.048780	55	130	6	9	75	0.1200000
NODE_305618_length_140_cov_34.048780	55	130	8	53	75	0.7066666
NODE_305619_length_140_cov_19.926829	44	118	2	74	74	1.0000000
NODE_305783_length_139_cov_29.700000	0	40	0	12	40	0.3000000
NODE_305783_length_139_cov_29.700000	0	40	4	22	40	0.5500000
NODE_305783_length_139_cov_29.700000	0	40	10	6	40	0.1500000
NODE_305783_length_139_cov_29.700000	0	40	0	12	40	0.3000000
NODE_305783_length_139_cov_29.700000	0	40	4	22	40	0.5500000
NODE_305783_length_139_cov_29.700000	0	40	10	6	40	0.1500000
NODE_305783_length_139_cov_29.700000	13	93	4	21	80	0.2625000
NODE_305783_length_139_cov_29.700000	13	93	10	59	80	0.7375000
NODE_305783_length_139_cov_29.700000	13	93	4	21	80	0.2625000
NODE_305783_length_139_cov_29.700000	13	93	10	59	80	0.7375000
NODE_305783_length_139_cov_29.700000	13	93	4	21	80	0.2625000
NODE_305783_length_139_cov_29.700000	13	93	10	59	80	0.7375000
NODE_305783_length_139_cov_29.700000	13	93	4	21	80	0.2625000
NODE_305783_length_139_cov_29.700000	13	93	10	59	80	0.7375000
NODE_305783_length_139_cov_29.700000	13	93	4	21	80	0.2625000
NODE_305783_length_139_cov_29.700000	13	93	10	59	80	0.7375000
NODE_305783_length_139_cov_29.700000	13	84	4	21	71	0.2957746
NODE_305783_length_139_cov_29.700000	13	84	10	50	71	0.7042254
NODE_305936_length_138_cov_1475.615385	30	97	116	1	67	0.0149254
NODE_305936_length_138_cov_1475.615385	30	97	120	4	67	0.0597015
NODE_305936_length_138_cov_1475.615385	30	97	122	1	67	0.0149254
NODE_305936_length_138_cov_1475.615385	30	97	124	61	67	0.9104478
NODE_305936_length_138_cov_1475.615385	70	138	52	1	68	0.0147059
NODE_305936_length_138_cov_1475.615385	70	138	58	1	68	0.0147059
NODE_305936_length_138_cov_1475.615385	70	138	62	3	68	0.0441176
NODE_305936_length_138_cov_1475.615385	70	138	70	1	68	0.0147059
NODE_305936_length_138_cov_1475.615385	70	138	78	2	68	0.0294118
NODE_305936_length_138_cov_1475.615385	70	138	82	1	68	0.0147059
NODE_305936_length_138_cov_1475.615385	70	138	84	1	68	0.0147059
NODE_305936_length_138_cov_1475.615385	70	138	90	4	68	0.0588235
NODE_305936_length_138_cov_1475.615385	70	138	98	2	68	0.0294118
NODE_305936_length_138_cov_1475.615385	70	138	102	3	68	0.0441176
NODE_305936_length_138_cov_1475.615385	70	138	104	1	68	0.0147059
NODE_305936_length_138_cov_1475.615385	70	138	106	2	68	0.0294118
NODE_305936_length_138_cov_1475.615385	70	138	112	5	68	0.0735294
NODE_305936_length_138_cov_1475.615385	70	138	120	3	68	0.0441176
NODE_305936_length_138_cov_1475.615385	70	138	122	1	68	0.0147059
NODE_305936_length_138_cov_1475.615385	70	138	124	37	68	0.5441176
NODE_305963_length_138_cov_29.564103	11	91	2	4	80	0.0500000
NODE_305963_length_138_cov_29.564103	11	91	15	63	80	0.7875000
NODE_305963_length_138_cov_29.564103	11	91	16	13	80	0.1625000
NODE_305963_length_138_cov_29.564103	11	91	2	4	80	0.0500000
NODE_305963_length_138_cov_29.564103	11	91	15	63	80	0.7875000
NODE_305963_length_138_cov_29.564103	11	91	16	13	80	0.1625000
NODE_305963_length_138_cov_29.564103	64	128	15	14	64	0.2187500
NODE_305963_length_138_cov_29.564103	64	128	16	50	64	0.7812500
NODE_305963_length_138_cov_29.564103	64	128	15	14	64	0.2187500
NODE_305963_length_138_cov_29.564103	64	128	16	50	64	0.7812500
NODE_306081_length_137_cov_185.684211	20	104	42	3	84	0.0357143
NODE_306081_length_137_cov_185.684211	20	104	44	7	84	0.0833333
NODE_306081_length_137_cov_185.684211	20	104	51	1	84	0.0119048
NODE_306081_length_137_cov_185.684211	20	104	52	2	84	0.0238095
NODE_306081_length_137_cov_185.684211	20	104	62	71	84	0.8452381
NODE_306092_length_137_cov_58.289474	76	106	34	1	30	0.0333333
NODE_306092_length_137_cov_58.289474	76	106	40	29	30	0.9666666
NODE_306099_length_137_cov_36.473684	31	111	14	80	80	1.0000000
NODE_306208_length_136_cov_1257.621622	27	107	82	3	80	0.0375000
NODE_306208_length_136_cov_1257.621622	27	107	86	3	80	0.0375000
NODE_306208_length_136_cov_1257.621622	27	107	88	74	80	0.9250000
NODE_306209_length_136_cov_769.594595	0	69	2	16	69	0.2318841
NODE_306209_length_136_cov_769.594595	0	69	4	7	69	0.1014493
NODE_306209_length_136_cov_769.594595	0	69	6	4	69	0.0579710
NODE_306209_length_136_cov_769.594595	0	69	8	3	69	0.0434783
NODE_306209_length_136_cov_769.594595	0	69	10	39	69	0.5652174
NODE_306222_length_136_cov_128.324324	39	119	8	80	80	1.0000000
NODE_306227_length_136_cov_90.783784	10	86	0	76	76	1.0000000
NODE_306227_length_136_cov_90.783784	59	136	0	77	77	1.0000000
NODE_306368_length_135_cov_2144.166667	0	73	17	1	73	0.0136986
NODE_306368_length_135_cov_2144.166667	0	73	19	1	73	0.0136986
NODE_306368_length_135_cov_2144.166667	0	73	25	1	73	0.0136986
NODE_306368_length_135_cov_2144.166667	0	73	40	1	73	0.0136986
NODE_306368_length_135_cov_2144.166667	0	73	49	1	73	0.0136986
NODE_306368_length_135_cov_2144.166667	0	73	64	1	73	0.0136986
NODE_306368_length_135_cov_2144.166667	0	73	90	1	73	0.0136986
NODE_306368_length_135_cov_2144.166667	0	73	92	1	73	0.0136986
NODE_306368_length_135_cov_2144.166667	0	73	106	1	73	0.0136986
NODE_306368_length_135_cov_2144.166667	0	73	111	1	73	0.0136986
NODE_306368_length_135_cov_2144.166667	0	73	113	1	73	0.0136986
NODE_306368_length_135_cov_2144.166667	0	73	117	1	73	0.0136986
NODE_306368_length_135_cov_2144.166667	0	73	119	2	73	0.0273973
NODE_306368_length_135_cov_2144.166667	0	73	129	1	73	0.0136986
NODE_306368_length_135_cov_2144.166667	0	73	141	1	73	0.0136986
NODE_306368_length_135_cov_2144.166667	0	73	145	1	73	0.0136986
NODE_306368_length_135_cov_2144.166667	0	73	157	1	73	0.0136986
NODE_306368_length_135_cov_2144.166667	0	73	163	1	73	0.0136986
NODE_306368_length_135_cov_2144.166667	0	73	175	1	73	0.0136986
NODE_306368_length_135_cov_2144.166667	0	73	177	1	73	0.0136986
NODE_306368_length_135_cov_2144.166667	0	73	178	1	73	0.0136986
NODE_306368_length_135_cov_2144.166667	0	73	179	1	73	0.0136986
NODE_306368_length_135_cov_2144.166667	0	73	182	2	73	0.0273973
NODE_306368_length_135_cov_2144.166667	0	73	188	1	73	0.0136986
NODE_306368_length_135_cov_2144.166667	0	73	192	1	73	0.0136986
NODE_306368_length_135_cov_2144.166667	0	73	194	1	73	0.0136986
NODE_306368_length_135_cov_2144.166667	0	73	198	1	73	0.0136986
NODE_306368_length_135_cov_2144.166667	0	73	203	1	73	0.0136986
NODE_306368_length_135_cov_2144.166667	0	73	207	1	73	0.0136986
NODE_306368_length_135_cov_2144.166667	0	73	208	1	73	0.0136986
NODE_306368_length_135_cov_2144.166667	0	73	210	1	73	0.0136986
NODE_306368_length_135_cov_2144.166667	0	73	215	7	73	0.0958904
NODE_306368_length_135_cov_2144.166667	0	73	216	33	73	0.4520548
NODE_306368_length_135_cov_2144.166667	46	126	42	2	80	0.0250000
NODE_306368_length_135_cov_2144.166667	46	126	54	1	80	0.0125000
NODE_306368_length_135_cov_2144.166667	46	126	62	2	80	0.0250000
NODE_306368_length_135_cov_2144.166667	46	126	78	1	80	0.0125000
NODE_306368_length_135_cov_2144.166667	46	126	101	1	80	0.0125000
NODE_306368_length_135_cov_2144.166667	46	126	103	1	80	0.0125000
NODE_306368_length_135_cov_2144.166667	46	126	129	1	80	0.0125000
NODE_306368_length_135_cov_2144.166667	46	126	138	1	80	0.0125000
NODE_306368_length_135_cov_2144.166667	46	126	143	1	80	0.0125000
NODE_306368_length_135_cov_2144.166667	46	126	147	1	80	0.0125000
NODE_306368_length_135_cov_2144.166667	46	126	149	1	80	0.0125000
NODE_306368_length_135_cov_2144.166667	46	126	159	1	80	0.0125000
NODE_306368_length_135_cov_2144.166667	46	126	161	1	80	0.0125000
NODE_306368_length_135_cov_2144.166667	46	126	172	1	80	0.0125000
NODE_306368_length_135_cov_2144.166667	46	126	179	1	80	0.0125000
NODE_306368_length_135_cov_2144.166667	46	126	183	1	80	0.0125000
NODE_306368_length_135_cov_2144.166667	46	126	192	1	80	0.0125000
NODE_306368_length_135_cov_2144.166667	46	126	197	3	80	0.0375000
NODE_306368_length_135_cov_2144.166667	46	126	199	1	80	0.0125000
NODE_306368_length_135_cov_2144.166667	46	126	212	1	80	0.0125000
NODE_306368_length_135_cov_2144.166667	46	126	213	1	80	0.0125000
NODE_306368_length_135_cov_2144.166667	46	126	215	35	80	0.4375000
NODE_306368_length_135_cov_2144.166667	46	126	216	20	80	0.2500000
NODE_306368_length_135_cov_2144.166667	83	135	8	2	52	0.0384615
NODE_306368_length_135_cov_2144.166667	83	135	14	1	52	0.0192308
NODE_306368_length_135_cov_2144.166667	83	135	18	2	52	0.0384615
NODE_306368_length_135_cov_2144.166667	83	135	29	1	52	0.0192308
NODE_306368_length_135_cov_2144.166667	83	135	32	1	52	0.0192308
NODE_306368_length_135_cov_2144.166667	83	135	36	1	52	0.0192308
NODE_306368_length_135_cov_2144.166667	83	135	40	1	52	0.0192308
NODE_306368_length_135_cov_2144.166667	83	135	42	2	52	0.0384615
NODE_306368_length_135_cov_2144.166667	83	135	54	1	52	0.0192308
NODE_306368_length_135_cov_2144.166667	83	135	62	2	52	0.0384615
NODE_306368_length_135_cov_2144.166667	83	135	78	1	52	0.0192308
NODE_306368_length_135_cov_2144.166667	83	135	101	1	52	0.0192308
NODE_306368_length_135_cov_2144.166667	83	135	103	1	52	0.0192308
NODE_306368_length_135_cov_2144.166667	83	135	129	1	52	0.0192308
NODE_306368_length_135_cov_2144.166667	83	135	138	1	52	0.0192308
NODE_306368_length_135_cov_2144.166667	83	135	143	1	52	0.0192308
NODE_306368_length_135_cov_2144.166667	83	135	147	1	52	0.0192308
NODE_306368_length_135_cov_2144.166667	83	135	149	1	52	0.0192308
NODE_306368_length_135_cov_2144.166667	83	135	159	1	52	0.0192308
NODE_306368_length_135_cov_2144.166667	83	135	161	1	52	0.0192308
NODE_306368_length_135_cov_2144.166667	83	135	172	1	52	0.0192308
NODE_306368_length_135_cov_2144.166667	83	135	179	1	52	0.0192308
NODE_306368_length_135_cov_2144.166667	83	135	183	1	52	0.0192308
NODE_306368_length_135_cov_2144.166667	83	135	192	1	52	0.0192308
NODE_306368_length_135_cov_2144.166667	83	135	197	3	52	0.0576923
NODE_306368_length_135_cov_2144.166667	83	135	199	1	52	0.0192308
NODE_306368_length_135_cov_2144.166667	83	135	212	1	52	0.0192308
NODE_306368_length_135_cov_2144.166667	83	135	213	1	52	0.0192308
NODE_306368_length_135_cov_2144.166667	83	135	215	18	52	0.3461539
NODE_306370_length_135_cov_630.194444	0	76	16	3	76	0.0394737
NODE_306370_length_135_cov_630.194444	0	76	22	1	76	0.0131579
NODE_306370_length_135_cov_630.194444	0	76	28	3	76	0.0394737
NODE_306370_length_135_cov_630.194444	0	76	30	3	76	0.0394737
NODE_306370_length_135_cov_630.194444	0	76	32	1	76	0.0131579
NODE_306370_length_135_cov_630.194444	0	76	36	2	76	0.0263158
NODE_306370_length_135_cov_630.194444	0	76	42	3	76	0.0394737
NODE_306370_length_135_cov_630.194444	0	76	48	1	76	0.0131579
NODE_306370_length_135_cov_630.194444	0	76	50	1	76	0.0131579
NODE_306370_length_135_cov_630.194444	0	76	52	4	76	0.0526316
NODE_306370_length_135_cov_630.194444	0	76	54	4	76	0.0526316
NODE_306370_length_135_cov_630.194444	0	76	56	2	76	0.0263158
NODE_306370_length_135_cov_630.194444	0	76	58	48	76	0.6315789
NODE_306371_length_135_cov_540.611111	0	76	44	1	76	0.0131579
NODE_306371_length_135_cov_540.611111	0	76	46	1	76	0.0131579
NODE_306371_length_135_cov_540.611111	0	76	48	1	76	0.0131579
NODE_306371_length_135_cov_540.611111	0	76	59	1	76	0.0131579
NODE_306371_length_135_cov_540.611111	0	76	74	2	76	0.0263158
NODE_306371_length_135_cov_540.611111	0	76	80	1	76	0.0131579
NODE_306371_length_135_cov_540.611111	0	76	86	1	76	0.0131579
NODE_306371_length_135_cov_540.611111	0	76	90	1	76	0.0131579
NODE_306371_length_135_cov_540.611111	0	76	92	2	76	0.0263158
NODE_306371_length_135_cov_540.611111	0	76	102	1	76	0.0131579
NODE_306371_length_135_cov_540.611111	0	76	104	1	76	0.0131579
NODE_306371_length_135_cov_540.611111	0	76	118	1	76	0.0131579
NODE_306371_length_135_cov_540.611111	0	76	120	1	76	0.0131579
NODE_306371_length_135_cov_540.611111	0	76	122	1	76	0.0131579
NODE_306371_length_135_cov_540.611111	0	76	136	1	76	0.0131579
NODE_306371_length_135_cov_540.611111	0	76	138	3	76	0.0394737
NODE_306371_length_135_cov_540.611111	0	76	142	2	76	0.0263158
NODE_306371_length_135_cov_540.611111	0	76	144	2	76	0.0263158
NODE_306371_length_135_cov_540.611111	0	76	148	1	76	0.0131579
NODE_306371_length_135_cov_540.611111	0	76	150	1	76	0.0131579
NODE_306371_length_135_cov_540.611111	0	76	158	1	76	0.0131579
NODE_306371_length_135_cov_540.611111	0	76	160	1	76	0.0131579
NODE_306371_length_135_cov_540.611111	0	76	166	1	76	0.0131579
NODE_306371_length_135_cov_540.611111	0	76	170	4	76	0.0526316
NODE_306371_length_135_cov_540.611111	0	76	176	43	76	0.5657895
NODE_306373_length_135_cov_257.416667	36	88	234	3	52	0.0576923
NODE_306373_length_135_cov_257.416667	36	88	235	3	52	0.0576923
NODE_306373_length_135_cov_257.416667	36	88	236	46	52	0.8846154
NODE_306374_length_135_cov_239.638889	97	135	2	2	38	0.0526316
NODE_306374_length_135_cov_239.638889	97	135	6	3	38	0.0789474
NODE_306374_length_135_cov_239.638889	97	135	10	1	38	0.0263158
NODE_306374_length_135_cov_239.638889	97	135	12	1	38	0.0263158
NODE_306374_length_135_cov_239.638889	97	135	20	2	38	0.0526316
NODE_306374_length_135_cov_239.638889	97	135	26	1	38	0.0263158
NODE_306374_length_135_cov_239.638889	97	135	32	1	38	0.0263158
NODE_306374_length_135_cov_239.638889	97	135	36	1	38	0.0263158
NODE_306374_length_135_cov_239.638889	97	135	38	1	38	0.0263158
NODE_306374_length_135_cov_239.638889	97	135	40	1	38	0.0263158
NODE_306374_length_135_cov_239.638889	97	135	46	1	38	0.0263158
NODE_306374_length_135_cov_239.638889	97	135	56	1	38	0.0263158
NODE_306374_length_135_cov_239.638889	97	135	58	1	38	0.0263158
NODE_306374_length_135_cov_239.638889	97	135	63	1	38	0.0263158
NODE_306374_length_135_cov_239.638889	97	135	64	1	38	0.0263158
NODE_306374_length_135_cov_239.638889	97	135	80	2	38	0.0526316
NODE_306374_length_135_cov_239.638889	97	135	82	2	38	0.0526316
NODE_306374_length_135_cov_239.638889	97	135	88	1	38	0.0263158
NODE_306374_length_135_cov_239.638889	97	135	94	1	38	0.0263158
NODE_306374_length_135_cov_239.638889	97	135	102	1	38	0.0263158
NODE_306374_length_135_cov_239.638889	97	135	104	1	38	0.0263158
NODE_306374_length_135_cov_239.638889	97	135	108	2	38	0.0526316
NODE_306374_length_135_cov_239.638889	97	135	110	9	38	0.2368421
NODE_306400_length_135_cov_35.055556	8	88	6	4	80	0.0500000
NODE_306400_length_135_cov_35.055556	8	88	13	14	80	0.1750000
NODE_306400_length_135_cov_35.055556	8	88	14	62	80	0.7750000
NODE_306400_length_135_cov_35.055556	61	125	8	10	64	0.1562500
NODE_306400_length_135_cov_35.055556	61	125	14	54	64	0.8437500
NODE_306400_length_135_cov_35.055556	61	125	8	10	64	0.1562500
NODE_306400_length_135_cov_35.055556	61	125	14	54	64	0.8437500
NODE_306402_length_135_cov_31.805556	0	76	0	30	76	0.3947369
NODE_306402_length_135_cov_31.805556	0	76	2	46	76	0.6052632
NODE_306658_length_133_cov_140.411765	8	43	26	2	35	0.0571429
NODE_306658_length_133_cov_140.411765	8	43	28	2	35	0.0571429
NODE_306658_length_133_cov_140.411765	8	43	34	1	35	0.0285714
NODE_306658_length_133_cov_140.411765	8	43	38	1	35	0.0285714
NODE_306658_length_133_cov_140.411765	8	43	40	2	35	0.0571429
NODE_306658_length_133_cov_140.411765	8	43	42	3	35	0.0857143
NODE_306658_length_133_cov_140.411765	8	43	44	3	35	0.0857143
NODE_306658_length_133_cov_140.411765	8	43	48	7	35	0.2000000
NODE_306658_length_133_cov_140.411765	8	43	50	14	35	0.4000000
NODE_306658_length_133_cov_140.411765	53	88	50	35	35	1.0000000
NODE_306658_length_133_cov_140.411765	98	133	18	3	35	0.0857143
NODE_306658_length_133_cov_140.411765	98	133	20	2	35	0.0571429
NODE_306658_length_133_cov_140.411765	98	133	24	3	35	0.0857143
NODE_306658_length_133_cov_140.411765	98	133	26	1	35	0.0285714
NODE_306658_length_133_cov_140.411765	98	133	28	1	35	0.0285714
NODE_306658_length_133_cov_140.411765	98	133	30	1	35	0.0285714
NODE_306658_length_133_cov_140.411765	98	133	34	8	35	0.2285714
NODE_306658_length_133_cov_140.411765	98	133	36	2	35	0.0571429
NODE_306658_length_133_cov_140.411765	98	133	42	2	35	0.0571429
NODE_306658_length_133_cov_140.411765	98	133	44	3	35	0.0857143
NODE_306658_length_133_cov_140.411765	98	133	46	1	35	0.0285714
NODE_306658_length_133_cov_140.411765	98	133	48	2	35	0.0571429
NODE_306658_length_133_cov_140.411765	98	133	50	6	35	0.1714286
NODE_306661_length_133_cov_109.441176	63	129	2	1	66	0.0151515
NODE_306661_length_133_cov_109.441176	63	129	4	1	66	0.0151515
NODE_306661_length_133_cov_109.441176	63	129	12	8	66	0.1212121
NODE_306661_length_133_cov_109.441176	63	129	14	2	66	0.0303030
NODE_306661_length_133_cov_109.441176	63	129	16	7	66	0.1060606
NODE_306661_length_133_cov_109.441176	63	129	22	8	66	0.1212121
NODE_306661_length_133_cov_109.441176	63	129	24	39	66	0.5909091
NODE_306812_length_132_cov_114.151515	2	44	0	9	42	0.2142857
NODE_306812_length_132_cov_114.151515	2	44	2	33	42	0.7857143
NODE_306812_length_132_cov_114.151515	4	44	0	7	40	0.1750000
NODE_306812_length_132_cov_114.151515	4	44	2	33	40	0.8250000
NODE_306812_length_132_cov_114.151515	17	83	2	66	66	1.0000000
NODE_306812_length_132_cov_114.151515	17	88	2	71	71	1.0000000
NODE_306824_length_132_cov_61.636364	3	76	0	2	73	0.0273973
NODE_306824_length_132_cov_61.636364	3	76	6	22	73	0.3013699
NODE_306824_length_132_cov_61.636364	3	76	10	2	73	0.0273973
NODE_306824_length_132_cov_61.636364	3	76	12	47	73	0.6438356
NODE_306824_length_132_cov_61.636364	49	130	8	18	81	0.2222222
NODE_306824_length_132_cov_61.636364	49	130	10	9	81	0.1111111
NODE_306824_length_132_cov_61.636364	49	130	12	54	81	0.6666667
NODE_306824_length_132_cov_61.636364	103	125	8	13	22	0.5909091
NODE_306824_length_132_cov_61.636364	103	125	10	9	22	0.4090909
NODE_306834_length_132_cov_33.393939	2	83	0	81	81	1.0000000
NODE_306834_length_132_cov_33.393939	7	29	0	22	22	1.0000000
NODE_306834_length_132_cov_33.393939	56	129	0	73	73	1.0000000
NODE_306965_length_131_cov_810.000000	0	60	26	1	60	0.0166667
NODE_306965_length_131_cov_810.000000	0	60	27	1	60	0.0166667
NODE_306965_length_131_cov_810.000000	0	60	37	1	60	0.0166667
NODE_306965_length_131_cov_810.000000	0	60	38	1	60	0.0166667
NODE_306965_length_131_cov_810.000000	0	60	44	1	60	0.0166667
NODE_306965_length_131_cov_810.000000	0	60	46	1	60	0.0166667
NODE_306965_length_131_cov_810.000000	0	60	62	1	60	0.0166667
NODE_306965_length_131_cov_810.000000	0	60	69	2	60	0.0333333
NODE_306965_length_131_cov_810.000000	0	60	77	1	60	0.0166667
NODE_306965_length_131_cov_810.000000	0	60	79	1	60	0.0166667
NODE_306965_length_131_cov_810.000000	0	60	104	1	60	0.0166667
NODE_306965_length_131_cov_810.000000	0	60	121	1	60	0.0166667
NODE_306965_length_131_cov_810.000000	0	60	134	1	60	0.0166667
NODE_306965_length_131_cov_810.000000	0	60	141	1	60	0.0166667
NODE_306965_length_131_cov_810.000000	0	60	145	2	60	0.0333333
NODE_306965_length_131_cov_810.000000	0	60	149	1	60	0.0166667
NODE_306965_length_131_cov_810.000000	0	60	151	1	60	0.0166667
NODE_306965_length_131_cov_810.000000	0	60	156	2	60	0.0333333
NODE_306965_length_131_cov_810.000000	0	60	166	1	60	0.0166667
NODE_306965_length_131_cov_810.000000	0	60	180	1	60	0.0166667
NODE_306965_length_131_cov_810.000000	0	60	198	1	60	0.0166667
NODE_306965_length_131_cov_810.000000	0	60	212	1	60	0.0166667
NODE_306965_length_131_cov_810.000000	0	60	214	1	60	0.0166667
NODE_306965_length_131_cov_810.000000	0	60	218	1	60	0.0166667
NODE_306965_length_131_cov_810.000000	0	60	226	1	60	0.0166667
NODE_306965_length_131_cov_810.000000	0	60	236	6	60	0.1000000
NODE_306965_length_131_cov_810.000000	0	60	237	16	60	0.2666667
NODE_306965_length_131_cov_810.000000	0	60	238	10	60	0.1666667
NODE_306965_length_131_cov_810.000000	33	97	236	1	64	0.0156250
NODE_306965_length_131_cov_810.000000	33	97	237	16	64	0.2500000
NODE_306965_length_131_cov_810.000000	33	97	238	47	64	0.7343750
NODE_306965_length_131_cov_810.000000	33	97	236	1	64	0.0156250
NODE_306965_length_131_cov_810.000000	33	97	237	16	64	0.2500000
NODE_306965_length_131_cov_810.000000	33	97	238	47	64	0.7343750
NODE_306965_length_131_cov_810.000000	33	97	236	1	64	0.0156250
NODE_306965_length_131_cov_810.000000	33	97	237	16	64	0.2500000
NODE_306965_length_131_cov_810.000000	33	97	238	47	64	0.7343750
NODE_306985_length_131_cov_149.187500	25	105	104	2	80	0.0250000
NODE_306985_length_131_cov_149.187500	25	105	105	1	80	0.0125000
NODE_306985_length_131_cov_149.187500	25	105	107	12	80	0.1500000
NODE_306985_length_131_cov_149.187500	25	105	108	65	80	0.8125000
NODE_306985_length_131_cov_149.187500	78	131	17	2	53	0.0377358
NODE_306985_length_131_cov_149.187500	78	131	21	2	53	0.0377358
NODE_306985_length_131_cov_149.187500	78	131	27	1	53	0.0188679
NODE_306985_length_131_cov_149.187500	78	131	29	3	53	0.0566038
NODE_306985_length_131_cov_149.187500	78	131	31	1	53	0.0188679
NODE_306985_length_131_cov_149.187500	78	131	53	1	53	0.0188679
NODE_306985_length_131_cov_149.187500	78	131	57	1	53	0.0188679
NODE_306985_length_131_cov_149.187500	78	131	69	1	53	0.0188679
NODE_306985_length_131_cov_149.187500	78	131	70	1	53	0.0188679
NODE_306985_length_131_cov_149.187500	78	131	81	1	53	0.0188679
NODE_306985_length_131_cov_149.187500	78	131	83	1	53	0.0188679
NODE_306985_length_131_cov_149.187500	78	131	87	1	53	0.0188679
NODE_306985_length_131_cov_149.187500	78	131	89	1	53	0.0188679
NODE_306985_length_131_cov_149.187500	78	131	93	1	53	0.0188679
NODE_306985_length_131_cov_149.187500	78	131	95	1	53	0.0188679
NODE_306985_length_131_cov_149.187500	78	131	99	1	53	0.0188679
NODE_306985_length_131_cov_149.187500	78	131	101	2	53	0.0377358
NODE_306985_length_131_cov_149.187500	78	131	105	2	53	0.0377358
NODE_306985_length_131_cov_149.187500	78	131	107	14	53	0.2641509
NODE_306985_length_131_cov_149.187500	78	131	108	15	53	0.2830189
NODE_307121_length_130_cov_319.806452	54	126	2	9	72	0.1250000
NODE_307121_length_130_cov_319.806452	54	126	4	3	72	0.0416667
NODE_307121_length_130_cov_319.806452	54	126	8	1	72	0.0138889
NODE_307121_length_130_cov_319.806452	54	126	9	1	72	0.0138889
NODE_307121_length_130_cov_319.806452	54	126	10	1	72	0.0138889
NODE_307121_length_130_cov_319.806452	54	126	12	6	72	0.0833333
NODE_307121_length_130_cov_319.806452	54	126	14	51	72	0.7083333
NODE_307132_length_130_cov_153.516129	82	113	0	31	31	1.0000000
NODE_307140_length_130_cov_79.064516	0	53	2	2	53	0.0377358
NODE_307140_length_130_cov_79.064516	0	53	4	3	53	0.0566038
NODE_307140_length_130_cov_79.064516	0	53	8	5	53	0.0943396
NODE_307140_length_130_cov_79.064516	0	53	10	1	53	0.0188679
NODE_307140_length_130_cov_79.064516	0	53	12	2	53	0.0377358
NODE_307140_length_130_cov_79.064516	0	53	14	1	53	0.0188679
NODE_307140_length_130_cov_79.064516	0	53	16	4	53	0.0754717
NODE_307140_length_130_cov_79.064516	0	53	20	7	53	0.1320755
NODE_307140_length_130_cov_79.064516	0	53	22	3	53	0.0566038
NODE_307140_length_130_cov_79.064516	0	53	24	25	53	0.4716981
NODE_307140_length_130_cov_79.064516	26	56	22	2	30	0.0666667
NODE_307140_length_130_cov_79.064516	26	56	24	28	30	0.9333333
NODE_307270_length_129_cov_1851.133333	0	45	0	1	45	0.0222222
NODE_307270_length_129_cov_1851.133333	0	45	4	2	45	0.0444444
NODE_307270_length_129_cov_1851.133333	0	45	12	1	45	0.0222222
NODE_307270_length_129_cov_1851.133333	0	45	16	1	45	0.0222222
NODE_307270_length_129_cov_1851.133333	0	45	28	2	45	0.0444444
NODE_307270_length_129_cov_1851.133333	0	45	36	1	45	0.0222222
NODE_307270_length_129_cov_1851.133333	0	45	38	3	45	0.0666667
NODE_307270_length_129_cov_1851.133333	0	45	44	1	45	0.0222222
NODE_307270_length_129_cov_1851.133333	0	45	48	1	45	0.0222222
NODE_307270_length_129_cov_1851.133333	0	45	50	1	45	0.0222222
NODE_307270_length_129_cov_1851.133333	0	45	58	1	45	0.0222222
NODE_307270_length_129_cov_1851.133333	0	45	66	4	45	0.0888889
NODE_307270_length_129_cov_1851.133333	0	45	68	2	45	0.0444444
NODE_307270_length_129_cov_1851.133333	0	45	70	3	45	0.0666667
NODE_307270_length_129_cov_1851.133333	0	45	74	2	45	0.0444444
NODE_307270_length_129_cov_1851.133333	0	45	80	19	45	0.4222222
NODE_307270_length_129_cov_1851.133333	18	98	66	1	80	0.0125000
NODE_307270_length_129_cov_1851.133333	18	98	68	2	80	0.0250000
NODE_307270_length_129_cov_1851.133333	18	98	70	3	80	0.0375000
NODE_307270_length_129_cov_1851.133333	18	98	74	2	80	0.0250000
NODE_307270_length_129_cov_1851.133333	18	98	80	72	80	0.9000000
NODE_307285_length_129_cov_186.500000	0	78	2	1	78	0.0128205
NODE_307285_length_129_cov_186.500000	0	78	4	2	78	0.0256410
NODE_307285_length_129_cov_186.500000	0	78	6	7	78	0.0897436
NODE_307285_length_129_cov_186.500000	0	78	10	4	78	0.0512821
NODE_307285_length_129_cov_186.500000	0	78	14	64	78	0.8205128
NODE_307285_length_129_cov_186.500000	53	129	0	1	76	0.0131579
NODE_307285_length_129_cov_186.500000	53	129	2	3	76	0.0394737
NODE_307285_length_129_cov_186.500000	53	129	4	2	76	0.0263158
NODE_307285_length_129_cov_186.500000	53	129	8	12	76	0.1578947
NODE_307285_length_129_cov_186.500000	53	129	12	8	76	0.1052632
NODE_307285_length_129_cov_186.500000	53	129	14	50	76	0.6578947
NODE_307287_length_129_cov_165.466667	36	111	29	3	75	0.0400000
NODE_307287_length_129_cov_165.466667	36	111	31	1	75	0.0133333
NODE_307287_length_129_cov_165.466667	36	111	33	1	75	0.0133333
NODE_307287_length_129_cov_165.466667	36	111	37	2	75	0.0266667
NODE_307287_length_129_cov_165.466667	36	111	39	39	75	0.5200000
NODE_307287_length_129_cov_165.466667	36	111	40	29	75	0.3866667
NODE_307287_length_129_cov_165.466667	84	113	20	1	29	0.0344828
NODE_307287_length_129_cov_165.466667	84	113	21	1	29	0.0344828
NODE_307287_length_129_cov_165.466667	84	113	29	3	29	0.1034483
NODE_307287_length_129_cov_165.466667	84	113	31	1	29	0.0344828
NODE_307287_length_129_cov_165.466667	84	113	33	1	29	0.0344828
NODE_307287_length_129_cov_165.466667	84	113	37	2	29	0.0689655
NODE_307287_length_129_cov_165.466667	84	113	39	20	29	0.6896552
NODE_307292_length_129_cov_90.366667	0	48	3	3	48	0.0625000
NODE_307292_length_129_cov_90.366667	0	48	13	7	48	0.1458333
NODE_307292_length_129_cov_90.366667	0	48	15	38	48	0.7916667
NODE_307292_length_129_cov_90.366667	0	48	3	3	48	0.0625000
NODE_307292_length_129_cov_90.366667	0	48	13	7	48	0.1458333
NODE_307292_length_129_cov_90.366667	0	48	15	38	48	0.7916667
NODE_307292_length_129_cov_90.366667	0	48	3	3	48	0.0625000
NODE_307292_length_129_cov_90.366667	0	48	13	7	48	0.1458333
NODE_307292_length_129_cov_90.366667	0	48	15	38	48	0.7916667
NODE_307292_length_129_cov_90.366667	21	101	15	80	80	1.0000000
NODE_307442_length_128_cov_2621.517241	3	83	53	1	80	0.0125000
NODE_307442_length_128_cov_2621.517241	3	83	58	1	80	0.0125000
NODE_307442_length_128_cov_2621.517241	3	83	68	1	80	0.0125000
NODE_307442_length_128_cov_2621.517241	3	83	74	1	80	0.0125000
NODE_307442_length_128_cov_2621.517241	3	83	78	1	80	0.0125000
NODE_307442_length_128_cov_2621.517241	3	83	90	1	80	0.0125000
NODE_307442_length_128_cov_2621.517241	3	83	96	1	80	0.0125000
NODE_307442_length_128_cov_2621.517241	3	83	114	1	80	0.0125000
NODE_307442_length_128_cov_2621.517241	3	83	140	1	80	0.0125000
NODE_307442_length_128_cov_2621.517241	3	83	144	1	80	0.0125000
NODE_307442_length_128_cov_2621.517241	3	83	148	1	80	0.0125000
NODE_307442_length_128_cov_2621.517241	3	83	153	1	80	0.0125000
NODE_307442_length_128_cov_2621.517241	3	83	155	1	80	0.0125000
NODE_307442_length_128_cov_2621.517241	3	83	159	2	80	0.0250000
NODE_307442_length_128_cov_2621.517241	3	83	161	3	80	0.0375000
NODE_307442_length_128_cov_2621.517241	3	83	173	1	80	0.0125000
NODE_307442_length_128_cov_2621.517241	3	83	175	1	80	0.0125000
NODE_307442_length_128_cov_2621.517241	3	83	176	1	80	0.0125000
NODE_307442_length_128_cov_2621.517241	3	83	178	1	80	0.0125000
NODE_307442_length_128_cov_2621.517241	3	83	180	1	80	0.0125000
NODE_307442_length_128_cov_2621.517241	3	83	184	57	80	0.7125000
NODE_307442_length_128_cov_2621.517241	8	30	90	1	22	0.0454545
NODE_307442_length_128_cov_2621.517241	8	30	96	1	22	0.0454545
NODE_307442_length_128_cov_2621.517241	8	30	114	1	22	0.0454545
NODE_307442_length_128_cov_2621.517241	8	30	140	1	22	0.0454545
NODE_307442_length_128_cov_2621.517241	8	30	144	1	22	0.0454545
NODE_307442_length_128_cov_2621.517241	8	30	148	1	22	0.0454545
NODE_307442_length_128_cov_2621.517241	8	30	153	1	22	0.0454545
NODE_307442_length_128_cov_2621.517241	8	30	155	1	22	0.0454545
NODE_307442_length_128_cov_2621.517241	8	30	159	2	22	0.0909091
NODE_307442_length_128_cov_2621.517241	8	30	161	3	22	0.1363636
NODE_307442_length_128_cov_2621.517241	8	30	173	1	22	0.0454545
NODE_307442_length_128_cov_2621.517241	8	30	175	1	22	0.0454545
NODE_307442_length_128_cov_2621.517241	8	30	176	1	22	0.0454545
NODE_307442_length_128_cov_2621.517241	8	30	178	1	22	0.0454545
NODE_307442_length_128_cov_2621.517241	8	30	180	1	22	0.0454545
NODE_307442_length_128_cov_2621.517241	8	30	184	4	22	0.1818182
NODE_307442_length_128_cov_2621.517241	56	128	25	1	72	0.0138889
NODE_307442_length_128_cov_2621.517241	56	128	27	1	72	0.0138889
NODE_307442_length_128_cov_2621.517241	56	128	31	1	72	0.0138889
NODE_307442_length_128_cov_2621.517241	56	128	33	7	72	0.0972222
NODE_307442_length_128_cov_2621.517241	56	128	45	1	72	0.0138889
NODE_307442_length_128_cov_2621.517241	56	128	47	1	72	0.0138889
NODE_307442_length_128_cov_2621.517241	56	128	59	1	72	0.0138889
NODE_307442_length_128_cov_2621.517241	56	128	71	1	72	0.0138889
NODE_307442_length_128_cov_2621.517241	56	128	91	1	72	0.0138889
NODE_307442_length_128_cov_2621.517241	56	128	93	1	72	0.0138889
NODE_307442_length_128_cov_2621.517241	56	128	108	1	72	0.0138889
NODE_307442_length_128_cov_2621.517241	56	128	116	1	72	0.0138889
NODE_307442_length_128_cov_2621.517241	56	128	130	2	72	0.0277778
NODE_307442_length_128_cov_2621.517241	56	128	153	1	72	0.0138889
NODE_307442_length_128_cov_2621.517241	56	128	166	1	72	0.0138889
NODE_307442_length_128_cov_2621.517241	56	128	167	1	72	0.0138889
NODE_307442_length_128_cov_2621.517241	56	128	172	1	72	0.0138889
NODE_307442_length_128_cov_2621.517241	56	128	178	1	72	0.0138889
NODE_307442_length_128_cov_2621.517241	56	128	182	1	72	0.0138889
NODE_307442_length_128_cov_2621.517241	56	128	184	46	72	0.6388889
NODE_307443_length_128_cov_1604.275862	58	127	2	3	69	0.0434783
NODE_307443_length_128_cov_1604.275862	58	127	4	3	69	0.0434783
NODE_307443_length_128_cov_1604.275862	58	127	6	63	69	0.9130435
NODE_307458_length_128_cov_79.034483	43	123	12	3	80	0.0375000
NODE_307458_length_128_cov_79.034483	43	123	14	5	80	0.0625000
NODE_307458_length_128_cov_79.034483	43	123	20	2	80	0.0250000
NODE_307458_length_128_cov_79.034483	43	123	30	4	80	0.0500000
NODE_307458_length_128_cov_79.034483	43	123	32	1	80	0.0125000
NODE_307458_length_128_cov_79.034483	43	123	36	65	80	0.8125000
NODE_307464_length_128_cov_61.793103	5	85	0	2	80	0.0250000
NODE_307464_length_128_cov_61.793103	5	85	6	4	80	0.0500000
NODE_307464_length_128_cov_61.793103	5	85	10	1	80	0.0125000
NODE_307464_length_128_cov_61.793103	5	85	14	11	80	0.1375000
NODE_307464_length_128_cov_61.793103	5	85	18	62	80	0.7750000
NODE_307549_length_127_cov_1879.785714	21	101	168	2	80	0.0250000
NODE_307549_length_127_cov_1879.785714	21	101	188	1	80	0.0125000
NODE_307549_length_127_cov_1879.785714	21	101	197	1	80	0.0125000
NODE_307549_length_127_cov_1879.785714	21	101	198	76	80	0.9500000
NODE_307549_length_127_cov_1879.785714	74	127	12	2	53	0.0377358
NODE_307549_length_127_cov_1879.785714	74	127	20	1	53	0.0188679
NODE_307549_length_127_cov_1879.785714	74	127	31	1	53	0.0188679
NODE_307549_length_127_cov_1879.785714	74	127	34	2	53	0.0377358
NODE_307549_length_127_cov_1879.785714	74	127	38	2	53	0.0377358
NODE_307549_length_127_cov_1879.785714	74	127	41	1	53	0.0188679
NODE_307549_length_127_cov_1879.785714	74	127	58	1	53	0.0188679
NODE_307549_length_127_cov_1879.785714	74	127	67	1	53	0.0188679
NODE_307549_length_127_cov_1879.785714	74	127	93	1	53	0.0188679
NODE_307549_length_127_cov_1879.785714	74	127	97	1	53	0.0188679
NODE_307549_length_127_cov_1879.785714	74	127	111	1	53	0.0188679
NODE_307549_length_127_cov_1879.785714	74	127	121	1	53	0.0188679
NODE_307549_length_127_cov_1879.785714	74	127	124	1	53	0.0188679
NODE_307549_length_127_cov_1879.785714	74	127	128	2	53	0.0377358
NODE_307549_length_127_cov_1879.785714	74	127	136	1	53	0.0188679
NODE_307549_length_127_cov_1879.785714	74	127	150	1	53	0.0188679
NODE_307549_length_127_cov_1879.785714	74	127	152	1	53	0.0188679
NODE_307549_length_127_cov_1879.785714	74	127	156	1	53	0.0188679
NODE_307549_length_127_cov_1879.785714	74	127	160	1	53	0.0188679
NODE_307549_length_127_cov_1879.785714	74	127	182	1	53	0.0188679
NODE_307549_length_127_cov_1879.785714	74	127	196	1	53	0.0188679
NODE_307549_length_127_cov_1879.785714	74	127	198	28	53	0.5283019
NODE_307583_length_127_cov_66.142857	38	118	0	80	80	1.0000000
NODE_307583_length_127_cov_66.142857	47	118	0	71	71	1.0000000
NODE_307590_length_127_cov_38.285714	12	86	6	7	74	0.0945946
NODE_307590_length_127_cov_38.285714	12	86	8	67	74	0.9054054
NODE_307596_length_127_cov_30.607143	21	93	0	72	72	1.0000000
NODE_307662_length_126_cov_936.777778	24	96	4	72	72	1.0000000
NODE_307675_length_126_cov_147.185185	2	66	0	64	64	1.0000000
NODE_307675_length_126_cov_147.185185	2	66	0	64	64	1.0000000
NODE_307675_length_126_cov_147.185185	2	66	0	64	64	1.0000000
NODE_307675_length_126_cov_147.185185	39	99	0	60	60	1.0000000
NODE_307675_length_126_cov_147.185185	55	99	0	44	44	1.0000000
NODE_307684_length_126_cov_82.518519	44	75	0	31	31	1.0000000
NODE_307793_length_125_cov_656.807692	19	99	60	80	80	1.0000000
NODE_307806_length_125_cov_143.615385	52	125	0	1	73	0.0136986
NODE_307806_length_125_cov_143.615385	52	125	4	1	73	0.0136986
NODE_307806_length_125_cov_143.615385	52	125	8	2	73	0.0273973
NODE_307806_length_125_cov_143.615385	52	125	12	2	73	0.0273973
NODE_307806_length_125_cov_143.615385	52	125	14	3	73	0.0410959
NODE_307806_length_125_cov_143.615385	52	125	16	3	73	0.0410959
NODE_307806_length_125_cov_143.615385	52	125	18	3	73	0.0410959
NODE_307806_length_125_cov_143.615385	52	125	23	1	73	0.0136986
NODE_307806_length_125_cov_143.615385	52	125	24	57	73	0.7808219
NODE_307810_length_125_cov_131.923077	3	52	14	2	49	0.0408163
NODE_307810_length_125_cov_131.923077	3	52	16	1	49	0.0204082
NODE_307810_length_125_cov_131.923077	3	52	22	2	49	0.0408163
NODE_307810_length_125_cov_131.923077	3	52	26	1	49	0.0204082
NODE_307810_length_125_cov_131.923077	3	52	28	2	49	0.0408163
NODE_307810_length_125_cov_131.923077	3	52	34	1	49	0.0204082
NODE_307810_length_125_cov_131.923077	3	52	44	4	49	0.0816327
NODE_307810_length_125_cov_131.923077	3	52	46	2	49	0.0408163
NODE_307810_length_125_cov_131.923077	3	52	50	4	49	0.0816327
NODE_307810_length_125_cov_131.923077	3	52	52	1	49	0.0204082
NODE_307810_length_125_cov_131.923077	3	52	54	29	49	0.5918368
NODE_307810_length_125_cov_131.923077	25	89	54	64	64	1.0000000
NODE_307810_length_125_cov_131.923077	25	89	54	64	64	1.0000000
NODE_307816_length_125_cov_102.500000	0	56	0	10	56	0.1785714
NODE_307816_length_125_cov_102.500000	0	56	6	3	56	0.0535714
NODE_307816_length_125_cov_102.500000	0	56	8	11	56	0.1964286
NODE_307816_length_125_cov_102.500000	0	56	10	32	56	0.5714286
NODE_307816_length_125_cov_102.500000	7	56	0	3	49	0.0612245
NODE_307816_length_125_cov_102.500000	7	56	6	3	49	0.0612245
NODE_307816_length_125_cov_102.500000	7	56	8	11	49	0.2244898
NODE_307816_length_125_cov_102.500000	7	56	10	32	49	0.6530612
NODE_307816_length_125_cov_102.500000	29	114	6	2	85	0.0235294
NODE_307816_length_125_cov_102.500000	29	114	8	4	85	0.0470588
NODE_307816_length_125_cov_102.500000	29	114	10	79	85	0.9294118
NODE_307816_length_125_cov_102.500000	29	114	6	2	85	0.0235294
NODE_307816_length_125_cov_102.500000	29	114	8	4	85	0.0470588
NODE_307816_length_125_cov_102.500000	29	114	10	79	85	0.9294118
NODE_307816_length_125_cov_102.500000	29	114	6	2	85	0.0235294
NODE_307816_length_125_cov_102.500000	29	114	8	4	85	0.0470588
NODE_307816_length_125_cov_102.500000	29	114	10	79	85	0.9294118
NODE_307839_length_125_cov_28.115385	17	90	32	1	73	0.0136986
NODE_307839_length_125_cov_28.115385	17	90	34	1	73	0.0136986
NODE_307839_length_125_cov_28.115385	17	90	36	2	73	0.0273973
NODE_307839_length_125_cov_28.115385	17	90	38	2	73	0.0273973
NODE_307839_length_125_cov_28.115385	17	90	40	67	73	0.9178082
NODE_307839_length_125_cov_28.115385	57	98	40	41	41	1.0000000
NODE_307906_length_124_cov_945.680000	0	73	6	2	73	0.0273973
NODE_307906_length_124_cov_945.680000	0	73	10	1	73	0.0136986
NODE_307906_length_124_cov_945.680000	0	73	14	2	73	0.0273973
NODE_307906_length_124_cov_945.680000	0	73	18	1	73	0.0136986
NODE_307906_length_124_cov_945.680000	0	73	22	2	73	0.0273973
NODE_307906_length_124_cov_945.680000	0	73	30	1	73	0.0136986
NODE_307906_length_124_cov_945.680000	0	73	38	1	73	0.0136986
NODE_307906_length_124_cov_945.680000	0	73	40	1	73	0.0136986
NODE_307906_length_124_cov_945.680000	0	73	42	2	73	0.0273973
NODE_307906_length_124_cov_945.680000	0	73	44	4	73	0.0547945
NODE_307906_length_124_cov_945.680000	0	73	46	1	73	0.0136986
NODE_307906_length_124_cov_945.680000	0	73	50	55	73	0.7534246
NODE_307906_length_124_cov_945.680000	53	124	2	1	71	0.0140845
NODE_307906_length_124_cov_945.680000	53	124	4	3	71	0.0422535
NODE_307906_length_124_cov_945.680000	53	124	11	1	71	0.0140845
NODE_307906_length_124_cov_945.680000	53	124	14	1	71	0.0140845
NODE_307906_length_124_cov_945.680000	53	124	16	1	71	0.0140845
NODE_307906_length_124_cov_945.680000	53	124	18	2	71	0.0281690
NODE_307906_length_124_cov_945.680000	53	124	30	2	71	0.0281690
NODE_307906_length_124_cov_945.680000	53	124	34	1	71	0.0140845
NODE_307906_length_124_cov_945.680000	53	124	36	1	71	0.0140845
NODE_307906_length_124_cov_945.680000	53	124	38	1	71	0.0140845
NODE_307906_length_124_cov_945.680000	53	124	44	1	71	0.0140845
NODE_307906_length_124_cov_945.680000	53	124	46	4	71	0.0563380
NODE_307906_length_124_cov_945.680000	53	124	48	2	71	0.0281690
NODE_307906_length_124_cov_945.680000	53	124	50	50	71	0.7042254
NODE_308023_length_123_cov_1186.083333	0	76	0	8	76	0.1052632
NODE_308023_length_123_cov_1186.083333	0	76	2	68	76	0.8947368
NODE_308023_length_123_cov_1186.083333	0	76	0	8	76	0.1052632
NODE_308023_length_123_cov_1186.083333	0	76	2	68	76	0.8947368
NODE_308023_length_123_cov_1186.083333	0	76	0	8	76	0.1052632
NODE_308023_length_123_cov_1186.083333	0	76	2	68	76	0.8947368
NODE_308023_length_123_cov_1186.083333	0	76	0	8	76	0.1052632
NODE_308023_length_123_cov_1186.083333	0	76	2	68	76	0.8947368
NODE_308023_length_123_cov_1186.083333	49	123	0	3	74	0.0405405
NODE_308023_length_123_cov_1186.083333	49	123	2	71	74	0.9594595
NODE_308023_length_123_cov_1186.083333	49	123	0	3	74	0.0405405
NODE_308023_length_123_cov_1186.083333	49	123	2	71	74	0.9594595
NODE_308023_length_123_cov_1186.083333	49	123	0	3	74	0.0405405
NODE_308023_length_123_cov_1186.083333	49	123	2	71	74	0.9594595
NODE_308024_length_123_cov_963.500000	19	88	4	69	69	1.0000000
NODE_308037_length_123_cov_181.291667	0	47	0	47	47	1.0000000
NODE_308037_length_123_cov_181.291667	24	100	0	76	76	1.0000000
NODE_308057_length_123_cov_55.375000	52	123	3	1	71	0.0140845
NODE_308057_length_123_cov_55.375000	52	123	7	4	71	0.0563380
NODE_308057_length_123_cov_55.375000	52	123	13	1	71	0.0140845
NODE_308057_length_123_cov_55.375000	52	123	15	4	71	0.0563380
NODE_308057_length_123_cov_55.375000	52	123	16	2	71	0.0281690
NODE_308057_length_123_cov_55.375000	52	123	18	2	71	0.0281690
NODE_308057_length_123_cov_55.375000	52	123	21	3	71	0.0422535
NODE_308057_length_123_cov_55.375000	52	123	23	2	71	0.0281690
NODE_308057_length_123_cov_55.375000	52	123	29	26	71	0.3661972
NODE_308057_length_123_cov_55.375000	52	123	30	26	71	0.3661972
NODE_308057_length_123_cov_55.375000	52	123	3	1	71	0.0140845
NODE_308057_length_123_cov_55.375000	52	123	7	4	71	0.0563380
NODE_308057_length_123_cov_55.375000	52	123	13	1	71	0.0140845
NODE_308057_length_123_cov_55.375000	52	123	15	4	71	0.0563380
NODE_308057_length_123_cov_55.375000	52	123	16	2	71	0.0281690
NODE_308057_length_123_cov_55.375000	52	123	18	2	71	0.0281690
NODE_308057_length_123_cov_55.375000	52	123	21	3	71	0.0422535
NODE_308057_length_123_cov_55.375000	52	123	23	2	71	0.0281690
NODE_308057_length_123_cov_55.375000	52	123	29	26	71	0.3661972
NODE_308057_length_123_cov_55.375000	52	123	30	26	71	0.3661972
NODE_308057_length_123_cov_55.375000	61	123	3	1	62	0.0161290
NODE_308057_length_123_cov_55.375000	61	123	7	4	62	0.0645161
NODE_308057_length_123_cov_55.375000	61	123	13	1	62	0.0161290
NODE_308057_length_123_cov_55.375000	61	123	15	4	62	0.0645161
NODE_308057_length_123_cov_55.375000	61	123	16	2	62	0.0322581
NODE_308057_length_123_cov_55.375000	61	123	18	2	62	0.0322581
NODE_308057_length_123_cov_55.375000	61	123	21	3	62	0.0483871
NODE_308057_length_123_cov_55.375000	61	123	23	2	62	0.0322581
NODE_308057_length_123_cov_55.375000	61	123	29	26	62	0.4193548
NODE_308057_length_123_cov_55.375000	61	123	30	17	62	0.2741936
NODE_308068_length_123_cov_40.958333	9	89	10	1	80	0.0125000
NODE_308068_length_123_cov_40.958333	9	89	14	79	80	0.9875000
NODE_308068_length_123_cov_40.958333	9	89	10	1	80	0.0125000
NODE_308068_length_123_cov_40.958333	9	89	14	79	80	0.9875000
NODE_308068_length_123_cov_40.958333	9	89	10	1	80	0.0125000
NODE_308068_length_123_cov_40.958333	9	89	14	79	80	0.9875000
NODE_308068_length_123_cov_40.958333	9	89	10	1	80	0.0125000
NODE_308068_length_123_cov_40.958333	9	89	14	79	80	0.9875000
NODE_308068_length_123_cov_40.958333	9	89	10	1	80	0.0125000
NODE_308068_length_123_cov_40.958333	9	89	14	79	80	0.9875000
NODE_308068_length_123_cov_40.958333	9	80	10	1	71	0.0140845
NODE_308068_length_123_cov_40.958333	9	80	14	70	71	0.9859155
NODE_308180_length_122_cov_111.043478	8	88	4	5	80	0.0625000
NODE_308180_length_122_cov_111.043478	8	88	8	75	80	0.9375000
NODE_308180_length_122_cov_111.043478	8	88	4	5	80	0.0625000
NODE_308180_length_122_cov_111.043478	8	88	8	75	80	0.9375000
NODE_308184_length_122_cov_67.565217	0	50	0	50	50	1.0000000
NODE_308184_length_122_cov_67.565217	0	50	0	50	50	1.0000000
NODE_308184_length_122_cov_67.565217	23	103	0	80	80	1.0000000
NODE_308184_length_122_cov_67.565217	23	103	0	80	80	1.0000000
NODE_308184_length_122_cov_67.565217	23	103	0	80	80	1.0000000
NODE_308184_length_122_cov_67.565217	23	103	0	80	80	1.0000000
NODE_308184_length_122_cov_67.565217	23	103	0	80	80	1.0000000
NODE_308184_length_122_cov_67.565217	23	94	0	71	71	1.0000000
NODE_308188_length_122_cov_58.826087	28	99	0	71	71	1.0000000
NODE_308188_length_122_cov_58.826087	33	99	0	66	66	1.0000000
NODE_308188_length_122_cov_58.826087	72	122	0	50	50	1.0000000
NODE_308188_length_122_cov_58.826087	72	122	0	50	50	1.0000000
NODE_308198_length_122_cov_38.173913	12	93	0	81	81	1.0000000
NODE_308257_length_121_cov_159.318182	24	55	2	31	31	1.0000000
NODE_308260_length_121_cov_120.181818	20	100	0	80	80	1.0000000
NODE_308260_length_121_cov_120.181818	20	95	0	75	75	1.0000000
NODE_308260_length_121_cov_120.181818	20	100	0	80	80	1.0000000
NODE_308260_length_121_cov_120.181818	29	100	0	71	71	1.0000000
NODE_308273_length_121_cov_54.181818	7	70	4	63	63	1.0000000
NODE_308273_length_121_cov_54.181818	7	70	4	63	63	1.0000000
NODE_308273_length_121_cov_54.181818	7	70	4	63	63	1.0000000
NODE_308273_length_121_cov_54.181818	9	70	4	61	61	1.0000000
NODE_308273_length_121_cov_54.181818	43	109	0	7	66	0.1060606
NODE_308273_length_121_cov_54.181818	43	109	4	59	66	0.8939394
NODE_308273_length_121_cov_54.181818	43	121	0	19	78	0.2435897
NODE_308273_length_121_cov_54.181818	43	121	4	59	78	0.7564102
NODE_308273_length_121_cov_54.181818	64	117	0	15	53	0.2830189
NODE_308273_length_121_cov_54.181818	64	117	4	38	53	0.7169811
NODE_308317_length_120_cov_1404.619048	0	64	12	1	64	0.0156250
NODE_308317_length_120_cov_1404.619048	0	64	26	1	64	0.0156250
NODE_308317_length_120_cov_1404.619048	0	64	41	1	64	0.0156250
NODE_308317_length_120_cov_1404.619048	0	64	56	1	64	0.0156250
NODE_308317_length_120_cov_1404.619048	0	64	58	1	64	0.0156250
NODE_308317_length_120_cov_1404.619048	0	64	67	1	64	0.0156250
NODE_308317_length_120_cov_1404.619048	0	64	79	1	64	0.0156250
NODE_308317_length_120_cov_1404.619048	0	64	96	1	64	0.0156250
NODE_308317_length_120_cov_1404.619048	0	64	98	1	64	0.0156250
NODE_308317_length_120_cov_1404.619048	0	64	102	2	64	0.0312500
NODE_308317_length_120_cov_1404.619048	0	64	105	1	64	0.0156250
NODE_308317_length_120_cov_1404.619048	0	64	110	1	64	0.0156250
NODE_308317_length_120_cov_1404.619048	0	64	123	1	64	0.0156250
NODE_308317_length_120_cov_1404.619048	0	64	128	3	64	0.0468750
NODE_308317_length_120_cov_1404.619048	0	64	130	1	64	0.0156250
NODE_308317_length_120_cov_1404.619048	0	64	132	46	64	0.7187500
NODE_308317_length_120_cov_1404.619048	45	117	66	1	72	0.0138889
NODE_308317_length_120_cov_1404.619048	45	117	72	1	72	0.0138889
NODE_308317_length_120_cov_1404.619048	45	117	86	1	72	0.0138889
NODE_308317_length_120_cov_1404.619048	45	117	93	1	72	0.0138889
NODE_308317_length_120_cov_1404.619048	45	117	100	1	72	0.0138889
NODE_308317_length_120_cov_1404.619048	45	117	112	3	72	0.0416667
NODE_308317_length_120_cov_1404.619048	45	117	119	1	72	0.0138889
NODE_308317_length_120_cov_1404.619048	45	117	128	3	72	0.0416667
NODE_308317_length_120_cov_1404.619048	45	117	130	1	72	0.0138889
NODE_308317_length_120_cov_1404.619048	45	117	132	59	72	0.8194444
NODE_308318_length_120_cov_1138.428571	19	99	16	80	80	1.0000000
NODE_308318_length_120_cov_1138.428571	72	120	12	1	48	0.0208333
NODE_308318_length_120_cov_1138.428571	72	120	14	1	48	0.0208333
NODE_308318_length_120_cov_1138.428571	72	120	16	46	48	0.9583333
NODE_308357_length_120_cov_54.666667	0	69	0	2	69	0.0289855
NODE_308357_length_120_cov_54.666667	0	69	7	5	69	0.0724638
NODE_308357_length_120_cov_54.666667	0	69	13	62	69	0.8985507
NODE_308357_length_120_cov_54.666667	0	69	0	2	69	0.0289855
NODE_308357_length_120_cov_54.666667	0	69	7	5	69	0.0724638
NODE_308357_length_120_cov_54.666667	0	69	13	62	69	0.8985507
NODE_308357_length_120_cov_54.666667	0	69	0	2	69	0.0289855
NODE_308357_length_120_cov_54.666667	0	69	7	5	69	0.0724638
NODE_308357_length_120_cov_54.666667	0	69	13	62	69	0.8985507
NODE_308357_length_120_cov_54.666667	42	108	13	66	66	1.0000000
NODE_308357_length_120_cov_54.666667	53	120	0	2	67	0.0298507
NODE_308357_length_120_cov_54.666667	53	120	4	1	67	0.0149254
NODE_308357_length_120_cov_54.666667	53	120	8	6	67	0.0895522
NODE_308357_length_120_cov_54.666667	53	120	11	2	67	0.0298507
NODE_308357_length_120_cov_54.666667	53	120	13	56	67	0.8358209
NODE_308357_length_120_cov_54.666667	53	120	0	2	67	0.0298507
NODE_308357_length_120_cov_54.666667	53	120	4	1	67	0.0149254
NODE_308357_length_120_cov_54.666667	53	120	8	6	67	0.0895522
NODE_308357_length_120_cov_54.666667	53	120	11	2	67	0.0298507
NODE_308357_length_120_cov_54.666667	53	120	13	56	67	0.8358209
NODE_308487_length_118_cov_1211.578947	49	116	4	10	67	0.1492537
NODE_308487_length_118_cov_1211.578947	49	116	6	3	67	0.0447761
NODE_308487_length_118_cov_1211.578947	49	116	8	54	67	0.8059701
NODE_308488_length_118_cov_1157.157895	4	70	2	4	66	0.0606061
NODE_308488_length_118_cov_1157.157895	4	70	8	2	66	0.0303030
NODE_308488_length_118_cov_1157.157895	4	70	10	1	66	0.0151515
NODE_308488_length_118_cov_1157.157895	4	70	12	2	66	0.0303030
NODE_308488_length_118_cov_1157.157895	4	70	14	57	66	0.8636364
NODE_308500_length_118_cov_218.210526	0	63	2	1	63	0.0158730
NODE_308500_length_118_cov_218.210526	0	63	6	1	63	0.0158730
NODE_308500_length_118_cov_218.210526	0	63	11	1	63	0.0158730
NODE_308500_length_118_cov_218.210526	0	63	12	7	63	0.1111111
NODE_308500_length_118_cov_218.210526	0	63	14	3	63	0.0476190
NODE_308500_length_118_cov_218.210526	0	63	18	50	63	0.7936508
NODE_308500_length_118_cov_218.210526	35	115	6	8	80	0.1000000
NODE_308500_length_118_cov_218.210526	35	115	8	4	80	0.0500000
NODE_308500_length_118_cov_218.210526	35	115	14	1	80	0.0125000
NODE_308500_length_118_cov_218.210526	35	115	18	67	80	0.8375000
NODE_308504_length_118_cov_161.052632	4	70	4	66	66	1.0000000
NODE_308572_length_117_cov_338.555556	7	70	24	2	63	0.0317460
NODE_308572_length_117_cov_338.555556	7	70	26	1	63	0.0158730
NODE_308572_length_117_cov_338.555556	7	70	28	60	63	0.9523810
NODE_308572_length_117_cov_338.555556	7	70	24	2	63	0.0317460
NODE_308572_length_117_cov_338.555556	7	70	26	1	63	0.0158730
NODE_308572_length_117_cov_338.555556	7	70	28	60	63	0.9523810
NODE_308572_length_117_cov_338.555556	7	70	24	2	63	0.0317460
NODE_308572_length_117_cov_338.555556	7	70	26	1	63	0.0158730
NODE_308572_length_117_cov_338.555556	7	70	28	60	63	0.9523810
NODE_308572_length_117_cov_338.555556	9	70	26	1	61	0.0163934
NODE_308572_length_117_cov_338.555556	9	70	28	60	61	0.9836066
NODE_308572_length_117_cov_338.555556	43	109	18	2	66	0.0303030
NODE_308572_length_117_cov_338.555556	43	109	20	2	66	0.0303030
NODE_308572_length_117_cov_338.555556	43	109	22	1	66	0.0151515
NODE_308572_length_117_cov_338.555556	43	109	24	2	66	0.0303030
NODE_308572_length_117_cov_338.555556	43	109	28	59	66	0.8939394
NODE_308572_length_117_cov_338.555556	43	114	18	7	71	0.0985916
NODE_308572_length_117_cov_338.555556	43	114	20	2	71	0.0281690
NODE_308572_length_117_cov_338.555556	43	114	22	1	71	0.0140845
NODE_308572_length_117_cov_338.555556	43	114	24	2	71	0.0281690
NODE_308572_length_117_cov_338.555556	43	114	28	59	71	0.8309859
NODE_308572_length_117_cov_338.555556	64	117	2	2	53	0.0377358
NODE_308572_length_117_cov_338.555556	64	117	17	1	53	0.0188679
NODE_308572_length_117_cov_338.555556	64	117	18	7	53	0.1320755
NODE_308572_length_117_cov_338.555556	64	117	20	2	53	0.0377358
NODE_308572_length_117_cov_338.555556	64	117	22	1	53	0.0188679
NODE_308572_length_117_cov_338.555556	64	117	24	2	53	0.0377358
NODE_308572_length_117_cov_338.555556	64	117	28	38	53	0.7169811
NODE_308654_length_116_cov_1897.470588	0	77	0	3	77	0.0389610
NODE_308654_length_116_cov_1897.470588	0	77	5	1	77	0.0129870
NODE_308654_length_116_cov_1897.470588	0	77	6	1	77	0.0129870
NODE_308654_length_116_cov_1897.470588	0	77	8	7	77	0.0909091
NODE_308654_length_116_cov_1897.470588	0	77	10	65	77	0.8441558
NODE_308654_length_116_cov_1897.470588	34	111	8	1	77	0.0129870
NODE_308654_length_116_cov_1897.470588	34	111	10	76	77	0.9870130
NODE_308668_length_116_cov_438.529412	15	95	10	80	80	1.0000000
NODE_308668_length_116_cov_438.529412	68	116	4	3	48	0.0625000
NODE_308668_length_116_cov_438.529412	68	116	8	9	48	0.1875000
NODE_308668_length_116_cov_438.529412	68	116	10	36	48	0.7500000
NODE_308701_length_116_cov_93.235294	52	116	0	2	64	0.0312500
NODE_308701_length_116_cov_93.235294	52	116	2	62	64	0.9687500
NODE_308722_length_116_cov_46.882353	6	66	20	5	60	0.0833333
NODE_308722_length_116_cov_46.882353	6	66	24	2	60	0.0333333
NODE_308722_length_116_cov_46.882353	6	66	30	53	60	0.8833333
NODE_308727_length_116_cov_38.352941	20	100	2	80	80	1.0000000
NODE_308746_length_115_cov_1012.625000	31	114	12	1	83	0.0120482
NODE_308746_length_115_cov_1012.625000	31	114	14	82	83	0.9879518
NODE_308750_length_115_cov_776.625000	9	92	10	83	83	1.0000000
NODE_308752_length_115_cov_623.937500	0	74	0	74	74	1.0000000
NODE_308782_length_115_cov_144.812500	4	73	8	4	69	0.0579710
NODE_308782_length_115_cov_144.812500	4	73	12	3	69	0.0434783
NODE_308782_length_115_cov_144.812500	4	73	16	62	69	0.8985507
NODE_308806_length_115_cov_65.187500	16	76	16	60	60	1.0000000
NODE_308846_length_114_cov_819.466667	40	114	0	4	74	0.0540541
NODE_308846_length_114_cov_819.466667	40	114	2	5	74	0.0675676
NODE_308846_length_114_cov_819.466667	40	114	6	1	74	0.0135135
NODE_308846_length_114_cov_819.466667	40	114	8	64	74	0.8648649
NODE_308846_length_114_cov_819.466667	40	114	0	4	74	0.0540541
NODE_308846_length_114_cov_819.466667	40	114	2	5	74	0.0675676
NODE_308846_length_114_cov_819.466667	40	114	6	1	74	0.0135135
NODE_308846_length_114_cov_819.466667	40	114	8	64	74	0.8648649
NODE_308846_length_114_cov_819.466667	49	114	0	4	65	0.0615385
NODE_308846_length_114_cov_819.466667	49	114	2	5	65	0.0769231
NODE_308846_length_114_cov_819.466667	49	114	6	1	65	0.0153846
NODE_308846_length_114_cov_819.466667	49	114	8	55	65	0.8461539
NODE_308866_length_114_cov_285.666667	0	78	0	78	78	1.0000000
NODE_308866_length_114_cov_285.666667	51	114	0	63	63	1.0000000
NODE_308886_length_114_cov_83.600000	51	82	0	31	31	1.0000000
NODE_308891_length_114_cov_67.666667	40	90	0	50	50	1.0000000
NODE_308939_length_113_cov_446.214286	5	82	8	77	77	1.0000000
NODE_308939_length_113_cov_446.214286	5	82	8	77	77	1.0000000
NODE_308967_length_113_cov_160.071429	0	64	4	5	64	0.0781250
NODE_308967_length_113_cov_160.071429	0	64	6	1	64	0.0156250
NODE_308967_length_113_cov_160.071429	0	64	9	14	64	0.2187500
NODE_308967_length_113_cov_160.071429	0	64	10	44	64	0.6875000
NODE_308967_length_113_cov_160.071429	0	64	4	5	64	0.0781250
NODE_308967_length_113_cov_160.071429	0	64	6	1	64	0.0156250
NODE_308967_length_113_cov_160.071429	0	64	9	14	64	0.2187500
NODE_308967_length_113_cov_160.071429	0	64	10	44	64	0.6875000
NODE_308967_length_113_cov_160.071429	37	103	9	53	66	0.8030303
NODE_308967_length_113_cov_160.071429	37	103	10	13	66	0.1969697
NODE_308967_length_113_cov_160.071429	37	108	9	58	71	0.8169014
NODE_308967_length_113_cov_160.071429	37	108	10	13	71	0.1830986
NODE_309037_length_112_cov_963.384615	43	112	0	69	69	1.0000000
NODE_309044_length_112_cov_653.615385	7	78	4	2	71	0.0281690
NODE_309044_length_112_cov_653.615385	7	78	6	69	71	0.9718310
NODE_309044_length_112_cov_653.615385	12	78	6	66	66	1.0000000
NODE_309044_length_112_cov_653.615385	51	112	2	8	61	0.1311475
NODE_309044_length_112_cov_653.615385	51	112	6	53	61	0.8688524
NODE_309044_length_112_cov_653.615385	51	112	2	8	61	0.1311475
NODE_309044_length_112_cov_653.615385	51	112	6	53	61	0.8688524
NODE_309067_length_112_cov_219.538462	0	62	0	62	62	1.0000000
NODE_309067_length_112_cov_219.538462	0	57	0	57	57	1.0000000
NODE_309067_length_112_cov_219.538462	0	62	0	62	62	1.0000000
NODE_309067_length_112_cov_219.538462	0	59	0	59	59	1.0000000
NODE_309067_length_112_cov_219.538462	35	112	0	77	77	1.0000000
NODE_309067_length_112_cov_219.538462	35	112	0	77	77	1.0000000
NODE_309067_length_112_cov_219.538462	35	112	0	77	77	1.0000000
NODE_309078_length_112_cov_160.307692	0	69	0	69	69	1.0000000
NODE_309079_length_112_cov_134.846154	11	91	0	80	80	1.0000000
NODE_309079_length_112_cov_134.846154	11	91	0	80	80	1.0000000
NODE_309079_length_112_cov_134.846154	64	112	0	48	48	1.0000000
NODE_309079_length_112_cov_134.846154	64	112	0	48	48	1.0000000
NODE_309079_length_112_cov_134.846154	64	112	0	48	48	1.0000000
NODE_309092_length_112_cov_84.384615	10	90	0	80	80	1.0000000
NODE_309097_length_112_cov_72.769231	36	100	8	64	64	1.0000000
NODE_309106_length_112_cov_35.307692	13	76	2	63	63	1.0000000
NODE_309123_length_111_cov_1107.833333	0	52	6	52	52	1.0000000
NODE_309123_length_111_cov_1107.833333	0	52	6	52	52	1.0000000
NODE_309123_length_111_cov_1107.833333	0	52	6	52	52	1.0000000
NODE_309123_length_111_cov_1107.833333	0	52	6	52	52	1.0000000
NODE_309123_length_111_cov_1107.833333	25	105	6	80	80	1.0000000
NODE_309123_length_111_cov_1107.833333	25	105	6	80	80	1.0000000
NODE_309123_length_111_cov_1107.833333	25	105	6	80	80	1.0000000
NODE_309123_length_111_cov_1107.833333	25	105	6	80	80	1.0000000
NODE_309123_length_111_cov_1107.833333	25	105	6	80	80	1.0000000
NODE_309123_length_111_cov_1107.833333	25	105	6	80	80	1.0000000
NODE_309126_length_111_cov_827.500000	3	74	14	4	71	0.0563380
NODE_309126_length_111_cov_827.500000	3	74	16	67	71	0.9436620
NODE_309126_length_111_cov_827.500000	8	74	16	66	66	1.0000000
NODE_309126_length_111_cov_827.500000	47	111	0	1	64	0.0156250
NODE_309126_length_111_cov_827.500000	47	111	2	4	64	0.0625000
NODE_309126_length_111_cov_827.500000	47	111	8	1	64	0.0156250
NODE_309126_length_111_cov_827.500000	47	111	16	58	64	0.9062500
NODE_309126_length_111_cov_827.500000	47	111	0	1	64	0.0156250
NODE_309126_length_111_cov_827.500000	47	111	2	4	64	0.0625000
NODE_309126_length_111_cov_827.500000	47	111	8	1	64	0.0156250
NODE_309126_length_111_cov_827.500000	47	111	16	58	64	0.9062500
NODE_309126_length_111_cov_827.500000	47	111	0	1	64	0.0156250
NODE_309126_length_111_cov_827.500000	47	111	2	4	64	0.0625000
NODE_309126_length_111_cov_827.500000	47	111	8	1	64	0.0156250
NODE_309126_length_111_cov_827.500000	47	111	16	58	64	0.9062500
NODE_309129_length_111_cov_726.833333	12	89	2	77	77	1.0000000
NODE_309129_length_111_cov_726.833333	12	89	2	77	77	1.0000000
NODE_309129_length_111_cov_726.833333	62	111	0	2	49	0.0408163
NODE_309129_length_111_cov_726.833333	62	111	2	47	49	0.9591837
NODE_309129_length_111_cov_726.833333	67	111	0	2	44	0.0454545
NODE_309129_length_111_cov_726.833333	67	111	2	42	44	0.9545454
NODE_309131_length_111_cov_692.416667	31	111	0	3	80	0.0375000
NODE_309131_length_111_cov_692.416667	31	111	17	1	80	0.0125000
NODE_309131_length_111_cov_692.416667	31	111	18	2	80	0.0250000
NODE_309131_length_111_cov_692.416667	31	111	33	22	80	0.2750000
NODE_309131_length_111_cov_692.416667	31	111	34	52	80	0.6500000
NODE_309149_length_111_cov_241.750000	30	97	2	67	67	1.0000000
NODE_309160_length_111_cov_169.416667	21	102	0	81	81	1.0000000
NODE_309200_length_110_cov_554.909091	1	28	10	4	27	0.1481481
NODE_309200_length_110_cov_554.909091	1	28	14	2	27	0.0740741
NODE_309200_length_110_cov_554.909091	1	28	18	21	27	0.7777778
NODE_309200_length_110_cov_554.909091	1	81	10	4	80	0.0500000
NODE_309200_length_110_cov_554.909091	1	81	14	2	80	0.0250000
NODE_309200_length_110_cov_554.909091	1	81	18	74	80	0.9250000
NODE_309202_length_110_cov_537.545455	0	75	0	5	75	0.0666667
NODE_309202_length_110_cov_537.545455	0	75	2	70	75	0.9333333
NODE_309202_length_110_cov_537.545455	53	107	0	3	54	0.0555556
NODE_309202_length_110_cov_537.545455	53	107	2	51	54	0.9444444
NODE_309235_length_110_cov_91.636364	19	54	0	35	35	1.0000000
NODE_309235_length_110_cov_91.636364	64	107	0	43	43	1.0000000
NODE_309239_length_110_cov_80.272727	19	54	0	35	35	1.0000000
NODE_309239_length_110_cov_80.272727	64	99	0	35	35	1.0000000
NODE_309241_length_110_cov_78.363636	19	54	0	35	35	1.0000000
NODE_309241_length_110_cov_78.363636	64	107	0	43	43	1.0000000
NODE_309245_length_110_cov_68.727273	11	46	0	35	35	1.0000000
NODE_309245_length_110_cov_68.727273	56	91	0	35	35	1.0000000
NODE_309252_length_110_cov_44.545455	5	57	0	52	52	1.0000000
NODE_309263_length_109_cov_1364.100000	29	98	6	69	69	1.0000000
NODE_309275_length_109_cov_689.800000	12	86	2	74	74	1.0000000
NODE_309309_length_109_cov_250.800000	4	66	0	62	62	1.0000000
NODE_309311_length_109_cov_242.000000	29	98	0	69	69	1.0000000
NODE_309326_length_109_cov_139.000000	26	106	0	1	80	0.0125000
NODE_309326_length_109_cov_139.000000	26	106	4	79	80	0.9875000
NODE_309345_length_109_cov_84.500000	33	93	8	60	60	1.0000000
NODE_309349_length_109_cov_75.300000	0	65	0	65	65	1.0000000
NODE_309384_length_108_cov_1542.666667	28	108	0	80	80	1.0000000
NODE_309391_length_108_cov_987.666667	5	85	4	80	80	1.0000000
NODE_309391_length_108_cov_987.666667	5	85	4	80	80	1.0000000
NODE_309391_length_108_cov_987.666667	5	85	4	80	80	1.0000000
NODE_309391_length_108_cov_987.666667	5	85	4	80	80	1.0000000
NODE_309391_length_108_cov_987.666667	5	85	4	80	80	1.0000000
NODE_309391_length_108_cov_987.666667	58	108	4	50	50	1.0000000
NODE_309391_length_108_cov_987.666667	58	108	4	50	50	1.0000000
NODE_309395_length_108_cov_841.666667	1	65	8	4	64	0.0625000
NODE_309395_length_108_cov_841.666667	1	65	12	60	64	0.9375000
NODE_309395_length_108_cov_841.666667	1	65	8	4	64	0.0625000
NODE_309395_length_108_cov_841.666667	1	65	12	60	64	0.9375000
NODE_309395_length_108_cov_841.666667	1	65	8	4	64	0.0625000
NODE_309395_length_108_cov_841.666667	1	65	12	60	64	0.9375000
NODE_309433_length_108_cov_213.333333	22	81	0	59	59	1.0000000
NODE_309433_length_108_cov_213.333333	55	81	0	26	26	1.0000000
NODE_309464_length_108_cov_107.888889	11	82	2	71	71	1.0000000
NODE_309464_length_108_cov_107.888889	16	82	2	66	66	1.0000000
NODE_309464_length_108_cov_107.888889	55	108	2	53	53	1.0000000
NODE_309464_length_108_cov_107.888889	55	108	2	53	53	1.0000000
NODE_309464_length_108_cov_107.888889	55	108	2	53	53	1.0000000
NODE_309472_length_108_cov_76.444444	13	76	6	63	63	1.0000000
NODE_309479_length_108_cov_51.000000	0	53	0	53	53	1.0000000
NODE_309479_length_108_cov_51.000000	0	53	0	53	53	1.0000000
NODE_309479_length_108_cov_51.000000	0	53	0	53	53	1.0000000
NODE_309479_length_108_cov_51.000000	26	106	0	80	80	1.0000000
NODE_309479_length_108_cov_51.000000	26	106	0	80	80	1.0000000
NODE_309479_length_108_cov_51.000000	26	106	0	80	80	1.0000000
NODE_309479_length_108_cov_51.000000	26	106	0	80	80	1.0000000
NODE_309479_length_108_cov_51.000000	26	106	0	80	80	1.0000000
NODE_309479_length_108_cov_51.000000	26	97	0	71	71	1.0000000
NODE_309490_length_108_cov_31.111111	11	82	0	71	71	1.0000000
NODE_309490_length_108_cov_31.111111	16	82	0	66	66	1.0000000
NODE_309490_length_108_cov_31.111111	55	108	0	53	53	1.0000000
NODE_309490_length_108_cov_31.111111	55	108	0	53	53	1.0000000
NODE_309490_length_108_cov_31.111111	55	108	0	53	53	1.0000000
NODE_309530_length_107_cov_608.250000	0	64	0	64	64	1.0000000
NODE_309530_length_107_cov_608.250000	53	103	0	50	50	1.0000000
NODE_309551_length_107_cov_303.250000	0	56	0	56	56	1.0000000
NODE_309551_length_107_cov_303.250000	29	99	0	70	70	1.0000000
NODE_309657_length_106_cov_522.571429	10	90	0	80	80	1.0000000
NODE_309657_length_106_cov_522.571429	10	90	0	80	80	1.0000000
NODE_309657_length_106_cov_522.571429	10	90	0	80	80	1.0000000
NODE_309657_length_106_cov_522.571429	10	90	0	80	80	1.0000000
NODE_309657_length_106_cov_522.571429	10	90	0	80	80	1.0000000
NODE_309657_length_106_cov_522.571429	19	90	0	71	71	1.0000000
NODE_309696_length_106_cov_161.857143	7	78	0	71	71	1.0000000
NODE_309696_length_106_cov_161.857143	51	106	0	55	55	1.0000000
NODE_309707_length_106_cov_130.714286	0	76	0	76	76	1.0000000
NODE_309714_length_106_cov_108.000000	0	76	0	76	76	1.0000000
NODE_309717_length_106_cov_102.142857	0	62	4	62	62	1.0000000
NODE_309717_length_106_cov_102.142857	35	106	0	2	71	0.0281690
NODE_309717_length_106_cov_102.142857	35	106	4	69	71	0.9718310
NODE_309717_length_106_cov_102.142857	35	106	0	2	71	0.0281690
NODE_309717_length_106_cov_102.142857	35	106	4	69	71	0.9718310
NODE_309747_length_106_cov_39.428571	0	76	0	76	76	1.0000000
NODE_309761_length_106_cov_30.857143	0	70	0	70	70	1.0000000
NODE_309761_length_106_cov_30.857143	0	70	0	70	70	1.0000000
NODE_309761_length_106_cov_30.857143	0	70	0	70	70	1.0000000
NODE_309761_length_106_cov_30.857143	43	92	0	49	49	1.0000000
NODE_309761_length_106_cov_30.857143	53	106	0	53	53	1.0000000
NODE_309761_length_106_cov_30.857143	53	106	0	53	53	1.0000000
NODE_309775_length_105_cov_2054.666667	31	105	0	74	74	1.0000000
NODE_309775_length_105_cov_2054.666667	31	105	0	74	74	1.0000000
NODE_309775_length_105_cov_2054.666667	31	105	0	74	74	1.0000000
NODE_309775_length_105_cov_2054.666667	31	105	0	74	74	1.0000000
NODE_309788_length_105_cov_830.833333	30	105	0	75	75	1.0000000
NODE_309789_length_105_cov_825.500000	0	77	0	77	77	1.0000000
NODE_309789_length_105_cov_825.500000	0	77	0	77	77	1.0000000
NODE_309789_length_105_cov_825.500000	50	99	0	49	49	1.0000000
NODE_309789_length_105_cov_825.500000	55	105	0	50	50	1.0000000
NODE_309815_length_105_cov_231.333333	0	54	0	54	54	1.0000000
NODE_309815_length_105_cov_231.333333	27	99	0	72	72	1.0000000
NODE_309842_length_105_cov_85.333333	14	94	0	80	80	1.0000000
NODE_309842_length_105_cov_85.333333	67	89	0	22	22	1.0000000
NODE_309855_length_105_cov_61.833333	23	103	0	80	80	1.0000000
NODE_309867_length_105_cov_40.666667	6	66	0	60	60	1.0000000
NODE_309925_length_104_cov_1016.000000	0	78	0	78	78	1.0000000
NODE_309925_length_104_cov_1016.000000	53	99	0	46	46	1.0000000
NODE_309935_length_104_cov_791.200000	0	67	0	67	67	1.0000000
NODE_309935_length_104_cov_791.200000	0	67	0	67	67	1.0000000
NODE_309935_length_104_cov_791.200000	40	104	0	64	64	1.0000000
NODE_309938_length_104_cov_574.200000	21	101	0	80	80	1.0000000
NODE_309938_length_104_cov_574.200000	21	101	0	80	80	1.0000000
NODE_309938_length_104_cov_574.200000	21	101	0	80	80	1.0000000
NODE_309938_length_104_cov_574.200000	21	101	0	80	80	1.0000000
NODE_309938_length_104_cov_574.200000	21	101	0	80	80	1.0000000
NODE_309938_length_104_cov_574.200000	21	92	0	71	71	1.0000000
NODE_309940_length_104_cov_547.400000	10	87	0	77	77	1.0000000
NODE_309940_length_104_cov_547.400000	10	87	0	77	77	1.0000000
NODE_310020_length_104_cov_46.800000	42	104	0	62	62	1.0000000
NODE_310054_length_103_cov_2267.000000	0	54	0	54	54	1.0000000
NODE_310054_length_103_cov_2267.000000	27	100	0	73	73	1.0000000
NODE_310082_length_103_cov_890.000000	6	70	2	64	64	1.0000000
NODE_310082_length_103_cov_890.000000	6	70	2	64	64	1.0000000
NODE_310082_length_103_cov_890.000000	6	70	2	64	64	1.0000000
NODE_310082_length_103_cov_890.000000	43	103	2	60	60	1.0000000
NODE_310082_length_103_cov_890.000000	59	103	2	44	44	1.0000000
NODE_310090_length_103_cov_768.500000	7	78	0	71	71	1.0000000
NODE_310090_length_103_cov_768.500000	12	78	0	66	66	1.0000000
NODE_310090_length_103_cov_768.500000	51	99	0	48	48	1.0000000
NODE_310090_length_103_cov_768.500000	51	99	0	48	48	1.0000000
NODE_310090_length_103_cov_768.500000	51	99	0	48	48	1.0000000
NODE_310091_length_103_cov_751.000000	0	71	0	1	71	0.0140845
NODE_310091_length_103_cov_751.000000	0	71	2	70	71	0.9859155
NODE_310091_length_103_cov_751.000000	0	71	0	1	71	0.0140845
NODE_310091_length_103_cov_751.000000	0	71	2	70	71	0.9859155
NODE_310091_length_103_cov_751.000000	44	93	2	49	49	1.0000000
NODE_310094_length_103_cov_678.000000	10	74	0	64	64	1.0000000
NODE_310094_length_103_cov_678.000000	10	74	0	64	64	1.0000000
NODE_310094_length_103_cov_678.000000	10	74	0	64	64	1.0000000
NODE_310094_length_103_cov_678.000000	47	96	0	49	49	1.0000000
NODE_310103_length_103_cov_462.750000	19	99	0	80	80	1.0000000
NODE_310116_length_103_cov_300.250000	0	63	0	63	63	1.0000000
NODE_310147_length_103_cov_103.250000	4	47	0	43	43	1.0000000
NODE_310152_length_103_cov_80.250000	36	99	0	63	63	1.0000000
NODE_310153_length_103_cov_76.500000	4	63	0	59	59	1.0000000
NODE_310160_length_103_cov_42.000000	0	78	0	78	78	1.0000000
NODE_310160_length_103_cov_42.000000	7	78	0	71	71	1.0000000
NODE_310160_length_103_cov_42.000000	12	78	0	66	66	1.0000000
NODE_310160_length_103_cov_42.000000	51	99	0	48	48	1.0000000
NODE_310160_length_103_cov_42.000000	51	99	0	48	48	1.0000000
NODE_310160_length_103_cov_42.000000	51	99	0	48	48	1.0000000
NODE_310211_length_102_cov_2033.666667	0	48	0	48	48	1.0000000
NODE_310211_length_102_cov_2033.666667	21	101	0	80	80	1.0000000
NODE_310227_length_102_cov_1028.333333	52	102	0	50	50	1.0000000
NODE_310230_length_102_cov_987.666667	15	98	0	83	83	1.0000000
NODE_310231_length_102_cov_934.000000	12	95	0	83	83	1.0000000
NODE_310246_length_102_cov_685.666667	0	73	0	73	73	1.0000000
NODE_310247_length_102_cov_646.666667	15	89	0	74	74	1.0000000
NODE_310269_length_102_cov_250.000000	12	72	0	60	60	1.0000000
NODE_310273_length_102_cov_216.333333	4	70	0	66	66	1.0000000
NODE_310273_length_102_cov_216.333333	4	70	0	66	66	1.0000000
NODE_310273_length_102_cov_216.333333	4	70	0	66	66	1.0000000
NODE_310273_length_102_cov_216.333333	43	92	0	49	49	1.0000000
NODE_310273_length_102_cov_216.333333	57	102	0	45	45	1.0000000
NODE_310287_length_102_cov_152.333333	0	63	0	63	63	1.0000000
NODE_310295_length_102_cov_124.333333	0	70	0	70	70	1.0000000
NODE_310302_length_102_cov_106.333333	0	78	0	78	78	1.0000000
NODE_310302_length_102_cov_106.333333	7	78	0	71	71	1.0000000
NODE_310302_length_102_cov_106.333333	12	78	0	66	66	1.0000000
NODE_310302_length_102_cov_106.333333	51	102	0	51	51	1.0000000
NODE_310302_length_102_cov_106.333333	51	102	0	51	51	1.0000000
NODE_310302_length_102_cov_106.333333	51	102	0	51	51	1.0000000
NODE_310316_length_102_cov_74.333333	31	99	0	68	68	1.0000000
NODE_310321_length_102_cov_71.000000	11	91	0	80	80	1.0000000
NODE_310336_length_102_cov_32.666667	0	65	0	65	65	1.0000000
NODE_310336_length_102_cov_32.666667	38	99	0	61	61	1.0000000
NODE_310405_length_101_cov_2217.000000	0	43	0	43	43	1.0000000
NODE_310405_length_101_cov_2217.000000	23	96	0	73	73	1.0000000
NODE_310464_length_101_cov_740.500000	2	66	0	64	64	1.0000000
NODE_310464_length_101_cov_740.500000	2	66	0	64	64	1.0000000
NODE_310464_length_101_cov_740.500000	2	66	0	64	64	1.0000000
NODE_310464_length_101_cov_740.500000	39	101	0	62	62	1.0000000
NODE_310464_length_101_cov_740.500000	55	101	0	46	46	1.0000000
NODE_310469_length_101_cov_701.000000	0	62	0	62	62	1.0000000
NODE_310469_length_101_cov_701.000000	35	99	0	64	64	1.0000000
NODE_310469_length_101_cov_701.000000	35	99	0	64	64	1.0000000
NODE_310469_length_101_cov_701.000000	35	99	0	64	64	1.0000000
NODE_310471_length_101_cov_679.000000	2	76	0	74	74	1.0000000
NODE_310500_length_101_cov_374.500000	2	50	0	48	48	1.0000000
NODE_310500_length_101_cov_374.500000	2	50	0	48	48	1.0000000
NODE_310500_length_101_cov_374.500000	2	50	0	48	48	1.0000000
NODE_310500_length_101_cov_374.500000	23	89	0	66	66	1.0000000
NODE_310500_length_101_cov_374.500000	23	94	0	71	71	1.0000000
NODE_310516_length_101_cov_294.000000	4	52	0	48	48	1.0000000
NODE_310516_length_101_cov_294.000000	4	52	0	48	48	1.0000000
NODE_310516_length_101_cov_294.000000	4	52	0	48	48	1.0000000
NODE_310516_length_101_cov_294.000000	25	91	0	66	66	1.0000000
NODE_310516_length_101_cov_294.000000	25	96	0	71	71	1.0000000
NODE_310529_length_101_cov_230.500000	2	76	0	74	74	1.0000000
NODE_310529_length_101_cov_230.500000	2	76	0	74	74	1.0000000
NODE_310529_length_101_cov_230.500000	2	76	0	74	74	1.0000000
NODE_310529_length_101_cov_230.500000	49	101	0	52	52	1.0000000
NODE_310529_length_101_cov_230.500000	55	101	0	46	46	1.0000000
NODE_310550_length_101_cov_157.000000	13	72	0	59	59	1.0000000
NODE_310550_length_101_cov_157.000000	46	72	0	26	26	1.0000000
NODE_310565_length_101_cov_134.500000	2	37	0	35	35	1.0000000
NODE_310685_length_100_cov_1883.000000	32	100	0	68	68	1.0000000
NODE_310685_length_100_cov_1883.000000	32	100	0	68	68	1.0000000
NODE_310685_length_100_cov_1883.000000	32	99	0	67	67	1.0000000
NODE_310685_length_100_cov_1883.000000	32	100	0	68	68	1.0000000
NODE_310704_length_100_cov_1310.000000	0	42	0	42	42	1.0000000
NODE_310704_length_100_cov_1310.000000	1	42	0	41	41	1.0000000
NODE_310704_length_100_cov_1310.000000	38	100	0	62	62	1.0000000
NODE_310704_length_100_cov_1310.000000	38	95	0	57	57	1.0000000
NODE_310704_length_100_cov_1310.000000	38	100	0	62	62	1.0000000
NODE_310704_length_100_cov_1310.000000	38	100	0	62	62	1.0000000
NODE_310708_length_100_cov_1239.000000	1	48	0	47	47	1.0000000
NODE_310740_length_100_cov_694.000000	0	62	0	62	62	1.0000000
NODE_310740_length_100_cov_694.000000	0	62	0	62	62	1.0000000
NODE_310740_length_100_cov_694.000000	35	100	0	65	65	1.0000000
NODE_310748_length_100_cov_602.000000	0	57	0	57	57	1.0000000
NODE_310750_length_100_cov_590.000000	0	58	0	58	58	1.0000000
NODE_310798_length_100_cov_274.000000	1	67	0	66	66	1.0000000
NODE_310798_length_100_cov_274.000000	1	67	0	66	66	1.0000000
NODE_310798_length_100_cov_274.000000	1	67	0	66	66	1.0000000
NODE_310798_length_100_cov_274.000000	40	100	0	60	60	1.0000000
NODE_310798_length_100_cov_274.000000	54	100	0	46	46	1.0000000
NODE_310808_length_100_cov_217.000000	4	75	0	71	71	1.0000000
NODE_310808_length_100_cov_217.000000	9	75	0	66	66	1.0000000
NODE_310808_length_100_cov_217.000000	48	99	0	51	51	1.0000000
NODE_310808_length_100_cov_217.000000	48	99	0	51	51	1.0000000
NODE_310808_length_100_cov_217.000000	48	99	0	51	51	1.0000000
NODE_310810_length_100_cov_209.000000	1	44	0	43	43	1.0000000
NODE_310810_length_100_cov_209.000000	40	100	0	60	60	1.0000000
NODE_310810_length_100_cov_209.000000	40	100	0	60	60	1.0000000
NODE_310819_length_100_cov_185.000000	0	46	0	46	46	1.0000000
NODE_310819_length_100_cov_185.000000	9	58	0	49	49	1.0000000
NODE_310819_length_100_cov_185.000000	31	99	0	68	68	1.0000000
NODE_310819_length_100_cov_185.000000	31	99	0	68	68	1.0000000
NODE_310819_length_100_cov_185.000000	31	99	0	68	68	1.0000000
NODE_310828_length_100_cov_164.000000	9	92	0	83	83	1.0000000
NODE_310837_length_100_cov_152.000000	11	91	0	80	80	1.0000000
NODE_310837_length_100_cov_152.000000	11	91	0	80	80	1.0000000
NODE_310837_length_100_cov_152.000000	11	91	0	80	80	1.0000000
NODE_310837_length_100_cov_152.000000	11	91	0	80	80	1.0000000
NODE_310837_length_100_cov_152.000000	11	91	0	80	80	1.0000000
NODE_310839_length_100_cov_150.000000	0	54	0	54	54	1.0000000
NODE_310839_length_100_cov_150.000000	0	54	0	54	54	1.0000000
NODE_310839_length_100_cov_150.000000	27	100	0	73	73	1.0000000
NODE_310839_length_100_cov_150.000000	27	100	0	73	73	1.0000000
NODE_310840_length_100_cov_148.000000	2	82	0	80	80	1.0000000
NODE_310841_length_100_cov_148.000000	0	71	0	71	71	1.0000000
NODE_310841_length_100_cov_148.000000	0	71	0	71	71	1.0000000
NODE_310841_length_100_cov_148.000000	0	62	0	62	62	1.0000000
NODE_310876_length_100_cov_71.000000	0	75	0	75	75	1.0000000
NODE_310876_length_100_cov_71.000000	4	75	0	71	71	1.0000000
NODE_310876_length_100_cov_71.000000	9	75	0	66	66	1.0000000
NODE_310876_length_100_cov_71.000000	48	100	0	52	52	1.0000000
NODE_310876_length_100_cov_71.000000	48	100	0	52	52	1.0000000
NODE_310876_length_100_cov_71.000000	48	100	0	52	52	1.0000000
NODE_310896_length_100_cov_41.000000	0	75	0	75	75	1.0000000
NODE_310896_length_100_cov_41.000000	4	75	0	71	71	1.0000000
NODE_310896_length_100_cov_41.000000	9	75	0	66	66	1.0000000
NODE_310896_length_100_cov_41.000000	48	99	0	51	51	1.0000000
NODE_310896_length_100_cov_41.000000	48	99	0	51	51	1.0000000
NODE_310896_length_100_cov_41.000000	48	99	0	51	51	1.0000000
NODE_310904_length_100_cov_30.000000	1	42	0	41	41	1.0000000
